account,age,amount,balance,card_present_flag,customer_id,date,first_name,gender,latitude,longitude,merchant_code,merchant_id,merchant_latitude,merchant_longitude,merchant_state,merchant_suburb,movement,status,transaction_id,txn_description,bin_age,year,month,day,hour,minute,dow,payment_period,annual_salary
ACC-1598451071,26,16.25,35.39,1.0,CUS-2487424745,2018-08-01,Diana,F,-27.95,153.41,,81c48296-73be-44a7-befa-d053f48ce7cd,-27.99,153.38,QLD,Ashmore,debit,authorized,a623070bfead4541a6b0fff8a09e706c,POS,20-30,2018,8,1,1,1,Wednesday,7 days,52855.65
ACC-1598451071,26,14.19,21.2,0.0,CUS-2487424745,2018-08-01,Diana,F,-27.95,153.41,,830a451c-316e-4a6a-bf25-e37caedca49e,-33.87,151.21,NSW,Sydney,debit,authorized,13270a2a902145da9db4c951e04b51b9,SALES-POS,20-30,2018,8,1,1,13,Wednesday,7 days,52855.65
ACC-1598451071,26,3.25,17.95,1.0,CUS-2487424745,2018-08-01,Diana,F,-27.95,153.41,,b4e02c10-0852-4273-b8fd-7b3395e32eb0,-28.06,153.44,QLD,Mermaid Beach,debit,authorized,329adf79878c4cf0aeb4188b4691c266,SALES-POS,20-30,2018,8,1,1,51,Wednesday,7 days,52855.65
ACC-1598451071,26,14.1,3.85,1.0,CUS-2487424745,2018-08-01,Diana,F,-27.95,153.41,,f2ef6270-cf91-409f-a6a2-fbd6735ea500,-28.63,153.6,NSW,Byron Bay,debit,authorized,1c12c9ad77894ef8b507fb091e41e928,POS,20-30,2018,8,1,8,9,Wednesday,7 days,52855.65
ACC-1598451071,26,10.67,1006.85,1.0,CUS-2487424745,2018-08-01,Diana,F,-27.95,153.41,,44abc19c-aa5c-40bd-b1d0-9b2f236189ea,-28.01,153.41,QLD,Bundall,debit,authorized,cd0113426970425a8524e55f4079408f,POS,20-30,2018,8,1,18,19,Wednesday,7 days,52855.65
ACC-1598451071,26,11.28,995.57,0.0,CUS-2487424745,2018-08-01,Diana,F,-27.95,153.41,,73aac058-cb31-46c2-826d-29b161bfb23e,-28.13,153.47,QLD,Elanora,debit,authorized,9a13829c885344c3ad6c6f1a2d30d1bc,SALES-POS,20-30,2018,8,1,19,33,Wednesday,7 days,52855.65
ACC-1598451071,26,8.99,986.58,0.0,CUS-2487424745,2018-08-01,Diana,F,-27.95,153.41,,d87e2b48-3fc5-47e4-87c5-014e56e493df,-28.13,153.47,QLD,Elanora,debit,authorized,e1949cb88eb74ad1b0391347a221e938,POS,20-30,2018,8,1,21,38,Wednesday,7 days,52855.65
ACC-1598451071,26,10.32,976.26,1.0,CUS-2487424745,2018-08-01,Diana,F,-27.95,153.41,,4345dbd1-dfa8-4466-892a-4136a5ae08a2,-27.94,153.41,QLD,Labrador,debit,authorized,e9ff93190c9a4a088994e0f74b02e953,POS,20-30,2018,8,1,22,25,Wednesday,7 days,52855.65
ACC-1598451071,26,8.11,968.15,1.0,CUS-2487424745,2018-08-02,Diana,F,-27.95,153.41,,f74ba6f1-102d-407b-a9e8-3008ad72cdf7,-28.09,153.45,QLD,Burleigh Heads,debit,authorized,61c858d71c9a4d40b66be9368076c940,SALES-POS,20-30,2018,8,2,8,42,Thursday,7 days,52855.65
ACC-1598451071,26,11.23,956.92,1.0,CUS-2487424745,2018-08-02,Diana,F,-27.95,153.41,,2b8320d0-06eb-46af-96d4-b4af7128ae91,-27.97,153.4,QLD,Labrador,debit,authorized,4b3f555adc0b4ff095c31458032e0577,POS,20-30,2018,8,2,9,46,Thursday,7 days,52855.65
ACC-1598451071,26,7.7,949.22,1.0,CUS-2487424745,2018-08-02,Diana,F,-27.95,153.41,,6a7723ac-8d34-4c11-a889-86425efdc1d5,-27.76,153.24,QLD,Ormeau,debit,authorized,4c418372cfd14a57a660a72376352f8a,SALES-POS,20-30,2018,8,2,9,54,Thursday,7 days,52855.65
ACC-1598451071,26,7.99,941.23,1.0,CUS-2487424745,2018-08-02,Diana,F,-27.95,153.41,,3ae539ca-2824-413c-b978-e87360b047ea,-27.91,153.4,QLD,Runaway Bay,debit,authorized,d47344bec5d3402aaee51e924368bd66,POS,20-30,2018,8,2,11,6,Thursday,7 days,52855.65
ACC-1598451071,26,9.47,931.76,1.0,CUS-2487424745,2018-08-02,Diana,F,-27.95,153.41,,ba6beee7-3cb0-49af-8d8f-d82fa84eac35,-28.65,153.6,NSW,Byron Bay,debit,authorized,1e9be2b1da234ed7b2268a6d542f1909,SALES-POS,20-30,2018,8,2,11,12,Thursday,7 days,52855.65
ACC-1598451071,26,195.0,736.76,,CUS-2487424745,2018-08-03,Diana,F,-27.95,153.41,,,,,,,debit,posted,041d726721d442a0a1ac610404774518,PAYMENT,20-30,2018,8,3,6,0,Friday,7 days,52855.65
ACC-1598451071,26,15.3,721.46,1.0,CUS-2487424745,2018-08-03,Diana,F,-27.95,153.41,,450aeceb-610b-4da2-b87f-1a515a10ef90,-27.96,153.41,QLD,Gold Coast,debit,authorized,0ac4a7a21d174767a766714145de697d,POS,20-30,2018,8,3,8,41,Friday,7 days,52855.65
ACC-1598451071,26,8.99,712.47,1.0,CUS-2487424745,2018-08-03,Diana,F,-27.95,153.41,,95cdffb0-3918-4ab1-bd23-a280ce15740d,-27.97,153.41,QLD,Southport,debit,authorized,56adfd3d5e1943ae844e8f930d3bc4c3,SALES-POS,20-30,2018,8,3,9,40,Friday,7 days,52855.65
ACC-1598451071,26,7.61,704.86,1.0,CUS-2487424745,2018-08-03,Diana,F,-27.95,153.41,,036c91ee-e290-4a2d-abcf-3ab1b6a07178,-27.96,153.38,QLD,Parkwood,debit,authorized,cacb53b6868947c48c72feb3d27725fa,SALES-POS,20-30,2018,8,3,9,52,Friday,7 days,52855.65
ACC-1598451071,26,2.08,702.78,0.0,CUS-2487424745,2018-08-03,Diana,F,-27.95,153.41,,1f91ac18-372f-40b5-bbf8-5a3580e8fa1b,-27.68,153.24,QLD,Carbrook,debit,authorized,95dfc6684cf144ecb038265af7f1c04c,SALES-POS,20-30,2018,8,3,11,4,Friday,7 days,52855.65
ACC-1598451071,26,11.29,691.49,1.0,CUS-2487424745,2018-08-03,Diana,F,-27.95,153.41,,b702b424-41ca-4827-8e3f-376aa91d210c,-27.52,153.29,QLD,Cleveland,debit,authorized,c74928b540494a29b16e4b83a7387da8,SALES-POS,20-30,2018,8,3,14,8,Friday,7 days,52855.65
ACC-1598451071,26,11.28,680.21,1.0,CUS-2487424745,2018-08-03,Diana,F,-27.95,153.41,,a9e009b8-fb6f-4dc7-97fa-3d4504ab7f4c,-28.09,153.45,QLD,Burleigh Heads,debit,authorized,368dd989cdbe4780a2b26107c4a82879,POS,20-30,2018,8,3,14,56,Friday,7 days,52855.65
ACC-1598451071,26,21.58,658.63,1.0,CUS-2487424745,2018-08-03,Diana,F,-27.95,153.41,,05b25c4a-c4dc-4662-9ddf-2e943553b0c2,-28.81,153.29,NSW,Lismore,debit,authorized,8f7df097432048d589851a864f9f9631,POS,20-30,2018,8,3,21,8,Friday,7 days,52855.65
ACC-1598451071,26,3.48,655.15,1.0,CUS-2487424745,2018-08-03,Diana,F,-27.95,153.41,,462e0fdf-e5b3-4d45-ad35-a6d3accb1843,-27.87,153.34,QLD,Hope Island,debit,authorized,353b2e7565c744a6bcdfac39ef3b6cd6,POS,20-30,2018,8,3,21,45,Friday,7 days,52855.65
ACC-1598451071,26,45.05,610.1,1.0,CUS-2487424745,2018-08-03,Diana,F,-27.95,153.41,,8fdb5fa1-582e-427b-9898-5bd6d3b82311,-28.3,153.57,NSW,Casuarina,debit,authorized,845f4820b2284a6bb927cd2b3baf34af,POS,20-30,2018,8,3,22,33,Friday,7 days,52855.65
ACC-1598451071,26,22.23,587.87,1.0,CUS-2487424745,2018-08-04,Diana,F,-27.95,153.41,,324eaa2a-4b1a-470b-a923-b94e72b7a8c2,-27.86,153.31,QLD,Upper Coomera,debit,authorized,c1534bac40344744b272fc08140e9696,SALES-POS,20-30,2018,8,4,4,41,Saturday,7 days,52855.65
ACC-1598451071,26,30.44,557.43,0.0,CUS-2487424745,2018-08-04,Diana,F,-27.95,153.41,,75b65ffc-1abf-4fae-9ab9-44a41247bb5a,-27.89,153.31,QLD,Oxenford,debit,authorized,2e019304a1bd47dc992d21255b24e165,SALES-POS,20-30,2018,8,4,9,33,Saturday,7 days,52855.65
ACC-1598451071,26,11.22,546.21,1.0,CUS-2487424745,2018-08-04,Diana,F,-27.95,153.41,,34d6657a-ebdf-489d-bb90-86dcf4d94639,-28.09,153.39,QLD,Robina,debit,authorized,15eef4224ab34d2bbd3151ba53c17327,SALES-POS,20-30,2018,8,4,10,44,Saturday,7 days,52855.65
ACC-1598451071,26,7.59,538.62,0.0,CUS-2487424745,2018-08-04,Diana,F,-27.95,153.41,,f4435455-d276-40ae-b24f-a4a6fbbe9916,-27.52,153.22,QLD,Alexandra Hills,debit,authorized,229e4e36180f4b388c8f215f797cf520,SALES-POS,20-30,2018,8,4,11,19,Saturday,7 days,52855.65
ACC-1598451071,26,2.0,536.62,1.0,CUS-2487424745,2018-08-04,Diana,F,-27.95,153.41,,a4d581b4-de41-47ae-9f1a-810a14dd318d,-27.49,152.97,QLD,Taringa,debit,authorized,a3a4f952a03040a98655205939a3f078,POS,20-30,2018,8,4,19,38,Saturday,7 days,52855.65
ACC-1598451071,26,8.09,528.53,0.0,CUS-2487424745,2018-08-04,Diana,F,-27.95,153.41,,248b0daa-3681-4ce7-aa87-60941e754b15,-28.17,153.53,QLD,Coolangatta,debit,authorized,28bcde4a2850428f84411c555b5c1d97,POS,20-30,2018,8,4,21,59,Saturday,7 days,52855.65
ACC-1598451071,26,11.48,517.05,0.0,CUS-2487424745,2018-08-05,Diana,F,-27.95,153.41,,d22c0bb7-5406-403f-a9bc-3e4d01f51df8,-33.85,151.03,NSW,Auburn,debit,authorized,7809827d85fc457d823cf80f0def3b6d,SALES-POS,20-30,2018,8,5,9,20,Sunday,7 days,52855.65
ACC-1598451071,26,2.85,514.2,1.0,CUS-2487424745,2018-08-05,Diana,F,-27.95,153.41,,52b227bb-c320-4201-8d08-e293e6d2e801,-28.87,153.56,NSW,Ballina,debit,authorized,3bf0b7a958334b5488334f0544556c7e,POS,20-30,2018,8,5,9,49,Sunday,7 days,52855.65
ACC-1598451071,26,7.54,506.66,1.0,CUS-2487424745,2018-08-05,Diana,F,-27.95,153.41,,45355f04-c1e4-41ca-93fd-a0e715b6e7f2,-27.93,153.34,QLD,Helensvale,debit,authorized,19330f81930843e1a00bcdffc649e17c,SALES-POS,20-30,2018,8,5,10,1,Sunday,7 days,52855.65
ACC-1598451071,26,17.71,488.95,1.0,CUS-2487424745,2018-08-05,Diana,F,-27.95,153.41,,05ab196b-f42c-4738-9d5a-bfd8b17055e2,-28.04,153.43,QLD,Mermaid Waters,debit,authorized,1fd8923bcbbd4746a952ff058497e93f,SALES-POS,20-30,2018,8,5,10,21,Sunday,7 days,52855.65
ACC-1598451071,26,33.82,455.13,1.0,CUS-2487424745,2018-08-06,Diana,F,-27.95,153.41,,d7160c68-7371-411c-aa52-9c0f39f5fff1,-34.77,138.63,SA,Salisbury Downs,debit,authorized,0c934978824040bc81bcb5a4cf4876cf,POS,20-30,2018,8,6,13,39,Monday,7 days,52855.65
ACC-1598451071,26,9.76,445.37,0.0,CUS-2487424745,2018-08-06,Diana,F,-27.95,153.41,,77aa0b0c-c684-4ae9-b387-8017dd022215,-28.26,153.58,NSW,Kingscliff,debit,authorized,913071e6b8254d648804c7ea5ffc0fb6,POS,20-30,2018,8,6,15,53,Monday,7 days,52855.65
ACC-1598451071,26,20.0,425.37,,CUS-2487424745,2018-08-07,Diana,F,-27.95,153.41,,,,,,,debit,posted,f0575037a5444f11a7947933b5659b17,INTER BANK,20-30,2018,8,7,2,0,Tuesday,7 days,52855.65
ACC-1598451071,26,36.0,389.37,,CUS-2487424745,2018-08-07,Diana,F,-27.95,153.41,,,,,,,debit,posted,7ddd508e3cb34b2f963003ab43a0c585,PAYMENT,20-30,2018,8,7,7,0,Tuesday,7 days,52855.65
ACC-1598451071,26,11.14,378.23,1.0,CUS-2487424745,2018-08-07,Diana,F,-27.95,153.41,,430c23a4-b449-4225-8c79-d7f274810e6e,-27.93,153.38,QLD,Arundel,debit,authorized,d7e77760b4d74382bf4610142e1aa48b,POS,20-30,2018,8,7,8,13,Tuesday,7 days,52855.65
ACC-1598451071,26,7.85,370.38,1.0,CUS-2487424745,2018-08-07,Diana,F,-27.95,153.41,,6a7723ac-8d34-4c11-a889-86425efdc1d5,-27.76,153.24,QLD,Ormeau,debit,authorized,64168ea78a73489d8a5c15d59a477c96,POS,20-30,2018,8,7,10,57,Tuesday,7 days,52855.65
ACC-1598451071,26,9.43,360.95,1.0,CUS-2487424745,2018-08-07,Diana,F,-27.95,153.41,,592ca063-02f5-437c-95e9-12818d48d3f7,-28.64,153.61,NSW,Byron Bay,debit,authorized,e324b43c055142d79013ecf1df4f3718,SALES-POS,20-30,2018,8,7,12,41,Tuesday,7 days,52855.65
ACC-1598451071,26,5.55,355.4,1.0,CUS-2487424745,2018-08-07,Diana,F,-27.95,153.41,,70a06eee-8c34-4bb2-a664-c962c5277930,-28.12,153.47,QLD,Palm Beach,debit,authorized,61896aa3b51842d9a7fc7c251e133efa,POS,20-30,2018,8,7,13,46,Tuesday,7 days,52855.65
ACC-1598451071,26,2.49,352.91,1.0,CUS-2487424745,2018-08-07,Diana,F,-27.95,153.41,,462e0fdf-e5b3-4d45-ad35-a6d3accb1843,-27.87,153.34,QLD,Hope Island,debit,authorized,78c1b7a9b2e94b2e8a71ae535af09f9b,SALES-POS,20-30,2018,8,7,15,26,Tuesday,7 days,52855.65
ACC-1598451071,26,11.27,341.64,1.0,CUS-2487424745,2018-08-07,Diana,F,-27.95,153.41,,9e569918-b62e-4730-a005-63940408281d,-28.06,153.44,QLD,Mermaid Beach,debit,authorized,55a63f6a55de45db806f7cd6710dbb16,POS,20-30,2018,8,7,15,43,Tuesday,7 days,52855.65
ACC-1598451071,26,8.4,333.24,1.0,CUS-2487424745,2018-08-07,Diana,F,-27.95,153.41,,0981935d-e304-4561-a782-c1b92474fee7,-27.97,153.4,QLD,Southport,debit,authorized,420538400675468fa80db95861c14023,SALES-POS,20-30,2018,8,7,18,9,Tuesday,7 days,52855.65
ACC-1598451071,26,3.26,329.98,1.0,CUS-2487424745,2018-08-07,Diana,F,-27.95,153.41,,08a01651-1bce-4462-ae8f-28d4b8660ca1,-28.12,153.47,QLD,Palm Beach,debit,authorized,13f26af3b47846c38d95f65f0765b870,SALES-POS,20-30,2018,8,7,19,10,Tuesday,7 days,52855.65
ACC-1598451071,26,7.57,1336.08,1.0,CUS-2487424745,2018-08-08,Diana,F,-27.95,153.41,,df4c4458-6b98-4e47-b245-e5566889929f,-27.85,153.3,QLD,Upper Coomera,debit,authorized,06e14931214a43f4aa5fc965ccaf20c3,POS,20-30,2018,8,8,16,19,Wednesday,7 days,52855.65
ACC-1598451071,26,5.81,1330.27,0.0,CUS-2487424745,2018-08-09,Diana,F,-27.95,153.41,,42aa7120-55a4-4f80-95b5-0a49f69ace7b,-27.96,153.4,QLD,Southport,debit,authorized,900fa95f73ef43608ff7efdeefcaca8d,POS,20-30,2018,8,9,15,7,Thursday,7 days,52855.65
ACC-1598451071,26,19.58,1310.69,1.0,CUS-2487424745,2018-08-09,Diana,F,-27.95,153.41,,84a31a99-0d2e-43c6-aa6c-dbf46b9ebac0,-28.08,153.39,QLD,Robina,debit,authorized,12ebaa4f00b94709b94741bff98c3ae9,SALES-POS,20-30,2018,8,9,15,37,Thursday,7 days,52855.65
ACC-1598451071,26,92.0,1218.69,,CUS-2487424745,2018-08-09,Diana,F,-27.95,153.41,,,,,,,debit,posted,c7fce5692d1a4395bad0bed9190450dc,INTER BANK,20-30,2018,8,9,16,0,Thursday,7 days,52855.65
ACC-1598451071,26,9.67,1209.02,0.0,CUS-2487424745,2018-08-09,Diana,F,-27.95,153.41,,c9aac2c8-cce7-42c4-b27b-292ff1c527de,-28.07,153.35,QLD,Tallai,debit,authorized,22d54c5542b648f6b0a0fd9e73467bae,POS,20-30,2018,8,9,19,28,Thursday,7 days,52855.65
ACC-1598451071,26,3.01,1206.01,1.0,CUS-2487424745,2018-08-09,Diana,F,-27.95,153.41,,f8ed9a68-00cf-41ea-9ea9-4458ae8451f2,-27.85,153.34,QLD,Coomera,debit,authorized,fee0448b547a48ffbc2427b5faf6790a,POS,20-30,2018,8,9,20,51,Thursday,7 days,52855.65
ACC-1598451071,26,4.03,1201.98,1.0,CUS-2487424745,2018-08-09,Diana,F,-27.95,153.41,,3f3477b8-9140-472e-98b8-35d5f6137ee3,-28.57,153.53,NSW,Brunswick Heads,debit,authorized,3d45e4cdbc5948369687500f45370d27,SALES-POS,20-30,2018,8,9,21,30,Thursday,7 days,52855.65
ACC-1598451071,26,4.02,1197.96,1.0,CUS-2487424745,2018-08-10,Diana,F,-27.95,153.41,,0db41b51-10e9-49d0-b6bd-2bb840dd76a9,-27.86,153.31,QLD,Coomera,debit,authorized,6c34778caf934f2c98d1e02320b685d9,POS,20-30,2018,8,10,1,12,Friday,7 days,52855.65
ACC-1598451071,26,6.38,1191.58,1.0,CUS-2487424745,2018-08-10,Diana,F,-27.95,153.41,,6ec8d30a-238b-4780-9ad5-b3522e4d5d06,-27.74,153.22,QLD,Yatala,debit,authorized,e42df6266c784b349d44ff10f297b54b,SALES-POS,20-30,2018,8,10,1,33,Friday,7 days,52855.65
ACC-1598451071,26,9.4,1182.18,1.0,CUS-2487424745,2018-08-10,Diana,F,-27.95,153.41,,1398e27b-ea17-4a5b-bc57-2bc2a8971e49,-27.8,153.1,QLD,Logan Village,debit,authorized,d1823cff86ab429d9767fb895e44078b,SALES-POS,20-30,2018,8,10,2,21,Friday,7 days,52855.65
ACC-1598451071,26,8.83,1173.35,1.0,CUS-2487424745,2018-08-10,Diana,F,-27.95,153.41,,8d3e868f-f125-4bda-99d8-4a7dc760b94d,-28.11,153.41,QLD,Reedy Creek,debit,authorized,5cc812fae6db4dd59b2681d1b75dd061,POS,20-30,2018,8,10,12,22,Friday,7 days,52855.65
ACC-1598451071,26,5.34,1168.01,1.0,CUS-2487424745,2018-08-10,Diana,F,-27.95,153.41,,664250bc-4ca4-4fa3-9a6a-d55e1609e2e7,-27.96,153.38,QLD,Southport,debit,authorized,ed1713aa549e40d69e7b65595e9f41da,POS,20-30,2018,8,10,13,32,Friday,7 days,52855.65
ACC-1598451071,26,6.59,1161.42,1.0,CUS-2487424745,2018-08-10,Diana,F,-27.95,153.41,,ae5366f9-cc5a-4d42-afb4-24d070b3cb24,-29.43,153.33,NSW,Yamba,debit,authorized,b6fdeb1b787b43d3ad8c6e57cf637b59,POS,20-30,2018,8,10,19,48,Friday,7 days,52855.65
ACC-1598451071,26,9.15,1152.27,0.0,CUS-2487424745,2018-08-10,Diana,F,-27.95,153.41,,3276a7a6-7fba-4312-a45d-5f2d27f6a55f,-27.98,153.41,QLD,Southport,debit,authorized,37a7682616af461db27831026e7a82dc,SALES-POS,20-30,2018,8,10,21,17,Friday,7 days,52855.65
ACC-1598451071,26,3.01,1149.26,1.0,CUS-2487424745,2018-08-10,Diana,F,-27.95,153.41,,9da2c9c4-5b1b-4a83-88f2-97c81f21c562,-27.51,153.05,QLD,Greenslopes,debit,authorized,96897b409f944dcc981211460dea2416,POS,20-30,2018,8,10,21,23,Friday,7 days,52855.65
ACC-1598451071,26,8.91,1140.35,1.0,CUS-2487424745,2018-08-10,Diana,F,-27.95,153.41,,dd29f230-3c0d-44c7-9267-83f10696bbd2,-27.99,153,QLD,Beaudesert,debit,authorized,1d506a04f0004f6f8d079f29eb23c05a,POS,20-30,2018,8,10,21,41,Friday,7 days,52855.65
ACC-1598451071,26,6.9,1133.45,1.0,CUS-2487424745,2018-08-10,Diana,F,-27.95,153.41,,2e0d3b49-8348-4697-ad34-ecc1303494de,-27.98,153.42,QLD,Main Beach,debit,authorized,69e923af03614ba68093a26670029d7b,SALES-POS,20-30,2018,8,10,21,47,Friday,7 days,52855.65
ACC-1598451071,26,13.21,1120.24,1.0,CUS-2487424745,2018-08-10,Diana,F,-27.95,153.41,,bc646123-57a9-4b89-9d9d-90f75c28e41e,-27.77,153.24,QLD,Ormeau,debit,authorized,229b7f0814c54e17a46ffe20127bccdf,POS,20-30,2018,8,10,23,36,Friday,7 days,52855.65
ACC-1598451071,26,6.31,1113.93,1.0,CUS-2487424745,2018-08-11,Diana,F,-27.95,153.41,,91a7806c-a87e-4187-adcf-466565f3c7a4,-28.05,153.41,QLD,Mermaid Waters,debit,authorized,55569919eb9a476e96a2d99d085d4335,SALES-POS,20-30,2018,8,11,8,2,Saturday,7 days,52855.65
ACC-1598451071,26,10.62,1103.31,1.0,CUS-2487424745,2018-08-11,Diana,F,-27.95,153.41,,a6f73114-758b-47d9-a7f1-cd084a2d74d6,-27.86,153.35,QLD,Hope Island,debit,authorized,ee9d955a38e84e36910437560cdcce52,POS,20-30,2018,8,11,14,51,Saturday,7 days,52855.65
ACC-1598451071,26,11.65,1091.66,1.0,CUS-2487424745,2018-08-11,Diana,F,-27.95,153.41,,803f3eb6-97e0-4d0f-961f-53168b5de7f5,-27.76,153.33,QLD,Woongoolba,debit,authorized,dae34d2367c144a6a4a8af9d90e921f6,SALES-POS,20-30,2018,8,11,14,58,Saturday,7 days,52855.65
ACC-1598451071,26,8.61,1083.05,1.0,CUS-2487424745,2018-08-11,Diana,F,-27.95,153.41,,f75cba91-43f5-48cb-83ac-c4c2254e0028,-28.85,153.45,NSW,Alstonville,debit,authorized,66af8d9f866244c187127002177b2747,SALES-POS,20-30,2018,8,11,15,20,Saturday,7 days,52855.65
ACC-1598451071,26,14.17,1068.88,1.0,CUS-2487424745,2018-08-11,Diana,F,-27.95,153.41,,06beb97d-453e-40d1-bab2-0a60d374fbdd,-27.93,153.34,QLD,Helensvale,debit,authorized,5ca017fe8f8b4364a9cb53bec5710110,SALES-POS,20-30,2018,8,11,21,1,Saturday,7 days,52855.65
ACC-1598451071,26,19.64,1049.24,1.0,CUS-2487424745,2018-08-11,Diana,F,-27.95,153.41,,5257cedb-4dfe-4584-9352-73b88ba737f8,-27.7,152.67,QLD,Willowbank,debit,authorized,bf4beb3992c2447db070a6ba8176f3b4,POS,20-30,2018,8,11,21,5,Saturday,7 days,52855.65
ACC-1598451071,26,6.51,1042.73,1.0,CUS-2487424745,2018-08-11,Diana,F,-27.95,153.41,,b5710e25-2a62-4c66-ae67-230befcf698d,-28.11,153.46,QLD,Palm Beach,debit,authorized,e6392f8fe90245ee9ae4c6599cd670b5,SALES-POS,20-30,2018,8,11,23,15,Saturday,7 days,52855.65
ACC-1598451071,26,14.86,1027.87,1.0,CUS-2487424745,2018-08-11,Diana,F,-27.95,153.41,,b16fad42-e29d-461c-9b88-207d0cbee2d8,-27.51,153.03,QLD,Annerley,debit,authorized,96be4dcc8e994f61a86f475fc10e3427,SALES-POS,20-30,2018,8,11,23,42,Saturday,7 days,52855.65
ACC-1598451071,26,209.16,818.71,1.0,CUS-2487424745,2018-08-12,Diana,F,-27.95,153.41,,d00d2c9a-883a-4564-806f-54b6533d5472,-33.87,151.21,NSW,Sydney,debit,authorized,9ae35a7ad1c448a48d675ef232ea07f7,SALES-POS,20-30,2018,8,12,9,43,Sunday,7 days,52855.65
ACC-1598451071,26,4.88,813.83,1.0,CUS-2487424745,2018-08-12,Diana,F,-27.95,153.41,,13a86f3d-9de1-4ab0-9700-e31af20b9133,-27.87,153.33,QLD,Coomera,debit,authorized,76f3bcee72384302b4665bd6e6082989,SALES-POS,20-30,2018,8,12,12,27,Sunday,7 days,52855.65
ACC-1598451071,26,9.87,803.96,1.0,CUS-2487424745,2018-08-12,Diana,F,-27.95,153.41,,2eb7ecb2-f70e-4578-8bfe-59d6308596ba,-27.47,153.03,QLD,Brisbane City,debit,authorized,e909a6a4fefc4e2b8f7e4ecf8cb5f267,SALES-POS,20-30,2018,8,12,13,25,Sunday,7 days,52855.65
ACC-1598451071,26,6.01,797.95,1.0,CUS-2487424745,2018-08-12,Diana,F,-27.95,153.41,,be172563-5944-47ae-ad39-c01576a33450,-37.82,144.97,VIC,Melbourne,debit,authorized,a5b266c0900b453fbe71491650b88755,POS,20-30,2018,8,12,16,39,Sunday,7 days,52855.65
ACC-1598451071,26,2.89,795.06,1.0,CUS-2487424745,2018-08-12,Diana,F,-27.95,153.41,,9c7e1fd1-943f-4c33-ac5a-736c3b81e307,-28.12,153.47,QLD,Palm Beach,debit,authorized,a9a375f5f9ee466d9b3ec5f88a70333e,SALES-POS,20-30,2018,8,12,20,53,Sunday,7 days,52855.65
ACC-1598451071,26,43.91,751.15,1.0,CUS-2487424745,2018-08-12,Diana,F,-27.95,153.41,,9ebd2935-4904-4580-9d45-1c8122e30afc,-27.82,153.32,QLD,Pimpama,debit,authorized,f719c98a7c254fcc9890c5e41e7f927f,SALES-POS,20-30,2018,8,12,21,1,Sunday,7 days,52855.65
ACC-1598451071,26,7.49,743.66,1.0,CUS-2487424745,2018-08-12,Diana,F,-27.95,153.41,,b24fe67f-27b4-4336-9d7d-d931c55053d3,-28.03,153.42,QLD,Broadbeach Waters,debit,authorized,d6a346e3668741799d1e9ab429189c3b,SALES-POS,20-30,2018,8,12,21,39,Sunday,7 days,52855.65
ACC-1598451071,26,14.46,729.2,1.0,CUS-2487424745,2018-08-13,Diana,F,-27.95,153.41,,8450f2c4-45ce-41bc-aa05-25014aec43ee,-27.91,153.34,QLD,Helensvale,debit,authorized,48fbbc450d944adeb4209d9ea56860d4,POS,20-30,2018,8,13,9,41,Monday,7 days,52855.65
ACC-1598451071,26,16.77,712.43,1.0,CUS-2487424745,2018-08-13,Diana,F,-27.95,153.41,,983a6731-95b8-4566-a5d4-540189ad384b,-28.08,153.35,QLD,Mudgeeraba,debit,authorized,be7c121ec6ee49b78722b91c63dfbee4,POS,20-30,2018,8,13,10,13,Monday,7 days,52855.65
ACC-1598451071,26,32.99,679.44,1.0,CUS-2487424745,2018-08-13,Diana,F,-27.95,153.41,,f5ae2ba9-8ffc-4d9f-bb7f-4ef5439a096e,-27.76,153.23,QLD,Yatala,debit,authorized,6ef7df512f564caa924e5e96d7892a4b,SALES-POS,20-30,2018,8,13,10,21,Monday,7 days,52855.65
ACC-1598451071,26,11.61,667.83,1.0,CUS-2487424745,2018-08-13,Diana,F,-27.95,153.41,,16f75a10-939f-4d59-9eeb-fc87e424489c,-28.03,153.43,QLD,Broadbeach,debit,authorized,f4a6e510b0464d74a0a1c267b53614f6,POS,20-30,2018,8,13,10,46,Monday,7 days,52855.65
ACC-1598451071,26,6.97,660.86,1.0,CUS-2487424745,2018-08-13,Diana,F,-27.95,153.41,,86703c27-a871-4aab-ab19-5133e765c7dd,-28.09,153.42,QLD,Varsity Lakes,debit,authorized,c466176dcb414982bc67091055c4d1c2,SALES-POS,20-30,2018,8,13,11,9,Monday,7 days,52855.65
ACC-1598451071,26,42.0,618.86,1.0,CUS-2487424745,2018-08-13,Diana,F,-27.95,153.41,,2923fb5b-08fe-468c-8c95-e8529b75f52c,-28.87,153.56,NSW,Ballina,debit,authorized,9efccee0adc740f185b8142ce9abb846,POS,20-30,2018,8,13,19,22,Monday,7 days,52855.65
ACC-1598451071,26,5.67,613.19,0.0,CUS-2487424745,2018-08-13,Diana,F,-27.95,153.41,,9c722f27-2495-4ca1-a7ec-562652a3b98c,-27.92,153.36,QLD,Coombabah,debit,authorized,151bc7707d5d4c6aa4bda36b2e670fbe,POS,20-30,2018,8,13,20,17,Monday,7 days,52855.65
ACC-1598451071,26,11.24,601.95,1.0,CUS-2487424745,2018-08-13,Diana,F,-27.95,153.41,,c8aad76d-c301-46ff-a583-3e25822ef861,-28.12,153.45,QLD,Palm Beach,debit,authorized,717bd033c77145078ea62480030fff8f,POS,20-30,2018,8,13,20,33,Monday,7 days,52855.65
ACC-1598451071,26,12.64,589.31,0.0,CUS-2487424745,2018-08-13,Diana,F,-27.95,153.41,,9e569918-b62e-4730-a005-63940408281d,-28.06,153.44,QLD,Mermaid Beach,debit,authorized,6a87adbdc73345f6a7bc7cba1d9aed8a,SALES-POS,20-30,2018,8,13,21,16,Monday,7 days,52855.65
ACC-1598451071,26,3.55,585.76,1.0,CUS-2487424745,2018-08-13,Diana,F,-27.95,153.41,,e2064305-56ce-40e0-87fe-bdc819c3a026,-27.99,153.41,QLD,Southport,debit,authorized,d67c77c0956548b8a7b5f2a8e21db138,SALES-POS,20-30,2018,8,13,21,41,Monday,7 days,52855.65
ACC-1598451071,26,6.44,579.32,1.0,CUS-2487424745,2018-08-13,Diana,F,-27.95,153.41,,a5d2b1a8-57be-4f3b-90c5-6b0d08a6c5e9,-27.98,153.43,QLD,Main Beach,debit,authorized,4ecbc0b644c84676a9a9da4e2d72d921,SALES-POS,20-30,2018,8,13,22,15,Monday,7 days,52855.65
ACC-1598451071,26,20.0,559.32,,CUS-2487424745,2018-08-14,Diana,F,-27.95,153.41,,,,,,,debit,posted,c73ec90c9fa14290915adb97f90664a5,INTER BANK,20-30,2018,8,14,2,0,Tuesday,7 days,52855.65
ACC-1598451071,26,36.0,523.32,,CUS-2487424745,2018-08-14,Diana,F,-27.95,153.41,,,,,,,debit,posted,4e4bdd976ec349e8b825e8e8729f8f5d,PAYMENT,20-30,2018,8,14,7,0,Tuesday,7 days,52855.65
ACC-1598451071,26,15.09,508.23,1.0,CUS-2487424745,2018-08-14,Diana,F,-27.95,153.41,,a01f26fd-0a90-4522-9206-687a8091125c,-27.94,153.4,QLD,Labrador,debit,authorized,34ee211ea4e04e52a7f0e62e4b107dec,SALES-POS,20-30,2018,8,14,9,39,Tuesday,7 days,52855.65
ACC-1598451071,26,10.56,497.67,0.0,CUS-2487424745,2018-08-14,Diana,F,-27.95,153.41,,a7df322f-dfe8-48cc-855b-c0659f039b92,-27.97,153.41,QLD,Southport,debit,authorized,2d43fb0ddbe1461b85bb0e9c95709c64,SALES-POS,20-30,2018,8,14,9,56,Tuesday,7 days,52855.65
ACC-1598451071,26,71.12,426.55,0.0,CUS-2487424745,2018-08-14,Diana,F,-27.95,153.41,,52a3362e-2540-4d25-ae5d-f63e0e1db0c9,-27.51,152.95,QLD,Kenmore,debit,authorized,d1d45afbd30547228bb9d3bf409b7122,SALES-POS,20-30,2018,8,14,12,7,Tuesday,7 days,52855.65
ACC-1598451071,26,7.7,1432.52,1.0,CUS-2487424745,2018-08-15,Diana,F,-27.95,153.41,,78706e2c-6904-4f24-a43d-9bc9b2c49e4b,-27.89,153.39,QLD,Paradise Point,debit,authorized,9fae6be988924ddab741e823bb7115b2,POS,20-30,2018,8,15,15,51,Wednesday,7 days,52855.65
ACC-1598451071,26,7.71,1424.81,0.0,CUS-2487424745,2018-08-15,Diana,F,-27.95,153.41,,e2f60095-8c17-4069-bbcd-a9256238b34f,-27.99,153.38,QLD,Ashmore,debit,authorized,81ff5fe0b6bc4dd98c51563f7e4edc19,POS,20-30,2018,8,15,15,57,Wednesday,7 days,52855.65
ACC-1598451071,26,17.75,1407.06,1.0,CUS-2487424745,2018-08-15,Diana,F,-27.95,153.41,,b06e1ff9-4b61-4cec-b78a-eae9c8e2bb70,-27.89,153.31,QLD,Oxenford,debit,authorized,94ef1baddcd24aadae980f5df7a122f4,POS,20-30,2018,8,15,16,26,Wednesday,7 days,52855.65
ACC-1598451071,26,27.19,1379.87,1.0,CUS-2487424745,2018-08-15,Diana,F,-27.95,153.41,,e3a92a7a-0c39-4461-8899-25fb8a3843c2,-33.88,151.19,NSW,Ultimo,debit,authorized,d441d051c1ca49fda4e9b0873e730836,POS,20-30,2018,8,15,17,52,Wednesday,7 days,52855.65
ACC-1598451071,26,35.91,1256.01,1.0,CUS-2487424745,2018-08-17,Diana,F,-27.95,153.41,,b41dff2b-f395-418f-a84c-373dcb9f10de,-28.26,153.58,NSW,Kingscliff,debit,authorized,a45eaf1a5de04eaa9f6cc4d93c5cc47a,SALES-POS,20-30,2018,8,17,1,3,Friday,7 days,52855.65
ACC-1598451071,26,5.12,1250.89,1.0,CUS-2487424745,2018-08-17,Diana,F,-27.95,153.41,,10a7f6e6-cf60-4c99-8021-004293e7509f,-27.49,153.06,QLD,Coorparoo,debit,authorized,e7fe8f38e72143289e28c417b1b72a4b,POS,20-30,2018,8,17,1,21,Friday,7 days,52855.65
ACC-1598451071,26,5.14,1245.75,1.0,CUS-2487424745,2018-08-17,Diana,F,-27.95,153.41,,664250bc-4ca4-4fa3-9a6a-d55e1609e2e7,-27.96,153.38,QLD,Southport,debit,authorized,a234a7450ef54d869222e8a968027ed1,POS,20-30,2018,8,17,8,19,Friday,7 days,52855.65
ACC-1598451071,26,22.3,1223.45,1.0,CUS-2487424745,2018-08-18,Diana,F,-27.95,153.41,,bb114176-22b5-4fc2-b6cb-3878142c3e20,-27.76,150.25,QLD,Moonie,debit,authorized,8c6c7b45d380446b96e62f45d53169a0,SALES-POS,20-30,2018,8,18,11,41,Saturday,7 days,52855.65
ACC-1598451071,26,6.15,1217.3,1.0,CUS-2487424745,2018-08-18,Diana,F,-27.95,153.41,,3ae539ca-2824-413c-b978-e87360b047ea,-27.91,153.4,QLD,Runaway Bay,debit,authorized,965c5d1bbdcc4f27a12116979ecdef30,POS,20-30,2018,8,18,11,49,Saturday,7 days,52855.65
ACC-1598451071,26,35.03,1182.27,1.0,CUS-2487424745,2018-08-18,Diana,F,-27.95,153.41,,f2111cef-4de4-45c7-8bb5-17639c3d5662,-37.82,144.96,VIC,Melbourne,debit,authorized,2491e9e7cdfb40a98034de31bbdb5f9a,SALES-POS,20-30,2018,8,18,15,50,Saturday,7 days,52855.65
ACC-1598451071,26,6.13,1176.14,1.0,CUS-2487424745,2018-08-18,Diana,F,-27.95,153.41,,4bcca166-bd6d-4b59-a0af-06080681e3fb,-28.08,153.38,QLD,Robina,debit,authorized,cbd63e197304426281715e871c1ef63e,SALES-POS,20-30,2018,8,18,16,7,Saturday,7 days,52855.65
ACC-1598451071,26,14.11,1162.03,1.0,CUS-2487424745,2018-08-18,Diana,F,-27.95,153.41,,06beb97d-453e-40d1-bab2-0a60d374fbdd,-27.93,153.34,QLD,Helensvale,debit,authorized,5bad5815f2c4417981288d084d060d50,POS,20-30,2018,8,18,20,39,Saturday,7 days,52855.65
ACC-1598451071,26,16.68,1145.35,1.0,CUS-2487424745,2018-08-19,Diana,F,-27.95,153.41,,0898833a-fca8-40b5-a738-8e1d4aa98322,-28.84,153.44,NSW,Alstonville,debit,authorized,48719844166c45bba6225af6d58ea50f,SALES-POS,20-30,2018,8,19,10,2,Sunday,7 days,52855.65
ACC-1598451071,26,16.84,1128.51,1.0,CUS-2487424745,2018-08-19,Diana,F,-27.95,153.41,,506e033d-e1af-4591-b9ea-37ad93798a7b,-28.04,153.43,QLD,MERMAID WATERS,debit,authorized,db6f7f3d4e994807a80acfb4eba4c3cf,POS,20-30,2018,8,19,10,27,Sunday,7 days,52855.65
ACC-1598451071,26,15.6,1112.91,1.0,CUS-2487424745,2018-08-19,Diana,F,-27.95,153.41,,7fd1b176-d418-4ba9-959f-320e20a3ae05,-37.95,145.04,VIC,Highett,debit,authorized,101e7c7436c74917bc25ef337da8ecd1,SALES-POS,20-30,2018,8,19,11,1,Sunday,7 days,52855.65
ACC-1598451071,26,4.79,1108.12,0.0,CUS-2487424745,2018-08-19,Diana,F,-27.95,153.41,,2c8781ed-408e-45ef-9621-11537c30de95,-27.85,153.3,QLD,Upper Coomera,debit,authorized,c6c19c58c0904dfa8a64adc25ff75acf,SALES-POS,20-30,2018,8,19,13,13,Sunday,7 days,52855.65
ACC-1598451071,26,4.11,1104.01,1.0,CUS-2487424745,2018-08-19,Diana,F,-27.95,153.41,,9175da65-caa7-4177-a9a6-4b75cded7acd,-27.43,153.54,QLD,Point Lookout,debit,authorized,a0d424277df645458d1089e9074fec64,SALES-POS,20-30,2018,8,19,15,38,Sunday,7 days,52855.65
ACC-1598451071,26,5.46,1098.55,0.0,CUS-2487424745,2018-08-19,Diana,F,-27.95,153.41,,645fd6ac-e636-4bd3-b979-c2a0e438586e,-27.85,153.3,QLD,Upper Coomera,debit,authorized,96322d9f4d694e16910dbead4758a0df,SALES-POS,20-30,2018,8,19,17,27,Sunday,7 days,52855.65
ACC-1598451071,26,13.03,1085.52,1.0,CUS-2487424745,2018-08-19,Diana,F,-27.95,153.41,,ab5ebe78-f6ea-4785-b49f-b51b2ecbd3ef,-28.64,153.61,NSW,Byron Bay,debit,authorized,695bf54c19da435badf3217987bd239d,SALES-POS,20-30,2018,8,19,19,16,Sunday,7 days,52855.65
ACC-1598451071,26,9.12,1076.4,1.0,CUS-2487424745,2018-08-20,Diana,F,-27.95,153.41,,ebb3087a-75c4-4dea-8354-9be1c746d6cb,-27.89,152.02,QLD,Pilton,debit,authorized,316520e3559e4f79b9386810a8bb0e5d,SALES-POS,20-30,2018,8,20,0,31,Monday,7 days,52855.65
ACC-1598451071,26,8.34,1068.06,1.0,CUS-2487424745,2018-08-20,Diana,F,-27.95,153.41,,6788c107-eea6-46d7-987e-4cf59238fd69,-27.5,153.05,QLD,Coorparoo,debit,authorized,8e66184b45fa4b4ab810bc133705e4c1,SALES-POS,20-30,2018,8,20,0,51,Monday,7 days,52855.65
ACC-1598451071,26,6.0,1062.06,1.0,CUS-2487424745,2018-08-20,Diana,F,-27.95,153.41,,6d7614d9-bdd5-485b-b70e-e32f64ced15c,-27.7,152.22,QLD,Caffey,debit,authorized,f976bbb2173b4d03ae04bea01798f025,SALES-POS,20-30,2018,8,20,9,23,Monday,7 days,52855.65
ACC-1598451071,26,20.0,1042.06,,CUS-2487424745,2018-08-21,Diana,F,-27.95,153.41,,,,,,,debit,posted,2bdd8e3b10f44e1696aa836efc533454,INTER BANK,20-30,2018,8,21,2,0,Tuesday,7 days,52855.65
ACC-1598451071,26,36.0,1006.06,,CUS-2487424745,2018-08-21,Diana,F,-27.95,153.41,,,,,,,debit,posted,6f08e09e2ed44d2fa091231a61d15289,PAYMENT,20-30,2018,8,21,7,0,Tuesday,7 days,52855.65
ACC-1598451071,26,30.58,975.48,1.0,CUS-2487424745,2018-08-21,Diana,F,-27.95,153.41,,4d4a87fc-a840-450f-ac8d-d96c7bc5ec31,-33.79,151.13,NSW,Macquarie Park,debit,authorized,9b1edf2a180c4262bb758752b29266db,POS,20-30,2018,8,21,9,10,Tuesday,7 days,52855.65
ACC-1598451071,26,4.33,971.15,0.0,CUS-2487424745,2018-08-21,Diana,F,-27.95,153.41,,f6d24b03-5ca8-4cb3-83e2-73db22103a8a,-37.91,145.25,VIC,Rowville,debit,authorized,453ba73bbe2a4ef181677162f936c26f,POS,20-30,2018,8,21,9,18,Tuesday,7 days,52855.65
ACC-1598451071,26,5.35,965.8,1.0,CUS-2487424745,2018-08-22,Diana,F,-27.95,153.41,,d9642f09-08df-4ac6-bc92-3ba4d45784e1,-27.97,153.42,QLD,Southport,debit,authorized,d785b27440a64180a88ea6c76903ad22,SALES-POS,20-30,2018,8,22,7,19,Wednesday,7 days,52855.65
ACC-1598451071,26,7.6,958.2,1.0,CUS-2487424745,2018-08-22,Diana,F,-27.95,153.41,,e2fca367-d81a-4c98-80bf-cf065d83a699,-28.01,153.41,QLD,Bundall,debit,authorized,857e3fe84b664fc7adda3005a22d7a5d,POS,20-30,2018,8,22,8,55,Wednesday,7 days,52855.65
ACC-1598451071,26,10.96,947.24,1.0,CUS-2487424745,2018-08-22,Diana,F,-27.95,153.41,,8e682076-5627-40ee-a196-d996c260e513,-27.95,153.35,QLD,Parkwood,debit,authorized,e54bd7f3d9094cd6b27ca0980626a44e,SALES-POS,20-30,2018,8,22,9,23,Wednesday,7 days,52855.65
ACC-1598451071,26,7.94,939.3,0.0,CUS-2487424745,2018-08-22,Diana,F,-27.95,153.41,,1c4d189b-15f8-4e6a-bf26-8c6e59804408,-27.88,151.27,QLD,Millmerran,debit,authorized,a094587920fb405d9124bb0efef6e607,SALES-POS,20-30,2018,8,22,9,40,Wednesday,7 days,52855.65
ACC-1598451071,26,20.91,918.39,1.0,CUS-2487424745,2018-08-22,Diana,F,-27.95,153.41,,4fed93ab-f622-4e44-b7ca-8dcdd6b43e35,-28.04,153.43,QLD,Broadbeach,debit,authorized,0af6c1a64efd4087874490194318b578,SALES-POS,20-30,2018,8,22,9,57,Wednesday,7 days,52855.65
ACC-1598451071,26,12.8,1919.26,1.0,CUS-2487424745,2018-08-22,Diana,F,-27.95,153.41,,30a7f8e5-0d78-45b8-afe5-5f479cafeb3b,-28.1,153.41,QLD,Varsity Lakes,debit,authorized,d73d054bd6fc477da7ff9f306486770d,SALES-POS,20-30,2018,8,22,15,30,Wednesday,7 days,52855.65
ACC-1598451071,26,51.04,1868.22,1.0,CUS-2487424745,2018-08-23,Diana,F,-27.95,153.41,,f9f4308c-48cd-431e-8979-b39f094912ab,-27.45,152.99,QLD,Ashgrove,debit,authorized,9606a559f14f49cabb4c0ea2cfcef8e3,SALES-POS,20-30,2018,8,23,4,43,Thursday,7 days,52855.65
ACC-1598451071,26,14.15,1854.07,1.0,CUS-2487424745,2018-08-24,Diana,F,-27.95,153.41,,ee789377-3783-4757-968a-2e3726fc057e,-27.98,152.55,QLD,Aratula,debit,authorized,8dac7e74fb064664baf96e9549e850ae,SALES-POS,20-30,2018,8,24,4,25,Friday,7 days,52855.65
ACC-1598451071,26,12.32,1841.75,1.0,CUS-2487424745,2018-08-24,Diana,F,-27.95,153.41,,75bc053a-5e96-464f-aa7f-2986c71ebcd3,-27.92,153.34,QLD,Helensvale,debit,authorized,b295a9ccabed41a7a9b5e1ce6f41a4a8,POS,20-30,2018,8,24,4,44,Friday,7 days,52855.65
ACC-1598451071,26,14.95,1826.8,0.0,CUS-2487424745,2018-08-24,Diana,F,-27.95,153.41,,f26401e1-93c1-4dc9-92e2-79cd25e902e2,-33.77,151.26,NSW,Brookvale,debit,authorized,5f7d22a1c52f4be59646926045e049a0,SALES-POS,20-30,2018,8,24,8,1,Friday,7 days,52855.65
ACC-1598451071,26,6.81,1819.99,0.0,CUS-2487424745,2018-08-24,Diana,F,-27.95,153.41,,608e64d0-0f15-4352-9209-87be26318a3d,-27.47,153.02,QLD,Brisbane City,debit,authorized,3e0c6bb4793c4f1a85c3caa1b9818c77,SALES-POS,20-30,2018,8,24,8,10,Friday,7 days,52855.65
ACC-1598451071,26,11.58,1808.41,1.0,CUS-2487424745,2018-08-24,Diana,F,-27.95,153.41,,c945ff25-3a84-4581-8119-c9d0ed5061f8,-27.47,153.02,QLD,Brisbane City,debit,authorized,874df76f12d944b59d6f622f1699e0de,SALES-POS,20-30,2018,8,24,14,8,Friday,7 days,52855.65
ACC-1598451071,26,14.37,1794.04,1.0,CUS-2487424745,2018-08-24,Diana,F,-27.95,153.41,,45480b96-358a-4cf7-ac7b-deb32fdc973a,-28.86,153.53,NSW,Ballina,debit,authorized,300dedaeab6d4cbab7c598e2c94897f5,POS,20-30,2018,8,24,14,43,Friday,7 days,52855.65
ACC-1598451071,26,9.67,1784.37,1.0,CUS-2487424745,2018-08-24,Diana,F,-27.95,153.41,,e5c3a999-72c2-46d6-b610-eaf688e8edf1,-28.08,153.45,QLD,Burleigh Heads,debit,authorized,5fef510c4ed6455a8ff160a48ea2daf2,POS,20-30,2018,8,24,17,39,Friday,7 days,52855.65
ACC-1598451071,26,5.87,1778.5,0.0,CUS-2487424745,2018-08-24,Diana,F,-27.95,153.41,,a9697144-d08a-42d7-868d-7283f8133962,-27.47,153.03,QLD,Brisbane City,debit,authorized,cf66e22bb0f94e148c15afdfa452fe15,POS,20-30,2018,8,24,19,31,Friday,7 days,52855.65
ACC-1598451071,26,8.33,1770.17,1.0,CUS-2487424745,2018-08-24,Diana,F,-27.95,153.41,,dc517250-5330-4567-8f8c-a737e8bf63ab,-28.11,153.46,QLD,Palm Beach,debit,authorized,f21a5ed61a4f4e499d368f1beec02738,POS,20-30,2018,8,24,21,15,Friday,7 days,52855.65
ACC-1598451071,26,17.59,1752.58,1.0,CUS-2487424745,2018-08-24,Diana,F,-27.95,153.41,,663064e6-36b7-4a9e-803c-4bb8339491d6,-28.04,153.43,QLD,Broadbeach,debit,authorized,799ec9c5c8cd4651b84c931e2d45005f,SALES-POS,20-30,2018,8,24,21,21,Friday,7 days,52855.65
ACC-1598451071,26,27.27,1725.31,1.0,CUS-2487424745,2018-08-24,Diana,F,-27.95,153.41,,e43c73c9-2a7e-46a6-963a-3108e4fc3d1e,-28.08,153.38,QLD,Robina,debit,authorized,919755c007ff4af499a4f49e89592758,SALES-POS,20-30,2018,8,24,21,28,Friday,7 days,52855.65
ACC-1598451071,26,8.64,1716.67,1.0,CUS-2487424745,2018-08-25,Diana,F,-27.95,153.41,,6399ce2b-7e1b-40c2-b5a0-5b56b98c89a5,-28.08,153.39,QLD,Robina,debit,authorized,7b57a3fc4e264dd8927628fc2d677bc9,POS,20-30,2018,8,25,10,23,Saturday,7 days,52855.65
ACC-1598451071,26,19.31,1697.36,0.0,CUS-2487424745,2018-08-25,Diana,F,-27.95,153.41,,41e1824a-1b05-4fc3-9dac-a144c0b295e8,-28.05,153.41,QLD,Mermaid Waters,debit,authorized,805d9bf761504cdd8285e95e2a244356,POS,20-30,2018,8,25,11,28,Saturday,7 days,52855.65
ACC-1598451071,26,26.5,1670.86,1.0,CUS-2487424745,2018-08-25,Diana,F,-27.95,153.41,,e4758c3b-e8d8-49bd-990a-a823a86dcabc,-28.07,153.36,QLD,Mudgeeraba,debit,authorized,c96211ece72f481bb3be0fab800b980e,SALES-POS,20-30,2018,8,25,15,37,Saturday,7 days,52855.65
ACC-1598451071,26,6.52,1664.34,1.0,CUS-2487424745,2018-08-25,Diana,F,-27.95,153.41,,86703c27-a871-4aab-ab19-5133e765c7dd,-28.09,153.42,QLD,Varsity Lakes,debit,authorized,9cf13b0d98f94f68986803c91ea0e091,POS,20-30,2018,8,25,18,41,Saturday,7 days,52855.65
ACC-1598451071,26,8.87,1655.47,1.0,CUS-2487424745,2018-08-25,Diana,F,-27.95,153.41,,5eb643ae-93ff-4af7-a134-99d6d3aa48be,-28.08,153.39,QLD,Robina,debit,authorized,7cdc397b2d6c4716b6f872c8c8a7fc30,SALES-POS,20-30,2018,8,25,19,34,Saturday,7 days,52855.65
ACC-1598451071,26,9.68,1645.79,0.0,CUS-2487424745,2018-08-25,Diana,F,-27.95,153.41,,58ca4138-eccc-44ed-b9f4-89f52f586b07,-27.94,153.4,QLD,Biggera Waters,debit,authorized,095cda69360348f7bf71661efc37e140,POS,20-30,2018,8,25,19,44,Saturday,7 days,52855.65
ACC-1598451071,26,8.17,1637.62,1.0,CUS-2487424745,2018-08-26,Diana,F,-27.95,153.41,,e7a45030-2dbf-44c5-bcb3-d0970bece74b,-27.98,152.55,QLD,Aratula,debit,authorized,2ca9811450aa4df5aa145b348e7f4039,POS,20-30,2018,8,26,9,35,Sunday,7 days,52855.65
ACC-1598451071,26,90.43,1547.19,0.0,CUS-2487424745,2018-08-26,Diana,F,-27.95,153.41,,1922639f-c45a-4381-bf09-c840853a5859,-27.47,153.02,QLD,Brisbane City,debit,authorized,dd569b3878404a3980dbd7d51d36e384,SALES-POS,20-30,2018,8,26,12,25,Sunday,7 days,52855.65
ACC-1598451071,26,9.67,1537.52,1.0,CUS-2487424745,2018-08-26,Diana,F,-27.95,153.41,,946f3a3f-4c0d-4761-af5e-9378354ac0c3,-28.08,153.39,QLD,Robina,debit,authorized,59de3920a4a44a8abc483cb314490300,SALES-POS,20-30,2018,8,26,13,3,Sunday,7 days,52855.65
ACC-1598451071,26,11.55,1525.97,1.0,CUS-2487424745,2018-08-26,Diana,F,-27.95,153.41,,430c23a4-b449-4225-8c79-d7f274810e6e,-27.93,153.38,QLD,Arundel,debit,authorized,33d206d0d4644060937c8b2279001143,SALES-POS,20-30,2018,8,26,13,43,Sunday,7 days,52855.65
ACC-1598451071,26,18.7,1507.27,0.0,CUS-2487424745,2018-08-26,Diana,F,-27.95,153.41,,2370e03c-2435-4c93-86a4-1e798799cb51,-28.65,153.46,NSW,Federal,debit,authorized,a080c16aed9c4feab1aa10f72b47ecb1,SALES-POS,20-30,2018,8,26,14,2,Sunday,7 days,52855.65
ACC-1598451071,26,6.52,1500.75,1.0,CUS-2487424745,2018-08-26,Diana,F,-27.95,153.41,,445d90d9-eee7-46ce-8457-5552c4227031,-27.85,153.3,QLD,Upper Coomera,debit,authorized,065aea0f516648f0a541243950ea9117,POS,20-30,2018,8,26,14,38,Sunday,7 days,52855.65
ACC-1598451071,26,12.14,1488.61,0.0,CUS-2487424745,2018-08-26,Diana,F,-27.95,153.41,,2b8320d0-06eb-46af-96d4-b4af7128ae91,-27.97,153.4,QLD,Labrador,debit,authorized,74d0e6bc850e472196565da2f9b0559d,SALES-POS,20-30,2018,8,26,15,55,Sunday,7 days,52855.65
ACC-1598451071,26,11.1,1477.51,1.0,CUS-2487424745,2018-08-26,Diana,F,-27.95,153.41,,c41ce215-6d2f-45d2-a6a0-e342bb6e8f4e,-28.04,153.42,QLD,Broadbeach,debit,authorized,68011d3c8fef449a810512998f42449d,SALES-POS,20-30,2018,8,26,16,33,Sunday,7 days,52855.65
ACC-1598451071,26,9.44,1468.07,0.0,CUS-2487424745,2018-08-26,Diana,F,-27.95,153.41,,4a4b54f2-c012-420b-849b-5c07e88543db,-27.91,153.4,QLD,Runaway Bay,debit,authorized,c02efc4a13fa418c83bae69fd636f7c6,POS,20-30,2018,8,26,19,18,Sunday,7 days,52855.65
ACC-1598451071,26,7.45,1460.62,1.0,CUS-2487424745,2018-08-26,Diana,F,-27.95,153.41,,8d3e868f-f125-4bda-99d8-4a7dc760b94d,-28.11,153.41,QLD,Reedy Creek,debit,authorized,5bc70d45bd264830be9fd807e548dcff,POS,20-30,2018,8,26,20,7,Sunday,7 days,52855.65
ACC-1598451071,26,12.46,1448.16,1.0,CUS-2487424745,2018-08-26,Diana,F,-27.95,153.41,,b0d3259e-ee73-4a1d-b00c-c8e77317358a,-28.81,153.28,NSW,Lismore,debit,authorized,f0ec08da1ec648e69aa1be7d6e6c66bf,POS,20-30,2018,8,26,20,32,Sunday,7 days,52855.65
ACC-1598451071,26,5.06,1443.1,1.0,CUS-2487424745,2018-08-26,Diana,F,-27.95,153.41,,0db41b51-10e9-49d0-b6bd-2bb840dd76a9,-27.86,153.31,QLD,Coomera,debit,authorized,3c5ca4071e8e468bb8f4252fc30fc678,POS,20-30,2018,8,26,20,56,Sunday,7 days,52855.65
ACC-1598451071,26,3.75,1439.35,0.0,CUS-2487424745,2018-08-27,Diana,F,-27.95,153.41,,996dfa41-bc48-4faa-aef3-b4366784b273,-27.97,153.42,QLD,Southport,debit,authorized,f0259b83e23a45b0b81becf0fb7a8988,SALES-POS,20-30,2018,8,27,12,4,Monday,7 days,52855.65
ACC-1598451071,26,3.95,1435.4,0.0,CUS-2487424745,2018-08-27,Diana,F,-27.95,153.41,,b0a6a7f9-b9c9-45b3-ac1b-eaf2e65a141c,-27.71,114.17,WA,Kalbarri,debit,authorized,d0f382e64f554592bb38f5b7bdf67fa5,SALES-POS,20-30,2018,8,27,14,4,Monday,7 days,52855.65
ACC-1598451071,26,21.0,1414.4,1.0,CUS-2487424745,2018-08-27,Diana,F,-27.95,153.41,,bcc12489-906b-442f-9df8-c57f6a58cc2c,-33.87,151.21,NSW,Sydney,debit,authorized,50880a5a301d418b912ada35db68e4ac,POS,20-30,2018,8,27,15,37,Monday,7 days,52855.65
ACC-1598451071,26,20.0,1394.4,,CUS-2487424745,2018-08-28,Diana,F,-27.95,153.41,,,,,,,debit,posted,79f4bd46a7b248b0874539ad66fc6882,INTER BANK,20-30,2018,8,28,2,0,Tuesday,7 days,52855.65
ACC-1598451071,26,36.0,1358.4,,CUS-2487424745,2018-08-28,Diana,F,-27.95,153.41,,,,,,,debit,posted,9ab8c3ca95a14808a7e43d3e58030774,PAYMENT,20-30,2018,8,28,7,0,Tuesday,7 days,52855.65
ACC-1598451071,26,9.73,1348.67,1.0,CUS-2487424745,2018-08-28,Diana,F,-27.95,153.41,,44abc19c-aa5c-40bd-b1d0-9b2f236189ea,-28.01,153.41,QLD,Bundall,debit,authorized,5172f8a8d4af44658b5860bd8270e07d,POS,20-30,2018,8,28,9,32,Tuesday,7 days,52855.65
ACC-1598451071,26,20.58,1328.09,1.0,CUS-2487424745,2018-08-28,Diana,F,-27.95,153.41,,909f941c-5b52-462e-bfe0-f1922f63ff18,-27.55,151.96,QLD,Toowoomba,debit,authorized,82d76b40e16347f59dbd3921e5dc68bf,SALES-POS,20-30,2018,8,28,10,1,Tuesday,7 days,52855.65
ACC-1598451071,26,6.76,1321.33,1.0,CUS-2487424745,2018-08-28,Diana,F,-27.95,153.41,,85188383-2318-413d-951b-631ba18d3ab8,-28.03,153.43,QLD,Broadbeach,debit,authorized,e7c858852c1c4343bce9255805e708c4,POS,20-30,2018,8,28,21,14,Tuesday,7 days,52855.65
ACC-1598451071,26,21.2,1300.13,1.0,CUS-2487424745,2018-08-29,Diana,F,-27.95,153.41,,8a2c577e-6d84-41ee-ba72-5148ad656792,-27.47,153.02,QLD,Brisbane City,debit,authorized,e9d2e321b17743129d06a50c14e5d702,SALES-POS,20-30,2018,8,29,5,54,Wednesday,7 days,52855.65
ACC-1598451071,26,1.59,1298.54,1.0,CUS-2487424745,2018-08-29,Diana,F,-27.95,153.41,,b248adfc-cf4e-4985-bc4e-d6cde93d8a14,-37.84,145.13,VIC,Box Hill South,debit,authorized,b3dc16e164d44322a28285eb7b50d858,SALES-POS,20-30,2018,8,29,8,23,Wednesday,7 days,52855.65
ACC-1598451071,26,7.09,1291.45,0.0,CUS-2487424745,2018-08-29,Diana,F,-27.95,153.41,,4ebc232a-cd11-42f7-88c5-3ac36610bcdc,-28.04,148.59,QLD,Saint George,debit,authorized,fb3028971f014127b23fcae566e6bc29,SALES-POS,20-30,2018,8,29,9,26,Wednesday,7 days,52855.65
ACC-1598451071,26,10.7,1280.75,1.0,CUS-2487424745,2018-08-29,Diana,F,-27.95,153.41,,da686f15-cfd8-461d-a2d2-9472254150bb,-28.03,153.43,QLD,Broadbeach,debit,authorized,1cd1490a2d4a40aa875c693179c26a67,SALES-POS,20-30,2018,8,29,9,35,Wednesday,7 days,52855.65
ACC-1598451071,26,12.69,1268.06,0.0,CUS-2487424745,2018-08-29,Diana,F,-27.95,153.41,,430c23a4-b449-4225-8c79-d7f274810e6e,-27.93,153.38,QLD,Arundel,debit,authorized,08555685b562493bb74aa68fd1627012,SALES-POS,20-30,2018,8,29,9,48,Wednesday,7 days,52855.65
ACC-1598451071,26,7.76,1260.3,1.0,CUS-2487424745,2018-08-29,Diana,F,-27.95,153.41,,82569bc7-3865-4737-b898-0e34e5544027,-28.1,153.42,QLD,Burleigh Waters,debit,authorized,cdd68d3cb28244329512bff2e0b5463c,POS,20-30,2018,8,29,10,47,Wednesday,7 days,52855.65
ACC-1598451071,26,11.93,2262.04,1.0,CUS-2487424745,2018-08-29,Diana,F,-27.95,153.41,,fc660c03-775e-4f8b-8b53-9c00a9cc908a,-27.93,153.39,QLD,Biggera Waters,debit,authorized,bda671ba7c8641618c3c3e0b88d7b38a,SALES-POS,20-30,2018,8,29,15,32,Wednesday,7 days,52855.65
ACC-1598451071,26,24.32,2237.72,1.0,CUS-2487424745,2018-08-29,Diana,F,-27.95,153.41,,65049f44-035f-4e42-ace7-f73689049758,-27.78,152.73,QLD,Peak Crossing,debit,authorized,773b6f3172704841ba79590d2e36be35,POS,20-30,2018,8,29,17,15,Wednesday,7 days,52855.65
ACC-1598451071,26,3.35,2234.37,1.0,CUS-2487424745,2018-08-29,Diana,F,-27.95,153.41,,f805f997-c939-49e2-9945-9b0b799b1f8d,-28.18,153.54,NSW,Tweed Heads,debit,authorized,2651132d588c4db8804de8ed23659aaa,POS,20-30,2018,8,29,17,59,Wednesday,7 days,52855.65
ACC-1598451071,26,5.32,2229.05,0.0,CUS-2487424745,2018-08-29,Diana,F,-27.95,153.41,,a1c4c7aa-b7da-4064-8ed1-d4a236d772c6,-28.15,153.49,QLD,Tugun,debit,authorized,6af63f830b1b461ba47e57c7f8377f3e,POS,20-30,2018,8,29,19,8,Wednesday,7 days,52855.65
ACC-1598451071,26,10.91,2218.14,1.0,CUS-2487424745,2018-08-29,Diana,F,-27.95,153.41,,b5e612f7-2329-4a73-9639-c86449fa0cc3,-28.17,153.54,QLD,Coolangatta,debit,authorized,e5ad7f02a47b428eacb6342c0b589aff,SALES-POS,20-30,2018,8,29,19,20,Wednesday,7 days,52855.65
ACC-1598451071,26,573.66,1644.48,1.0,CUS-2487424745,2018-08-29,Diana,F,-27.95,153.41,,174c502e-6804-4d22-bf4c-2b362b0b9c14,-33.9,151.18,NSW,Newtown,debit,authorized,6cf96dec10bb4dd7bf1c60d063697141,SALES-POS,20-30,2018,8,29,19,32,Wednesday,7 days,52855.65
ACC-1598451071,26,17.28,1627.2,1.0,CUS-2487424745,2018-08-29,Diana,F,-27.95,153.41,,b182afcd-b37f-47d4-afab-5d1ce407f1e5,-28.03,153.43,QLD,Broadbeach,debit,authorized,30750bbc66bf4307b896421bbfdf7e80,SALES-POS,20-30,2018,8,29,19,55,Wednesday,7 days,52855.65
ACC-1598451071,26,7.56,1619.64,0.0,CUS-2487424745,2018-08-31,Diana,F,-27.95,153.41,,978b4966-1922-4d31-91cb-ca658ab3f969,-28.52,153.54,NSW,Ocean Shores,debit,authorized,ae89cb26840c4e92ae2bc8ec424eb2d0,POS,20-30,2018,8,31,1,5,Friday,7 days,52855.65
ACC-1598451071,26,9.15,1610.49,1.0,CUS-2487424745,2018-08-31,Diana,F,-27.95,153.41,,d0619380-8617-465a-8dbf-22627a125790,-28.13,153.45,QLD,Elanora,debit,authorized,7c6b87bc723e4d919e0ae537c35f54d9,POS,20-30,2018,8,31,9,47,Friday,7 days,52855.65
ACC-1598451071,26,9.43,1601.06,1.0,CUS-2487424745,2018-08-31,Diana,F,-27.95,153.41,,f3720aac-32cc-43ef-a924-9d923af42601,-28.21,153.55,NSW,Tweed Heads South,debit,authorized,dbb855c2cdf840a1be5bd63eb97caa5a,POS,20-30,2018,8,31,10,8,Friday,7 days,52855.65
ACC-1598451071,26,11.25,1589.81,1.0,CUS-2487424745,2018-08-31,Diana,F,-27.95,153.41,,beeb6931-4e16-45cc-a6e0-30c23cf76d55,-27.95,153.35,QLD,Arundel,debit,authorized,a3d18b3a00af48b780bcc9dc1a611233,SALES-POS,20-30,2018,8,31,11,3,Friday,7 days,52855.65
ACC-1598451071,26,4.66,1585.15,1.0,CUS-2487424745,2018-08-31,Diana,F,-27.95,153.41,,6d400acf-6aa9-404f-9cf0-f932559d0c38,-27.82,153.32,QLD,Pimpama,debit,authorized,f785acbf2a4a4da98f307973e75c073d,POS,20-30,2018,8,31,11,43,Friday,7 days,52855.65
ACC-1598451071,26,2.4,1582.75,0.0,CUS-2487424745,2018-09-01,Diana,F,-27.95,153.41,,994f51ea-1a1f-49a7-b117-6651005b4bec,-27.47,153.03,QLD,Brisbane City,debit,authorized,65ac637026be4e15a21b52fd5bf92fc8,POS,20-30,2018,9,1,19,7,Saturday,7 days,52855.65
ACC-1598451071,26,24.88,1557.87,1.0,CUS-2487424745,2018-09-01,Diana,F,-27.95,153.41,,150a461b-53a5-4a53-9d26-8a6d4434308e,-28.03,153.43,QLD,Broadbeach,debit,authorized,bebea0e0835947719ecb36845d0c130f,SALES-POS,20-30,2018,9,1,20,33,Saturday,7 days,52855.65
ACC-1598451071,26,14.77,1543.1,1.0,CUS-2487424745,2018-09-01,Diana,F,-27.95,153.41,,efab2733-f248-47f8-aa0d-e92d3f436a43,-28.1,153.42,QLD,Burleigh Waters,debit,authorized,409a2b6237854a0faa2b23b3ddb7d585,SALES-POS,20-30,2018,9,1,21,0,Saturday,7 days,52855.65
ACC-1598451071,26,70.22,1472.88,1.0,CUS-2487424745,2018-09-01,Diana,F,-27.95,153.41,,e67cbcbd-e44b-4cf0-b318-30827a7425af,-37.82,144.95,VIC,Docklands,debit,authorized,ccdf83d242b440738a0fca54ae8c5abf,POS,20-30,2018,9,1,21,22,Saturday,7 days,52855.65
ACC-1598451071,26,7.51,1465.37,0.0,CUS-2487424745,2018-09-02,Diana,F,-27.95,153.41,,d7f79527-7860-4e9c-b96c-ec8d371fa06a,-27.95,153.39,QLD,Labrador,debit,authorized,871fdb737a26439ebbdddbbe582fbb20,POS,20-30,2018,9,2,4,7,Sunday,7 days,52855.65
ACC-1598451071,26,6.27,1459.1,1.0,CUS-2487424745,2018-09-02,Diana,F,-27.95,153.41,,4ebc232a-cd11-42f7-88c5-3ac36610bcdc,-28.04,148.59,QLD,Saint George,debit,authorized,23f1bbd8fc534357a5a7ad401aeff82d,POS,20-30,2018,9,2,5,43,Sunday,7 days,52855.65
ACC-1598451071,26,4.28,1454.82,0.0,CUS-2487424745,2018-09-02,Diana,F,-27.95,153.41,,4f9d4f51-26fb-4afb-b65f-6e05d31a9aca,-28.17,153.54,NSW,Tweed Heads,debit,authorized,a40aa94ddcdf459288337660d226ecb8,SALES-POS,20-30,2018,9,2,9,26,Sunday,7 days,52855.65
ACC-1598451071,26,8.46,1446.36,1.0,CUS-2487424745,2018-09-02,Diana,F,-27.95,153.41,,e7bffb4e-8d57-49cf-a546-7f4d7e0e54ea,-28.04,153.35,QLD,Worongary,debit,authorized,e8734e717f794ce2a8585d853acb2901,POS,20-30,2018,9,2,10,8,Sunday,7 days,52855.65
ACC-1598451071,26,12.15,1434.21,0.0,CUS-2487424745,2018-09-02,Diana,F,-27.95,153.41,,6a4ae845-a0ef-4ea6-9832-82b898c9b59d,-27.93,153.39,QLD,Biggera Waters,debit,authorized,c3a68f1743f3464da0acbff3d39417c9,POS,20-30,2018,9,2,10,42,Sunday,7 days,52855.65
ACC-1598451071,26,195.0,1239.21,,CUS-2487424745,2018-09-03,Diana,F,-27.95,153.41,,,,,,,debit,posted,6ec674c02a684c80a6898a7d9346788a,PAYMENT,20-30,2018,9,3,6,0,Monday,7 days,52855.65
ACC-1598451071,26,20.0,1219.21,,CUS-2487424745,2018-09-04,Diana,F,-27.95,153.41,,,,,,,debit,posted,0f23a906a3ae4ff3ad56853e601065a2,INTER BANK,20-30,2018,9,4,2,0,Tuesday,7 days,52855.65
ACC-1598451071,26,36.0,1183.21,,CUS-2487424745,2018-09-04,Diana,F,-27.95,153.41,,,,,,,debit,posted,79eaf936a8de437a8a38ae8a433a3d2f,PAYMENT,20-30,2018,9,4,7,0,Tuesday,7 days,52855.65
ACC-1598451071,26,3.86,1179.35,1.0,CUS-2487424745,2018-09-05,Diana,F,-27.95,153.41,,a684b7d9-e252-4550-8b5e-612e4a1ab080,-27.88,153.33,QLD,Hope Island,debit,authorized,c5ca6badf10c4090a11fcfc57e72bc6f,POS,20-30,2018,9,5,4,42,Wednesday,7 days,52855.65
ACC-1598451071,26,24.31,1155.04,1.0,CUS-2487424745,2018-09-05,Diana,F,-27.95,153.41,,9fe5e0a5-3eef-4531-9a82-d5b02cf0d118,-27.47,153.02,QLD,Spring Hill,debit,authorized,b82f604775a24f14b72b751051bd76d9,SALES-POS,20-30,2018,9,5,9,43,Wednesday,7 days,52855.65
ACC-1598451071,26,10.39,1144.65,0.0,CUS-2487424745,2018-09-05,Diana,F,-27.95,153.41,,7230b09a-e32b-4e1d-af1c-c8b4a587064f,-28.01,153.43,QLD,Surfers Paradise,debit,authorized,ab4ccde726f343fd929ce651ae2650c7,POS,20-30,2018,9,5,11,24,Wednesday,7 days,52855.65
ACC-1598451071,26,12.57,1132.08,1.0,CUS-2487424745,2018-09-05,Diana,F,-27.95,153.41,,7a08f0be-f9b7-4548-af8c-ef4af56bece5,-27.47,153.1,QLD,Cannon Hill,debit,authorized,260a6a7f0ca74ee9a2733103f2c51325,POS,20-30,2018,9,5,12,48,Wednesday,7 days,52855.65
ACC-1598451071,26,30.71,2115.04,1.0,CUS-2487424745,2018-09-05,Diana,F,-27.95,153.41,,42fee953-6ae3-4839-9853-f4a640a982e1,-27.97,153.42,QLD,Southport,debit,authorized,cd5ff1202c184c97ad097d8d52868195,SALES-POS,20-30,2018,9,5,15,34,Wednesday,7 days,52855.65
ACC-1598451071,26,14.19,2100.85,1.0,CUS-2487424745,2018-09-05,Diana,F,-27.95,153.41,,b6e53807-0021-478a-9b6a-5cab539d777a,-28.81,153.28,NSW,Lismore,debit,authorized,c49bf4b728824af0a1adc9a68945d184,POS,20-30,2018,9,5,22,46,Wednesday,7 days,52855.65
ACC-1598451071,26,12.98,2087.87,1.0,CUS-2487424745,2018-09-06,Diana,F,-27.95,153.41,,b0367e17-47cc-4360-a8ca-62f8eb43fa8b,-27.51,152.94,QLD,Kenmore,debit,authorized,6da51e87f9194207a377703365889fef,POS,20-30,2018,9,6,6,43,Thursday,7 days,52855.65
ACC-1598451071,26,23.84,2064.03,1.0,CUS-2487424745,2018-09-06,Diana,F,-27.95,153.41,,7d20a31e-9caf-411e-849c-87f510e7029f,-28.08,153.38,QLD,Robina,debit,authorized,d6d3d5ac5b8a4eddb96b56975383701f,SALES-POS,20-30,2018,9,6,8,2,Thursday,7 days,52855.65
ACC-1598451071,26,23.81,2040.22,1.0,CUS-2487424745,2018-09-06,Diana,F,-27.95,153.41,,e3e28ad9-50a4-4a33-b675-bb611d49b517,-27.7,114.17,WA,Kalbarri,debit,authorized,7118c30afeb543908eb8b732afe0e0d0,POS,20-30,2018,9,6,12,51,Thursday,7 days,52855.65
ACC-1598451071,26,17.71,2022.51,1.0,CUS-2487424745,2018-09-06,Diana,F,-27.95,153.41,,2d61b595-82bc-44e5-9566-4032fa51725a,-28.07,153.44,QLD,Miami,debit,authorized,ddcd54ad87b342a7912261cb906b6801,SALES-POS,20-30,2018,9,6,14,59,Thursday,7 days,52855.65
ACC-1598451071,26,7.9,2014.61,1.0,CUS-2487424745,2018-09-06,Diana,F,-27.95,153.41,,53d0f83c-e2c6-41e0-912b-81efd9d3130a,-27.93,153.4,QLD,Biggera Waters,debit,authorized,c98cb13e25d44ea9838c1d4804c7b47a,POS,20-30,2018,9,6,15,26,Thursday,7 days,52855.65
ACC-1598451071,26,23.67,1990.94,1.0,CUS-2487424745,2018-09-06,Diana,F,-27.95,153.41,,8c1bfecb-95f3-44f9-96e7-54bea0ed04ba,-33.88,151.21,NSW,Sydney,debit,authorized,8af5b6c1e0f642bfa80a8ba226203bfe,SALES-POS,20-30,2018,9,6,15,39,Thursday,7 days,52855.65
ACC-1598451071,26,8.97,1981.97,1.0,CUS-2487424745,2018-09-06,Diana,F,-27.95,153.41,,0c63889c-e2cc-482b-be44-774f70fdceaf,-28.04,153.43,QLD,Broadbeach,debit,authorized,d165e02b6e5741019762c376fa2bdca8,POS,20-30,2018,9,6,22,23,Thursday,7 days,52855.65
ACC-1598451071,26,8.71,1973.26,1.0,CUS-2487424745,2018-09-07,Diana,F,-27.95,153.41,,1bfa8201-d177-4949-a3ed-0ffecafc18f8,-27.99,153.38,QLD,Ashmore,debit,authorized,80811c2923224b74b61d5516963f8ffc,POS,20-30,2018,9,7,15,47,Friday,7 days,52855.65
ACC-1598451071,26,17.79,1955.47,1.0,CUS-2487424745,2018-09-07,Diana,F,-27.95,153.41,,b390bd6b-9e19-4a2d-8282-e81dcd657032,-28.01,153.34,QLD,Nerang,debit,authorized,3631c9c237d44978aea2527a689a0a9c,POS,20-30,2018,9,7,18,26,Friday,7 days,52855.65
ACC-1598451071,26,13.31,1942.16,1.0,CUS-2487424745,2018-09-07,Diana,F,-27.95,153.41,,a6f73114-758b-47d9-a7f1-cd084a2d74d6,-27.86,153.35,QLD,Hope Island,debit,authorized,93391e181116402d85bc14fb244ff2c0,SALES-POS,20-30,2018,9,7,20,18,Friday,7 days,52855.65
ACC-1598451071,26,3.32,1938.84,1.0,CUS-2487424745,2018-09-07,Diana,F,-27.95,153.41,,c385274f-a366-46c8-819b-b78addc3a289,-28.04,151.98,QLD,Allora,debit,authorized,f3499d930f5f426c872a4b0a86b36633,POS,20-30,2018,9,7,20,35,Friday,7 days,52855.65
ACC-1598451071,26,5.58,1933.26,1.0,CUS-2487424745,2018-09-07,Diana,F,-27.95,153.41,,b2cc24a4-c6bb-422e-bedb-a70d416990c6,-28.05,153.41,QLD,Mermaid Waters,debit,authorized,cf598d08172a456283e394b72b49c505,POS,20-30,2018,9,7,20,53,Friday,7 days,52855.65
ACC-1598451071,26,10.58,1922.68,1.0,CUS-2487424745,2018-09-07,Diana,F,-27.95,153.41,,aef30de1-c67e-4ab7-8577-2931a4bf3c7e,-27.97,144.64,QLD,Yowah,debit,authorized,a3ef89d1aae2485abb8894fd3b6c9ae6,POS,20-30,2018,9,7,21,1,Friday,7 days,52855.65
ACC-1598451071,26,6.12,1916.56,1.0,CUS-2487424745,2018-09-07,Diana,F,-27.95,153.41,,649e8a50-f564-4458-bc7a-26413299f36f,-27.96,153.38,QLD,Parkwood,debit,authorized,e52b8224455e45fbab62a6dca3ff2fce,POS,20-30,2018,9,7,22,46,Friday,7 days,52855.65
ACC-1598451071,26,10.39,1906.17,0.0,CUS-2487424745,2018-09-08,Diana,F,-27.95,153.41,,ca4fd50f-9cbe-4038-85e1-a00c6c410cc1,-28.06,153.44,QLD,Miami,debit,authorized,22e53c37a5724d7982591b70ce26c1c9,SALES-POS,20-30,2018,9,8,0,52,Saturday,7 days,52855.65
ACC-1598451071,26,6.55,1899.62,0.0,CUS-2487424745,2018-09-08,Diana,F,-27.95,153.41,,645fd6ac-e636-4bd3-b979-c2a0e438586e,-27.85,153.3,QLD,Upper Coomera,debit,authorized,f002a7b98ed44a599525ec3f2a7496d5,SALES-POS,20-30,2018,9,8,3,14,Saturday,7 days,52855.65
ACC-1598451071,26,10.7,1888.92,1.0,CUS-2487424745,2018-09-08,Diana,F,-27.95,153.41,,6b6f922a-8f7b-4708-a8b8-4054423556da,-27.98,152.99,QLD,Beaudesert,debit,authorized,7ed3e4cbb3de4e9f90705a785aa7f0c6,POS,20-30,2018,9,8,13,7,Saturday,7 days,52855.65
ACC-1598451071,26,11.75,1877.17,1.0,CUS-2487424745,2018-09-08,Diana,F,-27.95,153.41,,174192c8-c07d-461a-8d53-3062fe5151f5,-33.86,151.21,NSW,Sydney,debit,authorized,a85ec6a41f1f4cd785036c1b6e05fc25,POS,20-30,2018,9,8,13,43,Saturday,7 days,52855.65
ACC-1598451071,26,19.75,1857.42,0.0,CUS-2487424745,2018-09-08,Diana,F,-27.95,153.41,,05f07112-72a2-43e5-8d6a-6715c63d7edd,-27.89,153.31,QLD,Oxenford,debit,authorized,4a1b5d4b354b43da956c151854eabdf2,POS,20-30,2018,9,8,21,24,Saturday,7 days,52855.65
ACC-1598451071,26,14.69,1842.73,1.0,CUS-2487424745,2018-09-09,Diana,F,-27.95,153.41,,fcc5f982-d673-4dbd-a893-f01800e9c7de,-27.47,153.02,QLD,Brisbane City,debit,authorized,0e644da35fe84cf0826b5cdce8588b24,POS,20-30,2018,9,9,0,34,Sunday,7 days,52855.65
ACC-1598451071,26,6.45,1836.28,1.0,CUS-2487424745,2018-09-09,Diana,F,-27.95,153.41,,f37dc2ff-2dee-4774-b099-32860e4af443,-28.01,153.43,QLD,Surfers Paradise,debit,authorized,f56dcab44c8045fe91000e4a49367eb1,POS,20-30,2018,9,9,2,31,Sunday,7 days,52855.65
ACC-1598451071,26,97.24,1739.04,1.0,CUS-2487424745,2018-09-09,Diana,F,-27.95,153.41,,fc58e9b5-0dd5-4759-a022-0cbc32537772,-28.01,153.41,QLD,Bundall,debit,authorized,b00105207c42403fb5d873f4473371bd,SALES-POS,20-30,2018,9,9,10,42,Sunday,7 days,52855.65
ACC-1598451071,26,18.4,1720.64,0.0,CUS-2487424745,2018-09-09,Diana,F,-27.95,153.41,,65eb41e9-9412-428a-afb2-96662f0b669f,-27.95,153.4,QLD,Labrador,debit,authorized,d76f3ca0a84e46238516994e70da01d1,POS,20-30,2018,9,9,10,58,Sunday,7 days,52855.65
ACC-1598451071,26,6.69,1713.95,1.0,CUS-2487424745,2018-09-09,Diana,F,-27.95,153.41,,38f19626-3e10-4609-9ab4-13920ed89a5d,-27.51,153.04,QLD,Annerley,debit,authorized,891fcbde4dc44d4c9f65cb39f60f640b,SALES-POS,20-30,2018,9,9,11,33,Sunday,7 days,52855.65
ACC-1598451071,26,92.0,1621.95,,CUS-2487424745,2018-09-09,Diana,F,-27.95,153.41,,,,,,,debit,posted,d9439c79be8a4bb495de602bb697255e,INTER BANK,20-30,2018,9,9,16,0,Sunday,7 days,52855.65
ACC-1598451071,26,17.67,1604.28,1.0,CUS-2487424745,2018-09-09,Diana,F,-27.95,153.41,,328b4301-ddf2-495c-94fc-7f1cf84340be,-27.91,153.4,QLD,Runaway Bay,debit,authorized,12f09b07870a4e408b2af980e74b53bc,POS,20-30,2018,9,9,18,57,Sunday,7 days,52855.65
ACC-1598451071,26,17.37,1586.91,1.0,CUS-2487424745,2018-09-09,Diana,F,-27.95,153.41,,ee789377-3783-4757-968a-2e3726fc057e,-27.98,152.55,QLD,Aratula,debit,authorized,4e1742b25898483ca34151cf3f108660,SALES-POS,20-30,2018,9,9,20,5,Sunday,7 days,52855.65
ACC-1598451071,26,6.15,1580.76,0.0,CUS-2487424745,2018-09-10,Diana,F,-27.95,153.41,,91f952db-5094-4e65-8fd8-7c9cff78a66f,-28.04,153.42,QLD,Mermaid Waters,debit,authorized,49141797c5a14a02a79f9942f3fe2eaf,POS,20-30,2018,9,10,9,53,Monday,7 days,52855.65
ACC-1598451071,26,14.96,1565.8,0.0,CUS-2487424745,2018-09-10,Diana,F,-27.95,153.41,,6410042e-b13c-48b2-af42-5578536376f1,-27.93,153.39,QLD,Biggera Waters,debit,authorized,8dfb74a2a46e46c0bbd2d3796b3ebdb8,POS,20-30,2018,9,10,15,22,Monday,7 days,52855.65
ACC-1598451071,26,6.76,1559.04,1.0,CUS-2487424745,2018-09-10,Diana,F,-27.95,153.41,,2f1cfccd-c0d3-4c30-9e2b-46390b7fd4dd,-37.82,144.96,VIC,Melbourne,debit,authorized,81060dc00edb4a5bb21e6ccab06f4c81,SALES-POS,20-30,2018,9,10,20,20,Monday,7 days,52855.65
ACC-1598451071,26,20.0,1539.04,,CUS-2487424745,2018-09-11,Diana,F,-27.95,153.41,,,,,,,debit,posted,ef0047e43b9d41a78b1a36d8a055ea82,INTER BANK,20-30,2018,9,11,2,0,Tuesday,7 days,52855.65
ACC-1598451071,26,36.0,1503.04,,CUS-2487424745,2018-09-11,Diana,F,-27.95,153.41,,,,,,,debit,posted,05571bfecdb543b5941b0ab6ae841ad4,PAYMENT,20-30,2018,9,11,7,0,Tuesday,7 days,52855.65
ACC-1598451071,26,8.86,1494.18,1.0,CUS-2487424745,2018-09-11,Diana,F,-27.95,153.41,,0981935d-e304-4561-a782-c1b92474fee7,-27.97,153.4,QLD,Southport,debit,authorized,43669ed80eaf4f628426ed8c50694b2d,POS,20-30,2018,9,11,8,44,Tuesday,7 days,52855.65
ACC-1598451071,26,6.97,1487.21,1.0,CUS-2487424745,2018-09-11,Diana,F,-27.95,153.41,,4bdfc599-000b-4cda-bb7d-1a59a540c2ac,-28.09,153.45,QLD,Burleigh Heads,debit,authorized,d80be41ef7e344fe8b937c09cf635365,POS,20-30,2018,9,11,9,28,Tuesday,7 days,52855.65
ACC-1598451071,26,22.7,1464.51,1.0,CUS-2487424745,2018-09-11,Diana,F,-27.95,153.41,,e7750a26-513e-48b7-bc69-f6ed2e910a2f,-27.51,152.94,QLD,Kenmore,debit,authorized,c4fd845791d6429d87b17dc9cab225ff,SALES-POS,20-30,2018,9,11,9,36,Tuesday,7 days,52855.65
ACC-1598451071,26,10.34,1454.17,1.0,CUS-2487424745,2018-09-11,Diana,F,-27.95,153.41,,e7008444-e6ff-483a-99df-30f0c2ae32fc,-28.79,153.59,NSW,Lennox Head,debit,authorized,f25bcf19010244a8b7c47ff2b61fc50b,POS,20-30,2018,9,11,9,44,Tuesday,7 days,52855.65
ACC-1598451071,26,8.11,1446.06,1.0,CUS-2487424745,2018-09-11,Diana,F,-27.95,153.41,,df8967fd-6022-478b-829a-d54f1c288d25,-27.51,152.94,QLD,Kenmore,debit,authorized,11ec66c320c4479bb4847fc7567f85b2,SALES-POS,20-30,2018,9,11,10,16,Tuesday,7 days,52855.65
ACC-1598451071,26,28.74,1417.32,0.0,CUS-2487424745,2018-09-11,Diana,F,-27.95,153.41,,86f6f266-ca2e-4a5e-b563-2a40bda8d2e0,-37.82,144.96,VIC,Melbourne,debit,authorized,8f084359ba26407099f42103a493d2a5,SALES-POS,20-30,2018,9,11,13,4,Tuesday,7 days,52855.65
ACC-1598451071,26,14.86,1402.46,1.0,CUS-2487424745,2018-09-11,Diana,F,-27.95,153.41,,e4bc12e1-0e87-439e-bc3b-961a06af1371,-37.84,145,VIC,South Yarra,debit,authorized,c1be9e0e28904775bc693ae3074d6d47,SALES-POS,20-30,2018,9,11,14,7,Tuesday,7 days,52855.65
ACC-1598451071,26,0.76,1401.7,1.0,CUS-2487424745,2018-09-12,Diana,F,-27.95,153.41,,6ea10976-582a-43c5-8bb9-0662f0217237,-28.03,153.43,QLD,Broadbeach,debit,authorized,477a90092a2f493f857fc4675be80771,SALES-POS,20-30,2018,9,12,8,57,Wednesday,7 days,52855.65
ACC-1598451071,26,25.09,1376.61,1.0,CUS-2487424745,2018-09-12,Diana,F,-27.95,153.41,,165ae310-aa9e-43b6-b875-f996db6586bd,-27.47,153.03,QLD,Brisbane City,debit,authorized,4daabb2518dc4211a479c64ca0e0b57d,SALES-POS,20-30,2018,9,12,9,21,Wednesday,7 days,52855.65
ACC-1598451071,26,7.65,1368.96,1.0,CUS-2487424745,2018-09-12,Diana,F,-27.95,153.41,,f5cdbd66-84f1-438f-922a-455168c50e9b,-28.11,153.46,QLD,Palm Beach,debit,authorized,265f605db4e44633baa3110122bb9889,SALES-POS,20-30,2018,9,12,9,55,Wednesday,7 days,52855.65
ACC-1598451071,26,6.48,1362.48,1.0,CUS-2487424745,2018-09-12,Diana,F,-27.95,153.41,,4bdfc599-000b-4cda-bb7d-1a59a540c2ac,-28.09,153.45,QLD,Burleigh Heads,debit,authorized,a7e67bd01f72433b9bd57f7e79fc5bd8,SALES-POS,20-30,2018,9,12,12,10,Wednesday,7 days,52855.65
ACC-1598451071,26,13.54,1348.94,1.0,CUS-2487424745,2018-09-12,Diana,F,-27.95,153.41,,3bd3001e-4a98-4186-927f-ec765136749f,-27.98,153.41,QLD,Southport,debit,authorized,b391dbb4ed544c1281d660ddaa430c93,POS,20-30,2018,9,12,13,7,Wednesday,7 days,52855.65
ACC-1598451071,26,21.35,1327.59,1.0,CUS-2487424745,2018-09-12,Diana,F,-27.95,153.41,,91b3f708-5397-414f-8b12-912598664278,-28.14,153.47,QLD,Elanora,debit,authorized,b0b9f04770be40ecab8a410f8cd51f81,SALES-POS,20-30,2018,9,12,14,42,Wednesday,7 days,52855.65
ACC-1598451071,26,7.75,2333.51,1.0,CUS-2487424745,2018-09-13,Diana,F,-27.95,153.41,,1e767676-dfb1-428e-a532-8c652ef863ac,-28.04,153.43,QLD,Broadbeach,debit,authorized,150d126e8151459f998fe70380d9b9cf,POS,20-30,2018,9,13,1,12,Thursday,7 days,52855.65
ACC-1598451071,26,7.39,2326.12,0.0,CUS-2487424745,2018-09-13,Diana,F,-27.95,153.41,,70a06eee-8c34-4bb2-a664-c962c5277930,-28.12,153.47,QLD,Palm Beach,debit,authorized,c004b25e989843a5b39d61e9f73b8579,POS,20-30,2018,9,13,13,59,Thursday,7 days,52855.65
ACC-1598451071,26,12.4,2313.72,1.0,CUS-2487424745,2018-09-13,Diana,F,-27.95,153.41,,e9c44b2b-0f72-4ddc-9fc7-be5370aa0d44,-27.97,153.2,QLD,Tamborine Mountain,debit,authorized,5e11cd21ceb4434da3423cf073656372,POS,20-30,2018,9,13,14,9,Thursday,7 days,52855.65
ACC-1598451071,26,11.42,2302.3,1.0,CUS-2487424745,2018-09-13,Diana,F,-27.95,153.41,,41179464-a548-45e4-b684-71de31becfd6,-28.1,153.44,QLD,Burleigh Heads,debit,authorized,6a60d65493c74dbbae42a9acf900d1f2,SALES-POS,20-30,2018,9,13,14,39,Thursday,7 days,52855.65
ACC-1598451071,26,4.63,2297.67,1.0,CUS-2487424745,2018-09-13,Diana,F,-27.95,153.41,,1f740c9f-75ff-4562-a173-009a3cd55556,-28.05,153.41,QLD,Mermaid Waters,debit,authorized,e95280229e7c4d54aea5f72dcdf86f56,POS,20-30,2018,9,13,14,49,Thursday,7 days,52855.65
ACC-1598451071,26,33.11,2264.56,1.0,CUS-2487424745,2018-09-13,Diana,F,-27.95,153.41,,f5ae2ba9-8ffc-4d9f-bb7f-4ef5439a096e,-27.76,153.23,QLD,Yatala,debit,authorized,652812a3796f4756a7637d11984f69dd,POS,20-30,2018,9,13,16,51,Thursday,7 days,52855.65
ACC-1598451071,26,10.74,2253.82,0.0,CUS-2487424745,2018-09-14,Diana,F,-27.95,153.41,,bec54cd6-3005-4704-86bb-3fa30d7ff16d,-28.08,153.44,QLD,Miami,debit,authorized,6ccb8e6c4d8d4f7bb9c749ee40b48092,POS,20-30,2018,9,14,11,11,Friday,7 days,52855.65
ACC-1598451071,26,11.43,2242.39,1.0,CUS-2487424745,2018-09-14,Diana,F,-27.95,153.41,,be96bab8-7a1a-4783-adfb-901325016671,-27.95,153.41,QLD,Labrador,debit,authorized,c7b54096dff2498eadf9032674a0b47c,POS,20-30,2018,9,14,11,44,Friday,7 days,52855.65
ACC-1598451071,26,9.14,2233.25,1.0,CUS-2487424745,2018-09-14,Diana,F,-27.95,153.41,,67c8b27c-1b99-45e8-88f2-f182571064d0,-28.17,153.54,QLD,Coolangatta,debit,authorized,9f6543643c89452dbc7414401d61c299,SALES-POS,20-30,2018,9,14,14,12,Friday,7 days,52855.65
ACC-1598451071,26,5.83,2227.42,0.0,CUS-2487424745,2018-09-14,Diana,F,-27.95,153.41,,521bea81-43d7-4693-ac77-8c1f7ed2b96c,-27.96,153.41,QLD,Southport,debit,authorized,c679dc46a9994e7a8c86b60aab049b8c,SALES-POS,20-30,2018,9,14,15,32,Friday,7 days,52855.65
ACC-1598451071,26,11.9,2215.52,1.0,CUS-2487424745,2018-09-14,Diana,F,-27.95,153.41,,00097987-7795-4c01-92c7-66bf486bacca,-27.92,120.7,WA,Leinster,debit,authorized,853150e5a77240f8b3b61282dd878c21,POS,20-30,2018,9,14,15,47,Friday,7 days,52855.65
ACC-1598451071,26,20.22,2195.3,1.0,CUS-2487424745,2018-09-14,Diana,F,-27.95,153.41,,7f921c2c-4819-45e6-92c8-07b21dd06eac,-28.12,153.47,QLD,Palm Beach,debit,authorized,b2d1023ccbd149caace62d63e41f9ab7,SALES-POS,20-30,2018,9,14,21,5,Friday,7 days,52855.65
ACC-1598451071,26,14.28,2181.02,1.0,CUS-2487424745,2018-09-14,Diana,F,-27.95,153.41,,e6bf73ae-dd3e-492e-8afb-ab040dcdbd44,-28.01,153.39,QLD,Benowa,debit,authorized,34a020f7eda34aaaba8e5936969642d9,SALES-POS,20-30,2018,9,14,21,12,Friday,7 days,52855.65
ACC-1598451071,26,8.11,2172.91,1.0,CUS-2487424745,2018-09-14,Diana,F,-27.95,153.41,,7fbd6363-a171-4ce6-ad92-c59fd7991396,-33.86,151.06,NSW,Lidcombe,debit,authorized,fd42d54410f84166959b9c347527b3ae,POS,20-30,2018,9,14,21,47,Friday,7 days,52855.65
ACC-1598451071,26,4.66,2168.25,1.0,CUS-2487424745,2018-09-14,Diana,F,-27.95,153.41,,2c3aa0ea-feca-44ae-8979-800ccc9bf3cb,-27.51,152.94,QLD,Kenmore,debit,authorized,814abfbe44934848954c46c090cf3337,SALES-POS,20-30,2018,9,14,22,1,Friday,7 days,52855.65
ACC-1598451071,26,7.33,2160.92,1.0,CUS-2487424745,2018-09-14,Diana,F,-27.95,153.41,,b7804a62-1556-4743-adec-eb6fd8644365,-27.55,153.03,QLD,Salisbury,debit,authorized,16708e6f986640f6975c2ae9bcc0fa08,POS,20-30,2018,9,14,22,11,Friday,7 days,52855.65
ACC-1598451071,26,11.52,2149.4,1.0,CUS-2487424745,2018-09-14,Diana,F,-27.95,153.41,,9317b506-51f0-4c27-9542-af6af493ac81,-28.08,153.36,QLD,Mudgeeraba,debit,authorized,4936ea689109460f9c4ee7220df39926,POS,20-30,2018,9,14,23,37,Friday,7 days,52855.65
ACC-1598451071,26,13.1,2136.3,1.0,CUS-2487424745,2018-09-15,Diana,F,-27.95,153.41,,ddf112bb-15d5-4c0f-a0c5-5aa73fcd7ac7,-28.03,153.39,QLD,Clear Island Waters,debit,authorized,e0f7dbb35db949269d059a6ebe07bc99,SALES-POS,20-30,2018,9,15,10,48,Saturday,7 days,52855.65
ACC-1598451071,26,26.47,2109.83,1.0,CUS-2487424745,2018-09-15,Diana,F,-27.95,153.41,,d9f44176-42ac-4e50-ae36-0b16ba748caa,-28.03,153.43,QLD,Broadbeach,debit,authorized,7f5e623ee9ee4e7ca4326b78f4e55b38,POS,20-30,2018,9,15,20,21,Saturday,7 days,52855.65
ACC-1598451071,26,5.72,2104.11,0.0,CUS-2487424745,2018-09-15,Diana,F,-27.95,153.41,,0db41b51-10e9-49d0-b6bd-2bb840dd76a9,-27.86,153.31,QLD,Coomera,debit,authorized,7596101eaa5f4b00a6bad76732a7fe2f,SALES-POS,20-30,2018,9,15,20,43,Saturday,7 days,52855.65
ACC-1598451071,26,6.54,2097.57,0.0,CUS-2487424745,2018-09-16,Diana,F,-27.95,153.41,,f37dc2ff-2dee-4774-b099-32860e4af443,-28.01,153.43,QLD,Surfers Paradise,debit,authorized,eff708130b2440b8badbafc562725540,SALES-POS,20-30,2018,9,16,12,7,Sunday,7 days,52855.65
ACC-1598451071,26,12.65,2084.92,1.0,CUS-2487424745,2018-09-16,Diana,F,-27.95,153.41,,88fc4153-6fdc-40c0-8f45-56244b44601e,-28.01,153.41,QLD,Bundall,debit,authorized,cc700678ff1c4e5facd98664b6dc403f,POS,20-30,2018,9,16,13,23,Sunday,7 days,52855.65
ACC-1598451071,26,16.79,2068.13,1.0,CUS-2487424745,2018-09-16,Diana,F,-27.95,153.41,,bddc90d0-43ca-4529-a835-ff2f6802cb4d,-28.54,153.55,NSW,Brunswick Heads,debit,authorized,5be47ebfabab46d4b995e611ae3832bb,POS,20-30,2018,9,16,14,31,Sunday,7 days,52855.65
ACC-1598451071,26,12.05,2056.08,1.0,CUS-2487424745,2018-09-16,Diana,F,-27.95,153.41,,9317b506-51f0-4c27-9542-af6af493ac81,-28.08,153.36,QLD,Mudgeeraba,debit,authorized,5b94c4bfe0f548ada5f7bcdf2a20e21c,POS,20-30,2018,9,16,14,51,Sunday,7 days,52855.65
ACC-1598451071,26,13.51,2042.57,1.0,CUS-2487424745,2018-09-16,Diana,F,-27.95,153.41,,5bc650f2-cd8d-46e9-b58e-2cae0ba33a03,-27.7,153.21,QLD,Eagleby,debit,authorized,bb0efe4da32a4b6fa6777e210107f005,SALES-POS,20-30,2018,9,16,16,9,Sunday,7 days,52855.65
ACC-1598451071,26,20.55,2022.02,1.0,CUS-2487424745,2018-09-16,Diana,F,-27.95,153.41,,de1b4205-d411-437b-a5c8-6e7cf7413848,-28.01,153.41,QLD,Bundall,debit,authorized,fdbd3b24cefa440dab55473665bf2853,SALES-POS,20-30,2018,9,16,17,8,Sunday,7 days,52855.65
ACC-1598451071,26,7.44,2014.58,1.0,CUS-2487424745,2018-09-16,Diana,F,-27.95,153.41,,e5ea11d7-0577-4fde-a153-cd3065dd944b,-28.09,153.4,QLD,Robina,debit,authorized,13666e248f05412aa25bbbecce83a39e,POS,20-30,2018,9,16,18,25,Sunday,7 days,52855.65
ACC-1598451071,26,22.36,1992.22,1.0,CUS-2487424745,2018-09-16,Diana,F,-27.95,153.41,,9b2514bf-2cb4-4432-a412-2b71f6dc14d3,-27.99,153,QLD,Beaudesert,debit,authorized,440f2cd3424e4115af9d2e532fb174d0,POS,20-30,2018,9,16,22,2,Sunday,7 days,52855.65
ACC-1598451071,26,3.67,1988.55,1.0,CUS-2487424745,2018-09-16,Diana,F,-27.95,153.41,,eeca8a89-8c38-4312-a6c9-9db0628b3658,-28.17,153.54,QLD,Coolangatta,debit,authorized,dafb9eb0c8214b2b92a89cb6afa0654a,POS,20-30,2018,9,16,23,9,Sunday,7 days,52855.65
ACC-1598451071,26,38.94,1949.61,0.0,CUS-2487424745,2018-09-17,Diana,F,-27.95,153.41,,4486cfb1-b6f7-466b-9473-561db42f46d5,-33.9,151.2,NSW,Alexandria,debit,authorized,4dd88effcd6e497690298228597f1ccd,SALES-POS,20-30,2018,9,17,6,7,Monday,7 days,52855.65
ACC-1598451071,26,11.33,1938.28,1.0,CUS-2487424745,2018-09-17,Diana,F,-27.95,153.41,,6b6f922a-8f7b-4708-a8b8-4054423556da,-27.98,152.99,QLD,Beaudesert,debit,authorized,93913b8c3a914f148836e9aa95895ac8,POS,20-30,2018,9,17,8,2,Monday,7 days,52855.65
ACC-1598451071,26,11.46,1926.82,0.0,CUS-2487424745,2018-09-17,Diana,F,-27.95,153.41,,6040fc72-0968-4f97-a440-d21ea75aef84,-37.82,144.95,VIC,Melbourne,debit,authorized,d35c490a512b4985a06acce3753e6d42,SALES-POS,20-30,2018,9,17,13,45,Monday,7 days,52855.65
ACC-1598451071,26,16.55,1910.27,0.0,CUS-2487424745,2018-09-17,Diana,F,-27.95,153.41,,96771859-4bff-4c75-8db7-0132179e1380,-27.97,153.42,QLD,Southport,debit,authorized,40d60704e98a49babd3b4b9ffef504fb,SALES-POS,20-30,2018,9,17,20,33,Monday,7 days,52855.65
ACC-1598451071,26,4.98,1905.29,1.0,CUS-2487424745,2018-09-17,Diana,F,-27.95,153.41,,41b770ca-3a73-4a04-aabc-a278eb5478e2,-28.07,153.44,QLD,Miami,debit,authorized,18c0dc9fc79a4bdb90427c02ae92c9dc,POS,20-30,2018,9,17,21,18,Monday,7 days,52855.65
ACC-1598451071,26,20.0,1885.29,,CUS-2487424745,2018-09-18,Diana,F,-27.95,153.41,,,,,,,debit,posted,03d1f21c2ba5426e862b987d6cc97a33,INTER BANK,20-30,2018,9,18,2,0,Tuesday,7 days,52855.65
ACC-1598451071,26,36.0,1834.44,,CUS-2487424745,2018-09-18,Diana,F,-27.95,153.41,,,,,,,debit,posted,2f237400b0104f80a6a2c65bd35b062f,PAYMENT,20-30,2018,9,18,7,0,Tuesday,7 days,52855.65
ACC-1598451071,26,14.85,1870.44,1.0,CUS-2487424745,2018-09-18,Diana,F,-27.95,153.41,,8d7196ad-1377-4169-b035-42cbf36a7907,-27.93,153.34,QLD,Helensvale,debit,authorized,059836f3f37e4e86b8dd2d1b00be273e,POS,20-30,2018,9,18,7,47,Tuesday,7 days,52855.65
ACC-1598451071,26,58.31,1776.13,1.0,CUS-2487424745,2018-09-18,Diana,F,-27.95,153.41,,d1975543-9c34-4f1d-8f7d-980d0e2f024f,-28.28,153.58,NSW,Kingscliff,debit,authorized,e1a5c1dcf09546889c0f9b6fe5ce13e2,SALES-POS,20-30,2018,9,18,9,32,Tuesday,7 days,52855.65
ACC-1598451071,26,10.8,1765.33,1.0,CUS-2487424745,2018-09-18,Diana,F,-27.95,153.41,,4345dbd1-dfa8-4466-892a-4136a5ae08a2,-27.94,153.41,QLD,Labrador,debit,authorized,948e758a6afe4261a8c9931b88b955b6,POS,20-30,2018,9,18,10,54,Tuesday,7 days,52855.65
ACC-1598451071,26,14.13,1751.2,1.0,CUS-2487424745,2018-09-18,Diana,F,-27.95,153.41,,780c3e1e-47b6-49d3-a59f-6c86b4d1c924,-27.76,153.25,QLD,Ormeau,debit,authorized,13e4a08a0b29489b83326d59d4b98caf,POS,20-30,2018,9,18,11,7,Tuesday,7 days,52855.65
ACC-1598451071,26,5.0,1746.2,1.0,CUS-2487424745,2018-09-18,Diana,F,-27.95,153.41,,1463608f-b5ce-4d76-b951-aff54bb974f9,-27.45,153.01,QLD,Kelvin Grove,debit,authorized,ea1d90ab8d4a464bb7e57ca5aa700bb3,POS,20-30,2018,9,18,11,32,Tuesday,7 days,52855.65
ACC-1598451071,26,5.61,1740.59,1.0,CUS-2487424745,2018-09-18,Diana,F,-27.95,153.41,,4ebc6c77-466d-4bc1-84cb-79098be0f2df,-28.12,153.47,QLD,Palm Beach,debit,authorized,2ed29910605d4265bfa67687975b01e1,POS,20-30,2018,9,18,14,23,Tuesday,7 days,52855.65
ACC-1598451071,26,10.83,1729.76,1.0,CUS-2487424745,2018-09-18,Diana,F,-27.95,153.41,,a6a51af8-8bb2-44af-acdd-01bbec89e2a3,-27.5,153.04,QLD,Woolloongabba,debit,authorized,ccda2d9e7e9647cd9d259546525d07f1,SALES-POS,20-30,2018,9,18,14,46,Tuesday,7 days,52855.65
ACC-1598451071,26,2.28,1727.48,0.0,CUS-2487424745,2018-09-18,Diana,F,-27.95,153.41,,1f740c9f-75ff-4562-a173-009a3cd55556,-28.05,153.41,QLD,Mermaid Waters,debit,authorized,d6d3af40ec4d4012bb4160be94bdad55,SALES-POS,20-30,2018,9,18,22,16,Tuesday,7 days,52855.65
ACC-1598451071,26,7.93,1719.55,1.0,CUS-2487424745,2018-09-18,Diana,F,-27.95,153.41,,bec54cd6-3005-4704-86bb-3fa30d7ff16d,-28.08,153.44,QLD,Miami,debit,authorized,174fbc4a764b4724823ee4310fadb22e,SALES-POS,20-30,2018,9,18,23,16,Tuesday,7 days,52855.65
ACC-1598451071,26,5.79,1713.76,1.0,CUS-2487424745,2018-09-19,Diana,F,-27.95,153.41,,fd8549ee-2267-4a84-b019-4538e3ecf9e0,-27.52,153.22,QLD,Alexandra Hills,debit,authorized,284ab67698c74b828d54bd89f34a1493,SALES-POS,20-30,2018,9,19,0,44,Wednesday,7 days,52855.65
ACC-1598451071,26,9.53,2717.9,1.0,CUS-2487424745,2018-09-22,Diana,F,-27.95,153.41,,d1914cd8-5226-4cb0-9adc-8c5eb35d07ce,-28.01,153.33,QLD,Highland Park,debit,authorized,81e5f20d93e541c5a39be9b374c46910,SALES-POS,20-30,2018,9,22,10,17,Saturday,7 days,52855.65
ACC-1598451071,26,8.44,2709.46,1.0,CUS-2487424745,2018-09-22,Diana,F,-27.95,153.41,,b27689af-4d1e-49b2-b3af-4139ac5d2b6c,-27.94,153.37,VIC,Arundel,debit,authorized,ca6573025eb041e89c588796064bf604,SALES-POS,20-30,2018,9,22,10,39,Saturday,7 days,52855.65
ACC-1598451071,26,6.4,2703.06,1.0,CUS-2487424745,2018-09-22,Diana,F,-27.95,153.41,,905df638-9513-4d5d-b5c2-65da440c19d0,-27.47,153.03,QLD,Brisbane City,debit,authorized,d9ccfac6c76140e6a477813c8928a71c,SALES-POS,20-30,2018,9,22,11,23,Saturday,7 days,52855.65
ACC-1598451071,26,8.08,2694.98,1.0,CUS-2487424745,2018-09-22,Diana,F,-27.95,153.41,,215e3686-58cc-471e-9cfb-337fe006c84d,-27.93,153.39,QLD,Biggera Waters,debit,authorized,3804cde16eaf42cdbf8309596a69755e,SALES-POS,20-30,2018,9,22,11,38,Saturday,7 days,52855.65
ACC-1598451071,26,11.77,2683.21,1.0,CUS-2487424745,2018-09-22,Diana,F,-27.95,153.41,,bb894766-dd09-429c-9450-c7c778fb1a27,-27.49,152.98,QLD,Taringa,debit,authorized,8d8f57b8f96f4418b47a719c5fb0e869,SALES-POS,20-30,2018,9,22,12,36,Saturday,7 days,52855.65
ACC-1598451071,26,9.6,2673.61,1.0,CUS-2487424745,2018-09-22,Diana,F,-27.95,153.41,,561da974-7020-4548-835e-79727643471d,-27.93,153.39,QLD,Biggera Waters,debit,authorized,1efb5a26d9f34e719e11eb48decb70b3,POS,20-30,2018,9,22,12,52,Saturday,7 days,52855.65
ACC-1598451071,26,8.22,2665.39,1.0,CUS-2487424745,2018-09-22,Diana,F,-27.95,153.41,,6d5123a4-2e72-4fd3-9892-1b84bcd5e084,-28.01,153.4,QLD,Benowa,debit,authorized,032deb7c4d954e62a7654a7bb30bafa1,SALES-POS,20-30,2018,9,22,14,59,Saturday,7 days,52855.65
ACC-1598451071,26,6.52,2658.87,0.0,CUS-2487424745,2018-09-22,Diana,F,-27.95,153.41,,601bc008-50c1-4dad-9ea0-5f52273a2480,-27.93,153.4,QLD,Runaway Bay,debit,authorized,9ab5211d641a4d338af345c9ef89760d,SALES-POS,20-30,2018,9,22,18,18,Saturday,7 days,52855.65
ACC-1598451071,26,5.35,2653.52,1.0,CUS-2487424745,2018-09-22,Diana,F,-27.95,153.41,,91f952db-5094-4e65-8fd8-7c9cff78a66f,-28.04,153.42,QLD,Mermaid Waters,debit,authorized,4dcf19a602eb4aee9d17cbdfb6fa6c1d,SALES-POS,20-30,2018,9,22,19,24,Saturday,7 days,52855.65
ACC-1598451071,26,23.04,2630.48,1.0,CUS-2487424745,2018-09-22,Diana,F,-27.95,153.41,,62c5b6d2-c18d-4db6-a668-45b7ed074600,-28.03,153.43,QLD,Broadbeach,debit,authorized,8fd837ec412b47eb96918c525250ed55,SALES-POS,20-30,2018,9,22,21,29,Saturday,7 days,52855.65
ACC-1598451071,26,12.87,2617.61,1.0,CUS-2487424745,2018-09-22,Diana,F,-27.95,153.41,,4b1ac969-e729-47ab-a748-d08521dc1d1f,-28.09,153.45,QLD,Gold Coast,debit,authorized,cdbb53886c0c4353984995811b25207e,POS,20-30,2018,9,22,22,14,Saturday,7 days,52855.65
ACC-1598451071,26,11.81,2605.8,1.0,CUS-2487424745,2018-09-22,Diana,F,-27.95,153.41,,0abb2f4b-6297-4d55-9cec-147efad78b7f,-28.07,153.44,QLD,Miami,debit,authorized,cd405a75a4e44b7aa57d1cfe4e7bcfc4,SALES-POS,20-30,2018,9,22,22,31,Saturday,7 days,52855.65
ACC-1598451071,26,16.12,2589.68,1.0,CUS-2487424745,2018-09-23,Diana,F,-27.95,153.41,,205a6dce-4abe-4ccd-aa1f-f2912ff76583,-27.43,153.52,QLD,Point Lookout,debit,authorized,dbe4c39b58314b8e928bf4f65bd02329,POS,20-30,2018,9,23,11,50,Sunday,7 days,52855.65
ACC-1598451071,26,9.98,2579.7,1.0,CUS-2487424745,2018-09-23,Diana,F,-27.95,153.41,,dc517250-5330-4567-8f8c-a737e8bf63ab,-28.11,153.46,QLD,Palm Beach,debit,authorized,e65e2db8b93b43f5a6bd1c02943e30a7,POS,20-30,2018,9,23,12,3,Sunday,7 days,52855.65
ACC-1598451071,26,15.98,2563.72,1.0,CUS-2487424745,2018-09-23,Diana,F,-27.95,153.41,,541ca120-5600-48cd-adca-3e638d2baffb,-27.97,153.41,QLD,Southport,debit,authorized,de15a579948845aeb982407dce4aba4c,POS,20-30,2018,9,23,14,13,Sunday,7 days,52855.65
ACC-1598451071,26,18.08,2545.64,1.0,CUS-2487424745,2018-09-23,Diana,F,-27.95,153.41,,79f1d725-1af6-46a9-b6ae-9fb8ee12cd87,-27.9,153.31,QLD,Oxenford,debit,authorized,bbfec128abe3410e901562404dff2522,SALES-POS,20-30,2018,9,23,14,51,Sunday,7 days,52855.65
ACC-1598451071,26,19.99,2525.65,0.0,CUS-2487424745,2018-09-23,Diana,F,-27.95,153.41,,c7d169a9-fe96-4983-8d1e-9c0c6805a31e,-33.88,151.22,NSW,Darlinghurst,debit,authorized,1ff976e009ea4ce0bde15a1b3227fe51,SALES-POS,20-30,2018,9,23,15,3,Sunday,7 days,52855.65
ACC-1598451071,26,15.39,2510.26,1.0,CUS-2487424745,2018-09-23,Diana,F,-27.95,153.41,,8d7196ad-1377-4169-b035-42cbf36a7907,-27.93,153.34,QLD,Helensvale,debit,authorized,9f6304bd1fb44459903b21398236dc3f,SALES-POS,20-30,2018,9,23,21,6,Sunday,7 days,52855.65
ACC-1598451071,26,16.2,2494.06,1.0,CUS-2487424745,2018-09-23,Diana,F,-27.95,153.41,,c4ab07ea-6c0a-40e4-a23c-aee19b347d6c,-28.08,153.37,QLD,Mudgeeraba,debit,authorized,2092faf04e0c48619471f9d89452c2a4,POS,20-30,2018,9,23,21,29,Sunday,7 days,52855.65
ACC-1598451071,26,2.63,2491.43,1.0,CUS-2487424745,2018-09-23,Diana,F,-27.95,153.41,,996dfa41-bc48-4faa-aef3-b4366784b273,-27.97,153.42,QLD,Southport,debit,authorized,12cee6147c154bda87365d0f4832b644,POS,20-30,2018,9,23,21,44,Sunday,7 days,52855.65
ACC-1598451071,26,11.68,2479.75,1.0,CUS-2487424745,2018-09-23,Diana,F,-27.95,153.41,,6e611b46-b2f3-40bb-a965-cca9ac455e9a,-28.01,153.43,QLD,Surfers Paradise,debit,authorized,629437de264346f39207d717a1d42007,SALES-POS,20-30,2018,9,23,22,48,Sunday,7 days,52855.65
ACC-1598451071,26,13.59,2466.16,1.0,CUS-2487424745,2018-09-23,Diana,F,-27.95,153.41,,079b8a87-003e-4879-a8d3-04a2c8be71b6,-28.08,153.37,QLD,Mudgeeraba,debit,authorized,150efddf2e5e4e5fb3484fc9d5284f6d,POS,20-30,2018,9,23,22,55,Sunday,7 days,52855.65
ACC-1598451071,26,22.99,2443.17,1.0,CUS-2487424745,2018-09-24,Diana,F,-27.95,153.41,,324eaa2a-4b1a-470b-a923-b94e72b7a8c2,-27.86,153.31,QLD,Upper Coomera,debit,authorized,476684ec3c8746c985c7788e6b2c27c0,SALES-POS,20-30,2018,9,24,7,9,Monday,7 days,52855.65
ACC-1598451071,26,10.31,2432.86,0.0,CUS-2487424745,2018-09-24,Diana,F,-27.95,153.41,,3da9c75a-c681-49cd-8ac1-dbbc2d0feff1,-27.93,153.39,QLD,Biggera Waters,debit,authorized,ff8681a7fb164f129f18e00b4912fcac,POS,20-30,2018,9,24,8,40,Monday,7 days,52855.65
ACC-1598451071,26,6.74,2426.12,1.0,CUS-2487424745,2018-09-24,Diana,F,-27.95,153.41,,5a3d5cd5-8727-46ce-a599-5d51f1a10c41,-27.92,153.32,QLD,Oxenford,debit,authorized,e0378d9f66484da1a1b39e5847fc36c8,SALES-POS,20-30,2018,9,24,9,9,Monday,7 days,52855.65
ACC-1598451071,26,12.32,2413.8,0.0,CUS-2487424745,2018-09-24,Diana,F,-27.95,153.41,,8e505d2d-6f4a-45ba-b3f2-f22e4d7898f4,-27.51,153.06,QLD,Coorparoo,debit,authorized,4b598f031be44581bca485606acf8343,POS,20-30,2018,9,24,13,28,Monday,7 days,52855.65
ACC-1598451071,26,20.0,2393.8,,CUS-2487424745,2018-09-25,Diana,F,-27.95,153.41,,,,,,,debit,posted,51b7c7961f984ed39f04fb0526d0edd0,INTER BANK,20-30,2018,9,25,2,0,Tuesday,7 days,52855.65
ACC-1598451071,26,6.21,2387.59,1.0,CUS-2487424745,2018-09-25,Diana,F,-27.95,153.41,,79cfaa6a-041c-456d-b109-af68f24c694e,-28.02,153.37,QLD,Carrara,debit,authorized,0e7af8af8b184ef28444bb98d1fbd0ab,POS,20-30,2018,9,25,4,15,Tuesday,7 days,52855.65
ACC-1598451071,26,36.0,2351.59,,CUS-2487424745,2018-09-25,Diana,F,-27.95,153.41,,,,,,,debit,posted,9d664fe8de694922a565d585c0bffc2c,PAYMENT,20-30,2018,9,25,7,0,Tuesday,7 days,52855.65
ACC-1598451071,26,7.19,3358.07,0.0,CUS-2487424745,2018-09-27,Diana,F,-27.95,153.41,,8a0e9a21-4360-4421-8aac-9af5114c9cda,-28.08,153.39,QLD,Robina,debit,authorized,e88060924c1940b3811d1f0967868914,SALES-POS,20-30,2018,9,27,1,50,Thursday,7 days,52855.65
ACC-1598451071,26,11.28,3346.79,1.0,CUS-2487424745,2018-09-27,Diana,F,-27.95,153.41,,c41ce215-6d2f-45d2-a6a0-e342bb6e8f4e,-28.04,153.42,QLD,Broadbeach,debit,authorized,71e5eea7b3a448db89241f1c7cb31ded,POS,20-30,2018,9,27,9,54,Thursday,7 days,52855.65
ACC-1598451071,26,9.92,3336.87,1.0,CUS-2487424745,2018-09-27,Diana,F,-27.95,153.41,,5c978d97-ab41-45bc-bff0-84fa7090166a,-28.02,153.43,QLD,Surfers Paradise,debit,authorized,5ccd167195f842aaa16fdcc75c6a5208,SALES-POS,20-30,2018,9,27,11,15,Thursday,7 days,52855.65
ACC-1598451071,26,18.51,3318.36,1.0,CUS-2487424745,2018-09-27,Diana,F,-27.95,153.41,,a9bb0017-0584-442d-b2c3-12e1cf00cfc4,-28.07,153.44,QLD,Miami,debit,authorized,a2004279ce3a4bca8cabbef91a1228de,SALES-POS,20-30,2018,9,27,14,49,Thursday,7 days,52855.65
ACC-1598451071,26,25.92,3292.44,1.0,CUS-2487424745,2018-09-27,Diana,F,-27.95,153.41,,96597495-1fc0-496e-b131-e9667c9f72aa,-27.49,153.22,QLD,Birkdale,debit,authorized,e0928ba9a56c4fd8997c76d2dcee8fe3,SALES-POS,20-30,2018,9,27,21,3,Thursday,7 days,52855.65
ACC-1598451071,26,16.78,3275.66,1.0,CUS-2487424745,2018-09-27,Diana,F,-27.95,153.41,,b70eecd5-e205-4b88-a85d-839514a344da,-27.98,153.41,QLD,Southport,debit,authorized,79a409da2df34618aa535ac4a5135e6d,SALES-POS,20-30,2018,9,27,23,5,Thursday,7 days,52855.65
ACC-1598451071,26,8.25,3267.41,1.0,CUS-2487424745,2018-09-27,Diana,F,-27.95,153.41,,e1b3c433-30f3-401a-845b-6f88747e1078,-27.91,153.32,QLD,Helensvale,debit,authorized,b1339e98f362409bbcb07e275fc9c41e,POS,20-30,2018,9,27,23,29,Thursday,7 days,52855.65
ACC-1598451071,26,7.61,3259.8,1.0,CUS-2487424745,2018-09-28,Diana,F,-27.95,153.41,,a5d2b1a8-57be-4f3b-90c5-6b0d08a6c5e9,-27.98,153.43,QLD,Main Beach,debit,authorized,5775de1fe3d5484a96db6c3d0d61bb76,POS,20-30,2018,9,28,4,8,Friday,7 days,52855.65
ACC-1598451071,26,4.89,3254.91,1.0,CUS-2487424745,2018-09-28,Diana,F,-27.95,153.41,,db329e3a-807e-4476-9ad9-43611c4c73e2,-28.01,153.34,QLD,Nerang,debit,authorized,9488f2a1350f4d4c9ce3ccad5562613e,POS,20-30,2018,9,28,4,29,Friday,7 days,52855.65
ACC-1598451071,26,16.73,3238.18,1.0,CUS-2487424745,2018-09-28,Diana,F,-27.95,153.41,,4c06ba8a-d71c-439b-988c-3f5c305bd538,-27.42,152.99,QLD,Enoggera,debit,authorized,e5fa4dc87a084d968d29c03c06bd6785,SALES-POS,20-30,2018,9,28,8,43,Friday,7 days,52855.65
ACC-1598451071,26,10.99,3227.19,1.0,CUS-2487424745,2018-09-28,Diana,F,-27.95,153.41,,7230b09a-e32b-4e1d-af1c-c8b4a587064f,-28.01,153.43,QLD,Surfers Paradise,debit,authorized,e4c64de9260344348a07f8fb319293d8,POS,20-30,2018,9,28,9,1,Friday,7 days,52855.65
ACC-1598451071,26,9.68,3217.51,1.0,CUS-2487424745,2018-09-28,Diana,F,-27.95,153.41,,6b6f922a-8f7b-4708-a8b8-4054423556da,-27.98,152.99,QLD,Beaudesert,debit,authorized,65fffdb9adbf49e3ad02c7286c410595,SALES-POS,20-30,2018,9,28,9,13,Friday,7 days,52855.65
ACC-1598451071,26,5.71,3211.8,1.0,CUS-2487424745,2018-09-28,Diana,F,-27.95,153.41,,29389dcd-6b1a-43df-9fcd-165665b70f36,-27.85,153.3,QLD,Upper Coomera,debit,authorized,ac8c6004d2c949bdba82dcd6936c9db0,SALES-POS,20-30,2018,9,28,9,35,Friday,7 days,52855.65
ACC-1598451071,26,6.21,3205.59,0.0,CUS-2487424745,2018-09-28,Diana,F,-27.95,153.41,,85ce7f6f-63f0-4a59-8e8b-b0353ee225a7,-27.93,153.39,QLD,Biggera Waters,debit,authorized,8e07dae5a2bb44b78c52fdcb3c92aee7,POS,20-30,2018,9,28,9,58,Friday,7 days,52855.65
ACC-1598451071,26,6.89,3198.7,1.0,CUS-2487424745,2018-09-28,Diana,F,-27.95,153.41,,8a9715d5-d217-4dc4-949c-abacd9ba89b4,-27.93,153.39,QLD,Biggera Waters,debit,authorized,52b78845ab5a4e29a5a273a5d40dc0d6,POS,20-30,2018,9,28,10,49,Friday,7 days,52855.65
ACC-1598451071,26,10.36,3188.34,1.0,CUS-2487424745,2018-09-28,Diana,F,-27.95,153.41,,9324b04d-49fb-4492-8800-fea833f8024a,-27.47,153.1,QLD,Cannon Hill,debit,authorized,9f77ef1085124f14bd33ddfb1e44b8b8,SALES-POS,20-30,2018,9,28,11,45,Friday,7 days,52855.65
ACC-1598451071,26,9.69,3178.65,1.0,CUS-2487424745,2018-09-28,Diana,F,-27.95,153.41,,93a49bbd-78ee-4227-b5ed-13e6dc8dd1c4,-27.91,153.39,QLD,Runaway Bay,debit,authorized,3858723a5a684458a1ee86c4c65c3e9e,POS,20-30,2018,9,28,12,16,Friday,7 days,52855.65
ACC-1598451071,26,5.57,3173.08,1.0,CUS-2487424745,2018-09-28,Diana,F,-27.95,153.41,,09a24c18-f441-4f5b-8b8c-22a5acf21cf3,-28.05,153.37,QLD,Merrimac,debit,authorized,1761200953ce4e4387a6db36c014d5ce,POS,20-30,2018,9,28,12,31,Friday,7 days,52855.65
ACC-1598451071,26,8.78,3164.3,1.0,CUS-2487424745,2018-09-28,Diana,F,-27.95,153.41,,b25a0dce-883e-47ab-8713-28de5f69de01,-27.99,153.43,QLD,Surfers Paradise,debit,authorized,347ce5eec18446de9ab3f4ee2016e793,POS,20-30,2018,9,28,13,3,Friday,7 days,52855.65
ACC-1598451071,26,12.45,3151.85,0.0,CUS-2487424745,2018-09-28,Diana,F,-27.95,153.41,,c962337e-85c0-45ff-b1a3-9c9128a46328,-28.09,153.42,QLD,Varsity Lakes,debit,authorized,03222301b2be4d22be3fcd055ce87171,POS,20-30,2018,9,28,16,33,Friday,7 days,52855.65
ACC-1598451071,26,9.33,3142.52,1.0,CUS-2487424745,2018-09-28,Diana,F,-27.95,153.41,,168766cc-de85-4110-a46a-4bebab0aa5c6,-28.04,153.43,QLD,Broadbeach,debit,authorized,497c54feb2eb4cd1a0f09cf9afe9f89a,SALES-POS,20-30,2018,9,28,17,12,Friday,7 days,52855.65
ACC-1598451071,26,18.54,3123.98,0.0,CUS-2487424745,2018-09-28,Diana,F,-27.95,153.41,,8cd68604-4ece-404b-8332-4ae0374c0950,-28.01,153.4,QLD,Benowa,debit,authorized,f2c2bb54dbd1468c81a91008639b5844,POS,20-30,2018,9,28,19,19,Friday,7 days,52855.65
ACC-1598451071,26,8.13,3115.85,1.0,CUS-2487424745,2018-09-28,Diana,F,-27.95,153.41,,78706e2c-6904-4f24-a43d-9bc9b2c49e4b,-27.89,153.39,QLD,Paradise Point,debit,authorized,5508172604f24bdfa480635845203a72,POS,20-30,2018,9,28,19,37,Friday,7 days,52855.65
ACC-1598451071,26,10.45,3105.4,1.0,CUS-2487424745,2018-09-28,Diana,F,-27.95,153.41,,b4b8f69e-b04b-4bb4-8cd7-71a86f93829b,-27.51,153.11,QLD,Carindale,debit,authorized,7ad98b61ab164ce9953565a57541c90b,SALES-POS,20-30,2018,9,28,19,56,Friday,7 days,52855.65
ACC-1598451071,26,5.59,3099.81,1.0,CUS-2487424745,2018-09-28,Diana,F,-27.95,153.41,,935c57d3-5c51-4bba-a352-1efbf28c9854,-27.94,153.41,QLD,Labrador,debit,authorized,210419baedc4408eb92f7b1ec196d146,POS,20-30,2018,9,28,22,38,Friday,7 days,52855.65
ACC-1598451071,26,6.29,3093.52,1.0,CUS-2487424745,2018-09-28,Diana,F,-27.95,153.41,,8902f350-190c-43a7-b8cf-8784e654c6fb,-27.97,153.42,QLD,Southport,debit,authorized,7315075f078f41e4b04e2fcae3120d67,POS,20-30,2018,9,28,22,53,Friday,7 days,52855.65
ACC-1598451071,26,17.5,3076.02,1.0,CUS-2487424745,2018-09-29,Diana,F,-27.95,153.41,,f46c30a9-60b8-4294-8a21-c510190c32b0,-27.99,153,QLD,Beaudesert,debit,authorized,125195b9c97d42c3b78a9f638dca8753,POS,20-30,2018,9,29,4,21,Saturday,7 days,52855.65
ACC-1598451071,26,12.88,3063.14,1.0,CUS-2487424745,2018-09-29,Diana,F,-27.95,153.41,,08d6298a-aec8-4bbf-ae6c-f61173d93ae4,-28.52,153.55,NSW,Ocean Shores,debit,authorized,eda4bd5c34564b23ad3929e2802e18b8,SALES-POS,20-30,2018,9,29,9,13,Saturday,7 days,52855.65
ACC-1598451071,26,17.27,3045.87,1.0,CUS-2487424745,2018-09-29,Diana,F,-27.95,153.41,,7deda505-d941-43ac-9d5e-f866d57dcc4e,-27.93,153.34,QLD,Helensvale,debit,authorized,f5a687c9782d4e32b346d8ec6fb8652f,POS,20-30,2018,9,29,10,56,Saturday,7 days,52855.65
ACC-1598451071,26,12.68,3033.19,1.0,CUS-2487424745,2018-09-29,Diana,F,-27.95,153.41,,3a34050c-5a24-497c-a27f-1b2924c898bd,-27.96,153.38,QLD,Parkwood,debit,authorized,9817dd20f5e64f1f9e8a7cbd2caccb28,SALES-POS,20-30,2018,9,29,11,23,Saturday,7 days,52855.65
ACC-1598451071,26,15.9,3017.29,0.0,CUS-2487424745,2018-09-29,Diana,F,-27.95,153.41,,780c3e1e-47b6-49d3-a59f-6c86b4d1c924,-27.76,153.25,QLD,Ormeau,debit,authorized,bf5ed39a8fcc4948aa7aa6a641ccf1ba,SALES-POS,20-30,2018,9,29,11,55,Saturday,7 days,52855.65
ACC-1598451071,26,23.71,2993.58,0.0,CUS-2487424745,2018-09-29,Diana,F,-27.95,153.41,,9b2514bf-2cb4-4432-a412-2b71f6dc14d3,-27.99,153,QLD,Beaudesert,debit,authorized,c911b706f1c04558a1e775d99851c56b,SALES-POS,20-30,2018,9,29,12,3,Saturday,7 days,52855.65
ACC-1598451071,26,14.37,2979.21,1.0,CUS-2487424745,2018-09-29,Diana,F,-27.95,153.41,,e6bf73ae-dd3e-492e-8afb-ab040dcdbd44,-28.01,153.39,QLD,Benowa,debit,authorized,5279003889264adf9ffded5000115d51,SALES-POS,20-30,2018,9,29,17,7,Saturday,7 days,52855.65
ACC-1598451071,26,12.68,2966.53,1.0,CUS-2487424745,2018-09-29,Diana,F,-27.95,153.41,,430c23a4-b449-4225-8c79-d7f274810e6e,-27.93,153.38,QLD,Arundel,debit,authorized,cb500aae9ae94c658ac2c9cfdd325890,SALES-POS,20-30,2018,9,29,17,16,Saturday,7 days,52855.65
ACC-1598451071,26,24.77,2941.76,1.0,CUS-2487424745,2018-09-29,Diana,F,-27.95,153.41,,68884f04-d661-4dfd-8eb2-4c9c27573bbb,-27.91,153.39,QLD,Runaway Bay,debit,authorized,93f0f061d6634438b9fccb0c20f2c2ff,SALES-POS,20-30,2018,9,29,17,44,Saturday,7 days,52855.65
ACC-1598451071,26,10.33,2931.43,1.0,CUS-2487424745,2018-09-29,Diana,F,-27.95,153.41,,1b9a5c03-02c3-4604-8e87-89aa4f4c2322,-33.84,151.21,NSW,North Sydney,debit,authorized,137f2f7eb7f945dfbda148c2c1f3096b,POS,20-30,2018,9,29,19,5,Saturday,7 days,52855.65
ACC-1598451071,26,27.15,2904.28,1.0,CUS-2487424745,2018-09-29,Diana,F,-27.95,153.41,,65e6ea12-42c5-45e0-bf37-3d1448bea1a4,-28.09,153.45,QLD,Burleigh Heads,debit,authorized,5a970deb31624e089767a83ce5ebb022,SALES-POS,20-30,2018,9,29,21,40,Saturday,7 days,52855.65
ACC-1598451071,26,10.74,2893.54,1.0,CUS-2487424745,2018-09-29,Diana,F,-27.95,153.41,,ad7d9c43-19bb-4bf1-a1a8-cd67e51a50ec,-27.97,153.43,QLD,Main Beach,debit,authorized,3d861f8f67494d1ab8fb2d8495af228a,SALES-POS,20-30,2018,9,29,21,56,Saturday,7 days,52855.65
ACC-1598451071,26,3.3,2890.24,1.0,CUS-2487424745,2018-09-30,Diana,F,-27.95,153.41,,76a49112-72f3-4b14-bd9d-64937b9c0893,-27.93,153.39,QLD,Biggera Waters,debit,authorized,963bd86c60b3458e8bd4009f6cf0659b,SALES-POS,20-30,2018,9,30,16,39,Sunday,7 days,52855.65
ACC-1598451071,26,29.12,2861.12,1.0,CUS-2487424745,2018-09-30,Diana,F,-27.95,153.41,,7b7d9bd7-6683-44df-aa06-6b586edf869d,-33.87,151.21,NSW,Sydney,debit,authorized,cdb7833f2f16439d8b94f48e483abfae,POS,20-30,2018,9,30,17,1,Sunday,7 days,52855.65
ACC-1598451071,26,5.3,2855.82,1.0,CUS-2487424745,2018-09-30,Diana,F,-27.95,153.41,,59e3bccd-966c-403e-a6c5-29932099b26f,-28.06,153.41,QLD,Robina,debit,authorized,b791ad256ca84f4ba3f368069d96e830,SALES-POS,20-30,2018,9,30,21,19,Sunday,7 days,52855.65
ACC-1598451071,26,6.4,2849.42,1.0,CUS-2487424745,2018-09-30,Diana,F,-27.95,153.41,,73ab665f-b297-4746-bd85-d9d30ab48236,-27.97,153.41,QLD,Southport,debit,authorized,25b1aca58a2441aab0bcb0474437d4aa,SALES-POS,20-30,2018,9,30,21,55,Sunday,7 days,52855.65
ACC-1598451071,26,8.46,2840.96,0.0,CUS-2487424745,2018-09-30,Diana,F,-27.95,153.41,,df4c4458-6b98-4e47-b245-e5566889929f,-27.85,153.3,QLD,Upper Coomera,debit,authorized,afd9159013af4fd1bdb6ad63e60e5a42,POS,20-30,2018,9,30,22,3,Sunday,7 days,52855.65
ACC-1598451071,26,20.0,2820.96,,CUS-2487424745,2018-10-02,Diana,F,-27.95,153.41,,,,,,,debit,posted,4271de0f4e2a492fa964e1839d8b2a43,INTER BANK,20-30,2018,10,2,2,0,Tuesday,7 days,52855.65
ACC-1598451071,26,36.0,2784.96,,CUS-2487424745,2018-10-02,Diana,F,-27.95,153.41,,,,,,,debit,posted,3d6f8d318c4f486483d851ebbefa0697,PAYMENT,20-30,2018,10,2,7,0,Tuesday,7 days,52855.65
ACC-1598451071,26,19.72,2765.24,0.0,CUS-2487424745,2018-10-02,Diana,F,-27.95,153.41,,60ea21a0-2e86-4148-968e-ab73246ea0bb,-28.03,153.43,QLD,Broadbeach,debit,authorized,12ff2d98e63440f3a05c13e9fe450c22,POS,20-30,2018,10,2,9,49,Tuesday,7 days,52855.65
ACC-1598451071,26,16.14,2749.1,1.0,CUS-2487424745,2018-10-02,Diana,F,-27.95,153.41,,e29d3f0f-c26f-4c94-8646-12e43b8b6542,-33.73,150.96,NSW,Baulkham Hills,debit,authorized,3be0fa990ce144fc8da50c290fe01595,SALES-POS,20-30,2018,10,2,10,25,Tuesday,7 days,52855.65
ACC-1598451071,26,4.8,2744.3,0.0,CUS-2487424745,2018-10-02,Diana,F,-27.95,153.41,,023f7601-2795-4081-9ffe-3199ee4b49c2,-27.91,153.4,QLD,Runaway Bay,debit,authorized,f4304a11da934da3b44e2c104ca13624,POS,20-30,2018,10,2,10,54,Tuesday,7 days,52855.65
ACC-1598451071,26,10.74,2733.56,1.0,CUS-2487424745,2018-10-02,Diana,F,-27.95,153.41,,1bf93308-9108-4f13-9e18-4c4be1f07736,-27.97,153.42,QLD,Southport,debit,authorized,2d93d877c876469da89f58afe2919b7f,POS,20-30,2018,10,2,16,4,Tuesday,7 days,52855.65
ACC-1598451071,26,27.49,2706.07,1.0,CUS-2487424745,2018-10-03,Diana,F,-27.95,153.41,,680180ca-5735-4548-a19b-82f068a578b8,-27.47,153.01,QLD,Milton,debit,authorized,d586d8a270ed4d9fb334d53ad8a51ce3,POS,20-30,2018,10,3,1,55,Wednesday,7 days,52855.65
ACC-1598451071,26,0.1,2705.97,1.0,CUS-2487424745,2018-10-03,Diana,F,-27.95,153.41,,03b8bb86-abbd-4769-87e5-a78a0c13b95e,-28.03,153.43,QLD,Broadbeach,debit,authorized,4f3a5aff070e43fcaeebd0ae0cd24caa,SALES-POS,20-30,2018,10,3,3,19,Wednesday,7 days,52855.65
ACC-1598451071,26,195.0,2510.97,,CUS-2487424745,2018-10-03,Diana,F,-27.95,153.41,,,,,,,debit,posted,76cb9212c1ef4a59aacb59f88217d322,PAYMENT,20-30,2018,10,3,6,0,Wednesday,7 days,52855.65
ACC-1598451071,26,28.29,2482.68,1.0,CUS-2487424745,2018-10-03,Diana,F,-27.95,153.41,,b88cd541-59bf-4bb6-be5a-8a7e000dd472,-27.4,153.01,QLD,Stafford Heights,debit,authorized,1ec16b2f3e2d47509e6a31827f6bc71e,SALES-POS,20-30,2018,10,3,8,50,Wednesday,7 days,52855.65
ACC-1598451071,26,22.76,2459.92,1.0,CUS-2487424745,2018-10-03,Diana,F,-27.95,153.41,,55a8eac0-a5ab-44a0-be0d-e8d7ae1c3821,-27.99,153.37,QLD,Ashmore,debit,authorized,1168523a202445bead5c465667b02650,POS,20-30,2018,10,3,9,50,Wednesday,7 days,52855.65
ACC-1598451071,26,4.32,2455.6,1.0,CUS-2487424745,2018-10-03,Diana,F,-27.95,153.41,,0db41b51-10e9-49d0-b6bd-2bb840dd76a9,-27.86,153.31,QLD,Coomera,debit,authorized,2f92c8fa44e94fda80be795430938e82,POS,20-30,2018,10,3,10,50,Wednesday,7 days,52855.65
ACC-1598451071,26,3.21,2452.39,1.0,CUS-2487424745,2018-10-03,Diana,F,-27.95,153.41,,26041f6e-a1c0-4865-8583-144ab1209cc8,-27.9,153.33,QLD,Gold Coast,debit,authorized,cf7e63874d384d16a0891bb1ecc06aa9,POS,20-30,2018,10,3,10,59,Wednesday,7 days,52855.65
ACC-1598451071,26,20.99,2431.4,1.0,CUS-2487424745,2018-10-03,Diana,F,-27.95,153.41,,1849e9a7-7371-4790-a05e-4814e8bbf478,-28.08,153.42,QLD,Varsity Lakes,debit,authorized,c46ff26980324beab8cb0a6c1ec4edd0,SALES-POS,20-30,2018,10,3,12,18,Wednesday,7 days,52855.65
ACC-1598451071,26,9.86,2421.54,1.0,CUS-2487424745,2018-10-03,Diana,F,-27.95,153.41,,19bd4013-f94a-4e5f-9ea7-b178eeda602e,-27.5,152.97,QLD,Indooroopilly,debit,authorized,7f168919a1374057aee12b3388ce301a,SALES-POS,20-30,2018,10,3,12,53,Wednesday,7 days,52855.65
ACC-1598451071,26,23.19,3412.02,1.0,CUS-2487424745,2018-10-03,Diana,F,-27.95,153.41,,f914b445-a383-47c8-9abe-12c91c4ebf4a,-27.97,153.42,QLD,Southport,debit,authorized,091542286d6a446586431b94ef1fc455,POS,20-30,2018,10,3,17,18,Wednesday,7 days,52855.65
ACC-1598451071,26,39.37,3372.65,1.0,CUS-2487424745,2018-10-03,Diana,F,-27.95,153.41,,2f3332cd-18e0-431a-9479-6c2464e96b63,-27.66,153.04,QLD,Browns Plains,debit,authorized,bd559aa19edd4657be45b94cd9a8bb2e,SALES-POS,20-30,2018,10,3,19,2,Wednesday,7 days,52855.65
ACC-1598451071,26,15.68,3356.97,1.0,CUS-2487424745,2018-10-03,Diana,F,-27.95,153.41,,ee789377-3783-4757-968a-2e3726fc057e,-27.98,152.55,QLD,Aratula,debit,authorized,85760aff29b74dcfa639b08dcdb3ca52,POS,20-30,2018,10,3,19,24,Wednesday,7 days,52855.65
ACC-1598451071,26,10.11,3346.86,1.0,CUS-2487424745,2018-10-04,Diana,F,-27.95,153.41,,43cf52fd-86f6-4252-acf4-cc166595c481,-27.99,153.38,QLD,Ashmore,debit,authorized,24691a55769f44dc879f2e53e4f8e909,SALES-POS,20-30,2018,10,4,1,48,Thursday,7 days,52855.65
ACC-1598451071,26,6.11,3340.75,0.0,CUS-2487424745,2018-10-04,Diana,F,-27.95,153.41,,893ab9fb-3f66-44e2-88cd-a92261341085,-28.33,153.4,NSW,Murwillumbah,debit,authorized,70a1f42603f445e6a2d1a22a9bc69c12,SALES-POS,20-30,2018,10,4,4,39,Thursday,7 days,52855.65
ACC-1598451071,26,8.37,3332.38,1.0,CUS-2487424745,2018-10-04,Diana,F,-27.95,153.41,,c7c2857c-70d9-4a37-83c7-ce5ce9dda3c2,-28.01,153.34,QLD,Highland Park,debit,authorized,d392d021ab524cd7bf97a853027a8a9c,POS,20-30,2018,10,4,10,32,Thursday,7 days,52855.65
ACC-1598451071,26,6.71,3325.67,1.0,CUS-2487424745,2018-10-04,Diana,F,-27.95,153.41,,756f83f0-4796-420b-89ff-847bab77f1e2,-28.21,153.52,NSW,Banora Point,debit,authorized,197d5d0d9383461da244d8a2d42d3526,SALES-POS,20-30,2018,10,4,10,50,Thursday,7 days,52855.65
ACC-1598451071,26,20.2,3305.47,1.0,CUS-2487424745,2018-10-04,Diana,F,-27.95,153.41,,6835f0f4-606c-4fa6-badf-e5b86d26379d,-28.01,153.33,QLD,Nerang,debit,authorized,4a9ba2b54aef436892a11568442143e5,SALES-POS,20-30,2018,10,4,11,7,Thursday,7 days,52855.65
ACC-1598451071,26,20.8,3284.67,1.0,CUS-2487424745,2018-10-04,Diana,F,-27.95,153.41,,153c2c0b-f692-4ce0-9e3d-3257b6936d36,-27.56,152.93,QLD,Middle Park,debit,authorized,cd6a6f2513db48ac89ef1664e92d570b,POS,20-30,2018,10,4,11,31,Thursday,7 days,52855.65
ACC-1598451071,26,67.12,3217.55,1.0,CUS-2487424745,2018-10-04,Diana,F,-27.95,153.41,,29f683de-3b32-4a29-9e5b-cdfb8ef8e69d,-27.47,153.1,QLD,Cannon Hill,debit,authorized,3541cc17b5334257b6fdaf7be7ea567d,POS,20-30,2018,10,4,12,5,Thursday,7 days,52855.65
ACC-1598451071,26,15.36,3202.19,1.0,CUS-2487424745,2018-10-04,Diana,F,-27.95,153.41,,deec3013-7b5e-45b8-8ff5-b9c580651ef5,-27.97,153.39,QLD,Southport,debit,authorized,9eac3bd388244f2f9ba6bf3a8057bf7c,SALES-POS,20-30,2018,10,4,14,47,Thursday,7 days,52855.65
ACC-1598451071,26,10.3,3191.89,1.0,CUS-2487424745,2018-10-05,Diana,F,-27.95,153.41,,8ef27717-927e-4c96-ac19-e804a24c8126,-33.8,151.18,NSW,Chatswood,debit,authorized,682ea61011834b3fb07133a704afe7f1,SALES-POS,20-30,2018,10,5,11,17,Friday,7 days,52855.65
ACC-1598451071,26,9.98,3181.91,0.0,CUS-2487424745,2018-10-05,Diana,F,-27.95,153.41,,455658c2-aeb2-4a6d-9f7e-7b2d829a8060,-27.91,153.4,QLD,Runaway Bay,debit,authorized,cc1e9a01f6a74ad1bb2546cd07a4c33b,POS,20-30,2018,10,5,11,32,Friday,7 days,52855.65
ACC-1598451071,26,6.63,3175.28,1.0,CUS-2487424745,2018-10-05,Diana,F,-27.95,153.41,,8a0e9a21-4360-4421-8aac-9af5114c9cda,-28.08,153.39,QLD,Robina,debit,authorized,15584dadee0848dfa0047fcb33fae515,POS,20-30,2018,10,5,14,2,Friday,7 days,52855.65
ACC-1598451071,26,14.28,3161.0,1.0,CUS-2487424745,2018-10-05,Diana,F,-27.95,153.41,,ab37d27d-07d0-4376-b9fa-8e1a33bb3986,-28.15,153.47,QLD,Currumbin Waters,debit,authorized,30c948fc60764a3ea84a2046a7f52917,SALES-POS,20-30,2018,10,5,15,52,Friday,7 days,52855.65
ACC-1598451071,26,5.8,3155.2,1.0,CUS-2487424745,2018-10-05,Diana,F,-27.95,153.41,,3ae539ca-2824-413c-b978-e87360b047ea,-27.91,153.4,QLD,Runaway Bay,debit,authorized,bdc88e80db4047aaa97fec78f86f002d,SALES-POS,20-30,2018,10,5,16,17,Friday,7 days,52855.65
ACC-1598451071,26,3.13,3152.07,0.0,CUS-2487424745,2018-10-05,Diana,F,-27.95,153.41,,a8d5f0de-0033-4b3a-9668-26f6ad774dc3,-27.97,153.41,QLD,Southport,debit,authorized,09f246164172448ea238e119dfe1bea4,SALES-POS,20-30,2018,10,5,18,7,Friday,7 days,52855.65
ACC-1598451071,26,19.89,3132.18,1.0,CUS-2487424745,2018-10-05,Diana,F,-27.95,153.41,,856fe4d1-b371-4111-845d-fde8f27a048f,-27.93,153.32,QLD,Pacific Pines,debit,authorized,22862e9cf5574cd4b6c89390f75a407b,POS,20-30,2018,10,5,19,34,Friday,7 days,52855.65
ACC-1598451071,26,38.94,3093.24,1.0,CUS-2487424745,2018-10-05,Diana,F,-27.95,153.41,,6c7151d0-dfe2-42d7-88fc-9504ca6390cd,-33.87,151.21,NSW,Sydney,debit,authorized,3a75121ddf7d47dca9c2501069b3236e,SALES-POS,20-30,2018,10,5,19,44,Friday,7 days,52855.65
ACC-1598451071,26,9.82,3083.42,0.0,CUS-2487424745,2018-10-05,Diana,F,-27.95,153.41,,3276a7a6-7fba-4312-a45d-5f2d27f6a55f,-27.98,153.41,QLD,Southport,debit,authorized,f469531bc0904105b240e7ef93af0c7f,POS,20-30,2018,10,5,20,33,Friday,7 days,52855.65
ACC-1598451071,26,5.74,3077.68,1.0,CUS-2487424745,2018-10-05,Diana,F,-27.95,153.41,,263d626e-f62f-47bb-bfad-93ef4a1ee630,-27.93,153.32,QLD,Pacific Pines,debit,authorized,0fc7e1b2974e4fc599beb12d7dd9da4d,SALES-POS,20-30,2018,10,5,21,39,Friday,7 days,52855.65
ACC-1598451071,26,11.13,3066.55,1.0,CUS-2487424745,2018-10-05,Diana,F,-27.95,153.41,,202ea166-bafd-4b33-bdfc-1222faad3b29,-27.66,153.04,QLD,Browns Plains,debit,authorized,cda1dfed40e74c08916331eace205067,POS,20-30,2018,10,5,23,31,Friday,7 days,52855.65
ACC-1598451071,26,4.58,3061.97,0.0,CUS-2487424745,2018-10-06,Diana,F,-27.95,153.41,,a9d186de-f30b-43b1-af96-2cf6e5ed7b66,-28.12,153.47,QLD,Palm Beach,debit,authorized,fb59dd906e084bad94670b0e4a9e719e,POS,20-30,2018,10,6,9,22,Saturday,7 days,52855.65
ACC-1598451071,26,15.82,3046.15,1.0,CUS-2487424745,2018-10-06,Diana,F,-27.95,153.41,,b871810d-2737-45c0-8c1a-34dee0368cd3,-28.07,153.45,QLD,Miami,debit,authorized,23d5a009fc624cbf9a4edbcaa044ce52,SALES-POS,20-30,2018,10,6,10,23,Saturday,7 days,52855.65
ACC-1598451071,26,12.19,3033.96,1.0,CUS-2487424745,2018-10-06,Diana,F,-27.95,153.41,,4345dbd1-dfa8-4466-892a-4136a5ae08a2,-27.94,153.41,QLD,Labrador,debit,authorized,f953e12fecf14e2dab7bf425b5ba9843,POS,20-30,2018,10,6,11,1,Saturday,7 days,52855.65
ACC-1598451071,26,15.47,3018.49,1.0,CUS-2487424745,2018-10-06,Diana,F,-27.95,153.41,,6e73598f-dae0-4131-b907-9e07fed4fc58,-27.96,153.38,QLD,Southport,debit,authorized,3e2d7eb880b6452295153a034291f13d,POS,20-30,2018,10,6,17,57,Saturday,7 days,52855.65
ACC-1598451071,26,11.1,3007.39,1.0,CUS-2487424745,2018-10-06,Diana,F,-27.95,153.41,,bdca0bc4-7fae-4885-9ff0-378d0ed01674,-28.07,153.39,QLD,Robina,debit,authorized,d882861e2fcc40588b7be5e15d58578c,SALES-POS,20-30,2018,10,6,20,58,Saturday,7 days,52855.65
ACC-1598451071,26,14.22,2993.17,1.0,CUS-2487424745,2018-10-07,Diana,F,-27.95,153.41,,be3cc0f8-6a5e-4729-b286-c3f653b80d41,-27.93,153.39,QLD,Biggera Waters,debit,authorized,24f456712a4049708ad651d9c7927ffa,POS,20-30,2018,10,7,8,49,Sunday,7 days,52855.65
ACC-1598451071,26,8.55,2984.62,1.0,CUS-2487424745,2018-10-07,Diana,F,-27.95,153.41,,6d5123a4-2e72-4fd3-9892-1b84bcd5e084,-28.01,153.4,QLD,Benowa,debit,authorized,c74350c3e6704328aaa03894ae4e21c2,SALES-POS,20-30,2018,10,7,10,5,Sunday,7 days,52855.65
ACC-1598451071,26,31.64,2952.98,1.0,CUS-2487424745,2018-10-07,Diana,F,-27.95,153.41,,364eb330-c807-4890-9217-c8ed76bfdea9,-33.87,151.21,NSW,Sydney,debit,authorized,1a266e64523040898e27e5ea1956ece5,SALES-POS,20-30,2018,10,7,10,15,Sunday,7 days,52855.65
ACC-1598451071,26,10.88,2942.1,0.0,CUS-2487424745,2018-10-07,Diana,F,-27.95,153.41,,28b25291-6a46-4cb5-b5d2-265e43fa995f,-28,153.38,QLD,Ashmore,debit,authorized,29cebce07d7e44778b01ebee43e33e46,SALES-POS,20-30,2018,10,7,10,43,Sunday,7 days,52855.65
ACC-1598451071,26,9.99,2932.11,0.0,CUS-2487424745,2018-10-07,Diana,F,-27.95,153.41,,f5484a1d-7098-4279-892c-ef3d6630672e,-28.07,153.44,QLD,Miami,debit,authorized,6c3322651c6745e8b48a30ee9955a31b,POS,20-30,2018,10,7,15,51,Sunday,7 days,52855.65
ACC-1598451071,26,10.2,2921.91,1.0,CUS-2487424745,2018-10-07,Diana,F,-27.95,153.41,,91e04e5f-d1fc-4e7a-80d8-b85f6145d42c,-28.17,153.51,QLD,Coolangatta,debit,authorized,58f3f30ce876454991468c9aeb3e1279,POS,20-30,2018,10,7,17,7,Sunday,7 days,52855.65
ACC-1598451071,26,8.23,2913.68,1.0,CUS-2487424745,2018-10-07,Diana,F,-27.95,153.41,,a25aef15-f416-416f-9713-b0dd3326c03d,-28.04,153.43,QLD,Broadbeach,debit,authorized,e779023964d343a4997f394f45d252c7,POS,20-30,2018,10,7,20,43,Sunday,7 days,52855.65
ACC-1598451071,26,9.62,2904.06,1.0,CUS-2487424745,2018-10-07,Diana,F,-27.95,153.41,,45355f04-c1e4-41ca-93fd-a0e715b6e7f2,-27.93,153.34,QLD,Helensvale,debit,authorized,ae34a8d5b39749cc841196d689f01c0b,POS,20-30,2018,10,7,22,34,Sunday,7 days,52855.65
ACC-1598451071,26,32.77,2871.29,1.0,CUS-2487424745,2018-10-08,Diana,F,-27.95,153.41,,03a40eb3-377c-4693-9202-6f237e87f1f2,-33.73,150.97,NSW,Baulkham Hills,debit,authorized,db61748bfac14a7da4c88654e9a3ae40,SALES-POS,20-30,2018,10,8,0,25,Monday,7 days,52855.65
ACC-1598451071,26,33.94,2837.35,1.0,CUS-2487424745,2018-10-08,Diana,F,-27.95,153.41,,1b5cc322-e87a-465f-9bb0-f40b432d5ae9,-27.89,153.31,QLD,Oxenford,debit,authorized,61296ff34cf04c219065d91ca419581a,POS,20-30,2018,10,8,8,49,Monday,7 days,52855.65
ACC-1598451071,26,4.7,2832.65,0.0,CUS-2487424745,2018-10-08,Diana,F,-27.95,153.41,,058d38eb-48c8-4da5-966f-ec68b8d2ea76,-27.47,153.03,QLD,Brisbane City,debit,authorized,fce3432e80e0470284950599d502d759,SALES-POS,20-30,2018,10,8,10,29,Monday,7 days,52855.65
ACC-1598451071,26,22.84,2809.81,1.0,CUS-2487424745,2018-10-08,Diana,F,-27.95,153.41,,bb114176-22b5-4fc2-b6cb-3878142c3e20,-27.76,150.25,QLD,Moonie,debit,authorized,917c4ad4b3eb40dc878ca544a3a2352c,POS,20-30,2018,10,8,10,53,Monday,7 days,52855.65
ACC-1598451071,26,6.59,2803.22,1.0,CUS-2487424745,2018-10-08,Diana,F,-27.95,153.41,,eb7d3e54-cae7-4635-a2db-5f548bb25550,-28.07,153.44,QLD,Miami,debit,authorized,fa88b90c469145ebb80739ecbb1863ac,SALES-POS,20-30,2018,10,8,11,9,Monday,7 days,52855.65
ACC-1598451071,26,1452.21,1351.01,0.0,CUS-2487424745,2018-10-08,Diana,F,-27.95,153.41,,5eb77ade-5cba-40c1-95db-bdaea1dcfa5b,-28.03,153.43,QLD,Broadbeach,debit,authorized,d8496fdd9df54528b16ee3c1c4eb4641,POS,20-30,2018,10,8,11,57,Monday,7 days,52855.65
ACC-1598451071,26,11.66,1339.35,1.0,CUS-2487424745,2018-10-08,Diana,F,-27.95,153.41,,aa2ab9e7-d798-4888-aa95-1d925dc470b9,-27.95,153.35,QLD,Arundel,debit,authorized,fbf6e70f086c4ff7a1f8cc84a6cad553,SALES-POS,20-30,2018,10,8,15,15,Monday,7 days,52855.65
ACC-1598451071,26,20.2,1319.15,1.0,CUS-2487424745,2018-10-08,Diana,F,-27.95,153.41,,f07102f0-6b90-4650-8ba0-ec34cc2c69b6,-27.5,152.97,QLD,Indooroopilly,debit,authorized,3df1d76273d045faaf3d69284e8525c8,SALES-POS,20-30,2018,10,8,17,8,Monday,7 days,52855.65
ACC-1598451071,26,25.18,1293.97,0.0,CUS-2487424745,2018-10-08,Diana,F,-27.95,153.41,,907956c3-283d-4f7e-80f9-d944b5735c30,-33.88,151.02,NSW,Regents Park,debit,authorized,0cfe7ca14f6c457eb4e990270953717f,POS,20-30,2018,10,8,21,56,Monday,7 days,52855.65
ACC-1598451071,26,20.0,1273.97,,CUS-2487424745,2018-10-09,Diana,F,-27.95,153.41,,,,,,,debit,posted,9a813ce7b04743e19fb7d7d8105e62d6,INTER BANK,20-30,2018,10,9,2,0,Tuesday,7 days,52855.65
ACC-1598451071,26,16.6,1257.37,1.0,CUS-2487424745,2018-10-09,Diana,F,-27.95,153.41,,b390bd6b-9e19-4a2d-8282-e81dcd657032,-28.01,153.34,QLD,Nerang,debit,authorized,4ffddca3cc3c410f851177cb6adc0904,SALES-POS,20-30,2018,10,9,4,46,Tuesday,7 days,52855.65
ACC-1598451071,26,36.0,1221.37,,CUS-2487424745,2018-10-09,Diana,F,-27.95,153.41,,,,,,,debit,posted,92afe49581e643ce9ad86c9b8d00386d,PAYMENT,20-30,2018,10,9,7,0,Tuesday,7 days,52855.65
ACC-1598451071,26,92.0,1129.37,,CUS-2487424745,2018-10-09,Diana,F,-27.95,153.41,,,,,,,debit,posted,76b5e71d9b034944b627e36879440714,INTER BANK,20-30,2018,10,9,16,0,Tuesday,7 days,52855.65
ACC-1598451071,26,13.52,1115.85,1.0,CUS-2487424745,2018-10-09,Diana,F,-27.95,153.41,,780c3e1e-47b6-49d3-a59f-6c86b4d1c924,-27.76,153.25,QLD,Ormeau,debit,authorized,681c05e1b6574a65815364dd7c024e9f,POS,20-30,2018,10,9,19,37,Tuesday,7 days,52855.65
ACC-1598451071,26,63.0,1052.85,1.0,CUS-2487424745,2018-10-10,Diana,F,-27.95,153.41,,3647e656-341b-4fc7-b46e-d4b5fd2c93d4,-33.9,151.2,NSW,Alexandria,debit,authorized,35ea1b0dd0804a1b89aa0f1967a4eb12,POS,20-30,2018,10,10,9,27,Wednesday,7 days,52855.65
ACC-1598451071,26,7.0,2059.52,1.0,CUS-2487424745,2018-10-10,Diana,F,-27.95,153.41,,1f03f1d0-3cac-42e7-b949-4efab26faebd,-33.89,151.25,NSW,Bondi Junction,debit,authorized,475f4d7ed322414eb8666da466201c58,SALES-POS,20-30,2018,10,10,15,45,Wednesday,7 days,52855.65
ACC-1598451071,26,45.11,2014.41,1.0,CUS-2487424745,2018-10-10,Diana,F,-27.95,153.41,,9ebd2935-4904-4580-9d45-1c8122e30afc,-27.82,153.32,QLD,Pimpama,debit,authorized,ed44d6bcaa864a658320d093a4f7fd2f,SALES-POS,20-30,2018,10,10,15,51,Wednesday,7 days,52855.65
ACC-1598451071,26,13.4,2001.01,1.0,CUS-2487424745,2018-10-10,Diana,F,-27.95,153.41,,d47db140-7774-46b6-ba4c-6d9444291422,-28.09,153.42,QLD,Varsity Lakes,debit,authorized,263b5ca2c55e496890d5a7cb5f5586ed,POS,20-30,2018,10,10,17,5,Wednesday,7 days,52855.65
ACC-1598451071,26,12.39,1988.62,0.0,CUS-2487424745,2018-10-10,Diana,F,-27.95,153.41,,2e4529be-02ba-44b9-b740-b3914eb04c0a,-28.82,153.33,NSW,Goonellabah,debit,authorized,6ec1a73238494eecbf16bd7a7728e291,POS,20-30,2018,10,10,17,44,Wednesday,7 days,52855.65
ACC-1598451071,26,8.57,1980.05,1.0,CUS-2487424745,2018-10-10,Diana,F,-27.95,153.41,,f61cd5c3-8983-4a81-a810-c028066d83ab,-28.04,153.43,QLD,Broadbeach Waters,debit,authorized,54bf36adf28a48798768de0d1940ae1a,SALES-POS,20-30,2018,10,10,19,25,Wednesday,7 days,52855.65
ACC-1598451071,26,7.06,1972.99,0.0,CUS-2487424745,2018-10-11,Diana,F,-27.95,153.41,,254d64cc-70b8-4909-adc9-08b7affe878b,-28.09,153.39,QLD,Reedy Creek,debit,authorized,29e6b547799840f2b00f1a3cf74b7c37,POS,20-30,2018,10,11,9,13,Thursday,7 days,52855.65
ACC-1598451071,26,67.49,1905.5,0.0,CUS-2487424745,2018-10-11,Diana,F,-27.95,153.41,,da2ae6ff-10d4-422f-aa22-2cddefe0b45e,-28.86,153.56,NSW,Ballina,debit,authorized,4beaa83575954b0c9a9ca41112a2382f,SALES-POS,20-30,2018,10,11,9,18,Thursday,7 days,52855.65
ACC-1598451071,26,16.13,1889.37,1.0,CUS-2487424745,2018-10-11,Diana,F,-27.95,153.41,,3c3ed62e-55d5-473a-88bc-1f6207eaa8cd,-27.98,153.41,QLD,Southport,debit,authorized,a9b19aeaccfe42ce87cafd1f44808c5a,SALES-POS,20-30,2018,10,11,19,31,Thursday,7 days,52855.65
ACC-1598451071,26,10.18,1879.19,0.0,CUS-2487424745,2018-10-11,Diana,F,-27.95,153.41,,9b396220-0ff3-473d-8ad3-a169f8b37757,-37.9,145.13,VIC,Notting Hill,debit,authorized,9c1ceba4185b46d085a648db7e2157c2,POS,20-30,2018,10,11,20,58,Thursday,7 days,52855.65
ACC-1598451071,26,7.01,1872.18,1.0,CUS-2487424745,2018-10-12,Diana,F,-27.95,153.41,,44fae1da-7a1a-4f3f-871c-f508493a89f1,-28.08,153.39,QLD,Robina,debit,authorized,10c5caec44584fc7bc3d4c8989f635aa,POS,20-30,2018,10,12,9,14,Friday,7 days,52855.65
ACC-1598451071,26,6.1,1866.08,1.0,CUS-2487424745,2018-10-12,Diana,F,-27.95,153.41,,65a3d3ab-854d-494f-816d-ba0add460b26,-27.97,153.41,QLD,Southport,debit,authorized,bfd74ad92c8040eaa43cd8dca27cc141,SALES-POS,20-30,2018,10,12,9,29,Friday,7 days,52855.65
ACC-1598451071,26,10.57,1855.51,1.0,CUS-2487424745,2018-10-12,Diana,F,-27.95,153.41,,aef30de1-c67e-4ab7-8577-2931a4bf3c7e,-27.97,144.64,QLD,Yowah,debit,authorized,a4c325b956124a1cad32b7dd5fe7c4a0,SALES-POS,20-30,2018,10,12,10,20,Friday,7 days,52855.65
ACC-1598451071,26,33.36,1822.15,0.0,CUS-2487424745,2018-10-12,Diana,F,-27.95,153.41,,b0b80e1c-896a-44ab-aa56-6969c36ebb7d,-27.47,153.02,QLD,Brisbane City,debit,authorized,e3d70230e903486ca16e106090eabe05,SALES-POS,20-30,2018,10,12,15,4,Friday,7 days,52855.65
ACC-1598451071,26,97.44,1724.71,1.0,CUS-2487424745,2018-10-12,Diana,F,-27.95,153.41,,6bbcd84f-2bd6-466b-9084-d0998fe887b2,-37.8,144.99,VIC,Collingwood,debit,authorized,bacc0e66fe3341d6a67cf5528f72e196,POS,20-30,2018,10,12,17,9,Friday,7 days,52855.65
ACC-1598451071,26,4.42,1720.29,0.0,CUS-2487424745,2018-10-12,Diana,F,-27.95,153.41,,91cbf9f4-9bfe-4c13-9cb7-2e0615da4936,-27.47,153,QLD,Milton,debit,authorized,4d13f649628848bd8be3c361b6f626df,SALES-POS,20-30,2018,10,12,17,21,Friday,7 days,52855.65
ACC-1598451071,26,7.41,1712.88,1.0,CUS-2487424745,2018-10-12,Diana,F,-27.95,153.41,,cf2ac034-f61a-4c17-9312-09d5c68fecb3,-27.97,153.42,QLD,Southport,debit,authorized,63ca4b2f8838453bb41e108f348b805b,SALES-POS,20-30,2018,10,12,21,29,Friday,7 days,52855.65
ACC-1598451071,26,20.63,1692.25,1.0,CUS-2487424745,2018-10-12,Diana,F,-27.95,153.41,,f3c386d7-c74f-4eb5-ad11-71607fcdbb71,-33.87,151.21,NSW,Sydney,debit,authorized,a4353a9f843649648c8f67f087ddb956,SALES-POS,20-30,2018,10,12,21,50,Friday,7 days,52855.65
ACC-1598451071,26,21.35,1670.9,1.0,CUS-2487424745,2018-10-12,Diana,F,-27.95,153.41,,f3c386d7-c74f-4eb5-ad11-71607fcdbb71,-33.87,151.21,NSW,Sydney,debit,authorized,ccd32985a8a24cf68172184191edd759,POS,20-30,2018,10,12,22,14,Friday,7 days,52855.65
ACC-1598451071,26,73.92,1596.98,1.0,CUS-2487424745,2018-10-12,Diana,F,-27.95,153.41,,d114f678-d67d-48b2-ad90-3652b6f9abb1,-27.93,153.41,QLD,Biggera Waters,debit,authorized,22082d99985643479a9f9dd1e02b0313,SALES-POS,20-30,2018,10,12,23,15,Friday,7 days,52855.65
ACC-1598451071,26,18.56,1578.42,1.0,CUS-2487424745,2018-10-13,Diana,F,-27.95,153.41,,bb114176-22b5-4fc2-b6cb-3878142c3e20,-27.76,150.25,QLD,Moonie,debit,authorized,52e0f8c2bf1b4c2497d7519e76318403,SALES-POS,20-30,2018,10,13,2,3,Saturday,7 days,52855.65
ACC-1598451071,26,10.08,1568.34,1.0,CUS-2487424745,2018-10-13,Diana,F,-27.95,153.41,,a51a2d8c-7322-49ca-9914-a89010a78d7b,-27.97,153.42,QLD,Southport,debit,authorized,8c46b1c47ce94f12ad323c11fec3d2f6,POS,20-30,2018,10,13,8,42,Saturday,7 days,52855.65
ACC-1598451071,26,31.92,1536.42,1.0,CUS-2487424745,2018-10-13,Diana,F,-27.95,153.41,,b0b80e1c-896a-44ab-aa56-6969c36ebb7d,-27.47,153.02,QLD,Brisbane City,debit,authorized,c8001c56e14d47eeaeb97adf924cfb43,POS,20-30,2018,10,13,10,54,Saturday,7 days,52855.65
ACC-1598451071,26,15.39,1521.03,0.0,CUS-2487424745,2018-10-13,Diana,F,-27.95,153.41,,d16fcb3b-638a-49a8-8ddf-8d0d7836197a,-28.33,153.4,NSW,Murwillumbah,debit,authorized,286e7edee3e54fe09b335208cd66c7c8,SALES-POS,20-30,2018,10,13,11,22,Saturday,7 days,52855.65
ACC-1598451071,26,25.66,1495.37,1.0,CUS-2487424745,2018-10-13,Diana,F,-27.95,153.41,,fceeee93-a526-44e9-a3fb-5a1106555656,-28.13,153.45,QLD,Elanora,debit,authorized,ebc87b03c1d14e65aabfd97caf5e10d1,POS,20-30,2018,10,13,11,38,Saturday,7 days,52855.65
ACC-1598451071,26,7.93,1487.44,0.0,CUS-2487424745,2018-10-13,Diana,F,-27.95,153.41,,97f098ef-0fd9-4cb1-94d2-a68d8446ca6c,-28.87,153.56,NSW,Ballina,debit,authorized,ca2151ddd06d475ab4e67f8cb225e7d0,POS,20-30,2018,10,13,15,59,Saturday,7 days,52855.65
ACC-1598451071,26,9.52,1477.92,1.0,CUS-2487424745,2018-10-13,Diana,F,-27.95,153.41,,6b6f922a-8f7b-4708-a8b8-4054423556da,-27.98,152.99,QLD,Beaudesert,debit,authorized,7fdd305e0f594cbcb5d0fed929498e66,SALES-POS,20-30,2018,10,13,19,29,Saturday,7 days,52855.65
ACC-1598451071,26,612.0,839.09,,CUS-2487424745,2018-10-13,Diana,F,-27.95,153.41,,,,,,,debit,posted,e1f4baa126f0411a959a1b47a47df91a,PAYMENT,20-30,2018,10,13,20,0,Saturday,7 days,52855.65
ACC-1598451071,26,13.41,1464.51,0.0,CUS-2487424745,2018-10-13,Diana,F,-27.95,153.41,,beeb6931-4e16-45cc-a6e0-30c23cf76d55,-27.95,153.35,QLD,Arundel,debit,authorized,05e65952579f43939897ff5fb5f1f25d,SALES-POS,20-30,2018,10,13,20,34,Saturday,7 days,52855.65
ACC-1598451071,26,13.42,1451.09,1.0,CUS-2487424745,2018-10-13,Diana,F,-27.95,153.41,,75bc053a-5e96-464f-aa7f-2986c71ebcd3,-27.92,153.34,QLD,Helensvale,debit,authorized,30409ff808b64ae183dcecd2c4c34eab,POS,20-30,2018,10,13,20,55,Saturday,7 days,52855.65
ACC-1598451071,26,11.64,827.45,0.0,CUS-2487424745,2018-10-13,Diana,F,-27.95,153.41,,803f3eb6-97e0-4d0f-961f-53168b5de7f5,-27.76,153.33,QLD,Woongoolba,debit,authorized,36597fc52cdd4ab5aa3877b0da5291e8,POS,20-30,2018,10,13,21,19,Saturday,7 days,52855.65
ACC-1598451071,26,6.9,820.55,0.0,CUS-2487424745,2018-10-13,Diana,F,-27.95,153.41,,e1b3c433-30f3-401a-845b-6f88747e1078,-27.91,153.32,QLD,Helensvale,debit,authorized,a1d858b466bd4a6b8a91b81ae6b8892f,SALES-POS,20-30,2018,10,13,21,45,Saturday,7 days,52855.65
ACC-1598451071,26,5.72,814.83,1.0,CUS-2487424745,2018-10-13,Diana,F,-27.95,153.41,,4aa0c78c-a22c-4e9a-94aa-babed2d402d6,-27.47,153.1,QLD,Cannon Hill,debit,authorized,6b7f62117e54403e9df1d4ac799fc102,SALES-POS,20-30,2018,10,13,21,58,Saturday,7 days,52855.65
ACC-1598451071,26,5.8,809.03,0.0,CUS-2487424745,2018-10-15,Diana,F,-27.95,153.41,,b7c4918a-30c1-47f4-923c-8db4f23784c5,-27.68,153.12,QLD,Waterford West,debit,authorized,90880a76606c48ae8d57f9bb5644b8c3,POS,20-30,2018,10,15,9,16,Monday,7 days,52855.65
ACC-1598451071,26,15.3,793.73,0.0,CUS-2487424745,2018-10-15,Diana,F,-27.95,153.41,,944375b1-299b-4ea7-b0db-445c19046930,-27.57,151.98,QLD,Toowoomba,debit,authorized,4a7e911021dd4fcf88bddafbd086aadc,SALES-POS,20-30,2018,10,15,9,34,Monday,7 days,52855.65
ACC-1598451071,26,4.67,789.06,1.0,CUS-2487424745,2018-10-15,Diana,F,-27.95,153.41,,0bab531e-95a1-40b9-b27f-8f4a6c81e36c,-28.07,153.34,QLD,Tallai,debit,authorized,a3c38709d0a745e28634baa1072df469,SALES-POS,20-30,2018,10,15,10,42,Monday,7 days,52855.65
ACC-1598451071,26,5.76,783.3,1.0,CUS-2487424745,2018-10-15,Diana,F,-27.95,153.41,,980d701e-b8aa-4331-a51b-77cc14a05950,-27.98,153.4,QLD,Southport,debit,authorized,69ae46c6d4134fc7a7e884a52cb1c5bd,SALES-POS,20-30,2018,10,15,11,14,Monday,7 days,52855.65
ACC-1598451071,26,35.63,747.67,1.0,CUS-2487424745,2018-10-15,Diana,F,-27.95,153.41,,b53f4984-e11f-40e1-9b1d-e342e4350ca4,-28.86,153.56,NSW,Ballina,debit,authorized,1ff704c603234921aed9bd6a1c3f7f86,SALES-POS,20-30,2018,10,15,12,20,Monday,7 days,52855.65
ACC-1598451071,26,8.55,739.12,1.0,CUS-2487424745,2018-10-15,Diana,F,-27.95,153.41,,ebb3087a-75c4-4dea-8354-9be1c746d6cb,-27.89,152.02,QLD,Pilton,debit,authorized,d4b11e6519824c488f44d106eb183d78,SALES-POS,20-30,2018,10,15,14,58,Monday,7 days,52855.65
ACC-1598451071,26,26.07,713.05,0.0,CUS-2487424745,2018-10-15,Diana,F,-27.95,153.41,,d9f44176-42ac-4e50-ae36-0b16ba748caa,-28.03,153.43,QLD,Broadbeach,debit,authorized,948ea3347a2f43adb57cac183740840d,POS,20-30,2018,10,15,15,21,Monday,7 days,52855.65
ACC-1598451071,26,15.77,697.28,0.0,CUS-2487424745,2018-10-15,Diana,F,-27.95,153.41,,a01f26fd-0a90-4522-9206-687a8091125c,-27.94,153.4,QLD,Labrador,debit,authorized,bd2c1ac8b42c4a0f9da0046f4e38624b,POS,20-30,2018,10,15,20,10,Monday,7 days,52855.65
ACC-1598451071,26,14.5,682.78,1.0,CUS-2487424745,2018-10-15,Diana,F,-27.95,153.41,,50d8b1b1-fac8-4dd8-8208-fcb512e33798,-27.93,153.34,QLD,Helensvale,debit,authorized,2e0d7fddb2dd4ea2a6e161ac159576d2,POS,20-30,2018,10,15,20,22,Monday,7 days,52855.65
ACC-1598451071,26,6.27,676.51,1.0,CUS-2487424745,2018-10-15,Diana,F,-27.95,153.41,,2d40b521-fcbe-4955-b6f7-1f951a578f2b,-28.12,153.45,QLD,Palm Beach,debit,authorized,737cede15a7947daac1bf7edcff5bc13,SALES-POS,20-30,2018,10,15,21,8,Monday,7 days,52855.65
ACC-1598451071,26,3.77,672.74,1.0,CUS-2487424745,2018-10-15,Diana,F,-27.95,153.41,,4cdce227-c258-41f7-930a-6dcd4f2d62c1,-28.12,153.47,QLD,Palm Beach,debit,authorized,c5a2aba27d8946bbabd9ec6c9d0739ba,POS,20-30,2018,10,15,21,51,Monday,7 days,52855.65
ACC-1598451071,26,20.0,652.74,,CUS-2487424745,2018-10-16,Diana,F,-27.95,153.41,,,,,,,debit,posted,f6c44a5bfb3e48059fd1ba9af2eb131a,INTER BANK,20-30,2018,10,16,2,0,Tuesday,7 days,52855.65
ACC-1598451071,26,36.0,616.74,,CUS-2487424745,2018-10-16,Diana,F,-27.95,153.41,,,,,,,debit,posted,4ae70694bebb4b43aed160ff1863cc0a,PAYMENT,20-30,2018,10,16,7,0,Tuesday,7 days,52855.65
ACC-1598451071,26,4.04,612.7,1.0,CUS-2487424745,2018-10-16,Diana,F,-27.95,153.41,,e722da8a-d917-4894-b05f-9854077fce4c,-28.09,153.45,QLD,Burleigh Heads,debit,authorized,144edd82022c45b78785ec201f29098d,POS,20-30,2018,10,16,8,29,Tuesday,7 days,52855.65
ACC-1598451071,26,5.77,1620.6,1.0,CUS-2487424745,2018-10-17,Diana,F,-27.95,153.41,,79632a30-4507-43e8-b301-e4166dc24eb3,-28.03,153.43,QLD,Broadbeach,debit,authorized,c52153c88e004907b805b3f2b5d9b350,SALES-POS,20-30,2018,10,17,23,5,Wednesday,7 days,52855.65
ACC-1598451071,26,4.92,1615.68,0.0,CUS-2487424745,2018-10-17,Diana,F,-27.95,153.41,,023f7601-2795-4081-9ffe-3199ee4b49c2,-27.91,153.4,QLD,Runaway Bay,debit,authorized,203545caaf4b4d14983e0c4f541213d2,POS,20-30,2018,10,17,23,49,Wednesday,7 days,52855.65
ACC-1598451071,26,21.83,1593.85,1.0,CUS-2487424745,2018-10-18,Diana,F,-27.95,153.41,,4fed93ab-f622-4e44-b7ca-8dcdd6b43e35,-28.04,153.43,QLD,Broadbeach,debit,authorized,bff9ab5e3c7a4a0491243ccade36fafb,SALES-POS,20-30,2018,10,18,4,43,Thursday,7 days,52855.65
ACC-1598451071,26,26.93,1566.92,1.0,CUS-2487424745,2018-10-18,Diana,F,-27.95,153.41,,952c2d56-02bc-4d8c-9ba5-c0d33c306413,-28.01,153.34,QLD,Highland Park,debit,authorized,f79331ec62f8465681ef77cffb56d113,POS,20-30,2018,10,18,6,22,Thursday,7 days,52855.65
ACC-1598451071,26,11.37,1555.55,1.0,CUS-2487424745,2018-10-18,Diana,F,-27.95,153.41,,816c8634-ad16-4328-ac53-e48d407ee4f2,-27.99,153.33,QLD,Nerang,debit,authorized,61d7f4fe33df4a11a78a9b9471457aa7,POS,20-30,2018,10,18,7,32,Thursday,7 days,52855.65
ACC-1598451071,26,15.85,1539.7,1.0,CUS-2487424745,2018-10-19,Diana,F,-27.95,153.41,,deec3013-7b5e-45b8-8ff5-b9c580651ef5,-27.97,153.39,QLD,Southport,debit,authorized,f4dd41d078374a1da0b8d0a1239dbd52,POS,20-30,2018,10,19,8,0,Friday,7 days,52855.65
ACC-1598451071,26,6.0,1533.7,1.0,CUS-2487424745,2018-10-19,Diana,F,-27.95,153.41,,9c722f27-2495-4ca1-a7ec-562652a3b98c,-27.92,153.36,QLD,Coombabah,debit,authorized,b1fb0b157eb047bf97e79dd4358e7e51,SALES-POS,20-30,2018,10,19,9,13,Friday,7 days,52855.65
ACC-1598451071,26,54.18,1479.52,1.0,CUS-2487424745,2018-10-19,Diana,F,-27.95,153.41,,11b25409-e443-4612-a46b-823d75145d03,-27.92,153.34,QLD,Helensvale,debit,authorized,948ea15c11b245c4983914914c4f00ed,POS,20-30,2018,10,19,9,18,Friday,7 days,52855.65
ACC-1598451071,26,7.84,1471.68,1.0,CUS-2487424745,2018-10-19,Diana,F,-27.95,153.41,,a03fe884-d8cf-4cf2-a8ed-5983901fce10,-27.91,153.4,QLD,Runaway Bay,debit,authorized,4ca9578a4c6242be841362512b3d441a,POS,20-30,2018,10,19,9,37,Friday,7 days,52855.65
ACC-1598451071,26,13.67,1458.01,1.0,CUS-2487424745,2018-10-19,Diana,F,-27.95,153.41,,f2eb30ee-576c-4077-aec1-feca254ce541,-27.93,153.4,QLD,Biggera Waters,debit,authorized,07ff1f6421db433a90b30655a91f6614,SALES-POS,20-30,2018,10,19,14,12,Friday,7 days,52855.65
ACC-1598451071,26,13.58,1444.43,1.0,CUS-2487424745,2018-10-19,Diana,F,-27.95,153.41,,75c749e4-e234-4ce3-aaf4-d058b01426dc,-28.05,153.41,QLD,Mermaid Waters,debit,authorized,7b936a4376fa4439841ac87cc3995853,POS,20-30,2018,10,19,16,27,Friday,7 days,52855.65
ACC-1598451071,26,8.92,1435.51,1.0,CUS-2487424745,2018-10-19,Diana,F,-27.95,153.41,,ca530086-b9a0-4443-a770-e88dd85ac56f,-27.8,153.29,QLD,Pimpama,debit,authorized,a6f10dc1128c413782640caadda3ed3f,POS,20-30,2018,10,19,17,0,Friday,7 days,52855.65
ACC-1598451071,26,7.27,1428.24,1.0,CUS-2487424745,2018-10-20,Diana,F,-27.95,153.41,,aeaa9700-8b53-4bd9-923c-70adf228cf80,-28.04,153.43,QLD,Broadbeach Waters,debit,authorized,38c23a83b181486289d93cdc8165a10f,SALES-POS,20-30,2018,10,20,9,33,Saturday,7 days,52855.65
ACC-1598451071,26,22.06,1406.18,0.0,CUS-2487424745,2018-10-20,Diana,F,-27.95,153.41,,42c394f0-e22a-43e7-8c6d-b79da0684813,-27.93,153.39,QLD,Biggera Waters,debit,authorized,8acce0ba25d041839466083d520646f1,SALES-POS,20-30,2018,10,20,9,59,Saturday,7 days,52855.65
ACC-1598451071,26,12.09,1394.09,1.0,CUS-2487424745,2018-10-20,Diana,F,-27.95,153.41,,9e569918-b62e-4730-a005-63940408281d,-28.06,153.44,QLD,Mermaid Beach,debit,authorized,e2eae6d1fa50452999ea4b2948ac9965,SALES-POS,20-30,2018,10,20,10,19,Saturday,7 days,52855.65
ACC-1598451071,26,8.83,1385.26,1.0,CUS-2487424745,2018-10-20,Diana,F,-27.95,153.41,,8963ac9d-dbeb-46fc-997a-3a03d3925ba1,-27.99,153.34,QLD,Nerang,debit,authorized,02bb08fdd9fd4ff6b954230beab2202d,POS,20-30,2018,10,20,16,4,Saturday,7 days,52855.65
ACC-1598451071,26,12.3,1372.96,1.0,CUS-2487424745,2018-10-20,Diana,F,-27.95,153.41,,aef30de1-c67e-4ab7-8577-2931a4bf3c7e,-27.97,144.64,QLD,Yowah,debit,authorized,c1baf64f3e964ebf87c1e0f7ed694b39,SALES-POS,20-30,2018,10,20,17,6,Saturday,7 days,52855.65
ACC-1598451071,26,6.27,1366.69,1.0,CUS-2487424745,2018-10-20,Diana,F,-27.95,153.41,,a5dd6907-a988-439e-8eff-cb953cf65f05,-27.93,153.34,QLD,Helensvale,debit,authorized,9c845707d3fe44c6a1c9515a019915f0,SALES-POS,20-30,2018,10,20,17,17,Saturday,7 days,52855.65
ACC-1598451071,26,6.85,1359.84,0.0,CUS-2487424745,2018-10-20,Diana,F,-27.95,153.41,,11c310e0-eaa4-495b-90c0-f34d99fa508c,-27.71,151.86,QLD,Cambooya,debit,authorized,59c6779fe79a4ef2b82cf7b4fee0d4e5,SALES-POS,20-30,2018,10,20,17,49,Saturday,7 days,52855.65
ACC-1598451071,26,7.62,1352.22,1.0,CUS-2487424745,2018-10-20,Diana,F,-27.95,153.41,,e1b3c433-30f3-401a-845b-6f88747e1078,-27.91,153.32,QLD,Helensvale,debit,authorized,8d8a182a221043e5881fe88d71446067,SALES-POS,20-30,2018,10,20,18,22,Saturday,7 days,52855.65
ACC-1598451071,26,18.83,1333.39,0.0,CUS-2487424745,2018-10-20,Diana,F,-27.95,153.41,,e409298f-baab-4942-a431-beba6ea59c72,-37.82,145.2,VIC,Mitcham,debit,authorized,732caab9543e4969b91a16f0e1523b0c,POS,20-30,2018,10,20,19,46,Saturday,7 days,52855.65
ACC-1598451071,26,6.93,1326.46,1.0,CUS-2487424745,2018-10-20,Diana,F,-27.95,153.41,,63d09405-ec4d-493d-9b38-0845505821d2,-28.13,153.47,QLD,Palm Beach,debit,authorized,fee386600d5445449e7ee1b795a072a9,POS,20-30,2018,10,20,20,30,Saturday,7 days,52855.65
ACC-1598451071,26,16.91,1309.55,1.0,CUS-2487424745,2018-10-21,Diana,F,-27.95,153.41,,9aaf116a-c3b7-47c4-acc1-849f426bb73b,-28.07,153.38,QLD,Robina,debit,authorized,9b865a0ebcc6461d98b408073cad6d6b,POS,20-30,2018,10,21,0,57,Sunday,7 days,52855.65
ACC-1598451071,26,4.13,1305.42,1.0,CUS-2487424745,2018-10-21,Diana,F,-27.95,153.41,,4cdce227-c258-41f7-930a-6dcd4f2d62c1,-28.12,153.47,QLD,Palm Beach,debit,authorized,6d68b78205e14f749c51c40d7bdad35f,SALES-POS,20-30,2018,10,21,2,11,Sunday,7 days,52855.65
ACC-1598451071,26,5.55,1299.87,1.0,CUS-2487424745,2018-10-21,Diana,F,-27.95,153.41,,01b38778-2604-44f7-a36e-9f6f88de6851,-27.96,153.4,QLD,Southport,debit,authorized,d634dc8fbc1e40b3becdd6d348649381,SALES-POS,20-30,2018,10,21,4,7,Sunday,7 days,52855.65
ACC-1598451071,26,14.25,1285.62,1.0,CUS-2487424745,2018-10-21,Diana,F,-27.95,153.41,,5c09d618-0deb-466f-9ec3-7dad7778b9f0,-12.46,130.84,NT,Darwin City,debit,authorized,4e79cdf1a7384d3490be89da6c4c9c65,POS,20-30,2018,10,21,9,27,Sunday,7 days,52855.65
ACC-1598451071,26,17.41,1268.21,0.0,CUS-2487424745,2018-10-21,Diana,F,-27.95,153.41,,75757c49-5f18-4fce-b71b-967829284115,-28.03,153.43,QLD,Broadbeach,debit,authorized,1ffd25c494074c01a540de0a5aa58af9,POS,20-30,2018,10,21,15,29,Sunday,7 days,52855.65
ACC-1598451071,26,23.63,1244.58,1.0,CUS-2487424745,2018-10-21,Diana,F,-27.95,153.41,,bb68bf24-00e2-484e-8407-36b43a045110,-28.04,153.43,QLD,Broadbeach,debit,authorized,8c4cf2d8657348d798094683ec6e2419,SALES-POS,20-30,2018,10,21,16,53,Sunday,7 days,52855.65
ACC-1598451071,26,21.19,1223.39,1.0,CUS-2487424745,2018-10-21,Diana,F,-27.95,153.41,,42c394f0-e22a-43e7-8c6d-b79da0684813,-27.93,153.39,QLD,Biggera Waters,debit,authorized,b692a782fa3d44cdb138ae170ad76dd6,SALES-POS,20-30,2018,10,21,18,12,Sunday,7 days,52855.65
ACC-1598451071,26,9.35,1214.04,0.0,CUS-2487424745,2018-10-21,Diana,F,-27.95,153.41,,897c9336-d7d7-40aa-81d1-4d68b79ad71b,-27.47,153.1,QLD,Cannon Hill,debit,authorized,ca4cd328a01c4bdca4110724cf4769ca,POS,20-30,2018,10,21,19,9,Sunday,7 days,52855.65
ACC-1598451071,26,4.71,1209.33,1.0,CUS-2487424745,2018-10-21,Diana,F,-27.95,153.41,,bf25b889-6876-4393-b98a-9f87f813e461,-28,153.43,QLD,Surfers Paradise,debit,authorized,39afbb8bb38243fabd5cf4a805adb876,SALES-POS,20-30,2018,10,21,19,31,Sunday,7 days,52855.65
ACC-1598451071,26,7.65,1201.68,0.0,CUS-2487424745,2018-10-22,Diana,F,-27.95,153.41,,d7038675-b547-403d-a211-ec940d56ba75,-33.87,151.21,NSW,Sydney,debit,authorized,fc2a13e1f47d445c94aae83e2878ac62,POS,20-30,2018,10,22,1,8,Monday,7 days,52855.65
ACC-1598451071,26,9.54,1192.14,1.0,CUS-2487424745,2018-10-22,Diana,F,-27.95,153.41,,3276a7a6-7fba-4312-a45d-5f2d27f6a55f,-27.98,153.41,QLD,Southport,debit,authorized,60435085921f445085b2d40eb76b6f2b,SALES-POS,20-30,2018,10,22,8,44,Monday,7 days,52855.65
ACC-1598451071,26,9.28,1182.86,1.0,CUS-2487424745,2018-10-22,Diana,F,-27.95,153.41,,16f87b35-bf91-4632-83c5-b4d9041c7cbe,-27.53,151.93,QLD,Wilsonton Heights,debit,authorized,be7c5c74d49d4bd9985827c012e0d2d6,POS,20-30,2018,10,22,9,1,Monday,7 days,52855.65
ACC-1598451071,26,21.63,1161.23,1.0,CUS-2487424745,2018-10-22,Diana,F,-27.95,153.41,,7d20a31e-9caf-411e-849c-87f510e7029f,-28.08,153.38,QLD,Robina,debit,authorized,b107fa088c6f4fb68f5750b950957170,POS,20-30,2018,10,22,19,16,Monday,7 days,52855.65
ACC-1598451071,26,14.15,1147.08,1.0,CUS-2487424745,2018-10-22,Diana,F,-27.95,153.41,,f38a29b7-7468-4617-810b-9de0342575d6,-37.82,144.96,VIC,Melbourne,debit,authorized,326cda2e301642e597b82cf2418f47ca,SALES-POS,20-30,2018,10,22,20,9,Monday,7 days,52855.65
ACC-1598451071,26,41.97,1105.11,1.0,CUS-2487424745,2018-10-22,Diana,F,-27.95,153.41,,701440eb-e95b-4fa2-99b5-93b5356fbc08,-28.03,153.39,QLD,Carrara,debit,authorized,4649bf1aa0284571a93c9f3f06ab1fa4,SALES-POS,20-30,2018,10,22,21,56,Monday,7 days,52855.65
ACC-1598451071,26,20.0,1085.11,,CUS-2487424745,2018-10-23,Diana,F,-27.95,153.41,,,,,,,debit,posted,e03bddb5eb464b29a9741789048eb048,INTER BANK,20-30,2018,10,23,2,0,Tuesday,7 days,52855.65
ACC-1598451071,26,12.31,1072.8,1.0,CUS-2487424745,2018-10-23,Diana,F,-27.95,153.41,,88b6c03f-d7d0-4093-801d-e9b38a077a36,-28.04,153.43,QLD,Broadbeach,debit,authorized,af1e47417d164350be5d97d2b8d66520,POS,20-30,2018,10,23,6,39,Tuesday,7 days,52855.65
ACC-1598451071,26,36.0,1036.8,,CUS-2487424745,2018-10-23,Diana,F,-27.95,153.41,,,,,,,debit,posted,3ea95a29b106404f9ea7902368fb0ac3,PAYMENT,20-30,2018,10,23,7,0,Tuesday,7 days,52855.65
ACC-1598451071,26,8.8,1028.0,1.0,CUS-2487424745,2018-10-23,Diana,F,-27.95,153.41,,78f3d5fa-1ff6-435f-bdfb-faaf702fa37d,-28.06,153.44,QLD,Miami,debit,authorized,3131234b2a4042a484ae0bbaf5412d88,SALES-POS,20-30,2018,10,23,9,29,Tuesday,7 days,52855.65
ACC-1598451071,26,4.28,1023.72,1.0,CUS-2487424745,2018-10-23,Diana,F,-27.95,153.41,,b0a6a7f9-b9c9-45b3-ac1b-eaf2e65a141c,-27.71,114.17,WA,Kalbarri,debit,authorized,bdf35cdc48064a4a9edac49a020466bf,SALES-POS,20-30,2018,10,23,9,50,Tuesday,7 days,52855.65
ACC-1598451071,26,9.61,1014.11,1.0,CUS-2487424745,2018-10-23,Diana,F,-27.95,153.41,,92f28af9-2da9-48d4-8aac-5f89a5c1ae85,-28.12,153.47,QLD,Palm Beach,debit,authorized,4265cbe6249a4b58bb76d405cebeb389,SALES-POS,20-30,2018,10,23,15,12,Tuesday,7 days,52855.65
ACC-1598451071,26,14.74,999.37,1.0,CUS-2487424745,2018-10-24,Diana,F,-27.95,153.41,,87db1ac8-75c4-4b0e-ab42-2a27b2b85fdc,-28.01,153.34,QLD,Highland Park,debit,authorized,b861f13421ed43579e895820677f925f,POS,20-30,2018,10,24,1,24,Wednesday,7 days,52855.65
ACC-1598451071,26,9.51,989.86,1.0,CUS-2487424745,2018-10-24,Diana,F,-27.95,153.41,,572f66c0-da75-4c06-b538-4bc89f841fa9,-27.97,153.43,QLD,Main Beach,debit,authorized,66dff7cdafd645b6a7130c20412d0443,SALES-POS,20-30,2018,10,24,4,11,Wednesday,7 days,52855.65
ACC-1598451071,26,10.58,979.28,1.0,CUS-2487424745,2018-10-24,Diana,F,-27.95,153.41,,d1914cd8-5226-4cb0-9adc-8c5eb35d07ce,-28.01,153.33,QLD,Highland Park,debit,authorized,05ca354bb87d4aafb30301db2ee6dd07,SALES-POS,20-30,2018,10,24,8,57,Wednesday,7 days,52855.65
ACC-1598451071,26,16.88,962.4,1.0,CUS-2487424745,2018-10-24,Diana,F,-27.95,153.41,,51f03efa-4903-425b-b27e-c7ecfbc7789d,-33.81,151.02,NSW,Parramatta,debit,authorized,cfcd71491fda4de18bae7f8307f7bf5e,POS,20-30,2018,10,24,9,58,Wednesday,7 days,52855.65
ACC-1598451071,26,9.29,953.11,1.0,CUS-2487424745,2018-10-24,Diana,F,-27.95,153.41,,0c63889c-e2cc-482b-be44-774f70fdceaf,-28.04,153.43,QLD,Broadbeach,debit,authorized,7376e30efbbf498983f7848b33ba95b1,POS,20-30,2018,10,24,11,28,Wednesday,7 days,52855.65
ACC-1598451071,26,9.13,1957.65,1.0,CUS-2487424745,2018-10-25,Diana,F,-27.95,153.41,,47173446-e8b0-47fb-ac21-5b01208409b5,-27.99,152.99,QLD,Beaudesert,debit,authorized,870abd77919446e196efbbe8ae3299a9,POS,20-30,2018,10,25,13,0,Thursday,7 days,52855.65
ACC-1598451071,26,7.45,1950.2,0.0,CUS-2487424745,2018-10-25,Diana,F,-27.95,153.41,,4541999d-0fcc-40e5-8450-07ea95175e72,-27.94,153.41,QLD,Labrador,debit,authorized,7bc9893eb21f48d892d6af12646ba41c,SALES-POS,20-30,2018,10,25,14,1,Thursday,7 days,52855.65
ACC-1598451071,26,25.88,1924.32,1.0,CUS-2487424745,2018-10-25,Diana,F,-27.95,153.41,,65049f44-035f-4e42-ace7-f73689049758,-27.78,152.73,QLD,Peak Crossing,debit,authorized,d6d782ec57664bd189442d5be347afc5,POS,20-30,2018,10,25,14,24,Thursday,7 days,52855.65
ACC-1598451071,26,8.12,1916.2,1.0,CUS-2487424745,2018-10-26,Diana,F,-27.95,153.41,,c921ac57-7434-456f-b3ae-f6527fdf9441,-27.96,153.39,QLD,Southport,debit,authorized,68a1c7ccc73e4fcda03dadd53d1c3b0e,POS,20-30,2018,10,26,9,6,Friday,7 days,52855.65
ACC-1598451071,26,17.43,1898.77,0.0,CUS-2487424745,2018-10-26,Diana,F,-27.95,153.41,,e4f97038-2b5a-4530-81c5-1fe235bd5830,-27.97,153.41,QLD,Southport,debit,authorized,f3703355e1aa4a92851f636dde402967,SALES-POS,20-30,2018,10,26,9,41,Friday,7 days,52855.65
ACC-1598451071,26,10.91,1887.86,1.0,CUS-2487424745,2018-10-26,Diana,F,-27.95,153.41,,34d6657a-ebdf-489d-bb90-86dcf4d94639,-28.09,153.39,QLD,Robina,debit,authorized,4f5b805879c949b08ec4b0c16c556cda,POS,20-30,2018,10,26,10,49,Friday,7 days,52855.65
ACC-1598451071,26,9.65,1878.21,1.0,CUS-2487424745,2018-10-26,Diana,F,-27.95,153.41,,c8c21dd8-ec60-40b2-bded-8d7be0022c95,-27.97,153.41,QLD,Southport,debit,authorized,e677adc8ecfe4b6a92ec1ded5b16ab4b,POS,20-30,2018,10,26,11,4,Friday,7 days,52855.65
ACC-1598451071,26,5.6,1872.61,1.0,CUS-2487424745,2018-10-26,Diana,F,-27.95,153.41,,13a86f3d-9de1-4ab0-9700-e31af20b9133,-27.87,153.33,QLD,Coomera,debit,authorized,8253b032840344a483d6b49565988817,SALES-POS,20-30,2018,10,26,11,13,Friday,7 days,52855.65
ACC-1598451071,26,220.38,1652.23,1.0,CUS-2487424745,2018-10-26,Diana,F,-27.95,153.41,,44518ff8-179f-436a-afea-e2e5814ba172,-27.47,153.03,QLD,Brisbane City,debit,authorized,3f7f7fc57cda42ab8decda7f24b16463,SALES-POS,20-30,2018,10,26,13,5,Friday,7 days,52855.65
ACC-1598451071,26,15.19,1637.04,1.0,CUS-2487424745,2018-10-26,Diana,F,-27.95,153.41,,a3971d3a-f3a5-45a3-924d-71f3473bdb62,-27.89,153.31,QLD,Oxenford,debit,authorized,672343cc6c6d4842a011c8a27bb1832c,SALES-POS,20-30,2018,10,26,19,9,Friday,7 days,52855.65
ACC-1598451071,26,16.04,1621.0,1.0,CUS-2487424745,2018-10-26,Diana,F,-27.95,153.41,,9fa7e4de-fe93-4a2c-8ce9-00f898ef2d7b,-27.97,153.4,QLD,Southport,debit,authorized,e51746bfc79f4f3ab43cbe5b8b762033,POS,20-30,2018,10,26,19,49,Friday,7 days,52855.65
ACC-1598451071,26,9.99,1611.01,1.0,CUS-2487424745,2018-10-28,Diana,F,-27.95,153.41,,00097987-7795-4c01-92c7-66bf486bacca,-27.92,120.7,WA,Leinster,debit,authorized,3ab4b71008c9465caee7c5ca27da7cef,POS,20-30,2018,10,28,4,3,Sunday,7 days,52855.65
ACC-1598451071,26,13.42,1597.59,1.0,CUS-2487424745,2018-10-28,Diana,F,-27.95,153.41,,3027a299-76a5-4010-83d2-c81c75b74b0e,-27.93,153.33,QLD,Helensvale,debit,authorized,dfb4193694d84548853a436814b48457,SALES-POS,20-30,2018,10,28,10,23,Sunday,7 days,52855.65
ACC-1598451071,26,17.55,1580.04,1.0,CUS-2487424745,2018-10-28,Diana,F,-27.95,153.41,,b390bd6b-9e19-4a2d-8282-e81dcd657032,-28.01,153.34,QLD,Nerang,debit,authorized,b1535f68e5464fdc93d5803b35054763,POS,20-30,2018,10,28,12,27,Sunday,7 days,52855.65
ACC-1598451071,26,4.3,1575.74,1.0,CUS-2487424745,2018-10-28,Diana,F,-27.95,153.41,,83c05227-c420-40e2-b99b-f126be9af967,-28,153.41,QLD,Bundall,debit,authorized,4c533cc03b204a2aae205b0f28f629d0,SALES-POS,20-30,2018,10,28,13,56,Sunday,7 days,52855.65
ACC-1598451071,26,5.24,1570.5,0.0,CUS-2487424745,2018-10-28,Diana,F,-27.95,153.41,,b315c6de-4844-4e7e-bacd-01d364d5850e,-27.47,153.05,QLD,New Farm,debit,authorized,004f4d15953a4620b6462f3b1fcd6046,POS,20-30,2018,10,28,14,16,Sunday,7 days,52855.65
ACC-1598451071,26,4.95,1565.55,1.0,CUS-2487424745,2018-10-28,Diana,F,-27.95,153.41,,9509caa2-87ca-4231-a299-988beb17cb42,-28.04,153.44,QLD,Mermaid Beach,debit,authorized,c74df478a53b409aa98cf2f68e5f87c1,SALES-POS,20-30,2018,10,28,21,19,Sunday,7 days,52855.65
ACC-1598451071,26,13.98,1551.57,1.0,CUS-2487424745,2018-10-28,Diana,F,-27.95,153.41,,7bb597b4-2355-465b-88aa-0fd06e5fa3a2,-27.91,153.4,QLD,Runaway Bay,debit,authorized,ab34a0b0d00147eda953c3b92d84d7de,POS,20-30,2018,10,28,22,56,Sunday,7 days,52855.65
ACC-1598451071,26,14.45,1537.12,1.0,CUS-2487424745,2018-10-28,Diana,F,-27.95,153.41,,62862f41-20f4-4adf-9a2d-a73bb9abff4c,-27.51,153.06,QLD,Coorparoo,debit,authorized,9055297a887f4d5791cc5e6ac881a42a,SALES-POS,20-30,2018,10,28,23,53,Sunday,7 days,52855.65
ACC-1598451071,26,10.04,1527.08,0.0,CUS-2487424745,2018-10-29,Diana,F,-27.95,153.41,,15f6afd2-d100-4b6f-9189-01bcc4a1c362,-28.14,153.49,QLD,Tugun,debit,authorized,e81afa3e3c834a88a3ab3fb3ea4597b8,SALES-POS,20-30,2018,10,29,13,54,Monday,7 days,52855.65
ACC-1598451071,26,6.33,1520.75,0.0,CUS-2487424745,2018-10-29,Diana,F,-27.95,153.41,,de87aafc-b17e-4d34-ac3f-4eeb8053a6fe,-27.97,153.41,QLD,Southport,debit,authorized,84fb31726b6b46739a7f86f2ba226d64,POS,20-30,2018,10,29,14,18,Monday,7 days,52855.65
ACC-1598451071,26,6.48,1514.27,1.0,CUS-2487424745,2018-10-29,Diana,F,-27.95,153.41,,5eb643ae-93ff-4af7-a134-99d6d3aa48be,-28.08,153.39,QLD,Robina,debit,authorized,132429aeea4f411888ea16f369b08a3f,SALES-POS,20-30,2018,10,29,20,13,Monday,7 days,52855.65
ACC-1598451071,26,20.0,1494.27,,CUS-2487424745,2018-10-30,Diana,F,-27.95,153.41,,,,,,,debit,posted,66ed0996b27f48d3b8f0393adabecac7,INTER BANK,20-30,2018,10,30,2,0,Tuesday,7 days,52855.65
ACC-1598451071,26,36.0,1458.27,,CUS-2487424745,2018-10-30,Diana,F,-27.95,153.41,,,,,,,debit,posted,4d8a84172f304e61967002444537a8f9,PAYMENT,20-30,2018,10,30,7,0,Tuesday,7 days,52855.65
ACC-1598451071,26,11.91,1446.36,1.0,CUS-2487424745,2018-10-30,Diana,F,-27.95,153.41,,0bde4a33-7719-4033-8965-afa54b09e4d0,-27.77,153.11,QLD,Logan Village,debit,authorized,66833ae599704da2ab41251be72e7246,POS,20-30,2018,10,30,13,24,Tuesday,7 days,52855.65
ACC-1598451071,26,16.68,1429.68,0.0,CUS-2487424745,2018-10-30,Diana,F,-27.95,153.41,,9fa7e4de-fe93-4a2c-8ce9-00f898ef2d7b,-27.97,153.4,QLD,Southport,debit,authorized,c2d8193f0a2c4e6899d92cc0ee3e9d9a,SALES-POS,20-30,2018,10,30,15,11,Tuesday,7 days,52855.65
ACC-1598451071,26,3.62,1426.06,1.0,CUS-2487424745,2018-10-30,Diana,F,-27.95,153.41,,d2874065-277b-4374-afbf-662c5ba86bfd,-27.93,153.39,QLD,Labrador,debit,authorized,c898026d81e94ec0914aeee1bd6e92bd,SALES-POS,20-30,2018,10,30,19,14,Tuesday,7 days,52855.65
ACC-1598451071,26,10.2,1415.86,1.0,CUS-2487424745,2018-10-30,Diana,F,-27.95,153.41,,8147ece7-0e86-4be4-a248-9327a48a8d76,-28.17,153.54,NSW,Tweed Heads,debit,authorized,5029c4970cb64063877e917eb08727bf,SALES-POS,20-30,2018,10,30,20,45,Tuesday,7 days,52855.65
ACC-1598451071,26,33.51,1382.35,1.0,CUS-2487424745,2018-10-31,Diana,F,-27.95,153.41,,e6389142-a34c-4515-b2bf-1adb67d12aee,-37.89,145,VIC,Elsternwick,debit,authorized,a7711333efb1487da79d1c7d712d7ec1,SALES-POS,20-30,2018,10,31,4,15,Wednesday,7 days,52855.65
ACC-1598451071,26,2.76,1379.59,1.0,CUS-2487424745,2018-10-31,Diana,F,-27.95,153.41,,79e4bdc7-2892-45c9-abde-809730f38cb7,-27.97,153.41,QLD,Southport,debit,authorized,685308084eb644aea61724486d9ebfa6,POS,20-30,2018,10,31,4,50,Wednesday,7 days,52855.65
ACC-1598451071,26,4.09,1375.5,1.0,CUS-2487424745,2018-10-31,Diana,F,-27.95,153.41,,d7c86774-b185-4a86-a713-4ef414c32101,-28.01,153.41,QLD,Bundall,debit,authorized,e9311675d0d54a1ab00ab7f20f41ed4c,POS,20-30,2018,10,31,9,18,Wednesday,7 days,52855.65
ACC-1598451071,26,10.46,1365.04,1.0,CUS-2487424745,2018-10-31,Diana,F,-27.95,153.41,,a23a9054-b598-4b8e-99d2-5ba284bd30e9,-27.96,153.4,QLD,Southport,debit,authorized,bbbca348d9494d2c93cad56a7c04d586,POS,20-30,2018,10,31,11,33,Wednesday,7 days,52855.65
ACC-1598451071,26,4.23,1360.81,1.0,CUS-2487424745,2018-10-31,Diana,F,-27.95,153.41,,59e3bccd-966c-403e-a6c5-29932099b26f,-28.06,153.41,QLD,Robina,debit,authorized,a80db3b81e064e04a421286e75934f57,POS,20-30,2018,10,31,12,19,Wednesday,7 days,52855.65
ACC-1598451071,26,62.98,1297.83,1.0,CUS-2487424745,2018-10-31,Diana,F,-27.95,153.41,,2f3bc0c3-93fd-41a4-a1cc-5ad551adbecc,-33.87,151.2,NSW,Sydney,debit,authorized,d2c83051236f4f8db441de31f6820a73,SALES-POS,20-30,2018,10,31,12,38,Wednesday,7 days,52855.65
ACC-1598451071,26,29.71,1268.12,1.0,CUS-2487424745,2018-10-31,Diana,F,-27.95,153.41,,848f6f12-a594-461b-aaf5-72b7712ded60,-38.15,144.36,VIC,Geelong,debit,authorized,ed29bc1b79234f7e872c2202d0c04402,SALES-POS,20-30,2018,10,31,14,42,Wednesday,7 days,52855.65
ACC-1598451071,26,10.24,2271.55,1.0,CUS-2487424745,2018-10-31,Diana,F,-27.95,153.41,,7da3714d-964e-41e4-9d08-cc12a078f7ec,-27.56,153.08,QLD,Upper Mount Gravatt,debit,authorized,9b66b2391c1141fc831eba43dd873e53,SALES-POS,20-30,2018,10,31,15,0,Wednesday,7 days,52855.65
ACC-1598451071,26,10.74,2260.81,0.0,CUS-2487424745,2018-10-31,Diana,F,-27.95,153.41,,d87e2b48-3fc5-47e4-87c5-014e56e493df,-28.13,153.47,QLD,Elanora,debit,authorized,ab0686ed8f8b446d9f88254d53a16e06,POS,20-30,2018,10,31,15,8,Wednesday,7 days,52855.65
ACC-1598451071,26,24.37,2236.44,0.0,CUS-2487424745,2018-10-31,Diana,F,-27.95,153.41,,e4758c3b-e8d8-49bd-990a-a823a86dcabc,-28.07,153.36,QLD,Mudgeeraba,debit,authorized,78fe3dcf051e47f88767ac7f4bb63f1b,SALES-POS,20-30,2018,10,31,15,38,Wednesday,7 days,52855.65
ACC-1598451071,26,16.3,2220.14,1.0,CUS-2487424745,2018-10-31,Diana,F,-27.95,153.41,,a074e4af-d785-465d-a813-4701cc355c78,-27.47,153.02,QLD,Brisbane City,debit,authorized,db9aa7f3f1e44c6997376691b3d8d733,SALES-POS,20-30,2018,10,31,18,42,Wednesday,7 days,52855.65
ACC-1598451071,26,25.88,2194.26,0.0,CUS-2487424745,2018-10-31,Diana,F,-27.95,153.41,,e4758c3b-e8d8-49bd-990a-a823a86dcabc,-28.07,153.36,QLD,Mudgeeraba,debit,authorized,bb90a98fdcbd40a69ad40a4fcd3971f6,POS,20-30,2018,10,31,19,4,Wednesday,7 days,52855.65
ACC-1598451071,26,46.2,2148.06,1.0,CUS-2487424745,2018-10-31,Diana,F,-27.95,153.41,,f951df7c-92b7-444c-959b-e227f5bb6735,-33.85,151.05,NSW,Lidcombe,debit,authorized,362ee085d8794e1088f9906cde2aaa15,POS,20-30,2018,10,31,19,31,Wednesday,7 days,52855.65
ACC-1598451071,26,13.2,2134.86,1.0,CUS-2487424745,2018-10-31,Diana,F,-27.95,153.41,,202ea166-bafd-4b33-bdfc-1222faad3b29,-27.66,153.04,QLD,Browns Plains,debit,authorized,34a9a3b018124af08d911653ff720a61,SALES-POS,20-30,2018,10,31,21,8,Wednesday,7 days,52855.65
ACC-1222300524,38,6.42,5.71,1.0,CUS-2142601169,2018-08-01,Michael,M,-33.94,151.23,,835c231d-8cdf-4e96-859d-e9d571760cf0,-33.87,151.21,NSW,Sydney,debit,authorized,feb79e7ecd7048a5a36ec889d1a94270,POS,30-40,2018,8,1,1,26,Wednesday,7 days,52253.921
ACC-1222300524,38,5.46,0.25,1.0,CUS-2142601169,2018-08-07,Michael,M,-33.94,151.23,,f6d24b03-5ca8-4cb3-83e2-73db22103a8a,-37.91,145.25,VIC,Rowville,debit,authorized,34055a1bc26942a69ee70eab55d29cd5,POS,30-40,2018,8,7,15,34,Tuesday,7 days,52253.921
ACC-1222300524,38,7.4,994.98,1.0,CUS-2142601169,2018-08-08,Michael,M,-33.94,151.23,,29110340-14ea-43b8-b60e-59c756b03fc3,-33.89,151.27,NSW,Bondi Beach,debit,authorized,1115b2ea0a1345fd9c4f541bc7784a1e,POS,30-40,2018,8,8,9,31,Wednesday,7 days,52253.921
ACC-1222300524,38,17.1,977.88,1.0,CUS-2142601169,2018-08-08,Michael,M,-33.94,151.23,,6823b519-3882-4889-97f2-ab54da53f0a7,-33.9,151,NSW,Bass Hill,debit,authorized,36778499c9fe4ec6b149e6a794265215,SALES-POS,30-40,2018,8,8,10,30,Wednesday,7 days,52253.921
ACC-1222300524,38,24.74,953.14,1.0,CUS-2142601169,2018-08-08,Michael,M,-33.94,151.23,,ee20c998-1621-488e-96ad-f8c1d8cb9799,-33.92,151.15,NSW,Marrickville,debit,authorized,70e5091f8e4a4975924985bca00d1edc,SALES-POS,30-40,2018,8,8,10,46,Wednesday,7 days,52253.921
ACC-1222300524,38,11.12,942.02,1.0,CUS-2142601169,2018-08-08,Michael,M,-33.94,151.23,,a6d5b5b4-593b-409e-87f2-5754b053cd62,-33.83,151.24,NSW,Mosman,debit,authorized,deb145847190481a9ab310fb58a42d61,POS,30-40,2018,8,8,15,36,Wednesday,7 days,52253.921
ACC-1222300524,38,19.85,922.17,1.0,CUS-2142601169,2018-08-08,Michael,M,-33.94,151.23,,3d42f4da-87cc-41d9-a2d0-f0fb9fc97f67,-33.77,151.03,NSW,North Rocks,debit,authorized,34c00ed142ff4ecf9b9e8c56eae0c152,POS,30-40,2018,8,8,15,42,Wednesday,7 days,52253.921
ACC-1222300524,38,13.36,908.81,1.0,CUS-2142601169,2018-08-08,Michael,M,-33.94,151.23,,fd1c9a34-9224-4338-9716-e8f10005b83a,-27.43,153,QLD,Alderley,debit,authorized,8fa4c7428c6b489a81c1f5c7e86c1286,SALES-POS,30-40,2018,8,8,17,18,Wednesday,7 days,52253.921
ACC-1222300524,38,18.79,890.02,1.0,CUS-2142601169,2018-08-08,Michael,M,-33.94,151.23,,26543f15-1756-4fe0-9feb-33a15bee4e60,-33.78,150.83,NSW,Minchinbury,debit,authorized,b3100dc2495e4ae48691b91d43041819,SALES-POS,30-40,2018,8,8,18,58,Wednesday,7 days,52253.921
ACC-1222300524,38,4.78,885.24,1.0,CUS-2142601169,2018-08-08,Michael,M,-33.94,151.23,,0b987f8d-d345-4b1c-8113-b433631aae15,-33.92,150.92,NSW,Liverpool,debit,authorized,44e9a619eaa54ef38a77dc85970fda84,POS,30-40,2018,8,8,23,50,Wednesday,7 days,52253.921
ACC-1222300524,38,12.67,872.57,1.0,CUS-2142601169,2018-08-09,Michael,M,-33.94,151.23,,5dadf9a3-bbd8-4944-ad92-35347499359c,-33.89,151.16,NSW,Leichhardt,debit,authorized,52779d7b528f4b178d2784f483070050,POS,30-40,2018,8,9,1,1,Thursday,7 days,52253.921
ACC-1222300524,38,8.11,864.46,1.0,CUS-2142601169,2018-08-09,Michael,M,-33.94,151.23,,9e416b5d-5d51-49ab-a38a-a55f33afadca,-33.87,151.21,NSW,Sydney,debit,authorized,663b374c5c3341eb82bd54b18f4f7805,POS,30-40,2018,8,9,14,41,Thursday,7 days,52253.921
ACC-1222300524,38,50.0,803.7,,CUS-2142601169,2018-08-09,Michael,M,-33.94,151.23,,,,,,,debit,posted,6cd050b5e92e4f7cb787a7ec57a01461,PAYMENT,30-40,2018,8,9,19,0,Thursday,7 days,52253.921
ACC-1222300524,38,10.76,853.7,1.0,CUS-2142601169,2018-08-09,Michael,M,-33.94,151.23,,aa5aa2e9-e9b4-46a6-a8ad-d723edc8e77d,-33.91,150.87,NSW,Green Valley,debit,authorized,c8cfc13ddc364a49b1fd916994205628,SALES-POS,30-40,2018,8,9,19,18,Thursday,7 days,52253.921
ACC-1222300524,38,104.13,699.57,1.0,CUS-2142601169,2018-08-10,Michael,M,-33.94,151.23,,343ea9db-c612-48e1-85c9-46bfc3311b67,-33.92,150.86,NSW,Hinchinbrook,debit,authorized,011dbc469fa74d2494afbb40777f0159,POS,30-40,2018,8,10,4,27,Friday,7 days,52253.921
ACC-1222300524,38,25.81,673.76,0.0,CUS-2142601169,2018-08-10,Michael,M,-33.94,151.23,,84335287-a509-4a8f-836a-f71fa050bf4d,-37.83,145,VIC,Richmond,debit,authorized,c485269a6b2449fc8243fb57371caf1e,POS,30-40,2018,8,10,10,14,Friday,7 days,52253.921
ACC-1222300524,38,43.5,630.26,1.0,CUS-2142601169,2018-08-10,Michael,M,-33.94,151.23,,a33597e2-742c-4bde-aa32-880e687454b2,-33.79,151.2,NSW,Chatswood,debit,authorized,1a7dab8c43b14c03aa800df0c44984de,SALES-POS,30-40,2018,8,10,11,46,Friday,7 days,52253.921
ACC-1222300524,38,5.91,624.35,1.0,CUS-2142601169,2018-08-10,Michael,M,-33.94,151.23,,1d576c21-3e89-46b7-878d-042a6a982021,-33.82,151.24,NSW,Mosman,debit,authorized,26ce79d92335419fb32c079422889ae3,SALES-POS,30-40,2018,8,10,15,32,Friday,7 days,52253.921
ACC-1222300524,38,6.04,618.31,1.0,CUS-2142601169,2018-08-10,Michael,M,-33.94,151.23,,e6d52b86-4c77-4486-b7fa-63785ef12b11,-33.81,151,NSW,Parramatta,debit,authorized,957828e8cea34138ae588bd404e445d4,SALES-POS,30-40,2018,8,10,15,54,Friday,7 days,52253.921
ACC-1222300524,38,7.23,611.08,1.0,CUS-2142601169,2018-08-10,Michael,M,-33.94,151.23,,7b65e1b5-1a06-4ed0-9da1-56c65f7cb53d,-23.88,151.22,QLD,Clinton,debit,authorized,8256a3b075574f59b4f9c8a2eeb2fcfb,SALES-POS,30-40,2018,8,10,16,2,Friday,7 days,52253.921
ACC-1222300524,38,73.7,537.38,1.0,CUS-2142601169,2018-08-10,Michael,M,-33.94,151.23,,aaeed7be-046d-4e82-b71f-f28911441d2e,-33.87,151.21,NSW,Sydney,debit,authorized,16f1a5d4033f47e2b534dd4775a96a8e,POS,30-40,2018,8,10,18,13,Friday,7 days,52253.921
ACC-1222300524,38,49.13,488.25,1.0,CUS-2142601169,2018-08-10,Michael,M,-33.94,151.23,,c05793a8-011a-4cee-bb28-54127559c420,-33.87,151.21,NSW,Sydney,debit,authorized,507134c6c4a54b959384ad52df7c6f11,POS,30-40,2018,8,10,20,15,Friday,7 days,52253.921
ACC-1222300524,38,10.37,477.88,0.0,CUS-2142601169,2018-08-10,Michael,M,-33.94,151.23,,de440092-1855-4457-9f2f-746d3a78dfcd,-33.93,137.63,SA,Wallaroo,debit,authorized,da9fb048881e415aac7b1f350957b35b,POS,30-40,2018,8,10,22,27,Friday,7 days,52253.921
ACC-1222300524,38,7.84,470.04,1.0,CUS-2142601169,2018-08-11,Michael,M,-33.94,151.23,,174e837f-f0fb-497f-96ba-6bfd26e764cb,-33.84,151.22,NSW,Neutral Bay,debit,authorized,801306afd63d4362b85e2f810e00c7c6,SALES-POS,30-40,2018,8,11,2,24,Saturday,7 days,52253.921
ACC-1222300524,38,17.61,452.43,1.0,CUS-2142601169,2018-08-11,Michael,M,-33.94,151.23,,9fc40400-d1e4-4785-b009-711de7834ed6,-33.95,150.91,NSW,Casula,debit,authorized,95f27c56ccb442e6a91073fc486a13b6,POS,30-40,2018,8,11,2,45,Saturday,7 days,52253.921
ACC-1222300524,38,17.91,434.52,1.0,CUS-2142601169,2018-08-11,Michael,M,-33.94,151.23,,0eddf2c5-0432-4dba-afac-5bce83027625,-33.94,151.09,NSW,Kingsgrove,debit,authorized,1c08e303658e458ba18f91aec1084c83,POS,30-40,2018,8,11,3,13,Saturday,7 days,52253.921
ACC-1222300524,38,18.89,415.63,1.0,CUS-2142601169,2018-08-11,Michael,M,-33.94,151.23,,f508fb74-e9e5-4f0a-bf9f-10b00516b565,-33.94,150.94,NSW,Moorebank,debit,authorized,7bf89883ab704e72a5762f3bca07ff17,SALES-POS,30-40,2018,8,11,9,52,Saturday,7 days,52253.921
ACC-1222300524,38,7.47,408.16,1.0,CUS-2142601169,2018-08-11,Michael,M,-33.94,151.23,,240ca90a-50e6-4e42-b644-1b64daf3162e,-33.89,151.19,NSW,Sydney,debit,authorized,f1abb715f54441d290a649c1995d5f8a,SALES-POS,30-40,2018,8,11,16,55,Saturday,7 days,52253.921
ACC-1222300524,38,11.15,397.01,1.0,CUS-2142601169,2018-08-11,Michael,M,-33.94,151.23,,6714d0be-9a69-4d2c-8d45-c8fc84df9eaa,-37.82,144.97,VIC,Melbourne,debit,authorized,1079428f62ac4d3f92cb178fe872374a,POS,30-40,2018,8,11,20,15,Saturday,7 days,52253.921
ACC-1222300524,38,7.75,389.26,1.0,CUS-2142601169,2018-08-11,Michael,M,-33.94,151.23,,8f2c36dd-9a99-4230-b00f-99bbb42b68ef,-33.96,137.71,SA,Kadina,debit,authorized,107294959b644db4bae6a9125f7e67a5,POS,30-40,2018,8,11,20,41,Saturday,7 days,52253.921
ACC-1222300524,38,4.18,385.08,1.0,CUS-2142601169,2018-08-11,Michael,M,-33.94,151.23,,0240783c-8903-4a0a-bc0e-5910e9d44efb,-33.9,151.18,NSW,Newtown,debit,authorized,9ee6c59da0e94f458f71f79ab397faa8,POS,30-40,2018,8,11,22,33,Saturday,7 days,52253.921
ACC-1222300524,38,16.23,368.85,1.0,CUS-2142601169,2018-08-12,Michael,M,-33.94,151.23,,d9d425e5-747b-4dd7-8fba-c386ba9aa68b,-33.87,151.11,NSW,Five Dock,debit,authorized,4eef6744992d44c1b36bfe5e18e7e10d,SALES-POS,30-40,2018,8,12,8,43,Sunday,7 days,52253.921
ACC-1222300524,38,15.07,353.78,0.0,CUS-2142601169,2018-08-12,Michael,M,-33.94,151.23,,05f675e8-7ccb-4a5a-8d29-c92ddc222db8,-33.93,150.95,NSW,Moorebank,debit,authorized,653c77a7ce9d4c1aa42bfafa81fa8153,SALES-POS,30-40,2018,8,12,9,17,Sunday,7 days,52253.921
ACC-1222300524,38,12.08,341.7,1.0,CUS-2142601169,2018-08-12,Michael,M,-33.94,151.23,,87620d95-8b80-4280-b37f-06630416adf0,-33.82,151,NSW,Parramatta,debit,authorized,de89ca71ae054180862d6420d917488a,POS,30-40,2018,8,12,9,38,Sunday,7 days,52253.921
ACC-1222300524,38,26.9,314.8,1.0,CUS-2142601169,2018-08-12,Michael,M,-33.94,151.23,,4013a506-269f-4c00-8292-ac00faee2da2,-33.9,151.11,NSW,Croydon Park,debit,authorized,147924b95b7d4fa399295a189e41dd32,SALES-POS,30-40,2018,8,12,9,54,Sunday,7 days,52253.921
ACC-1222300524,38,8.29,306.51,1.0,CUS-2142601169,2018-08-12,Michael,M,-33.94,151.23,,f1c4fbd8-97d4-47f2-8d03-cb82f24dc169,-23.87,151.24,QLD,West Gladstone,debit,authorized,2084a37af8d44564ba8ef946516eb3ac,POS,30-40,2018,8,12,12,9,Sunday,7 days,52253.921
ACC-1222300524,38,11.14,295.37,1.0,CUS-2142601169,2018-08-12,Michael,M,-33.94,151.23,,ebf3ad3a-f6d5-48c5-bd49-a9ceb9fc0561,-33.92,151.08,NSW,Lakemba,debit,authorized,5619d7311fd343998dc4045dc53aafb2,POS,30-40,2018,8,12,13,45,Sunday,7 days,52253.921
ACC-1222300524,38,9.8,285.57,1.0,CUS-2142601169,2018-08-12,Michael,M,-33.94,151.23,,04d91fae-917e-4815-be46-c4eb87b9add7,-33.91,151.16,NSW,Marrickville,debit,authorized,22b4d01045ba46cd881ab4c1fe09fe74,SALES-POS,30-40,2018,8,12,21,14,Sunday,7 days,52253.921
ACC-1222300524,38,23.59,261.98,1.0,CUS-2142601169,2018-08-12,Michael,M,-33.94,151.23,,48b3eea8-ba57-4271-9b5d-ba3554f1b2ad,-33.92,150.92,NSW,Liverpool,debit,authorized,8aae79cb46834b259b688735af23e130,SALES-POS,30-40,2018,8,12,21,33,Sunday,7 days,52253.921
ACC-1222300524,38,14.73,247.25,0.0,CUS-2142601169,2018-08-12,Michael,M,-33.94,151.23,,5c7008d4-2b8a-4232-bcf0-b42a300f9b0f,-33.81,151,NSW,Parramatta,debit,authorized,7ae0fc57f76341ed8dfcb26f69d19d3f,POS,30-40,2018,8,12,21,46,Sunday,7 days,52253.921
ACC-1222300524,38,2.1,245.15,1.0,CUS-2142601169,2018-08-13,Michael,M,-33.94,151.23,,6ffb6914-0de5-4322-b2ad-25bfad838eb7,-33.81,151.17,NSW,Lane Cove,debit,authorized,fc5675fbcc0c4266ba8653726c5ddf46,POS,30-40,2018,8,13,7,35,Monday,7 days,52253.921
ACC-1222300524,38,7.41,237.74,1.0,CUS-2142601169,2018-08-13,Michael,M,-33.94,151.23,,2f8d2948-0840-4110-9132-7df7e7f3ee2d,-33.77,150.82,NSW,Mount Druitt,debit,authorized,9fbd74096cb54732885ff136ece717b7,SALES-POS,30-40,2018,8,13,9,19,Monday,7 days,52253.921
ACC-1222300524,38,8.28,229.46,1.0,CUS-2142601169,2018-08-13,Michael,M,-33.94,151.23,,356f2efa-440f-4438-ad88-9415976f58f0,-33.87,151.07,NSW,Homebush West,debit,authorized,f7c5f102fb5c490daa7d8eec8513b48d,POS,30-40,2018,8,13,10,30,Monday,7 days,52253.921
ACC-1222300524,38,98.93,130.53,1.0,CUS-2142601169,2018-08-13,Michael,M,-33.94,151.23,,596306e9-de9d-4ebb-8309-71088dafcf1d,-33.92,151.04,NSW,Bankstown,debit,authorized,87e7bdc08aa9496887dc8d8796e5c708,SALES-POS,30-40,2018,8,13,13,22,Monday,7 days,52253.921
ACC-1222300524,38,6.87,2077.92,1.0,CUS-2142601169,2018-08-22,Michael,M,-33.94,151.23,,308ac76c-03d3-4de8-b593-4eec154824c3,-33.92,151.09,NSW,Belmore,debit,authorized,f0ad3996412348c895563c99249256f7,POS,30-40,2018,8,22,11,4,Wednesday,7 days,52253.921
ACC-1222300524,38,4.76,2073.16,1.0,CUS-2142601169,2018-08-22,Michael,M,-33.94,151.23,,fb24053d-5522-4646-bdc7-71130114e96c,-33.8,151.18,NSW,Chatswood,debit,authorized,8b25208647c543d183836220ef3d0e72,SALES-POS,30-40,2018,8,22,11,19,Wednesday,7 days,52253.921
ACC-1222300524,38,79.01,1994.15,1.0,CUS-2142601169,2018-08-22,Michael,M,-33.94,151.23,,143beac6-1608-4b52-9288-70a6b2617ad2,-33.95,151,NSW,Panania,debit,authorized,a6d9e63d81054fe88c3867973cea6d0c,SALES-POS,30-40,2018,8,22,16,39,Wednesday,7 days,52253.921
ACC-1222300524,38,34.97,1959.18,1.0,CUS-2142601169,2018-08-22,Michael,M,-33.94,151.23,,63c4c62f-d976-4854-97d5-f2a83f11bdb5,-33.75,151.25,NSW,Beacon Hill,debit,authorized,762140984800405cb47d30a9e7398cf3,SALES-POS,30-40,2018,8,22,19,24,Wednesday,7 days,52253.921
ACC-1222300524,38,21.96,1937.22,0.0,CUS-2142601169,2018-08-22,Michael,M,-33.94,151.23,,1f3cf107-6d54-43a9-b6be-b0a1ee2ba1da,-33.92,150.92,NSW,Liverpool,debit,authorized,01b794d03d2d483a849e7f0b0207e022,SALES-POS,30-40,2018,8,22,20,52,Wednesday,7 days,52253.921
ACC-1222300524,38,23.33,1913.89,1.0,CUS-2142601169,2018-08-22,Michael,M,-33.94,151.23,,24a75e8c-8f54-465d-94a7-d3b058ee32e7,-33.93,150.96,NSW,Moorebank,debit,authorized,7240db01719a4938af94bb396e4d9049,SALES-POS,30-40,2018,8,22,22,0,Wednesday,7 days,52253.921
ACC-1222300524,38,18.28,1895.61,1.0,CUS-2142601169,2018-08-23,Michael,M,-33.94,151.23,,94358d5e-9b20-4f42-b60f-db977bf8ba23,-33.79,151.08,NSW,Eastwood,debit,authorized,8585c1c4ea4d4dd9aef54179f916d8fb,SALES-POS,30-40,2018,8,23,1,19,Thursday,7 days,52253.921
ACC-1222300524,38,7.65,1887.96,0.0,CUS-2142601169,2018-08-23,Michael,M,-33.94,151.23,,a1ca1b7e-a737-4fc8-b070-3e606f52c0d6,-33.95,115.07,WA,Margaret River,debit,authorized,8548d8e4aeb549478717d5651c008d7b,POS,30-40,2018,8,23,15,27,Thursday,7 days,52253.921
ACC-1222300524,38,19.14,1868.82,1.0,CUS-2142601169,2018-08-23,Michael,M,-33.94,151.23,,eff25fdb-a677-437b-bb87-f4e4b4614499,-33.92,151.04,NSW,Bankstown,debit,authorized,0908dbda136147f4992ea8f6e8980214,POS,30-40,2018,8,23,18,43,Thursday,7 days,52253.921
ACC-1222300524,38,50.0,1818.82,,CUS-2142601169,2018-08-23,Michael,M,-33.94,151.23,,,,,,,debit,posted,d55089db092c45a0ba799613d6f54287,PAYMENT,30-40,2018,8,23,19,0,Thursday,7 days,52253.921
ACC-1222300524,38,80.89,1737.93,1.0,CUS-2142601169,2018-08-23,Michael,M,-33.94,151.23,,bf5f0640-01bb-44e5-ba16-8bd356c8ce9c,-33.77,150.91,NSW,Blacktown,debit,authorized,3ab068da21c84209896a9443f6bb7487,SALES-POS,30-40,2018,8,23,23,36,Thursday,7 days,52253.921
ACC-1222300524,38,16.3,1721.63,1.0,CUS-2142601169,2018-08-24,Michael,M,-33.94,151.23,,ac64dff2-d786-44fa-a332-3f530bdd0444,-33.96,151.14,NSW,Rockdale,debit,authorized,01948766d87d40b8b275de9ab0486bc3,SALES-POS,30-40,2018,8,24,11,1,Friday,7 days,52253.921
ACC-1222300524,38,21.75,1699.88,1.0,CUS-2142601169,2018-08-24,Michael,M,-33.94,151.23,,a9ef765f-2a48-4d8d-a08f-5cf8e5ed52c9,-33.81,150.94,NSW,Greystanes,debit,authorized,5efa08581a1448eea225b306588987f8,SALES-POS,30-40,2018,8,24,11,9,Friday,7 days,52253.921
ACC-1222300524,38,15.17,1684.71,0.0,CUS-2142601169,2018-08-24,Michael,M,-33.94,151.23,,bfbb283f-f5a2-4b5b-b1e3-9e5edc057ae3,-33.8,151.18,NSW,Chatswood,debit,authorized,0d62fbc5421740ec9dd5e68d9d5849b3,SALES-POS,30-40,2018,8,24,12,29,Friday,7 days,52253.921
ACC-1222300524,38,12.59,1672.12,1.0,CUS-2142601169,2018-08-24,Michael,M,-33.94,151.23,,63e318b8-783c-46f2-af70-0b0e0324e027,-33.87,151.2,NSW,Sydney,debit,authorized,e58e404d30f44c44b17f78de442d2240,SALES-POS,30-40,2018,8,24,23,58,Friday,7 days,52253.921
ACC-1222300524,38,12.6,1659.52,1.0,CUS-2142601169,2018-08-25,Michael,M,-33.94,151.23,,518c54bf-8f28-4d8c-8c70-aacfe46d1865,-33.96,137.7,SA,New Town,debit,authorized,6b74fe83067f4f4ea8e3b782146bf71c,SALES-POS,30-40,2018,8,25,8,59,Saturday,7 days,52253.921
ACC-1222300524,38,77.25,1582.27,1.0,CUS-2142601169,2018-08-25,Michael,M,-33.94,151.23,,16e2e89f-c7ba-40b9-ba89-26d0cf5bb9fd,-33.82,151,NSW,Parramatta,debit,authorized,97f58cd2b253439c82b43a3d566ddb61,SALES-POS,30-40,2018,8,25,10,2,Saturday,7 days,52253.921
ACC-1222300524,38,5.04,1577.23,1.0,CUS-2142601169,2018-08-25,Michael,M,-33.94,151.23,,4a53422f-6e66-44ae-909f-ba93192dc76b,-33.92,150.92,NSW,Liverpool,debit,authorized,20342dec499e472c9665e1f9e703b41e,POS,30-40,2018,8,25,12,47,Saturday,7 days,52253.921
ACC-1222300524,38,8.64,1568.59,1.0,CUS-2142601169,2018-08-25,Michael,M,-33.94,151.23,,bcd0ee88-b7f0-4e27-a66a-c865787b88d2,-33.92,150.92,NSW,Liverpool,debit,authorized,78be1dcac804461c95a3c824e0d983e7,SALES-POS,30-40,2018,8,25,14,38,Saturday,7 days,52253.921
ACC-1222300524,38,37.68,1530.91,1.0,CUS-2142601169,2018-08-25,Michael,M,-33.94,151.23,,4d4a87fc-a840-450f-ac8d-d96c7bc5ec31,-33.79,151.13,NSW,Macquarie Park,debit,authorized,90e5af37ecc04a2998cfa59109f4c4fd,POS,30-40,2018,8,25,17,14,Saturday,7 days,52253.921
ACC-1222300524,38,14.91,1516.0,1.0,CUS-2142601169,2018-08-26,Michael,M,-33.94,151.23,,96828216-c471-47f3-b14b-e25f78f32c79,-33.96,151.08,NSW,Penshurst,debit,authorized,09fd47bdd6214188b7d8849a66f69d5d,SALES-POS,30-40,2018,8,26,10,12,Sunday,7 days,52253.921
ACC-1222300524,38,7.65,1508.35,0.0,CUS-2142601169,2018-08-26,Michael,M,-33.94,151.23,,77d5548f-16a1-4821-a564-bed19ba18f24,-33.92,150.86,NSW,Len Waters Estate,debit,authorized,6bfe43b0ebaa440ca139bc03645dbb3b,POS,30-40,2018,8,26,10,40,Sunday,7 days,52253.921
ACC-1222300524,38,11.96,1496.39,1.0,CUS-2142601169,2018-08-26,Michael,M,-33.94,151.23,,805e2d12-0bb1-44ca-bf7f-ede7377f09db,-33.77,151.26,NSW,Brookvale,debit,authorized,751bdae27b0b4047a2dc700f5a82046f,SALES-POS,30-40,2018,8,26,12,6,Sunday,7 days,52253.921
ACC-1222300524,38,10.05,1486.34,1.0,CUS-2142601169,2018-08-26,Michael,M,-33.94,151.23,,a1563cc9-1efa-430f-808c-b7236e129749,-33.76,138.44,SA,Hart,debit,authorized,dfdbf658ccee4055bec7d7a24c370c20,SALES-POS,30-40,2018,8,26,13,23,Sunday,7 days,52253.921
ACC-1222300524,38,7.57,1478.77,1.0,CUS-2142601169,2018-08-26,Michael,M,-33.94,151.23,,1c4d189b-15f8-4e6a-bf26-8c6e59804408,-27.88,151.27,QLD,Millmerran,debit,authorized,8068326c95bb4a7b8c61875d89c4c0b5,SALES-POS,30-40,2018,8,26,21,30,Sunday,7 days,52253.921
ACC-1222300524,38,81.95,1396.82,1.0,CUS-2142601169,2018-08-26,Michael,M,-33.94,151.23,,9d51aada-0f7e-4664-aa5d-6119a888f759,-33.87,151.21,NSW,Sydney,debit,authorized,289cf8f03a5b4406b573b753ac902640,SALES-POS,30-40,2018,8,26,22,18,Sunday,7 days,52253.921
ACC-1222300524,38,23.3,1373.52,1.0,CUS-2142601169,2018-08-27,Michael,M,-33.94,151.23,,4b70e3d4-96ca-407d-ab8a-f5c54c0b6036,-33.93,150.92,NSW,Liverpool,debit,authorized,7eacc797b1d34cb08f53492cb110c816,SALES-POS,30-40,2018,8,27,10,18,Monday,7 days,52253.921
ACC-1222300524,38,25.39,1348.13,0.0,CUS-2142601169,2018-08-27,Michael,M,-33.94,151.23,,438fdb3a-9c2c-45ac-9583-f138420f0d18,-33.96,137.72,SA,Kadina,debit,authorized,5ddd1374fc5f4e2eb4a97383aa09d454,SALES-POS,30-40,2018,8,27,21,22,Monday,7 days,52253.921
ACC-1222300524,38,14.76,1333.37,1.0,CUS-2142601169,2018-08-28,Michael,M,-33.94,151.23,,ff07af80-5a16-4b43-9ce9-d471b3d0daf1,-33.93,151.08,NSW,Sydney,debit,authorized,ead1aee7f61044e88498bdc7debdedce,POS,30-40,2018,8,28,4,22,Tuesday,7 days,52253.921
ACC-1222300524,38,5.94,1327.43,1.0,CUS-2142601169,2018-08-28,Michael,M,-33.94,151.23,,8ca8ce61-1e0b-4bac-80ba-201190896c37,-33.95,151.02,NSW,Revesby,debit,authorized,8bbd142e488d42309534d4e32b3f707a,SALES-POS,30-40,2018,8,28,9,8,Tuesday,7 days,52253.921
ACC-1222300524,38,24.59,1302.84,1.0,CUS-2142601169,2018-08-28,Michael,M,-33.94,151.23,,eff24725-7bf4-4609-b729-a5cb67288f3d,-33.94,151.04,NSW,Padstow,debit,authorized,3d457495dab3465ab85fc2096489e9bf,POS,30-40,2018,8,28,9,44,Tuesday,7 days,52253.921
ACC-1222300524,38,25.34,1277.5,1.0,CUS-2142601169,2018-08-28,Michael,M,-33.94,151.23,,d7cf976a-7c9c-453a-9fdf-ece9ecb9a484,-23.88,151.22,QLD,Clinton,debit,authorized,0220f94ae71c43ecbdb336064ba5f951,POS,30-40,2018,8,28,11,1,Tuesday,7 days,52253.921
ACC-1222300524,38,12.33,2267.3,1.0,CUS-2142601169,2018-08-29,Michael,M,-33.94,151.23,,79b9f09f-73fd-4bae-a1b9-0f8e13358b4c,-33.87,151.2,NSW,Pyrmont,debit,authorized,b85c8fbfa55f416c8cda751ae9dec695,POS,30-40,2018,8,29,14,46,Wednesday,7 days,52253.921
ACC-1222300524,38,17.05,2250.25,0.0,CUS-2142601169,2018-08-29,Michael,M,-33.94,151.23,,0ee8697e-18ad-41b7-a285-4973c6634982,-33.75,150.72,NSW,Cambridge Park,debit,authorized,9a0fdc174139484f97c469709ebf7a2b,SALES-POS,30-40,2018,8,29,15,14,Wednesday,7 days,52253.921
ACC-1222300524,38,8.1,2242.15,1.0,CUS-2142601169,2018-08-29,Michael,M,-33.94,151.23,,3ce2653e-5bde-4459-9aef-af93e8ebaf1c,-33.84,151.21,NSW,North Sydney,debit,authorized,6955ba8efb2d416a9f8921bd4fe4ece3,POS,30-40,2018,8,29,15,37,Wednesday,7 days,52253.921
ACC-1222300524,38,27.35,2214.8,0.0,CUS-2142601169,2018-08-30,Michael,M,-33.94,151.23,,4c7213c1-8e71-4c8a-917f-cea08a5cf4db,-33.93,150.9,NSW,Lurnea,debit,authorized,8fbc2ea160364e93a08e8d5d8854033b,SALES-POS,30-40,2018,8,30,15,3,Thursday,7 days,52253.921
ACC-1222300524,38,4.17,2210.63,1.0,CUS-2142601169,2018-08-30,Michael,M,-33.94,151.23,,658fbab9-3626-4516-9ad0-d4fc2e7eafbc,-33.93,151.04,NSW,Punchbowl,debit,authorized,83d9d4b9d63b42f39cd5c59e2d469327,SALES-POS,30-40,2018,8,30,15,34,Thursday,7 days,52253.921
ACC-1222300524,38,13.29,2197.34,1.0,CUS-2142601169,2018-08-30,Michael,M,-33.94,151.23,,abe64210-3df3-4615-83d7-5cc2c28964d6,-33.88,151.2,NSW,Ultimo,debit,authorized,b466499527744863bd4ecd461c3acbdf,POS,30-40,2018,8,30,15,40,Thursday,7 days,52253.921
ACC-1222300524,38,22.34,2175.0,1.0,CUS-2142601169,2018-08-30,Michael,M,-33.94,151.23,,6f483fb2-c860-4d75-8c48-846fd9ce5500,-33.75,150.66,NSW,Emu Plains,debit,authorized,90de06607ab2415d88202218dbb8441c,SALES-POS,30-40,2018,8,30,16,11,Thursday,7 days,52253.921
ACC-1222300524,38,92.88,2082.12,1.0,CUS-2142601169,2018-08-30,Michael,M,-33.94,151.23,,3075b265-3b29-4d54-a38e-c379113f73bf,-33.79,115.97,WA,Balingup,debit,authorized,1f3dcc274d3944e5939f41499416a3b3,SALES-POS,30-40,2018,8,30,17,7,Thursday,7 days,52253.921
ACC-1222300524,38,9.57,2072.55,1.0,CUS-2142601169,2018-08-30,Michael,M,-33.94,151.23,,134b1580-cc99-4261-992d-8aef5b5b1375,-33.81,150.99,NSW,Westmead,debit,authorized,35d21ae2ed334b7481b106eeb1b48cf1,POS,30-40,2018,8,30,17,19,Thursday,7 days,52253.921
ACC-1222300524,38,50.0,2022.55,,CUS-2142601169,2018-08-30,Michael,M,-33.94,151.23,,,,,,,debit,posted,b8c8649704f740a1a800028b020ff18e,PAYMENT,30-40,2018,8,30,19,0,Thursday,7 days,52253.921
ACC-1222300524,38,17.31,2005.24,0.0,CUS-2142601169,2018-08-30,Michael,M,-33.94,151.23,,a992af86-06b6-48e4-a951-ec1ceb529957,-33.96,151.06,NSW,Peakhurst,debit,authorized,c971e3dc8c554cd796a7bbc1373125ec,SALES-POS,30-40,2018,8,30,21,55,Thursday,7 days,52253.921
ACC-1222300524,38,3.25,2001.99,0.0,CUS-2142601169,2018-08-30,Michael,M,-33.94,151.23,,1e48b1a9-5fe2-408f-92f2-1b0406edb2c8,-33.97,151.08,NSW,Mortdale,debit,authorized,2ac6a76a7550494eaec0fa87d1f33b91,POS,30-40,2018,8,30,23,39,Thursday,7 days,52253.921
ACC-1222300524,38,50.89,1951.1,1.0,CUS-2142601169,2018-08-31,Michael,M,-33.94,151.23,,31dfa493-202d-4c6f-93c6-a4722c1fc92f,-33.87,151.2,NSW,Sydney,debit,authorized,364a88067bfb44a3947e46e9c54b26df,POS,30-40,2018,8,31,1,57,Friday,7 days,52253.921
ACC-1222300524,38,7.37,1943.73,1.0,CUS-2142601169,2018-08-31,Michael,M,-33.94,151.23,,68b25786-f854-4deb-9e9b-bc3e11217907,-33.81,150.99,NSW,Westmead,debit,authorized,e1e04ae854ff44d8b9d8e3a26224d948,POS,30-40,2018,8,31,8,7,Friday,7 days,52253.921
ACC-1222300524,38,10.07,1933.66,1.0,CUS-2142601169,2018-09-01,Michael,M,-33.94,151.23,,fce3c46f-5fa7-47aa-a50a-7b12ad1644b8,-33.93,151.07,NSW,Roselands,debit,authorized,1f67543070b54735aa156b3a7476510d,SALES-POS,30-40,2018,9,1,15,10,Saturday,7 days,52253.921
ACC-1222300524,38,8.74,1924.92,1.0,CUS-2142601169,2018-09-01,Michael,M,-33.94,151.23,,5bef6f4d-3555-4b95-9419-bb8816864048,-37.86,145.09,VIC,Ashburton,debit,authorized,2085c18ea33c4a06aab92fff65045894,SALES-POS,30-40,2018,9,1,16,29,Saturday,7 days,52253.921
ACC-1222300524,38,16.95,1907.97,0.0,CUS-2142601169,2018-09-01,Michael,M,-33.94,151.23,,14dceb58-aa1a-4fa3-9633-e359b7247c0b,-33.87,151.11,NSW,Five Dock,debit,authorized,063fba39c72b46ab853c9d9359cb8132,POS,30-40,2018,9,1,17,8,Saturday,7 days,52253.921
ACC-1222300524,38,6.44,1901.53,1.0,CUS-2142601169,2018-09-02,Michael,M,-33.94,151.23,,81c98cac-899b-4aea-b50b-8382e706a5ad,-33.92,151.04,NSW,Bankstown,debit,authorized,a4c274a24ac144ea9488b737607fc4ec,POS,30-40,2018,9,2,10,28,Sunday,7 days,52253.921
ACC-1222300524,38,46.02,1855.51,1.0,CUS-2142601169,2018-09-02,Michael,M,-33.94,151.23,,5cf787f7-83e4-4354-bae2-05be0334d290,-27.41,153.08,QLD,Eagle Farm,debit,authorized,bbd610a2571b4299a0efdb9f48f54791,SALES-POS,30-40,2018,9,2,13,40,Sunday,7 days,52253.921
ACC-1222300524,38,20.93,1834.58,1.0,CUS-2142601169,2018-09-02,Michael,M,-33.94,151.23,,7747bd2b-e29e-486f-b6aa-ad20ec5f6971,-33.92,151.04,NSW,Bankstown,debit,authorized,152da5aedd6f4a96a43db48e0af96f64,SALES-POS,30-40,2018,9,2,13,58,Sunday,7 days,52253.921
ACC-1222300524,38,102.0,1732.58,,CUS-2142601169,2018-09-02,Michael,M,-33.94,151.23,,,,,,,debit,posted,7f82031ee2674ddea7ed3da4b8ee1dac,PAYMENT,30-40,2018,9,2,23,0,Sunday,7 days,52253.921
ACC-1222300524,38,80.51,1652.07,1.0,CUS-2142601169,2018-09-03,Michael,M,-33.94,151.23,,7aa35faa-c607-489f-b7ea-226b095b16ee,-37.82,144.96,VIC,Melbourne,debit,authorized,bd12331fd9734731a8f876985492c0ba,POS,30-40,2018,9,3,8,29,Monday,7 days,52253.921
ACC-1222300524,38,5.81,1646.26,1.0,CUS-2142601169,2018-09-03,Michael,M,-33.94,151.23,,bcd0ee88-b7f0-4e27-a66a-c865787b88d2,-33.92,150.92,NSW,Liverpool,debit,authorized,34d064aed5e241f79c8ec44c03657e22,POS,30-40,2018,9,3,15,26,Monday,7 days,52253.921
ACC-1222300524,38,4.53,1641.73,1.0,CUS-2142601169,2018-09-03,Michael,M,-33.94,151.23,,c791c707-2472-4ac0-9fa1-33a47d2b608b,-33.87,151.03,NSW,Berala,debit,authorized,e00d79fa67fa429bb52597ec7ee1bf19,POS,30-40,2018,9,3,17,36,Monday,7 days,52253.921
ACC-1222300524,38,83.06,1558.67,1.0,CUS-2142601169,2018-09-04,Michael,M,-33.94,151.23,,9d51aada-0f7e-4664-aa5d-6119a888f759,-33.87,151.21,NSW,Sydney,debit,authorized,4a3b335076e34ea0a89be27ab096aa1b,SALES-POS,30-40,2018,9,4,11,41,Tuesday,7 days,52253.921
ACC-1222300524,38,15.41,1543.26,1.0,CUS-2142601169,2018-09-04,Michael,M,-33.94,151.23,,f2c76ff1-b59a-4739-8e40-fa5cde1289c5,-33.98,151.11,NSW,South Hurstville,debit,authorized,144796a769c045399c7ff3f7a57ec9e4,POS,30-40,2018,9,4,13,34,Tuesday,7 days,52253.921
ACC-1222300524,38,9.67,1533.59,1.0,CUS-2142601169,2018-09-04,Michael,M,-33.94,151.23,,e87637aa-6498-48b3-ac58-0725fb7c60a0,-33.75,150.69,NSW,Penrith,debit,authorized,f12f08beb0ed4c57bac4b543b52c6b06,POS,30-40,2018,9,4,14,39,Tuesday,7 days,52253.921
ACC-1222300524,38,2349.55,186.17,1.0,CUS-2142601169,2018-09-05,Michael,M,-33.94,151.23,,e5b2b589-812a-44a1-a1bb-403d9ee9a1b4,-33.94,151.17,NSW,Mascot,debit,authorized,e9d3f4a032944711b58ba0eba4c4c33b,POS,30-40,2018,9,5,9,1,Wednesday,7 days,52253.921
ACC-1222300524,38,5.04,181.13,1.0,CUS-2142601169,2018-09-05,Michael,M,-33.94,151.23,,09f289b2-6d59-4325-b710-689496f66c77,-37.85,144.86,VIC,Williamstown North,debit,authorized,fe77129bbf1d43c5b59ead41a13b8f76,SALES-POS,30-40,2018,9,5,16,6,Wednesday,7 days,52253.921
ACC-1222300524,38,15.22,165.91,1.0,CUS-2142601169,2018-09-05,Michael,M,-33.94,151.23,,86d8554a-921c-4369-84b6-e347b16e92a7,-33.92,151.08,NSW,Lakemba,debit,authorized,7108b13d83fe4d8aa8460d7423506bd5,POS,30-40,2018,9,5,22,15,Wednesday,7 days,52253.921
ACC-1222300524,38,45.07,120.84,1.0,CUS-2142601169,2018-09-06,Michael,M,-33.94,151.23,,9690a753-fe1a-4bfd-be12-5b33652e8093,-33.75,150.69,NSW,Penrith,debit,authorized,4aed7e3896344514a1513fe0a876e65e,POS,30-40,2018,9,6,9,5,Thursday,7 days,52253.921
ACC-1222300524,38,50.0,70.84,,CUS-2142601169,2018-09-06,Michael,M,-33.94,151.23,,,,,,,debit,posted,5e4b77f981b649939c877b524ba3867a,PAYMENT,30-40,2018,9,6,19,0,Thursday,7 days,52253.921
ACC-1222300524,38,6.71,64.13,1.0,CUS-2142601169,2018-09-07,Michael,M,-33.94,151.23,,bd55b2be-eda5-45e8-8a91-053eafbd5480,-33.96,116.14,WA,Bridgetown,debit,authorized,fe6986c1f84c4e399deacedddd992d79,SALES-POS,30-40,2018,9,7,12,6,Friday,7 days,52253.921
ACC-1222300524,38,14.72,49.41,0.0,CUS-2142601169,2018-09-07,Michael,M,-33.94,151.23,,0b4b5cb5-ced8-443e-b4ff-b472bdf7fe88,-33.75,151.28,NSW,Dee Why,debit,authorized,4ec59652ed694deea2628e1c2e29be1d,SALES-POS,30-40,2018,9,7,13,52,Friday,7 days,52253.921
ACC-1222300524,38,16.57,32.84,1.0,CUS-2142601169,2018-09-07,Michael,M,-33.94,151.23,,3c794012-c383-4f54-9ecf-7bff64e564ce,-33.81,115.12,WA,Metricup,debit,authorized,7677693654504fd3ad2d35df50d0adb1,SALES-POS,30-40,2018,9,7,17,40,Friday,7 days,52253.921
ACC-1222300524,38,4.75,28.09,1.0,CUS-2142601169,2018-09-08,Michael,M,-33.94,151.23,,bc1d521f-0e20-483f-84b1-0462893ab4e9,-33.92,150.88,NSW,Miller,debit,authorized,6783e619d7ee435288d19acc86fcaf19,SALES-POS,30-40,2018,9,8,13,25,Saturday,7 days,52253.921
ACC-1222300524,38,8.86,19.23,0.0,CUS-2142601169,2018-09-08,Michael,M,-33.94,151.23,,55295baa-7aa8-4c67-bebe-ea99985be37c,-33.92,150.92,NSW,Liverpool,debit,authorized,c2ba589da66245a1bfe35e08142f51d4,POS,30-40,2018,9,8,16,6,Saturday,7 days,52253.921
ACC-1222300524,38,15.03,4.2,1.0,CUS-2142601169,2018-09-09,Michael,M,-33.94,151.23,,6ad3211d-0c5e-46a7-b768-a094d85fe5cf,-33.93,151.06,NSW,Punchbowl,debit,authorized,62828bcb045049008873f34677c24cc7,POS,30-40,2018,9,9,10,27,Sunday,7 days,52253.921
ACC-1222300524,38,9.11,997.22,0.0,CUS-2142601169,2018-09-12,Michael,M,-33.94,151.23,,b086c009-8b97-4706-b6f9-bcde403a3f49,-33.91,151.17,NSW,Marrickville,debit,authorized,d695060a9d5942a086a19d2d531aac04,POS,30-40,2018,9,12,9,47,Wednesday,7 days,52253.921
ACC-1222300524,38,6.39,990.83,1.0,CUS-2142601169,2018-09-12,Michael,M,-33.94,151.23,,ac3990bf-7638-42d6-b442-da11826fb40d,-33.92,150.92,NSW,Liverpool,debit,authorized,8d1e8aad7bc04d2488512783a576dec8,SALES-POS,30-40,2018,9,12,15,41,Wednesday,7 days,52253.921
ACC-1222300524,38,31.8,959.03,1.0,CUS-2142601169,2018-09-12,Michael,M,-33.94,151.23,,f656c191-9b37-4ca9-9b91-4f91ebed5cbe,-33.91,151.19,NSW,Alexandria,debit,authorized,06ab051a128b4718a2bf32a0db35f578,SALES-POS,30-40,2018,9,12,17,38,Wednesday,7 days,52253.921
ACC-1222300524,38,18.5,940.53,0.0,CUS-2142601169,2018-09-12,Michael,M,-33.94,151.23,,2c5f2074-e8cc-4e01-ac39-30fd936dd547,-33.8,151.18,NSW,Chatswood,debit,authorized,2e3b485aa4754a6a94f5e79fdb2ae58c,POS,30-40,2018,9,12,18,37,Wednesday,7 days,52253.921
ACC-1222300524,38,16.34,924.19,0.0,CUS-2142601169,2018-09-13,Michael,M,-33.94,151.23,,ca504361-fa5f-4c0a-a6f5-800343d80b98,-33.96,151.16,NSW,Brighton-Le-Sands,debit,authorized,8c538f41fddc4577b73ff14ca5e72a1e,SALES-POS,30-40,2018,9,13,9,5,Thursday,7 days,52253.921
ACC-1222300524,38,7.38,916.81,1.0,CUS-2142601169,2018-09-13,Michael,M,-33.94,151.23,,72cdcf17-312b-49c3-9fbe-bd3cdcf97d42,-37.81,144.95,VIC,West Melbourne,debit,authorized,564a561b680f437892edde0c40eb41ef,POS,30-40,2018,9,13,9,42,Thursday,7 days,52253.921
ACC-1222300524,38,8.13,908.68,0.0,CUS-2142601169,2018-09-13,Michael,M,-33.94,151.23,,a1ca1b7e-a737-4fc8-b070-3e606f52c0d6,-33.95,115.07,WA,Margaret River,debit,authorized,c5d7f8293a3e4928ac155cc9fba1f5aa,POS,30-40,2018,9,13,10,40,Thursday,7 days,52253.921
ACC-1222300524,38,19.62,889.06,1.0,CUS-2142601169,2018-09-13,Michael,M,-33.94,151.23,,a1082d97-f4c7-4fbd-85c6-271112d5b94d,-33.95,151.03,NSW,Padstow,debit,authorized,de57028c22554d798727bbe0e7ea82d1,POS,30-40,2018,9,13,11,9,Thursday,7 days,52253.921
ACC-1222300524,38,43.85,845.21,1.0,CUS-2142601169,2018-09-13,Michael,M,-33.94,151.23,,296a0500-8552-48ac-ac81-ec37065b568e,-33.96,150.88,NSW,Casula,debit,authorized,727c305e1c904251812e4a71d5c66184,POS,30-40,2018,9,13,11,35,Thursday,7 days,52253.921
ACC-1222300524,38,50.0,795.21,,CUS-2142601169,2018-09-13,Michael,M,-33.94,151.23,,,,,,,debit,posted,f7ab1f65221a4e7f80d030fe37707bff,PAYMENT,30-40,2018,9,13,19,0,Thursday,7 days,52253.921
ACC-1222300524,38,14.04,781.17,1.0,CUS-2142601169,2018-09-14,Michael,M,-33.94,151.23,,f3c3b9e2-0600-4e15-9ca5-d1c901744c37,-33.79,151,NSW,Northmead,debit,authorized,2e20c76f166b40b0952b6a7e7415a4eb,POS,30-40,2018,9,14,7,23,Friday,7 days,52253.921
ACC-1222300524,38,26.89,754.28,1.0,CUS-2142601169,2018-09-14,Michael,M,-33.94,151.23,,06fc4a45-fc32-4940-85a3-4e5c414c40ee,-33.75,150.98,NSW,Baulkham Hills,debit,authorized,7898fc7977e04a45b35ccb2b4c9c2930,POS,30-40,2018,9,14,9,55,Friday,7 days,52253.921
ACC-1222300524,38,747.83,6.45,1.0,CUS-2142601169,2018-09-14,Michael,M,-33.94,151.23,,8fcf9ffb-8c03-47ef-a976-b579343f2afb,-33.9,150.9,NSW,Mount Pritchard,debit,authorized,5ca70dc81ce9417bb8a02708eeff4985,POS,30-40,2018,9,14,14,30,Friday,7 days,52253.921
ACC-1222300524,38,5.47,0.98,1.0,CUS-2142601169,2018-09-14,Michael,M,-33.94,151.23,,a1ca1b7e-a737-4fc8-b070-3e606f52c0d6,-33.95,115.07,WA,Margaret River,debit,authorized,2fc1fc588217444aa9c03a070f94512c,SALES-POS,30-40,2018,9,14,20,8,Friday,7 days,52253.921
ACC-1222300524,38,23.6,979.51,0.0,CUS-2142601169,2018-09-18,Michael,M,-33.94,151.23,,1bbee098-5421-4236-961f-b93cf7a1c1e6,-33.95,151.04,NSW,Padstow,debit,authorized,26d0948314b246ee826f5abec3aaa0ab,SALES-POS,30-40,2018,9,18,21,8,Tuesday,7 days,52253.921
ACC-1222300524,38,20.75,958.76,1.0,CUS-2142601169,2018-09-18,Michael,M,-33.94,151.23,,65633340-2daa-4ef9-9592-0a4194581db1,-33.84,151.01,NSW,Granville,debit,authorized,b8f2156add994181b06864b13a055f5d,POS,30-40,2018,9,18,21,28,Tuesday,7 days,52253.921
ACC-1222300524,38,56.99,901.77,1.0,CUS-2142601169,2018-09-19,Michael,M,-33.94,151.23,,58e9515d-2cdf-4f69-94d7-47d9fbf54e7a,-33.92,151.18,NSW,Mascot,debit,authorized,26baff56846244a591c512654dd01813,POS,30-40,2018,9,19,6,39,Wednesday,7 days,52253.921
ACC-1222300524,38,10.49,891.28,0.0,CUS-2142601169,2018-09-19,Michael,M,-33.94,151.23,,4d67f493-f181-4480-be5e-215c36812157,-33.91,150.87,NSW,Green Valley,debit,authorized,40a7003b8ac34aa39994f85ced99683e,SALES-POS,30-40,2018,9,19,8,28,Wednesday,7 days,52253.921
ACC-1222300524,38,19.18,872.1,1.0,CUS-2142601169,2018-09-19,Michael,M,-33.94,151.23,,6d74ef2f-57b5-4c6b-93a3-bbd3bb7ab8e4,-33.97,151.08,NSW,Mortdale,debit,authorized,81425b5b39c142698b3fa3cdb4ad4edf,SALES-POS,30-40,2018,9,19,8,54,Wednesday,7 days,52253.921
ACC-1222300524,38,9.09,863.01,1.0,CUS-2142601169,2018-09-19,Michael,M,-33.94,151.23,,d1c66cfe-1569-4918-bbb2-ca9f76a14e08,-33.87,151.2,NSW,Sydney,debit,authorized,e0da5a8c65914910a9718b9d245891b4,POS,30-40,2018,9,19,9,44,Wednesday,7 days,52253.921
ACC-1222300524,38,7.88,855.13,0.0,CUS-2142601169,2018-09-19,Michael,M,-33.94,151.23,,0bbb6cf4-2b52-40d2-87bc-260688679d24,-33.77,150.91,NSW,Blacktown,debit,authorized,95c793308d434f8c8f6d11a62b83931e,SALES-POS,30-40,2018,9,19,11,20,Wednesday,7 days,52253.921
ACC-1222300524,38,23.2,831.93,1.0,CUS-2142601169,2018-09-19,Michael,M,-33.94,151.23,,ab7309b7-ad87-4d24-bd87-111c70b56759,-37.84,144.97,VIC,Melbourne,debit,authorized,4551fc93f60f4b1b907f781ed8912c41,SALES-POS,30-40,2018,9,19,12,31,Wednesday,7 days,52253.921
ACC-1222300524,38,7.41,824.52,1.0,CUS-2142601169,2018-09-19,Michael,M,-33.94,151.23,,f3419ce8-536c-4dcf-9d0c-12c9aed8c55c,-33.92,151.04,NSW,Bankstown,debit,authorized,5a4d632dab194a8f84148d0242471422,POS,30-40,2018,9,19,19,20,Wednesday,7 days,52253.921
ACC-1222300524,38,7.89,816.63,1.0,CUS-2142601169,2018-09-19,Michael,M,-33.94,151.23,,1827d393-4034-4c80-88a5-1cd6ac9deddd,-33.76,150.99,NSW,Baulkham Hills,debit,authorized,a2f108166f2e405d8e5bdd14e26b92a2,SALES-POS,30-40,2018,9,19,20,48,Wednesday,7 days,52253.921
ACC-1222300524,38,5.54,811.09,1.0,CUS-2142601169,2018-09-19,Michael,M,-33.94,151.23,,8732ce7a-f43b-4402-aa94-0583c1d5e0ed,-33.73,151.01,NSW,Castle Hill,debit,authorized,d12d6d2c8b9345308a6aad4620dfa0a8,POS,30-40,2018,9,19,21,13,Wednesday,7 days,52253.921
ACC-1222300524,38,15.96,795.13,0.0,CUS-2142601169,2018-09-20,Michael,M,-33.94,151.23,,d3624e41-20b8-4226-a0b6-af6adb623309,-33.97,151.13,NSW,Kogarah,debit,authorized,142dcfdda9c44df4a6a43d8e654671dc,POS,30-40,2018,9,20,11,54,Thursday,7 days,52253.921
ACC-1222300524,38,16.01,779.12,1.0,CUS-2142601169,2018-09-20,Michael,M,-33.94,151.23,,c3c23f78-96e5-4742-af04-e90764e601de,-33.94,151.07,NSW,Roselands,debit,authorized,81d6a5a8898344acb0be94207a0cb4ae,SALES-POS,30-40,2018,9,20,12,7,Thursday,7 days,52253.921
ACC-1222300524,38,10.09,769.03,1.0,CUS-2142601169,2018-09-20,Michael,M,-33.94,151.23,,ac5da399-3ad5-40b0-928c-040c6d2852f6,-33.92,150.92,NSW,Liverpool,debit,authorized,dd985b32ca4c4e13a67dfa4f7095aa47,POS,30-40,2018,9,20,15,27,Thursday,7 days,52253.921
ACC-1222300524,38,15.98,753.05,1.0,CUS-2142601169,2018-09-20,Michael,M,-33.94,151.23,,7ba901bb-74a6-4f92-a67b-09910a832a30,-33.94,151.14,NSW,Arncliffe,debit,authorized,ab055a402ba040fea4df3cce66bd1c4d,POS,30-40,2018,9,20,15,49,Thursday,7 days,52253.921
ACC-1222300524,38,6.24,746.81,1.0,CUS-2142601169,2018-09-20,Michael,M,-33.94,151.23,,d104c46f-5796-49c9-a5cd-4086bf4b04b8,-33.97,151.1,NSW,Hurstville,debit,authorized,0da5868fa1394beb917ac4885f93c791,SALES-POS,30-40,2018,9,20,17,42,Thursday,7 days,52253.921
ACC-1222300524,38,50.0,685.2,,CUS-2142601169,2018-09-20,Michael,M,-33.94,151.23,,,,,,,debit,posted,e93bad8a8ee44326bf2286b05072a97d,PAYMENT,30-40,2018,9,20,19,0,Thursday,7 days,52253.921
ACC-1222300524,38,11.61,735.2,0.0,CUS-2142601169,2018-09-20,Michael,M,-33.94,151.23,,518c54bf-8f28-4d8c-8c70-aacfe46d1865,-33.96,137.7,SA,New Town,debit,authorized,e64f661231ca456d8f3cfe117f9b57e7,POS,30-40,2018,9,20,19,40,Thursday,7 days,52253.921
ACC-1222300524,38,5.26,679.94,1.0,CUS-2142601169,2018-09-21,Michael,M,-33.94,151.23,,3de8133f-edc1-4361-9e29-9d56c03f46a1,-33.92,151.08,NSW,Lakemba,debit,authorized,4a5ea4538f124f6daddf3c6aee673ea7,SALES-POS,30-40,2018,9,21,3,47,Friday,7 days,52253.921
ACC-1222300524,38,25.33,654.61,1.0,CUS-2142601169,2018-09-21,Michael,M,-33.94,151.23,,383acd24-6920-4f3f-89ec-28f47e5f09c3,-33.95,151.23,NSW,Eastgardens,debit,authorized,906ad9e17c1840bd8a8694e3695c0013,POS,30-40,2018,9,21,5,57,Friday,7 days,52253.921
ACC-1222300524,38,49.85,604.76,1.0,CUS-2142601169,2018-09-21,Michael,M,-33.94,151.23,,4f031f12-e88a-464b-bfe5-ceb5695d753b,-33.92,151.2,NSW,Alexandria,debit,authorized,c9396668aa664836a0f9a6e9591f5aa3,POS,30-40,2018,9,21,9,49,Friday,7 days,52253.921
ACC-1222300524,38,63.52,541.24,1.0,CUS-2142601169,2018-09-21,Michael,M,-33.94,151.23,,69092272-47e1-4a35-9dcc-683f750cb571,-33.9,150.99,NSW,Bass Hill,debit,authorized,cf46626499654e8ea3465549d58f789b,SALES-POS,30-40,2018,9,21,11,13,Friday,7 days,52253.921
ACC-1222300524,38,75.25,465.99,1.0,CUS-2142601169,2018-09-21,Michael,M,-33.94,151.23,,d4acd296-f531-4576-8fdd-e91a92a7ff44,-33.87,151.21,NSW,Sydney,debit,authorized,b662ca4dccaf4829a42767167657971b,SALES-POS,30-40,2018,9,21,14,53,Friday,7 days,52253.921
ACC-1222300524,38,18.16,447.83,1.0,CUS-2142601169,2018-09-21,Michael,M,-33.94,151.23,,146cffd0-87c3-47e3-b0f3-815483a532b9,-33.96,137.71,SA,Kadina,debit,authorized,0c56df540ced469e9ff9a79024fa93f9,POS,30-40,2018,9,21,17,2,Friday,7 days,52253.921
ACC-1222300524,38,10.18,437.65,0.0,CUS-2142601169,2018-09-21,Michael,M,-33.94,151.23,,b5a3852f-4c2c-4de8-8d06-5f3d5b76c45c,-33.93,151.18,NSW,Mascot,debit,authorized,a46dc580953d4a24a4f4db348a43ee30,POS,30-40,2018,9,21,18,6,Friday,7 days,52253.921
ACC-1222300524,38,23.51,414.14,1.0,CUS-2142601169,2018-09-22,Michael,M,-33.94,151.23,,438fdb3a-9c2c-45ac-9583-f138420f0d18,-33.96,137.72,SA,Kadina,debit,authorized,82c1c0f97dc14f379603f66570d661dd,POS,30-40,2018,9,22,8,42,Saturday,7 days,52253.921
ACC-1222300524,38,10.58,403.56,1.0,CUS-2142601169,2018-09-22,Michael,M,-33.94,151.23,,de440092-1855-4457-9f2f-746d3a78dfcd,-33.93,137.63,SA,Wallaroo,debit,authorized,777e535139af4cf4b1a76e49404796d2,POS,30-40,2018,9,22,9,8,Saturday,7 days,52253.921
ACC-1222300524,38,13.45,390.11,0.0,CUS-2142601169,2018-09-22,Michael,M,-33.94,151.23,,0de75523-e772-4706-bd59-350afa6d3907,-33.8,151.29,NSW,Manly,debit,authorized,c4061641066c4e3491da0d75a1f6fd02,POS,30-40,2018,9,22,9,22,Saturday,7 days,52253.921
ACC-1222300524,38,11.24,378.87,1.0,CUS-2142601169,2018-09-22,Michael,M,-33.94,151.23,,c413a9a5-efe0-4b77-9138-af5afd0fa758,-33.89,151.18,NSW,Camperdown,debit,authorized,23f8ca1a2ce248738a30df71386e6171,SALES-POS,30-40,2018,9,22,9,57,Saturday,7 days,52253.921
ACC-1222300524,38,14.46,364.41,1.0,CUS-2142601169,2018-09-22,Michael,M,-33.94,151.23,,d5e0405e-956b-429c-bab8-8ec555b86f7b,-33.93,150.95,NSW,Moorebank,debit,authorized,232952ffde894fe688699f109d4aab52,SALES-POS,30-40,2018,9,22,10,6,Saturday,7 days,52253.921
ACC-1222300524,38,6.83,357.58,1.0,CUS-2142601169,2018-09-22,Michael,M,-33.94,151.23,,02bfed71-b829-462d-bcf4-7f143ca7766b,-33.87,151.13,NSW,Croydon,debit,authorized,e55cb2bae8584d26b466463a0eea9feb,POS,30-40,2018,9,22,19,56,Saturday,7 days,52253.921
ACC-1222300524,38,25.66,331.92,1.0,CUS-2142601169,2018-09-24,Michael,M,-33.94,151.23,,7d323148-3f01-4b5e-8645-221ccd753fe4,-33.82,151.02,NSW,Rosehill,debit,authorized,92ec484bb6b14812b3fa9b09e64b4e3b,POS,30-40,2018,9,24,9,43,Monday,7 days,52253.921
ACC-1222300524,38,18.48,313.44,1.0,CUS-2142601169,2018-09-24,Michael,M,-33.94,151.23,,ed1b9b0c-c647-4257-963a-01cad02e6944,-33.94,151.22,NSW,Eastgardens,debit,authorized,bc4d041881e44f9ab6f7217e98cc27d6,POS,30-40,2018,9,24,10,38,Monday,7 days,52253.921
ACC-1222300524,38,14.16,299.28,1.0,CUS-2142601169,2018-09-24,Michael,M,-33.94,151.23,,914cea98-2f5a-4ee4-b8b1-441ff0d41bf8,-33.96,151.07,NSW,Peakhurst,debit,authorized,b31281a75caf44a1a0d52db3e08042f5,POS,30-40,2018,9,24,17,21,Monday,7 days,52253.921
ACC-1222300524,38,17.47,281.81,1.0,CUS-2142601169,2018-09-24,Michael,M,-33.94,151.23,,90bcca1c-37b3-4e43-8320-e6886b13dc71,-33.95,150.95,NSW,Hammondville,debit,authorized,e3d09d41594b404fa1b2c58e7d80361c,POS,30-40,2018,9,24,18,31,Monday,7 days,52253.921
ACC-1222300524,38,6.29,275.52,1.0,CUS-2142601169,2018-09-24,Michael,M,-33.94,151.23,,0b987f8d-d345-4b1c-8113-b433631aae15,-33.92,150.92,NSW,Liverpool,debit,authorized,fdbc15c910244b3ab8f18bf0b32882d9,POS,30-40,2018,9,24,21,16,Monday,7 days,52253.921
ACC-1222300524,38,22.59,252.93,1.0,CUS-2142601169,2018-09-25,Michael,M,-33.94,151.23,,a57eacaa-1a0f-4de6-8245-c193f5bb530f,-33.94,150.91,NSW,Casula,debit,authorized,5d402dc443f04e40a477155454a70180,POS,30-40,2018,9,25,9,24,Tuesday,7 days,52253.921
ACC-1222300524,38,5.15,247.78,1.0,CUS-2142601169,2018-09-25,Michael,M,-33.94,151.23,,c0b5acb9-1ee4-411f-a28c-d4b707f8a46b,-33.78,151.07,NSW,Epping,debit,authorized,9c2635dfa3cc4f9f838e403268b16ef4,SALES-POS,30-40,2018,9,25,10,2,Tuesday,7 days,52253.921
ACC-1222300524,38,36.65,211.13,1.0,CUS-2142601169,2018-09-25,Michael,M,-33.94,151.23,,848f6f12-a594-461b-aaf5-72b7712ded60,-38.15,144.36,VIC,Geelong,debit,authorized,b84bb46bfacc43ce9bfca536f4ca867b,POS,30-40,2018,9,25,11,42,Tuesday,7 days,52253.921
ACC-1222300524,38,9.18,1204.08,1.0,CUS-2142601169,2018-09-26,Michael,M,-33.94,151.23,,31f7772a-ba76-4ab4-bcbc-de9176844b25,-33.92,150.92,NSW,Liverpool,debit,authorized,18bd099fdb2149c6ae0444d7e2e65025,POS,30-40,2018,9,26,9,11,Wednesday,7 days,52253.921
ACC-1222300524,38,7.75,1196.33,1.0,CUS-2142601169,2018-09-26,Michael,M,-33.94,151.23,,cda59185-3935-4d2c-91b0-b435ee6c94fb,-33.82,151.19,NSW,St Leonards,debit,authorized,88ac65e081bc4aa495f5873007b2cae2,POS,30-40,2018,9,26,10,6,Wednesday,7 days,52253.921
ACC-1222300524,38,77.24,1119.09,1.0,CUS-2142601169,2018-09-26,Michael,M,-33.94,151.23,,a43ea02a-4dfd-4be4-a7b6-5438df923271,-33.86,151.21,NSW,Sydney,debit,authorized,8f01899c8c32473897481f736c7ff246,POS,30-40,2018,9,26,10,30,Wednesday,7 days,52253.921
ACC-1222300524,38,13.01,1106.08,1.0,CUS-2142601169,2018-09-26,Michael,M,-33.94,151.23,,3487252d-4932-4c32-a137-4afb9966a517,-33.87,151.21,NSW,Sydney,debit,authorized,0af35d8adfb841d99bc2f1ffbee586ea,SALES-POS,30-40,2018,9,26,11,57,Wednesday,7 days,52253.921
ACC-1222300524,38,16.96,1089.12,1.0,CUS-2142601169,2018-09-26,Michael,M,-33.94,151.23,,b21820e2-c98c-4f04-914f-7492254f7067,-33.93,137.62,SA,Wallaroo,debit,authorized,2cf35bfdddb247e2876a706706fcd0ad,SALES-POS,30-40,2018,9,26,12,48,Wednesday,7 days,52253.921
ACC-1222300524,38,9.41,1079.71,1.0,CUS-2142601169,2018-09-26,Michael,M,-33.94,151.23,,22b641b6-f2e4-4abd-9fc6-6a5a3b375ff2,-33.75,150.74,NSW,Werrington County,debit,authorized,f5563d3f997440108de0401be4467ee6,POS,30-40,2018,9,26,15,22,Wednesday,7 days,52253.921
ACC-1222300524,38,6.25,1073.46,1.0,CUS-2142601169,2018-09-27,Michael,M,-33.94,151.23,,bc1d521f-0e20-483f-84b1-0462893ab4e9,-33.92,150.88,NSW,Miller,debit,authorized,ded94d63051d4ff68c07791c69176737,POS,30-40,2018,9,27,10,24,Thursday,7 days,52253.921
ACC-1222300524,38,11.56,1061.9,1.0,CUS-2142601169,2018-09-27,Michael,M,-33.94,151.23,,b9510d80-80d9-4fe5-b712-523881bfff75,-33.65,115.34,WA,Busselton,debit,authorized,1686b90470f74548b7d5cb6ab64486f3,SALES-POS,30-40,2018,9,27,11,41,Thursday,7 days,52253.921
ACC-1222300524,38,9.06,1052.84,1.0,CUS-2142601169,2018-09-27,Michael,M,-33.94,151.23,,c54e03a8-bd5e-482e-b152-309c4471f5fc,-33.93,151.2,NSW,Mascot,debit,authorized,84f968b068c34a0ba60abc207db7f083,SALES-POS,30-40,2018,9,27,15,17,Thursday,7 days,52253.921
ACC-1222300524,38,50.0,980.31,,CUS-2142601169,2018-09-27,Michael,M,-33.94,151.23,,,,,,,debit,posted,e036d5b1edb34919a824c5c3155a55a1,PAYMENT,30-40,2018,9,27,19,0,Thursday,7 days,52253.921
ACC-1222300524,38,22.53,1030.31,1.0,CUS-2142601169,2018-09-27,Michael,M,-33.94,151.23,,34254520-3daa-49b5-8267-7f5499ed69a5,-33.91,151.06,NSW,Greenacre,debit,authorized,9d3faf3ff2b746c5a3a99c6264cb023c,POS,30-40,2018,9,27,19,7,Thursday,7 days,52253.921
ACC-1222300524,38,5.43,974.88,1.0,CUS-2142601169,2018-09-28,Michael,M,-33.94,151.23,,a1ca1b7e-a737-4fc8-b070-3e606f52c0d6,-33.95,115.07,WA,Margaret River,debit,authorized,171c240078c94773a8fcd0c55eb5bf97,SALES-POS,30-40,2018,9,28,8,4,Friday,7 days,52253.921
ACC-1222300524,38,16.2,958.68,1.0,CUS-2142601169,2018-09-28,Michael,M,-33.94,151.23,,579e51c0-f568-47cc-93a3-b0764131af81,-33.89,151.04,NSW,Yagoona,debit,authorized,2d68ffdc05294fdbaa76026d1c378716,POS,30-40,2018,9,28,9,7,Friday,7 days,52253.921
ACC-1222300524,38,18.31,940.37,0.0,CUS-2142601169,2018-09-28,Michael,M,-33.94,151.23,,dc7b49e7-2598-4e97-884d-953ee606ab1b,-33.92,150.92,NSW,Liverpool,debit,authorized,f7cbd52078064a48812d1814b59558c0,POS,30-40,2018,9,28,16,0,Friday,7 days,52253.921
ACC-1222300524,38,26.12,914.25,1.0,CUS-2142601169,2018-09-28,Michael,M,-33.94,151.23,,9fafd25e-2baa-44ee-8ca3-bd2edfcd9150,-33.91,150.92,NSW,Liverpool,debit,authorized,66cd13316bc14c3c9309c212c03ba653,SALES-POS,30-40,2018,9,28,22,0,Friday,7 days,52253.921
ACC-1222300524,38,28.78,885.47,1.0,CUS-2142601169,2018-09-29,Michael,M,-33.94,151.23,,f6cb6b79-8707-4c6d-a6bc-2b2012de5aed,-33.87,151.19,NSW,Pyrmont,debit,authorized,0653e6e86aca4273bf6b7e15eeb5d8f9,SALES-POS,30-40,2018,9,29,10,46,Saturday,7 days,52253.921
ACC-1222300524,38,6.41,879.06,1.0,CUS-2142601169,2018-09-29,Michael,M,-33.94,151.23,,b71b927f-3c14-4f05-92ee-842378fa8293,-33.93,151.19,NSW,Mascot,debit,authorized,421e107ce6d74c8bba7925bbed1d596e,SALES-POS,30-40,2018,9,29,14,50,Saturday,7 days,52253.921
ACC-1222300524,38,16.6,862.46,0.0,CUS-2142601169,2018-09-29,Michael,M,-33.94,151.23,,f0517635-0ebe-4a8c-815c-b726f570b5cf,-33.74,150.81,NSW,Emerton,debit,authorized,a03017e012284d30ae2fd86c7c4f5df6,SALES-POS,30-40,2018,9,29,18,50,Saturday,7 days,52253.921
ACC-1222300524,38,11.73,850.73,1.0,CUS-2142601169,2018-09-29,Michael,M,-33.94,151.23,,668f860c-514a-4f52-a2a5-b8651b2f61d9,-33.94,151.04,NSW,Punchbowl,debit,authorized,e1d74e8da06f4cf18f230e4fe72cf258,POS,30-40,2018,9,29,19,36,Saturday,7 days,52253.921
ACC-1222300524,38,18.47,832.26,1.0,CUS-2142601169,2018-09-29,Michael,M,-33.94,151.23,,ad5f71d0-7acb-475b-943d-db95b7abf4ca,-33.87,151.21,NSW,Sydney,debit,authorized,3fd3b1dec5c24fbcb5c07bad72585870,POS,30-40,2018,9,29,22,26,Saturday,7 days,52253.921
ACC-1222300524,38,9.02,823.24,1.0,CUS-2142601169,2018-09-30,Michael,M,-33.94,151.23,,4bc0e750-4818-4aec-af42-3be72ef0de7b,-33.75,150.69,NSW,Penrith,debit,authorized,1d9503a0936a4720b1ed04ed1649f36f,SALES-POS,30-40,2018,9,30,4,54,Sunday,7 days,52253.921
ACC-1222300524,38,21.08,802.16,1.0,CUS-2142601169,2018-09-30,Michael,M,-33.94,151.23,,604ad808-441d-43dd-9d1d-559649785f90,-33.77,150.91,NSW,Blacktown,debit,authorized,599b3ece28dd45cebf4b853d2f9edd90,SALES-POS,30-40,2018,9,30,21,26,Sunday,7 days,52253.921
ACC-1222300524,38,19.23,782.93,1.0,CUS-2142601169,2018-09-30,Michael,M,-33.94,151.23,,02174352-993c-4f6f-a379-18d6a710ada0,-33.81,151.11,NSW,Ryde,debit,authorized,6f247ef2529b4e1eb1fce1fbe4ece9d2,POS,30-40,2018,9,30,21,33,Sunday,7 days,52253.921
ACC-1222300524,38,29.57,753.36,0.0,CUS-2142601169,2018-10-01,Michael,M,-33.94,151.23,,7163ba4e-86e2-4146-b5e1-033b0a1d43d2,-37.84,144.98,VIC,Melbourne,debit,authorized,f077102cbe80453eabf96683eafc8496,SALES-POS,30-40,2018,10,1,0,23,Monday,7 days,52253.921
ACC-1222300524,38,8.44,744.92,0.0,CUS-2142601169,2018-10-01,Michael,M,-33.94,151.23,,aee28413-5126-40ac-909a-2d91cafad528,-33.78,151.12,NSW,Macquarie Park,debit,authorized,0c9bdb3d9298473b9f47dc08988c8d7a,POS,30-40,2018,10,1,1,26,Monday,7 days,52253.921
ACC-1222300524,38,8.21,736.71,1.0,CUS-2142601169,2018-10-01,Michael,M,-33.94,151.23,,a06611b8-173d-42ec-8cc6-874fa5d6fee5,-33.87,151.21,NSW,Sydney,debit,authorized,0588ed5db65a49b3a4728e66677a86d6,SALES-POS,30-40,2018,10,1,7,19,Monday,7 days,52253.921
ACC-1222300524,38,26.53,710.18,1.0,CUS-2142601169,2018-10-01,Michael,M,-33.94,151.23,,176a01ec-0cd5-4763-88e5-563d120ed7ad,-27.47,153.02,QLD,Brisbane City,debit,authorized,1cfefa8d1d1b40b68c2b5c0150afd4fc,POS,30-40,2018,10,1,13,24,Monday,7 days,52253.921
ACC-1222300524,38,18.76,691.42,1.0,CUS-2142601169,2018-10-02,Michael,M,-33.94,151.23,,898045e0-b5a7-4466-a793-21a32b32f41b,-33.95,151.04,NSW,Padstow,debit,authorized,3639beba0ba04a71b6d5b98cfe1be46e,POS,30-40,2018,10,2,1,43,Tuesday,7 days,52253.921
ACC-1222300524,38,8.06,683.36,1.0,CUS-2142601169,2018-10-02,Michael,M,-33.94,151.23,,5024d6e4-302c-40df-aa6b-8906910ba0db,-33.8,151.29,NSW,Manly,debit,authorized,e076551783ae4cbfa65f222e74bc7781,POS,30-40,2018,10,2,9,4,Tuesday,7 days,52253.921
ACC-1222300524,38,5.96,677.4,1.0,CUS-2142601169,2018-10-02,Michael,M,-33.94,151.23,,bd55b2be-eda5-45e8-8a91-053eafbd5480,-33.96,116.14,WA,Bridgetown,debit,authorized,8709c8e1b24b47be8ddda29547b4dc45,SALES-POS,30-40,2018,10,2,9,44,Tuesday,7 days,52253.921
ACC-1222300524,38,61.85,615.55,0.0,CUS-2142601169,2018-10-02,Michael,M,-33.94,151.23,,69092272-47e1-4a35-9dcc-683f750cb571,-33.9,150.99,NSW,Bass Hill,debit,authorized,a2da02a8db1445deb987fa573ed73fc8,POS,30-40,2018,10,2,9,58,Tuesday,7 days,52253.921
ACC-1222300524,38,13.32,602.23,0.0,CUS-2142601169,2018-10-02,Michael,M,-33.94,151.23,,78a916e4-135e-4a54-bbb8-cd6689eb6967,-33.93,151.11,NSW,Earlwood,debit,authorized,32fa36c433e34a6da207740be7eefad4,SALES-POS,30-40,2018,10,2,11,21,Tuesday,7 days,52253.921
ACC-1222300524,38,11.87,590.36,1.0,CUS-2142601169,2018-10-02,Michael,M,-33.94,151.23,,aa5aa2e9-e9b4-46a6-a8ad-d723edc8e77d,-33.91,150.87,NSW,Green Valley,debit,authorized,a1347dda53d041d8a2ef7a192264b0f1,SALES-POS,30-40,2018,10,2,14,43,Tuesday,7 days,52253.921
ACC-1222300524,38,102.0,1490.49,,CUS-2142601169,2018-10-02,Michael,M,-33.94,151.23,,,,,,,debit,posted,65ebf6aff5c646b192ccca83f021a20d,PAYMENT,30-40,2018,10,2,23,0,Tuesday,7 days,52253.921
ACC-1222300524,38,19.76,1470.73,1.0,CUS-2142601169,2018-10-03,Michael,M,-33.94,151.23,,2417b1fb-18e7-4f7a-83e3-bbe74963d5e3,-33.93,150.97,NSW,Moorebank,debit,authorized,1dcf3a8ee06d4e669d0c2a08ccb1f10e,SALES-POS,30-40,2018,10,3,9,42,Wednesday,7 days,52253.921
ACC-1222300524,38,6.61,1464.12,1.0,CUS-2142601169,2018-10-03,Michael,M,-33.94,151.23,,3278e728-f1be-42d4-9769-908afa601ff6,-33.97,151.1,NSW,Hurstville,debit,authorized,7fa1b5d0f16248618fa2d57304f51196,SALES-POS,30-40,2018,10,3,10,22,Wednesday,7 days,52253.921
ACC-1222300524,38,6.55,1457.57,1.0,CUS-2142601169,2018-10-03,Michael,M,-33.94,151.23,,aa6e2d44-eada-49c5-b7b2-839c58acbc22,-33.78,150.9,NSW,Blacktown,debit,authorized,308558e5c22e471c95f32a03a03563ce,POS,30-40,2018,10,3,11,36,Wednesday,7 days,52253.921
ACC-1222300524,38,6.28,1451.29,1.0,CUS-2142601169,2018-10-03,Michael,M,-33.94,151.23,,a1ca1b7e-a737-4fc8-b070-3e606f52c0d6,-33.95,115.07,WA,Margaret River,debit,authorized,c36b33b2a2694f3bbe9263338ab84e16,POS,30-40,2018,10,3,13,11,Wednesday,7 days,52253.921
ACC-1222300524,38,13.41,1437.88,1.0,CUS-2142601169,2018-10-03,Michael,M,-33.94,151.23,,455c2862-fa06-4c7f-bdee-cfcf63095c66,-33.91,151.26,NSW,Clovelly,debit,authorized,d13a592f2f594dadb84469bdde4ff9a5,POS,30-40,2018,10,3,14,9,Wednesday,7 days,52253.921
ACC-1222300524,38,50.0,1387.88,,CUS-2142601169,2018-10-04,Michael,M,-33.94,151.23,,,,,,,debit,posted,5b5f3cba2649403dbafd1456a4eb8c15,PAYMENT,30-40,2018,10,4,19,0,Thursday,7 days,52253.921
ACC-1222300524,38,2.39,1385.49,1.0,CUS-2142601169,2018-10-05,Michael,M,-33.94,151.23,,b1a88e2a-7b07-4cb0-bc9b-547dd5d70f85,-33.95,115.07,WA,Margaret River,debit,authorized,3f3e9acd1e764981bc6349bf7ede84e8,POS,30-40,2018,10,5,2,13,Friday,7 days,52253.921
ACC-1222300524,38,16.85,1368.64,1.0,CUS-2142601169,2018-10-05,Michael,M,-33.94,151.23,,ca504361-fa5f-4c0a-a6f5-800343d80b98,-33.96,151.16,NSW,Brighton-Le-Sands,debit,authorized,d9bfd738588f41cabbd14587019bac90,POS,30-40,2018,10,5,4,37,Friday,7 days,52253.921
ACC-1222300524,38,20.78,1347.86,1.0,CUS-2142601169,2018-10-05,Michael,M,-33.94,151.23,,e7176f10-4bb2-453e-85c6-3aebd8fb7408,-33.77,150.9,NSW,Blacktown,debit,authorized,109ed7a9508c47aa83355c8324acaa47,POS,30-40,2018,10,5,12,38,Friday,7 days,52253.921
ACC-1222300524,38,13.71,1334.15,1.0,CUS-2142601169,2018-10-05,Michael,M,-33.94,151.23,,ecc0b9d5-ce2a-4eec-8507-13f65df181da,-33.91,151.1,NSW,Campsie,debit,authorized,a8324da9135e47409298e4cde1d83805,SALES-POS,30-40,2018,10,5,14,19,Friday,7 days,52253.921
ACC-1222300524,38,6.82,1327.33,1.0,CUS-2142601169,2018-10-05,Michael,M,-33.94,151.23,,f7643a90-424d-46ec-97ee-320406f77268,-33.7,150.56,NSW,Springwood,debit,authorized,d7ea34ced504497c9fde177c7bc8e45d,POS,30-40,2018,10,5,15,18,Friday,7 days,52253.921
ACC-1222300524,38,29.42,1297.91,1.0,CUS-2142601169,2018-10-05,Michael,M,-33.94,151.23,,87b6a0b0-8b78-4e4c-b9d8-17a5e8956c0b,-33.81,151,NSW,Parramatta,debit,authorized,2ff44bb91eb64f13ac34ba7e94c424c0,POS,30-40,2018,10,5,15,35,Friday,7 days,52253.921
ACC-1222300524,38,7.35,1290.56,0.0,CUS-2142601169,2018-10-05,Michael,M,-33.94,151.23,,2d6a19c0-bc02-44a9-9014-aaf637d16225,-33.8,151.29,NSW,Manly,debit,authorized,3eb0fe0377e544fb88014f40384e3830,SALES-POS,30-40,2018,10,5,17,3,Friday,7 days,52253.921
ACC-1222300524,38,7.26,1283.3,0.0,CUS-2142601169,2018-10-05,Michael,M,-33.94,151.23,,3153c43b-b27d-4a61-b92c-e3f233564081,-33.92,151.26,NSW,Coogee,debit,authorized,e90a4e43475c4def8535253fff785837,POS,30-40,2018,10,5,18,49,Friday,7 days,52253.921
ACC-1222300524,38,29.28,1254.02,1.0,CUS-2142601169,2018-10-05,Michael,M,-33.94,151.23,,e9074350-40c1-46e0-9acd-57f458e461d6,-33.96,150.89,NSW,Casula,debit,authorized,ad479be2940541e1984918d287fe70a5,SALES-POS,30-40,2018,10,5,19,54,Friday,7 days,52253.921
ACC-1222300524,38,18.05,1235.97,1.0,CUS-2142601169,2018-10-06,Michael,M,-33.94,151.23,,6ad3211d-0c5e-46a7-b768-a094d85fe5cf,-33.93,151.06,NSW,Punchbowl,debit,authorized,f26ef936f7f74e66bd43106b37489e72,SALES-POS,30-40,2018,10,6,8,0,Saturday,7 days,52253.921
ACC-1222300524,38,562.76,673.21,0.0,CUS-2142601169,2018-10-06,Michael,M,-33.94,151.23,,f6fe96a8-b6c9-403c-b187-708a20528584,-33.94,151.06,NSW,Punchbowl,debit,authorized,0f7c6beb52bd495eacf1df88eb793732,POS,30-40,2018,10,6,10,36,Saturday,7 days,52253.921
ACC-1222300524,38,14.19,659.02,1.0,CUS-2142601169,2018-10-06,Michael,M,-33.94,151.23,,2fe4b555-6114-420d-92ac-1b9ab3294c8e,-33.91,150.92,NSW,Liverpool,debit,authorized,9e35ce296b014f7da33347a0f3217e4b,POS,30-40,2018,10,6,14,35,Saturday,7 days,52253.921
ACC-1222300524,38,5.15,653.87,1.0,CUS-2142601169,2018-10-06,Michael,M,-33.94,151.23,,018eeae6-d3d9-4c1c-b74c-cf436ae9fb58,-33.77,150.94,NSW,Seven Hills,debit,authorized,c31f887186874ba7bb9013aac196f1bd,POS,30-40,2018,10,6,22,30,Saturday,7 days,52253.921
ACC-1222300524,38,9.12,644.75,1.0,CUS-2142601169,2018-10-06,Michael,M,-33.94,151.23,,e9c95a83-b406-414e-b447-0ec282d38faf,-33.95,115.07,WA,Margaret River,debit,authorized,47299db04c55462d8273903b208f4602,SALES-POS,30-40,2018,10,6,22,48,Saturday,7 days,52253.921
ACC-1222300524,38,22.22,622.53,0.0,CUS-2142601169,2018-10-07,Michael,M,-33.94,151.23,,77911254-b808-4b74-abeb-64c39634f202,-33.9,151.19,NSW,Alexandria,debit,authorized,622b7ac047f84a20b1c8dd32099641e0,POS,30-40,2018,10,7,18,54,Sunday,7 days,52253.921
ACC-1222300524,38,9.98,612.55,1.0,CUS-2142601169,2018-10-08,Michael,M,-33.94,151.23,,bdcf9ea0-9997-4409-b44f-a05b96fb41d8,-37.85,144.98,VIC,Melbourne,debit,authorized,61812beb78bd4d8fa4fad3018384f20b,POS,30-40,2018,10,8,9,21,Monday,7 days,52253.921
ACC-1222300524,38,23.03,589.52,1.0,CUS-2142601169,2018-10-08,Michael,M,-33.94,151.23,,bea54ad1-8c10-4b04-a57f-9309f92c8093,-33.81,151,NSW,Parramatta,debit,authorized,86d24e76c83448bb855bbd7fe8539d34,POS,30-40,2018,10,8,14,23,Monday,7 days,52253.921
ACC-1222300524,38,23.99,565.53,1.0,CUS-2142601169,2018-10-09,Michael,M,-33.94,151.23,,ba206cd5-781c-43b7-aace-f65100831212,-33.95,150.91,NSW,Casula,debit,authorized,9a05c4869dfd4082aee026010cb77a8e,POS,30-40,2018,10,9,12,36,Tuesday,7 days,52253.921
ACC-1222300524,38,6.43,559.1,1.0,CUS-2142601169,2018-10-09,Michael,M,-33.94,151.23,,e449ea4c-04e0-4958-bcd1-6a5d531f8e8c,-33.92,151.2,NSW,Alexandria,debit,authorized,2ac50172d2404024887d8cdb63bd3abb,POS,30-40,2018,10,9,13,20,Tuesday,7 days,52253.921
ACC-1222300524,38,31.32,1529.91,1.0,CUS-2142601169,2018-10-10,Michael,M,-33.94,151.23,,4199792e-da85-4e56-b456-c9e06e96e52c,-33.92,151.24,NSW,Randwick,debit,authorized,ec3b1a7bab7b435ca11976093d70bef0,POS,30-40,2018,10,10,17,57,Wednesday,7 days,52253.921
ACC-1222300524,38,18.62,1511.29,1.0,CUS-2142601169,2018-10-10,Michael,M,-33.94,151.23,,dd23bec4-0f94-4936-957a-3b2960a40df3,-33.87,151.07,NSW,Homebush West,debit,authorized,c5f2d0aec9244b509ebaddd869731cc2,SALES-POS,30-40,2018,10,10,21,4,Wednesday,7 days,52253.921
ACC-1222300524,38,36.68,1474.61,1.0,CUS-2142601169,2018-10-10,Michael,M,-33.94,151.23,,52be1d52-533e-45ec-8f27-7721f9535c87,-33.91,150.87,NSW,Green Valley,debit,authorized,c6a1a9aa752b4a89b767e40662c578a9,SALES-POS,30-40,2018,10,10,21,42,Wednesday,7 days,52253.921
ACC-1222300524,38,15.97,1458.64,1.0,CUS-2142601169,2018-10-11,Michael,M,-33.94,151.23,,b3a5109d-7d66-4526-bd50-389ddd02c27f,-33.93,150.95,NSW,Chipping Norton,debit,authorized,3a438225136846b8954915b4ecf407f7,POS,30-40,2018,10,11,1,18,Thursday,7 days,52253.921
ACC-1222300524,38,5.4,1453.24,0.0,CUS-2142601169,2018-10-11,Michael,M,-33.94,151.23,,ce553c72-ed0c-4e30-b730-164b6af76520,-33.77,150.91,NSW,Blacktown,debit,authorized,5e5c82bc32e24a3bba8957418d4ac0c0,POS,30-40,2018,10,11,8,11,Thursday,7 days,52253.921
ACC-1222300524,38,10.67,1442.57,1.0,CUS-2142601169,2018-10-11,Michael,M,-33.94,151.23,,f6a67a8d-ad19-4e99-b4ce-6166942bb92f,-33.93,150.99,NSW,Milperra,debit,authorized,c71f7374021944758ad018a30fd7da01,POS,30-40,2018,10,11,8,18,Thursday,7 days,52253.921
ACC-1222300524,38,50.0,1392.57,,CUS-2142601169,2018-10-11,Michael,M,-33.94,151.23,,,,,,,debit,posted,5335b0bad70641329ca1292e5ae5eef7,PAYMENT,30-40,2018,10,11,19,0,Thursday,7 days,52253.921
ACC-1222300524,38,33.77,1358.8,0.0,CUS-2142601169,2018-10-14,Michael,M,-33.94,151.23,,1be15a76-9a7e-4a85-99cf-f065b1dc9591,-33.97,151.1,NSW,Hurstville,debit,authorized,fa0d33ea41ce4037a269679c06f3a1f3,POS,30-40,2018,10,14,13,56,Sunday,7 days,52253.921
ACC-1222300524,38,15.54,1343.26,1.0,CUS-2142601169,2018-10-14,Michael,M,-33.94,151.23,,5c134d37-923c-49b8-8559-6980b0047703,-33.92,151.03,NSW,Bankstown,debit,authorized,f2d880b51dfd4ba18396c687dd84ebcd,POS,30-40,2018,10,14,17,55,Sunday,7 days,52253.921
ACC-1222300524,38,25.87,1317.39,1.0,CUS-2142601169,2018-10-14,Michael,M,-33.94,151.23,,9fafd25e-2baa-44ee-8ca3-bd2edfcd9150,-33.91,150.92,NSW,Liverpool,debit,authorized,c299385314814fef8e52991eb6867853,POS,30-40,2018,10,14,20,23,Sunday,7 days,52253.921
ACC-1222300524,38,10.6,1306.79,1.0,CUS-2142601169,2018-10-14,Michael,M,-33.94,151.23,,e9c95a83-b406-414e-b447-0ec282d38faf,-33.95,115.07,WA,Margaret River,debit,authorized,ea5ca0aa94b444e3b665644dc477e034,POS,30-40,2018,10,14,21,38,Sunday,7 days,52253.921
ACC-1222300524,38,9.82,1296.97,1.0,CUS-2142601169,2018-10-15,Michael,M,-33.94,151.23,,9980b7fe-3d5f-4aee-9ed0-74f4b050a175,-33.92,151.04,NSW,Bankstown,debit,authorized,7e074ea940da4f379dc18cf671b786be,SALES-POS,30-40,2018,10,15,8,8,Monday,7 days,52253.921
ACC-1222300524,38,13.11,1283.86,0.0,CUS-2142601169,2018-10-15,Michael,M,-33.94,151.23,,74991e65-5c75-42fc-8d01-ae06d2d66179,-33.93,150.92,NSW,Liverpool,debit,authorized,9f1a7cfb19ed4b1c9d7c812de6051556,SALES-POS,30-40,2018,10,15,10,27,Monday,7 days,52253.921
ACC-1222300524,38,6.33,1277.53,1.0,CUS-2142601169,2018-10-15,Michael,M,-33.94,151.23,,591082c5-10c9-421c-bb90-e2f76180cf58,-33.86,151.21,NSW,Sydney,debit,authorized,ea54af33f576473e93c7509dedf2a435,POS,30-40,2018,10,15,13,47,Monday,7 days,52253.921
ACC-1222300524,38,12.35,1265.18,0.0,CUS-2142601169,2018-10-15,Michael,M,-33.94,151.23,,40193d6a-141e-40c3-bbc9-231721981719,-33.86,151.21,NSW,Sydney,debit,authorized,c94a3bc807404829a3ebbdb29e3c4cc2,POS,30-40,2018,10,15,17,34,Monday,7 days,52253.921
ACC-1222300524,38,5.37,1259.81,1.0,CUS-2142601169,2018-10-15,Michael,M,-33.94,151.23,,f3419ce8-536c-4dcf-9d0c-12c9aed8c55c,-33.92,151.04,NSW,Bankstown,debit,authorized,1146e87387aa4321abd081347c27bcda,SALES-POS,30-40,2018,10,15,21,17,Monday,7 days,52253.921
ACC-1222300524,38,8.95,1250.86,1.0,CUS-2142601169,2018-10-16,Michael,M,-33.94,151.23,,b82483f8-57c4-4f6f-92ff-4f7b680495d2,-33.65,115.34,WA,Busselton,debit,authorized,16bf3862447e44649dbd372380a58e1c,SALES-POS,30-40,2018,10,16,4,28,Tuesday,7 days,52253.921
ACC-1222300524,38,7.97,1242.89,1.0,CUS-2142601169,2018-10-16,Michael,M,-33.94,151.23,,96bf0a2c-2a73-4486-8228-8aa93ae68ba4,-33.92,150.92,NSW,Liverpool,debit,authorized,1dcbf619b995469da9956a1d291bd459,POS,30-40,2018,10,16,10,43,Tuesday,7 days,52253.921
ACC-1222300524,38,14.24,2230.78,1.0,CUS-2142601169,2018-10-17,Michael,M,-33.94,151.23,,e14b1577-0809-44e7-8af3-f5ce6bcbfc25,-33.93,151.18,NSW,Sydney,debit,authorized,a79e7d250eac4c75bcae0d0fcc196f16,SALES-POS,30-40,2018,10,17,7,36,Wednesday,7 days,52253.921
ACC-1222300524,38,40.04,2190.74,1.0,CUS-2142601169,2018-10-17,Michael,M,-33.94,151.23,,03a40eb3-377c-4693-9202-6f237e87f1f2,-33.73,150.97,NSW,Baulkham Hills,debit,authorized,64edf66dc6b544fa9196e9355877a9cc,SALES-POS,30-40,2018,10,17,8,59,Wednesday,7 days,52253.921
ACC-1222300524,38,13.2,2177.54,1.0,CUS-2142601169,2018-10-17,Michael,M,-33.94,151.23,,24879f07-b76f-4d5f-a376-1f2720c0c29a,-33.77,150.77,NSW,Saint Marys,debit,authorized,2f554f38a594423bad4193faf8332069,POS,30-40,2018,10,17,9,55,Wednesday,7 days,52253.921
ACC-1222300524,38,8.35,2169.19,1.0,CUS-2142601169,2018-10-17,Michael,M,-33.94,151.23,,06ffce70-5bf8-461b-95d2-ea34885759c8,-33.96,151.13,NSW,Kogarah,debit,authorized,7e3b8c9a7d4d46eb918cb2ba3f2b3309,POS,30-40,2018,10,17,11,1,Wednesday,7 days,52253.921
ACC-1222300524,38,9.37,2159.82,1.0,CUS-2142601169,2018-10-17,Michael,M,-33.94,151.23,,e9569816-7d10-403a-8ca2-4ae5fffe10bb,-33.92,150.92,NSW,Liverpool,debit,authorized,13787ab3f1a14e37ad68fbd94a8c518b,POS,30-40,2018,10,17,11,26,Wednesday,7 days,52253.921
ACC-1222300524,38,9.35,2150.47,1.0,CUS-2142601169,2018-10-17,Michael,M,-33.94,151.23,,e597c518-a64e-4091-a7a2-0bf8bc8e7159,-33.96,116.14,WA,Bridgetown,debit,authorized,e12c3f0f058b47c5bf60c80b74943460,POS,30-40,2018,10,17,11,51,Wednesday,7 days,52253.921
ACC-1222300524,38,20.08,2130.39,1.0,CUS-2142601169,2018-10-17,Michael,M,-33.94,151.23,,40efb93c-93d5-4666-9b19-df4341aaa043,-33.87,151.21,NSW,Sydney,debit,authorized,7d827e4549384c099246779b8831393d,POS,30-40,2018,10,17,13,55,Wednesday,7 days,52253.921
ACC-1222300524,38,17.17,2113.22,1.0,CUS-2142601169,2018-10-17,Michael,M,-33.94,151.23,,40ecb26c-e294-4d59-b535-878d19330463,-33.86,151.17,NSW,Rozelle,debit,authorized,057814726f1348ccb110c6fc2f36e226,SALES-POS,30-40,2018,10,17,14,24,Wednesday,7 days,52253.921
ACC-1222300524,38,7.31,2105.91,0.0,CUS-2142601169,2018-10-17,Michael,M,-33.94,151.23,,8213e3af-7b48-4dde-8541-a1f7a0e5030d,-33.97,151.11,NSW,Hurstville,debit,authorized,900a04a7b9964b9c8416192f47ad39aa,POS,30-40,2018,10,17,19,39,Wednesday,7 days,52253.921
ACC-1222300524,38,3.87,2102.04,1.0,CUS-2142601169,2018-10-18,Michael,M,-33.94,151.23,,bb87b061-4673-4173-b9d7-13f95e3f72f0,-33.8,150.99,NSW,Westmead,debit,authorized,ba648e2d5a694b4d8771273609d5ebc4,POS,30-40,2018,10,18,14,0,Thursday,7 days,52253.921
ACC-1222300524,38,11.06,2090.98,1.0,CUS-2142601169,2018-10-18,Michael,M,-33.94,151.23,,dce0853b-745e-42f2-9e54-359e2aa99fdd,-33.76,150.99,NSW,Baulkham Hills,debit,authorized,8958ee8d8ff74593b4ad42d2f2fffd99,POS,30-40,2018,10,18,14,21,Thursday,7 days,52253.921
ACC-1222300524,38,50.0,2040.98,,CUS-2142601169,2018-10-18,Michael,M,-33.94,151.23,,,,,,,debit,posted,b2b4422c51eb4c19aee4459e78500144,PAYMENT,30-40,2018,10,18,19,0,Thursday,7 days,52253.921
ACC-1222300524,38,89.11,1951.87,1.0,CUS-2142601169,2018-10-18,Michael,M,-33.94,151.23,,3de16e20-02c7-47cb-9ad8-98ce5b04d22a,-33.87,151.21,NSW,Sydney,debit,authorized,eebdc14ee5024a51a3811f60c922370d,SALES-POS,30-40,2018,10,18,23,19,Thursday,7 days,52253.921
ACC-1222300524,38,25.0,1926.87,1.0,CUS-2142601169,2018-10-18,Michael,M,-33.94,151.23,,e7478dc3-3708-4b13-9852-871c2381bfb5,-33.7,151.1,NSW,Hornsby,debit,authorized,8f993f88ecac4e84b00a9956d72d6e4c,POS,30-40,2018,10,18,23,39,Thursday,7 days,52253.921
ACC-1222300524,38,4.76,1922.11,0.0,CUS-2142601169,2018-10-19,Michael,M,-33.94,151.23,,ea333a5f-9d67-4fa9-9687-c35b260732df,-33.94,151.1,NSW,Kingsgrove,debit,authorized,f4795ca97dae4230a26e470cf7cb8d2e,SALES-POS,30-40,2018,10,19,11,49,Friday,7 days,52253.921
ACC-1222300524,38,6.04,1916.07,1.0,CUS-2142601169,2018-10-19,Michael,M,-33.94,151.23,,54875e18-471a-4dd6-bcb0-53cff32e4a56,-33.93,151.18,NSW,Sydney Airport,debit,authorized,acdeb5f0410d4e5fa5a2ccb32153dd05,POS,30-40,2018,10,19,14,31,Friday,7 days,52253.921
ACC-1222300524,38,19.95,1896.12,1.0,CUS-2142601169,2018-10-20,Michael,M,-33.94,151.23,,296a60e7-5693-4d50-8d33-b5b994093d2e,-33.86,151.2,NSW,Sydney,debit,authorized,b965a2ef329e4f908a959923d0dccc99,POS,30-40,2018,10,20,11,8,Saturday,7 days,52253.921
ACC-1222300524,38,40.37,1855.75,1.0,CUS-2142601169,2018-10-20,Michael,M,-33.94,151.23,,b19f0688-a296-4826-9865-9c9eb8940db3,-33.96,151.06,NSW,Peakhurst,debit,authorized,ef0739983d12468ab6c33d6aa606b395,POS,30-40,2018,10,20,13,41,Saturday,7 days,52253.921
ACC-1222300524,38,25.04,1830.71,0.0,CUS-2142601169,2018-10-20,Michael,M,-33.94,151.23,,a57eacaa-1a0f-4de6-8245-c193f5bb530f,-33.94,150.91,NSW,Casula,debit,authorized,33700c6fae0f411c902cc0ea7bebb52a,SALES-POS,30-40,2018,10,20,14,15,Saturday,7 days,52253.921
ACC-1222300524,38,45.05,1785.66,1.0,CUS-2142601169,2018-10-21,Michael,M,-33.94,151.23,,b0e3fc82-a4d3-4740-bfb1-e2339a5e96de,-37.83,145.01,VIC,Richmond,debit,authorized,98036e3a80fa4285b1c3f90e1dbdb400,SALES-POS,30-40,2018,10,21,13,23,Sunday,7 days,52253.921
ACC-1222300524,38,21.55,1764.11,1.0,CUS-2142601169,2018-10-22,Michael,M,-33.94,151.23,,b828e4d7-0d82-47fd-a4da-2b6cb543b96e,-33.91,150.87,NSW,Hinchinbrook,debit,authorized,3ca35dd90d8848d389c29b6c7c12cdd6,POS,30-40,2018,10,22,10,32,Monday,7 days,52253.921
ACC-1222300524,38,7.96,1756.15,1.0,CUS-2142601169,2018-10-23,Michael,M,-33.94,151.23,,e597c518-a64e-4091-a7a2-0bf8bc8e7159,-33.96,116.14,WA,Bridgetown,debit,authorized,f7ebe2adc01d4b169dcabf61f59fb412,SALES-POS,30-40,2018,10,23,17,58,Tuesday,7 days,52253.921
ACC-1222300524,38,18.59,2739.69,1.0,CUS-2142601169,2018-10-24,Michael,M,-33.94,151.23,,51b5442f-31a4-44a4-bb86-bddb39381290,-33.93,151.06,NSW,Punchbowl,debit,authorized,e0a087f3ea1f4111a04eb3ae4e2a7b17,POS,30-40,2018,10,24,10,6,Wednesday,7 days,52253.921
ACC-1222300524,38,418.63,2321.06,1.0,CUS-2142601169,2018-10-24,Michael,M,-33.94,151.23,,d377fe00-3eb5-4bb6-9546-31ff7875d454,-33.81,151.18,NSW,Artarmon,debit,authorized,93ce4eedc86a439888dfc15c580d527a,SALES-POS,30-40,2018,10,24,15,0,Wednesday,7 days,52253.921
ACC-1222300524,38,50.0,2271.06,,CUS-2142601169,2018-10-25,Michael,M,-33.94,151.23,,,,,,,debit,posted,8100e63373ce47eeb792b26c06d2a35f,PAYMENT,30-40,2018,10,25,19,0,Thursday,7 days,52253.921
ACC-1222300524,38,7.54,2263.52,0.0,CUS-2142601169,2018-10-25,Michael,M,-33.94,151.23,,cb39705d-436f-4b8b-b543-d339e092c99d,-33.73,150.96,NSW,Baulkham Hills,debit,authorized,746d0f0e942a4b1092ea9eb93dd5534a,SALES-POS,30-40,2018,10,25,22,38,Thursday,7 days,52253.921
ACC-1222300524,38,9.39,2254.13,1.0,CUS-2142601169,2018-10-26,Michael,M,-33.94,151.23,,e5ed6561-f07b-4255-8cfe-62f905a3416c,-33.91,150.92,NSW,Liverpool,debit,authorized,a5be72dd4b614231bc060d7e8ef5f4b0,POS,30-40,2018,10,26,9,21,Friday,7 days,52253.921
ACC-1222300524,38,23.93,2230.2,0.0,CUS-2142601169,2018-10-26,Michael,M,-33.94,151.23,,438fdb3a-9c2c-45ac-9583-f138420f0d18,-33.96,137.72,SA,Kadina,debit,authorized,bd68cd3b37c44656818ea16258f72b6c,SALES-POS,30-40,2018,10,26,16,0,Friday,7 days,52253.921
ACC-1222300524,38,77.79,2152.41,1.0,CUS-2142601169,2018-10-26,Michael,M,-33.94,151.23,,2f4e2a37-caf3-422f-9564-ff591d9a7dc7,-33.87,151.2,NSW,Sydney,debit,authorized,7e4983e9caa649ea91c6108ce600e0f3,POS,30-40,2018,10,26,20,25,Friday,7 days,52253.921
ACC-1222300524,38,13.13,2139.28,0.0,CUS-2142601169,2018-10-26,Michael,M,-33.94,151.23,,62d50c71-3c47-48f5-9598-e0e0b0e7a21f,-37.82,144.97,VIC,Southbank,debit,authorized,ba65245a82ef41bda73f08f04a6b56d4,SALES-POS,30-40,2018,10,26,22,21,Friday,7 days,52253.921
ACC-1222300524,38,10.04,2129.24,1.0,CUS-2142601169,2018-10-27,Michael,M,-33.94,151.23,,a71d5a48-83e3-44c4-96b1-72973a9880a4,-33.8,151.29,NSW,Manly,debit,authorized,477ea7e6917c41e49ddfdd2fefe97244,POS,30-40,2018,10,27,2,2,Saturday,7 days,52253.921
ACC-1222300524,38,229.0,1900.24,,CUS-2142601169,2018-10-27,Michael,M,-33.94,151.23,,,,,,,debit,posted,2a2e07057f864ce184331c51c5fad2a9,PAYMENT,30-40,2018,10,27,5,0,Saturday,7 days,52253.921
ACC-1222300524,38,24.17,1876.07,0.0,CUS-2142601169,2018-10-27,Michael,M,-33.94,151.23,,438fdb3a-9c2c-45ac-9583-f138420f0d18,-33.96,137.72,SA,Kadina,debit,authorized,86f624e23a1f4c5f8dd4f1ec2b5bca7c,POS,30-40,2018,10,27,19,40,Saturday,7 days,52253.921
ACC-1222300524,38,246.04,1630.03,1.0,CUS-2142601169,2018-10-28,Michael,M,-33.94,151.23,,18505d09-546f-42ec-a296-07243abd3696,-33.96,151,NSW,Panania,debit,authorized,2e3aff67b3904d199d32ee77e3992f00,POS,30-40,2018,10,28,1,35,Sunday,7 days,52253.921
ACC-1222300524,38,17.53,1612.5,1.0,CUS-2142601169,2018-10-28,Michael,M,-33.94,151.23,,146cffd0-87c3-47e3-b0f3-815483a532b9,-33.96,137.71,SA,Kadina,debit,authorized,aacb570ca55f4212bed9e1c3d977bdb0,POS,30-40,2018,10,28,16,27,Sunday,7 days,52253.921
ACC-1222300524,38,40.87,1571.63,1.0,CUS-2142601169,2018-10-28,Michael,M,-33.94,151.23,,f798235c-1190-4fab-9a68-8f0ae5f841d8,-33.93,147.26,NSW,Wyalong,debit,authorized,f7d75393c32c4e27bf144ae424bd1ad9,POS,30-40,2018,10,28,16,43,Sunday,7 days,52253.921
ACC-1222300524,38,13.83,1557.8,1.0,CUS-2142601169,2018-10-28,Michael,M,-33.94,151.23,,9cb42fec-930a-47b2-a364-0d3872105e9c,-33.81,151,NSW,Parramatta,debit,authorized,ff14af4280ac4c5ebe5dd98dd6470488,SALES-POS,30-40,2018,10,28,21,14,Sunday,7 days,52253.921
ACC-1222300524,38,103.45,1454.35,1.0,CUS-2142601169,2018-10-29,Michael,M,-33.94,151.23,,e77e7118-9958-4ae0-8ecd-b705bde43c16,-33.87,151.21,NSW,Sydney,debit,authorized,307fa3cfa75141618f9b35a647b900e2,SALES-POS,30-40,2018,10,29,17,49,Monday,7 days,52253.921
ACC-1222300524,38,9.37,1444.98,1.0,CUS-2142601169,2018-10-29,Michael,M,-33.94,151.23,,309aaeb5-6644-4f03-a09d-1d35d9d63c51,-33.73,151.29,NSW,Collaroy Plateau,debit,authorized,720e81b36ba347ce8e5ada54344d391c,SALES-POS,30-40,2018,10,29,21,26,Monday,7 days,52253.921
ACC-1222300524,38,11.9,1433.08,1.0,CUS-2142601169,2018-10-30,Michael,M,-33.94,151.23,,2f5e2cd6-42cd-4a61-b068-f96af367c48e,-33.87,151.21,NSW,Sydney,debit,authorized,bac2121aa1234bfe9dad55dfa4ad5a52,POS,30-40,2018,10,30,8,14,Tuesday,7 days,52253.921
ACC-1222300524,38,23.51,1409.57,1.0,CUS-2142601169,2018-10-30,Michael,M,-33.94,151.23,,11f18ded-66fb-4df5-b136-0a144fc8e9fd,-33.96,151.14,NSW,Rockdale,debit,authorized,ec54cb36bdfd4dafa6dae4082cd10fd8,POS,30-40,2018,10,30,16,16,Tuesday,7 days,52253.921
ACC-1222300524,38,36.23,2375.47,0.0,CUS-2142601169,2018-10-31,Michael,M,-33.94,151.23,,c517e9ce-fba4-4269-ac69-739d51ef969b,-30.52,151.67,NSW,Armidale,debit,authorized,01b2fa3b2c304a2db74012bf84374177,SALES-POS,30-40,2018,10,31,10,23,Wednesday,7 days,52253.921
ACC-1222300524,38,5.02,2370.45,1.0,CUS-2142601169,2018-10-31,Michael,M,-33.94,151.23,,76f74eb9-c15b-49c1-8ab5-3edbd0bfcf12,-33.91,151.19,NSW,Alexandria,debit,authorized,9ffbc8fe90bf42cd9fdc5f02c8d77cc0,SALES-POS,30-40,2018,10,31,14,15,Wednesday,7 days,52253.921
ACC-1222300524,38,10.53,2359.92,1.0,CUS-2142601169,2018-10-31,Michael,M,-33.94,151.23,,46950be0-90fe-4387-a8c9-e35650d486f6,-33.91,151.24,NSW,Randwick,debit,authorized,4c91ed13c8e246d590e2565c941474fb,SALES-POS,30-40,2018,10,31,16,19,Wednesday,7 days,52253.921
ACC-1222300524,38,19.67,2340.25,1.0,CUS-2142601169,2018-10-31,Michael,M,-33.94,151.23,,aa8af5d1-53d4-448b-a612-6acd4b5bb310,-33.66,151.31,NSW,Newport,debit,authorized,6c6e9ec3d6d647e391192a7338856d44,POS,30-40,2018,10,31,17,19,Wednesday,7 days,52253.921
ACC-1222300524,38,19.19,2321.06,0.0,CUS-2142601169,2018-10-31,Michael,M,-33.94,151.23,,85536a50-fecc-4eac-9d42-a423ae233dc1,-33.75,150.69,NSW,Penrith,debit,authorized,cda53418938c41b2a8fe33105c53b383,POS,30-40,2018,10,31,17,43,Wednesday,7 days,52253.921
ACC-1037050564,40,40.9,2117.22,1.0,CUS-1614226872,2018-08-01,Rhonda,F,-27.66,153.10,,48514682-c78a-4a88-b0da-2d6302e64673,-26.68,153.05,QLD,Buderim,debit,authorized,2698170da3704fd981b15e64a006079e,SALES-POS,30-40,2018,8,1,1,38,Wednesday,7 days,46516.121
ACC-1037050564,40,45.12,2072.1,1.0,CUS-1614226872,2018-08-01,Rhonda,F,-27.66,153.10,,02d45834-6f65-4f52-9a33-0b242dd7a078,-27.21,152.99,QLD,North Lakes,debit,authorized,ad101b96b9d44b968b2519e2bb26a649,POS,30-40,2018,8,1,9,15,Wednesday,7 days,46516.121
ACC-1037050564,40,32.0,2040.1,,CUS-1614226872,2018-08-01,Rhonda,F,-27.66,153.10,,,,,,,debit,posted,94622881419c44e1b799a52d82572207,PAYMENT,30-40,2018,8,1,10,0,Wednesday,7 days,46516.121
ACC-1037050564,40,11.05,2029.05,1.0,CUS-1614226872,2018-08-01,Rhonda,F,-27.66,153.10,,1ab3e343-3775-4d54-9dac-2b0834500025,-31.43,152.92,NSW,Port Macquarie,debit,authorized,353c30ef66e345059a22305b36f138a2,SALES-POS,30-40,2018,8,1,14,28,Wednesday,7 days,46516.121
ACC-1037050564,40,65.11,1963.94,1.0,CUS-1614226872,2018-08-01,Rhonda,F,-27.66,153.10,,3de54244-f7ba-46c9-aa99-01bd54625d25,-27.39,153.12,QLD,Brisbane Airport,debit,authorized,fe3610e9d3ab418bba2ae7a62c56bc97,SALES-POS,30-40,2018,8,1,20,9,Wednesday,7 days,46516.121
ACC-1037050564,40,46.83,1917.11,1.0,CUS-1614226872,2018-08-02,Rhonda,F,-27.66,153.10,,25fd0d90-dec6-4462-85a0-fcdffa6864bb,-27.53,153.19,QLD,Capalaba,debit,authorized,ea6093226962428b90595ce9bed3f015,POS,30-40,2018,8,2,7,57,Thursday,7 days,46516.121
ACC-1037050564,40,44.39,1872.72,1.0,CUS-1614226872,2018-08-02,Rhonda,F,-27.66,153.10,,e3e28ad9-50a4-4a33-b675-bb611d49b517,-27.7,114.17,WA,Kalbarri,debit,authorized,3f04e8c7a5f6483289263a1b4f02a95a,POS,30-40,2018,8,2,9,12,Thursday,7 days,46516.121
ACC-1037050564,40,27.68,1845.04,1.0,CUS-1614226872,2018-08-02,Rhonda,F,-27.66,153.10,,f940d132-74b5-4a4d-9e7e-9b92ebe0570e,-27.51,153.05,QLD,Greenslopes,debit,authorized,8528dba42b854d2798fa048af404ac49,POS,30-40,2018,8,2,9,16,Thursday,7 days,46516.121
ACC-1037050564,40,18.7,1826.34,1.0,CUS-1614226872,2018-08-02,Rhonda,F,-27.66,153.10,,62b17722-b7a4-4cbe-a004-4627f928bdb9,-30.3,153.11,NSW,Coffs Harbour,debit,authorized,fb9a2978a4c142678510597fa808840b,POS,30-40,2018,8,2,9,25,Thursday,7 days,46516.121
ACC-1037050564,40,10.0,1816.34,1.0,CUS-1614226872,2018-08-02,Rhonda,F,-27.66,153.10,,df148a2c-f28b-46cd-bf67-06c07620ee35,-27.7,152.22,QLD,Caffey,debit,authorized,bcd6443cd0e848789ebee22dfa6535d0,SALES-POS,30-40,2018,8,2,9,29,Thursday,7 days,46516.121
ACC-1037050564,40,25.34,1791.0,1.0,CUS-1614226872,2018-08-02,Rhonda,F,-27.66,153.10,,0b5d87a1-cc4d-46f1-b2bd-0aa4e21ccfb7,-27.66,153.04,QLD,Browns Plains,debit,authorized,b647047b241d40ac9cbd4c9780750e6e,SALES-POS,30-40,2018,8,2,14,57,Thursday,7 days,46516.121
ACC-1037050564,40,33.0,1758.0,,CUS-1614226872,2018-08-02,Rhonda,F,-27.66,153.10,,,,,,,debit,posted,a39ab9c73d394c2e98a02790f50db315,PAYMENT,30-40,2018,8,2,15,0,Thursday,7 days,46516.121
ACC-1037050564,40,60.61,1697.39,1.0,CUS-1614226872,2018-08-02,Rhonda,F,-27.66,153.10,,e6389142-a34c-4515-b2bf-1adb67d12aee,-37.89,145,VIC,Elsternwick,debit,authorized,9cbfc3bb7e3b4b3592f287e1d44a7fd4,POS,30-40,2018,8,2,22,56,Thursday,7 days,46516.121
ACC-1037050564,40,22.0,1675.39,1.0,CUS-1614226872,2018-08-03,Rhonda,F,-27.66,153.10,,114110b6-5ed6-4ce8-b8b2-ff00a61fa14d,-30.17,153.19,NSW,Emerald Beach,debit,authorized,c88fbe548ca14e22a413064108a1b95b,SALES-POS,30-40,2018,8,3,19,26,Friday,7 days,46516.121
ACC-1037050564,40,15.25,1660.14,1.0,CUS-1614226872,2018-08-04,Rhonda,F,-27.66,153.10,,55a875c7-6e14-4f60-abce-14da7582698f,-27.42,153.06,QLD,Clayfield,debit,authorized,c380296b66fb48f5bfa8ce7d5851821a,POS,30-40,2018,8,4,8,9,Saturday,7 days,46516.121
ACC-1037050564,40,5.09,1655.05,1.0,CUS-1614226872,2018-08-04,Rhonda,F,-27.66,153.10,,a7058552-ddef-4ba2-a9a8-8d50ab7aa081,-27.49,153.15,QLD,Gumdale,debit,authorized,c3597e4626184c75b78e94ecb30dcd0f,POS,30-40,2018,8,4,9,18,Saturday,7 days,46516.121
ACC-1037050564,40,8.07,1646.98,1.0,CUS-1614226872,2018-08-04,Rhonda,F,-27.66,153.10,,6282ba45-37bf-4df2-be1b-596e839d5588,-27.62,152.89,QLD,Goodna,debit,authorized,9aad6e2e9a874b5f89c9687d8d4f4ebb,POS,30-40,2018,8,4,10,15,Saturday,7 days,46516.121
ACC-1037050564,40,124.61,1522.37,1.0,CUS-1614226872,2018-08-04,Rhonda,F,-27.66,153.10,,2e7749e4-91da-4f3d-b182-b6a1e9dad3a0,-27.47,153.02,QLD,Brisbane City,debit,authorized,2db944c070f5458098051b3f4eb4b027,SALES-POS,30-40,2018,8,4,11,58,Saturday,7 days,46516.121
ACC-1037050564,40,101.1,1421.27,1.0,CUS-1614226872,2018-08-04,Rhonda,F,-27.66,153.10,,5ff7b607-5c7e-48ea-b3f1-5af6effabde5,-37.82,145.19,VIC,Mitcham,debit,authorized,b307071967394ce3b42fee81a78a6daa,POS,30-40,2018,8,4,12,14,Saturday,7 days,46516.121
ACC-1037050564,40,44.74,1376.53,0.0,CUS-1614226872,2018-08-04,Rhonda,F,-27.66,153.10,,96597495-1fc0-496e-b131-e9667c9f72aa,-27.49,153.22,QLD,Birkdale,debit,authorized,b7ca1314c4e24b009453bb1c204e9c8b,POS,30-40,2018,8,4,12,48,Saturday,7 days,46516.121
ACC-1037050564,40,21.36,1355.17,1.0,CUS-1614226872,2018-08-04,Rhonda,F,-27.66,153.10,,713f9e48-f582-4670-a6b1-ac3bed1d4d77,-27.49,153.07,QLD,Camp Hill,debit,authorized,b706f2bec70945a4828fcbe8d1c441f5,POS,30-40,2018,8,4,18,49,Saturday,7 days,46516.121
ACC-1037050564,40,145.72,1209.45,1.0,CUS-1614226872,2018-08-04,Rhonda,F,-27.66,153.10,,18f0643a-1e62-45dd-8d7e-588320cae569,-27.64,153.13,QLD,Slacks Creek,debit,authorized,afa25129eff947d8badea8226c61f767,SALES-POS,30-40,2018,8,4,23,1,Saturday,7 days,46516.121
ACC-1037050564,40,45.13,1164.32,1.0,CUS-1614226872,2018-08-05,Rhonda,F,-27.66,153.10,,28c2b16f-c23c-4755-98e9-f3b4dae76ed7,-28.03,153.29,QLD,Advancetown,debit,authorized,099cd2523f2d40e9811ecefcb4d99aff,SALES-POS,30-40,2018,8,5,10,15,Sunday,7 days,46516.121
ACC-1037050564,40,32.59,1131.73,0.0,CUS-1614226872,2018-08-05,Rhonda,F,-27.66,153.10,,8ffac03b-542c-474f-9644-50a12ffc58bc,-27.34,153.04,QLD,Taigum,debit,authorized,e870fb6122ea4a2ca6ecca2f0596e6ec,POS,30-40,2018,8,5,10,28,Sunday,7 days,46516.121
ACC-1037050564,40,26.27,1105.46,1.0,CUS-1614226872,2018-08-05,Rhonda,F,-27.66,153.10,,be259eeb-3c6f-43de-8b12-64d12e72d7ce,-30.63,152.97,NSW,Valla,debit,authorized,806b457b7ef14e60be7c955b66225d40,SALES-POS,30-40,2018,8,5,13,6,Sunday,7 days,46516.121
ACC-1037050564,40,7.66,1097.8,1.0,CUS-1614226872,2018-08-05,Rhonda,F,-27.66,153.10,,6282ba45-37bf-4df2-be1b-596e839d5588,-27.62,152.89,QLD,Goodna,debit,authorized,27e61411084841f7bf23a08f44325006,SALES-POS,30-40,2018,8,5,14,28,Sunday,7 days,46516.121
ACC-1037050564,40,24.15,1073.65,0.0,CUS-1614226872,2018-08-05,Rhonda,F,-27.66,153.10,,1dbddb26-17b7-4268-8531-91e3eb7c5685,-27.46,153.04,QLD,New Farm,debit,authorized,d945bcd294814f008a7011d2b34b1225,SALES-POS,30-40,2018,8,5,18,50,Sunday,7 days,46516.121
ACC-1037050564,40,6.21,1067.44,1.0,CUS-1614226872,2018-08-06,Rhonda,F,-27.66,153.10,,afb9be07-e9a1-4b39-a117-ca5c976455ff,-27.39,153.12,QLD,Brisbane Airport,debit,authorized,4d0150b02315426384fdcb69b9d12f6f,POS,30-40,2018,8,6,10,20,Monday,7 days,46516.121
ACC-1037050564,40,45.96,1021.48,1.0,CUS-1614226872,2018-08-06,Rhonda,F,-27.66,153.10,,45551396-cfd2-4998-bcdc-f9ec12206e8d,-26.76,152.96,QLD,Mooloolah Valley,debit,authorized,598851726fa14435b069354fbe3117f5,POS,30-40,2018,8,6,10,27,Monday,7 days,46516.121
ACC-1037050564,40,34.81,986.67,1.0,CUS-1614226872,2018-08-06,Rhonda,F,-27.66,153.10,,e71b8df0-1ecb-486c-b3e3-a04a2c2deb43,-27.42,152.95,QLD,Keperra,debit,authorized,f478326e7e0446d9a16bccba0a227ff6,SALES-POS,30-40,2018,8,6,10,57,Monday,7 days,46516.121
ACC-1037050564,40,13.16,1865.6,1.0,CUS-1614226872,2018-08-06,Rhonda,F,-27.66,153.10,,b5585b6d-384e-43cb-823f-6de486160a0a,-27.7,153.04,QLD,Park Ridge,debit,authorized,d00bf34dfc2b4896bec4aff739a0d74c,SALES-POS,30-40,2018,8,6,19,37,Monday,7 days,46516.121
ACC-1037050564,40,51.34,1814.26,1.0,CUS-1614226872,2018-08-07,Rhonda,F,-27.66,153.10,,ffaffe7f-3d95-4429-a3dd-96a8d6088863,-37.85,145,VIC,Prahran,debit,authorized,98eb203781f646ae996cb72ec37719b9,POS,30-40,2018,8,7,9,37,Tuesday,7 days,46516.121
ACC-1037050564,40,9.18,1805.08,1.0,CUS-1614226872,2018-08-07,Rhonda,F,-27.66,153.10,,42b9bd12-297b-4cae-a557-821c5c0c22b2,-31.98,115.82,WA,Crawley,debit,authorized,e9a1a77ff08a41ef88cc935bfdc72fc6,POS,30-40,2018,8,7,9,54,Tuesday,7 days,46516.121
ACC-1037050564,40,21.22,1783.86,1.0,CUS-1614226872,2018-08-07,Rhonda,F,-27.66,153.10,,cfce0f5c-07c5-40fd-ac84-d8b1d701e12b,-27.5,152.97,QLD,Indooroopilly,debit,authorized,db118cef61864cc7bc66bfb7786da132,POS,30-40,2018,8,7,11,50,Tuesday,7 days,46516.121
ACC-1037050564,40,22.47,1761.39,1.0,CUS-1614226872,2018-08-07,Rhonda,F,-27.66,153.10,,88d6b153-fb28-4ef9-b5ed-2a5cb822c177,-26.4,153.07,QLD,Noosaville,debit,authorized,81fd769ce2694d02b73cb49027f78630,POS,30-40,2018,8,7,13,3,Tuesday,7 days,46516.121
ACC-1037050564,40,32.0,1729.39,,CUS-1614226872,2018-08-08,Rhonda,F,-27.66,153.10,,,,,,,debit,posted,06c49b547a31416689b4d43291c7cba8,PAYMENT,30-40,2018,8,8,10,0,Wednesday,7 days,46516.121
ACC-1037050564,40,44.43,1684.96,1.0,CUS-1614226872,2018-08-08,Rhonda,F,-27.66,153.10,,3ddd1aeb-7bc6-4db0-8f38-cdc6a09f1d2d,-27.98,153.41,QLD,Southport,debit,authorized,24c76b76ee57411b8e41fbd85ff70047,POS,30-40,2018,8,8,19,35,Wednesday,7 days,46516.121
ACC-1037050564,40,13.28,1671.68,1.0,CUS-1614226872,2018-08-09,Rhonda,F,-27.66,153.10,,464ff702-b989-4a5c-a815-6d3449cb6682,-27.72,153.21,QLD,Beenleigh,debit,authorized,adba89418d2e421387a58aa112ddd565,POS,30-40,2018,8,9,4,44,Thursday,7 days,46516.121
ACC-1037050564,40,9.06,1662.62,1.0,CUS-1614226872,2018-08-09,Rhonda,F,-27.66,153.10,,c5013ac7-720c-47a6-85db-12f7cc8ccc48,-27.54,153.11,QLD,Mansfield,debit,authorized,40e2aee92ce146a09c4f60f497bb720f,POS,30-40,2018,8,9,5,49,Thursday,7 days,46516.121
ACC-1037050564,40,25.62,1637.0,1.0,CUS-1614226872,2018-08-09,Rhonda,F,-27.66,153.10,,97538b72-9571-4cdc-b9cf-714b3abd297b,-27.46,153.04,QLD,Fortitude Valley,debit,authorized,6239094c2170443da05fd4137a75fcc5,POS,30-40,2018,8,9,8,5,Thursday,7 days,46516.121
ACC-1037050564,40,17.59,1619.41,1.0,CUS-1614226872,2018-08-09,Rhonda,F,-27.66,153.10,,33abec93-e352-440e-ae45-f52d37b4c291,-27.59,151.95,QLD,Kearneys Spring,debit,authorized,62c43ce96a024efd90b183d3fe9ba6c5,POS,30-40,2018,8,9,11,47,Thursday,7 days,46516.121
ACC-1037050564,40,7.69,1611.72,1.0,CUS-1614226872,2018-08-09,Rhonda,F,-27.66,153.10,,cd62798b-8895-4037-99f7-50c70d39abe0,-26.4,153.09,QLD,Noosa Heads,debit,authorized,1b23a88c69524eae833bddca41b126cb,SALES-POS,30-40,2018,8,9,11,56,Thursday,7 days,46516.121
ACC-1037050564,40,33.0,1578.72,,CUS-1614226872,2018-08-09,Rhonda,F,-27.66,153.10,,,,,,,debit,posted,5c94a6cf33b7476784c250ecdb5110fa,PAYMENT,30-40,2018,8,9,15,0,Thursday,7 days,46516.121
ACC-1037050564,40,9.27,1569.45,1.0,CUS-1614226872,2018-08-10,Rhonda,F,-27.66,153.10,,29daf27d-ec46-4183-8e3f-5735ba4ccf3b,-27.5,153.02,QLD,Saint Lucia,debit,authorized,d903c8b9ed444a778a7a47249940aab5,SALES-POS,30-40,2018,8,10,7,31,Friday,7 days,46516.121
ACC-1037050564,40,36.03,1533.42,1.0,CUS-1614226872,2018-08-10,Rhonda,F,-27.66,153.10,,de0e0029-583d-49d2-868a-57fe34229723,-27.55,153.04,QLD,Salisbury,debit,authorized,01818d6c534b40d295956a0c2eaf46af,SALES-POS,30-40,2018,8,10,8,36,Friday,7 days,46516.121
ACC-1037050564,40,42.11,1491.31,1.0,CUS-1614226872,2018-08-10,Rhonda,F,-27.66,153.10,,258f989d-1dc6-4455-ba67-56409320899e,-27.5,152.97,QLD,Indooroopilly,debit,authorized,313c932cc8654a9ab0ddac0685f53c3e,SALES-POS,30-40,2018,8,10,9,1,Friday,7 days,46516.121
ACC-1037050564,40,41.46,1449.85,0.0,CUS-1614226872,2018-08-10,Rhonda,F,-27.66,153.10,,e3e28ad9-50a4-4a33-b675-bb611d49b517,-27.7,114.17,WA,Kalbarri,debit,authorized,a6cd24aabf5d41958c1929cee65c95f1,SALES-POS,30-40,2018,8,10,9,29,Friday,7 days,46516.121
ACC-1037050564,40,38.02,1411.83,1.0,CUS-1614226872,2018-08-10,Rhonda,F,-27.66,153.10,,bb114176-22b5-4fc2-b6cb-3878142c3e20,-27.76,150.25,QLD,Moonie,debit,authorized,2b406f7c4577456d91687eb70bf63181,SALES-POS,30-40,2018,8,10,13,14,Friday,7 days,46516.121
ACC-1037050564,40,30.46,1381.37,1.0,CUS-1614226872,2018-08-11,Rhonda,F,-27.66,153.10,,7d0b5cc1-17ae-459e-a5b2-0c8e031dd242,-26.69,153.02,QLD,Forest Glen,debit,authorized,f00d70154c3a4262818158cd7b29c8af,POS,30-40,2018,8,11,12,10,Saturday,7 days,46516.121
ACC-1037050564,40,235.36,1146.01,1.0,CUS-1614226872,2018-08-11,Rhonda,F,-27.66,153.10,,cb979da4-882c-4a98-a0eb-8c219a7a86ed,-26.74,153.12,QLD,Birtinya,debit,authorized,70d85fe66fbb4baf85e726a4e6e4eecd,POS,30-40,2018,8,11,18,31,Saturday,7 days,46516.121
ACC-1037050564,40,12.62,1133.39,1.0,CUS-1614226872,2018-08-13,Rhonda,F,-27.66,153.10,,5536aa35-95c4-44d9-866b-fe3dbeec2446,-27.46,153.16,QLD,Wynnum West,debit,authorized,6c4904d9d6f84656a8e4504280be9b00,SALES-POS,30-40,2018,8,13,9,23,Monday,7 days,46516.121
ACC-1037050564,40,51.04,1974.44,1.0,CUS-1614226872,2018-08-14,Rhonda,F,-27.66,153.10,,58f50c7e-ab42-4a15-8b69-bd0c14c692ea,-27.59,153.28,QLD,Victoria Point,debit,authorized,9209437b7fdb43c386e0da24aaa01b97,POS,30-40,2018,8,14,13,11,Tuesday,7 days,46516.121
ACC-1037050564,40,13.8,1960.64,0.0,CUS-1614226872,2018-08-14,Rhonda,F,-27.66,153.10,,d1c66cfe-1569-4918-bbb2-ca9f76a14e08,-33.87,151.2,NSW,Sydney,debit,authorized,467d017c67c84ba2876470aa4c93c8f5,POS,30-40,2018,8,14,17,41,Tuesday,7 days,46516.121
ACC-1037050564,40,40.82,1919.82,1.0,CUS-1614226872,2018-08-15,Rhonda,F,-27.66,153.10,,5445f8d0-51b8-49e4-b142-c82cfece661d,-27.41,153.01,QLD,Stafford,debit,authorized,bab554d9fa8847439ccbeb1445294b05,POS,30-40,2018,8,15,4,23,Wednesday,7 days,46516.121
ACC-1037050564,40,32.0,1887.82,,CUS-1614226872,2018-08-15,Rhonda,F,-27.66,153.10,,,,,,,debit,posted,52735a4178d94ded94755ef40f4a9b33,PAYMENT,30-40,2018,8,15,10,0,Wednesday,7 days,46516.121
ACC-1037050564,40,29.24,1825.58,1.0,CUS-1614226872,2018-08-17,Rhonda,F,-27.66,153.10,,a41c062a-2513-4791-8271-631d12033398,-27.57,153.06,QLD,Sunnybank,debit,authorized,5a6f148364854efbab48ef5919ff2d3b,SALES-POS,30-40,2018,8,17,21,39,Friday,7 days,46516.121
ACC-1037050564,40,19.8,1805.78,1.0,CUS-1614226872,2018-08-18,Rhonda,F,-27.66,153.10,,73903428-2d9a-4549-868a-2049e3e6aea4,-37.81,144.97,VIC,Melbourne,debit,authorized,45ac946d24c342c2a2da39fccf83c3e4,SALES-POS,30-40,2018,8,18,19,47,Saturday,7 days,46516.121
ACC-1037050564,40,24.94,1780.84,1.0,CUS-1614226872,2018-08-18,Rhonda,F,-27.66,153.10,,656a515d-e5c7-4198-8dee-7ebd0491d435,-27.38,153.06,QLD,Northgate,debit,authorized,3c49fc1ef8bd4f699fe7c49b0ecf48c3,SALES-POS,30-40,2018,8,18,23,14,Saturday,7 days,46516.121
ACC-1037050564,40,22.49,1758.35,1.0,CUS-1614226872,2018-08-19,Rhonda,F,-27.66,153.10,,4bef22a5-6cb0-48bd-add4-d1377bb4b746,-26.86,152.96,QLD,Beerwah,debit,authorized,23da891a544a4b35ae83dbbff440736e,POS,30-40,2018,8,19,12,14,Sunday,7 days,46516.121
ACC-1037050564,40,13.39,1744.96,1.0,CUS-1614226872,2018-08-19,Rhonda,F,-27.66,153.10,,1434b7bb-7175-4d3f-8eb9-369399d1b560,-27.47,153.02,QLD,Spring Hill,debit,authorized,defaece1246e4c7ab19c04fc6ab4736a,SALES-POS,30-40,2018,8,19,23,54,Sunday,7 days,46516.121
ACC-1037050564,40,8.43,1736.53,0.0,CUS-1614226872,2018-08-20,Rhonda,F,-27.66,153.10,,43525b49-d268-4411-9aad-133da4344cf6,-26.69,153.12,QLD,Mooloolaba,debit,authorized,34afa8c25c214277be56b041a918e009,POS,30-40,2018,8,20,10,50,Monday,7 days,46516.121
ACC-1037050564,40,16.18,2612.44,1.0,CUS-1614226872,2018-08-20,Rhonda,F,-27.66,153.10,,35091d81-268d-4a65-ab8d-9f239ce6eb14,-27.53,152.95,QLD,Jindalee,debit,authorized,a8069eea1fc14f878ce2f051e68fbb4f,POS,30-40,2018,8,20,13,44,Monday,7 days,46516.121
ACC-1037050564,40,22.0,2590.44,0.0,CUS-1614226872,2018-08-20,Rhonda,F,-27.66,153.10,,a74a9d78-f255-4197-87de-869b18eb126d,-27.93,153.33,QLD,Helensvale,debit,authorized,8ab4c10b25ec44d4b9a1a607bc2878f4,POS,30-40,2018,8,20,14,34,Monday,7 days,46516.121
ACC-1037050564,40,12.39,2578.05,1.0,CUS-1614226872,2018-08-20,Rhonda,F,-27.66,153.10,,f7555e60-9962-4248-a713-120f5d18a5b6,-26.41,153.11,QLD,Sunshine Beach,debit,authorized,29534737850144fd9c374346aeb466d9,SALES-POS,30-40,2018,8,20,18,1,Monday,7 days,46516.121
ACC-1037050564,40,32.0,2546.05,,CUS-1614226872,2018-08-22,Rhonda,F,-27.66,153.10,,,,,,,debit,posted,25ab66f423f745f9859e646f19a436ac,PAYMENT,30-40,2018,8,22,10,0,Wednesday,7 days,46516.121
ACC-1037050564,40,33.0,2513.05,,CUS-1614226872,2018-08-23,Rhonda,F,-27.66,153.10,,,,,,,debit,posted,b2a0ab40f06849619e558a1a6c2b25b0,PAYMENT,30-40,2018,8,23,15,0,Thursday,7 days,46516.121
ACC-1037050564,40,5.89,2507.16,1.0,CUS-1614226872,2018-08-24,Rhonda,F,-27.66,153.10,,f22a316e-2132-447d-8f2b-4eea97c76954,-27.64,152.85,QLD,Redbank Plains,debit,authorized,b56d438bfaee4ca7b23e6990a1a4f0cb,POS,30-40,2018,8,24,20,50,Friday,7 days,46516.121
ACC-1037050564,40,76.17,2430.99,1.0,CUS-1614226872,2018-08-24,Rhonda,F,-27.66,153.10,,7e0fa6aa-b48a-4d55-afed-ff2034fda51c,-27.39,153.07,QLD,Northgate,debit,authorized,29f1accd2bf744099e81c18532da40ff,POS,30-40,2018,8,24,22,43,Friday,7 days,46516.121
ACC-1037050564,40,9.95,2421.04,0.0,CUS-1614226872,2018-08-24,Rhonda,F,-27.66,153.10,,ffe6b6d5-9816-4fb2-8838-3147a9606042,-27.44,153.07,QLD,Hamilton,debit,authorized,9f4d205ad6ef485d8078fe420f3018ff,POS,30-40,2018,8,24,23,12,Friday,7 days,46516.121
ACC-1037050564,40,19.23,2401.81,1.0,CUS-1614226872,2018-08-25,Rhonda,F,-27.66,153.10,,254e708d-db62-4590-894e-826163758478,-26.41,153.06,QLD,Noosaville,debit,authorized,d20882eb177440d38ded3b65de65dcb5,POS,30-40,2018,8,25,6,37,Saturday,7 days,46516.121
ACC-1037050564,40,3.88,2397.93,1.0,CUS-1614226872,2018-08-25,Rhonda,F,-27.66,153.10,,6c5b7811-101f-4b48-ba42-cabd2883a833,-30.27,153.13,NSW,Coffs Harbour,debit,authorized,278a03fd8f144d1794ab8a8cda6986fa,SALES-POS,30-40,2018,8,25,10,34,Saturday,7 days,46516.121
ACC-1037050564,40,48.97,2348.96,0.0,CUS-1614226872,2018-08-25,Rhonda,F,-27.66,153.10,,fa2bf76e-c908-4516-9763-a8539c144f95,-37.97,145.09,VIC,Moorabbin Airport,debit,authorized,b495423d9bdd4ca980c83d9fdab2b0d7,POS,30-40,2018,8,25,11,5,Saturday,7 days,46516.121
ACC-1037050564,40,23.29,2325.67,1.0,CUS-1614226872,2018-08-25,Rhonda,F,-27.66,153.10,,27194f06-6f73-4b86-bc8b-cef90c71e9b0,-27.52,153.2,QLD,Capalaba,debit,authorized,fe063402cafb477797e617640c57ae50,SALES-POS,30-40,2018,8,25,14,4,Saturday,7 days,46516.121
ACC-1037050564,40,6.88,2318.79,1.0,CUS-1614226872,2018-08-25,Rhonda,F,-27.66,153.10,,84874637-317c-4d84-8ac6-b9c83c125c12,-26.68,153.12,QLD,Mooloolaba,debit,authorized,aa1ab0b0dc8b4f51beb5e72d94303a73,POS,30-40,2018,8,25,22,14,Saturday,7 days,46516.121
ACC-1037050564,40,150.6,2168.19,1.0,CUS-1614226872,2018-08-27,Rhonda,F,-27.66,153.10,,f66b8549-7586-4571-b7ec-7ddc5f8bd9af,-27.47,153.02,QLD,South Brisbane,debit,authorized,ab4c596d8d58473b89f8e5c6bf3740c4,POS,30-40,2018,8,27,9,48,Monday,7 days,46516.121
ACC-1037050564,40,12.8,3047.48,1.0,CUS-1614226872,2018-08-27,Rhonda,F,-27.66,153.10,,32a4151d-1ae3-4037-a011-9711e3214134,-27.57,151.95,QLD,South Toowoomba,debit,authorized,0c1797177e184c7b90c5ded62385bf8d,POS,30-40,2018,8,27,20,56,Monday,7 days,46516.121
ACC-1037050564,40,24.7,3022.78,1.0,CUS-1614226872,2018-08-27,Rhonda,F,-27.66,153.10,,6a478059-ed0e-48ce-a825-e7474d269678,-27.47,153.03,QLD,Brisbane City,debit,authorized,0c118443193d4ade82ef5ba7efae75d1,POS,30-40,2018,8,27,21,10,Monday,7 days,46516.121
ACC-1037050564,40,11.38,3011.4,1.0,CUS-1614226872,2018-08-27,Rhonda,F,-27.66,153.10,,8468fd72-60c4-45aa-a49c-4129f51bf0c7,-27.5,153.02,QLD,Saint Lucia,debit,authorized,7e19acb81fd649afb9851d786aece010,SALES-POS,30-40,2018,8,27,23,24,Monday,7 days,46516.121
ACC-1037050564,40,15.59,2995.81,1.0,CUS-1614226872,2018-08-28,Rhonda,F,-27.66,153.10,,8390a7a1-b9cd-4d86-9b06-a5229b2abf30,-27.47,153.03,QLD,Brisbane City,debit,authorized,14da11296d394f61926dc84f8b30a2d5,SALES-POS,30-40,2018,8,28,1,34,Tuesday,7 days,46516.121
ACC-1037050564,40,10.21,2985.6,1.0,CUS-1614226872,2018-08-28,Rhonda,F,-27.66,153.10,,55b0b1fe-4776-4af2-9527-d89b201f16bf,-27.38,153.03,QLD,Chermside,debit,authorized,3fb8433183324d1d9e20cf9a5145c7fd,POS,30-40,2018,8,28,7,56,Tuesday,7 days,46516.121
ACC-1037050564,40,7.72,2977.88,1.0,CUS-1614226872,2018-08-28,Rhonda,F,-27.66,153.10,,1c507e4f-e0cb-424a-9ee4-ac3a102707cc,-27.48,152.99,QLD,Toowong,debit,authorized,1a82773b2854494e8160418b95d0f577,POS,30-40,2018,8,28,12,47,Tuesday,7 days,46516.121
ACC-1037050564,40,24.01,2953.87,1.0,CUS-1614226872,2018-08-28,Rhonda,F,-27.66,153.10,,e0304e19-67ed-4182-aeef-c0cee26d4d5c,-27.45,153.04,QLD,Newstead,debit,authorized,4eb9bde281e1405d9e6147d7d0bb256d,SALES-POS,30-40,2018,8,28,17,19,Tuesday,7 days,46516.121
ACC-1037050564,40,32.0,2921.87,,CUS-1614226872,2018-08-29,Rhonda,F,-27.66,153.10,,,,,,,debit,posted,ec522fdd6ba74377a0d7dff437843e0a,PAYMENT,30-40,2018,8,29,10,0,Wednesday,7 days,46516.121
ACC-1037050564,40,33.0,2888.87,,CUS-1614226872,2018-08-30,Rhonda,F,-27.66,153.10,,,,,,,debit,posted,d94d455b88fe4211b974b2b347105ac3,PAYMENT,30-40,2018,8,30,15,0,Thursday,7 days,46516.121
ACC-1037050564,40,36.87,3744.09,1.0,CUS-1614226872,2018-09-05,Rhonda,F,-27.66,153.10,,53e97379-86d7-4916-8592-0db9faeeef6e,-27.47,153.1,QLD,Cannon Hill,debit,authorized,6aedca5985754ceead2cb55c8f2ecfa6,POS,30-40,2018,9,5,9,51,Wednesday,7 days,46516.121
ACC-1037050564,40,32.0,3712.09,,CUS-1614226872,2018-09-05,Rhonda,F,-27.66,153.10,,,,,,,debit,posted,8344101958dc460d909865626a657e16,PAYMENT,30-40,2018,9,5,10,0,Wednesday,7 days,46516.121
ACC-1037050564,40,29.16,3682.93,1.0,CUS-1614226872,2018-09-05,Rhonda,F,-27.66,153.10,,0161c377-c49c-4899-917e-56c96fc17715,-27.54,153.08,QLD,Mount Gravatt,debit,authorized,0efbf114d0324400babbdf304e9f1b8e,POS,30-40,2018,9,5,12,11,Wednesday,7 days,46516.121
ACC-1037050564,40,64.43,3618.5,1.0,CUS-1614226872,2018-09-05,Rhonda,F,-27.66,153.10,,188cd2e8-a942-4d1d-9ce4-f4435fa3c674,-27.48,153,QLD,Auchenflower,debit,authorized,09be6205c3b946bdb7583472f12cb496,SALES-POS,30-40,2018,9,5,14,40,Wednesday,7 days,46516.121
ACC-1037050564,40,35.01,3583.49,1.0,CUS-1614226872,2018-09-05,Rhonda,F,-27.66,153.10,,0f7e5570-8655-4e82-9728-d813c909e79f,-27.35,153.01,QLD,Carseldine,debit,authorized,6cd148f8657c4ce6b81b765d932f5ea8,SALES-POS,30-40,2018,9,5,16,23,Wednesday,7 days,46516.121
ACC-1037050564,40,20.76,3562.73,1.0,CUS-1614226872,2018-09-06,Rhonda,F,-27.66,153.10,,803f3eb6-97e0-4d0f-961f-53168b5de7f5,-27.76,153.33,QLD,Woongoolba,debit,authorized,a2ea0b85c968486295e45ee05dce80fd,POS,30-40,2018,9,6,4,31,Thursday,7 days,46516.121
ACC-1037050564,40,10.5,3552.23,1.0,CUS-1614226872,2018-09-06,Rhonda,F,-27.66,153.10,,5a40d5a8-c40c-4c38-b402-790882c6f94a,-27.47,153.03,QLD,Brisbane City,debit,authorized,7fe2eed8288349ec8e936984a8298bf1,SALES-POS,30-40,2018,9,6,10,56,Thursday,7 days,46516.121
ACC-1037050564,40,13.36,3538.87,1.0,CUS-1614226872,2018-09-06,Rhonda,F,-27.66,153.10,,9e414e98-fee9-4b59-a364-a68023693ecf,-27.45,153.01,QLD,Kelvin Grove,debit,authorized,43cf9a36d5e34b1aa23c8a63a4f8f9ac,SALES-POS,30-40,2018,9,6,13,29,Thursday,7 days,46516.121
ACC-1037050564,40,21.73,3517.14,1.0,CUS-1614226872,2018-09-06,Rhonda,F,-27.66,153.10,,b0184cc3-5de1-4aef-a8bf-2be468d546a9,-30.3,153.12,NSW,Coffs Harbour,debit,authorized,56f45716d515447995625bdbce5041ac,SALES-POS,30-40,2018,9,6,14,3,Thursday,7 days,46516.121
ACC-1037050564,40,33.0,3484.14,,CUS-1614226872,2018-09-06,Rhonda,F,-27.66,153.10,,,,,,,debit,posted,b8d001ab50e64f8ea177da250df2fe6f,PAYMENT,30-40,2018,9,6,15,0,Thursday,7 days,46516.121
ACC-1037050564,40,10.25,3473.89,1.0,CUS-1614226872,2018-09-07,Rhonda,F,-27.66,153.10,,7615faac-e3cb-46ec-bcfe-69ba4b92ca6b,-26.69,152.96,QLD,Palmwoods,debit,authorized,b7dc3785c65344749eeee7c962ea46ee,POS,30-40,2018,9,7,4,57,Friday,7 days,46516.121
ACC-1037050564,40,8.04,3465.85,1.0,CUS-1614226872,2018-09-07,Rhonda,F,-27.66,153.10,,d4d24e28-a394-4232-a236-1c9189fd5482,-27.95,153.32,QLD,Pacific Pines,debit,authorized,db2cdaa00e2a42e8b373c63189f95f4f,SALES-POS,30-40,2018,9,7,8,22,Friday,7 days,46516.121
ACC-1037050564,40,8.49,3457.36,1.0,CUS-1614226872,2018-09-07,Rhonda,F,-27.66,153.10,,b0a6a7f9-b9c9-45b3-ac1b-eaf2e65a141c,-27.71,114.17,WA,Kalbarri,debit,authorized,2015201054b846c9895dbc4764d97a52,SALES-POS,30-40,2018,9,7,9,56,Friday,7 days,46516.121
ACC-1037050564,40,68.15,3389.21,1.0,CUS-1614226872,2018-09-07,Rhonda,F,-27.66,153.10,,3161a05c-2201-4b86-96a5-f794a4295472,-27.5,153.21,QLD,Birkdale,debit,authorized,904c0c740b4640cf81a66fc1904c8ec9,POS,30-40,2018,9,7,15,22,Friday,7 days,46516.121
ACC-1037050564,40,101.67,3287.54,0.0,CUS-1614226872,2018-09-07,Rhonda,F,-27.66,153.10,,9148f42a-c5b8-487d-8f5a-a38264d30552,-37.82,144.97,VIC,Melbourne,debit,authorized,33e8fc30ab5e4a15aa6fb80248bee867,SALES-POS,30-40,2018,9,7,16,8,Friday,7 days,46516.121
ACC-1037050564,40,37.46,3250.08,1.0,CUS-1614226872,2018-09-07,Rhonda,F,-27.66,153.10,,a8960f5e-08b3-4ce8-bf6a-535ceaecc77a,-38.01,145.2,VIC,Dandenong South,debit,authorized,dc3b0091899e4ec7b86aef03e8cc0ee5,SALES-POS,30-40,2018,9,7,17,8,Friday,7 days,46516.121
ACC-1037050564,40,17.07,3233.01,1.0,CUS-1614226872,2018-09-07,Rhonda,F,-27.66,153.10,,067f7496-40ee-4a33-a9ed-2fc4895363bc,-27.48,153.01,QLD,West End,debit,authorized,f4d5a5e87aae4cc8b52c747dff73d35d,POS,30-40,2018,9,7,18,4,Friday,7 days,46516.121
ACC-1037050564,40,6.55,3226.46,0.0,CUS-1614226872,2018-09-07,Rhonda,F,-27.66,153.10,,abceb6ed-6007-4ce8-b391-763bf0afe0cd,-27.48,153.02,QLD,South Brisbane,debit,authorized,9ba06a4a9ddd444589faa0165238f427,SALES-POS,30-40,2018,9,7,19,23,Friday,7 days,46516.121
ACC-1037050564,40,43.61,3182.85,1.0,CUS-1614226872,2018-09-07,Rhonda,F,-27.66,153.10,,df68d1b0-f167-4a7e-9cf1-072d466b3ab9,-27.4,152.93,QLD,Ferny Grove,debit,authorized,3663b0dd7c86446386866dcd3cf04649,SALES-POS,30-40,2018,9,7,22,33,Friday,7 days,46516.121
ACC-1037050564,40,43.83,3139.02,1.0,CUS-1614226872,2018-09-08,Rhonda,F,-27.66,153.10,,d21390fc-6411-4b33-9a2d-fad1e293ceee,-27.47,153.02,QLD,Brisbane City,debit,authorized,e0f079b832b1406dac5bb0ee03456357,POS,30-40,2018,9,8,9,43,Saturday,7 days,46516.121
ACC-1037050564,40,25.02,3114.0,1.0,CUS-1614226872,2018-09-08,Rhonda,F,-27.66,153.10,,e7cebec6-f27d-443c-81eb-0ce04ffd9659,-27.74,152.98,QLD,Greenbank,debit,authorized,99dcf58331994459a0f1ed24cb9d5ae8,POS,30-40,2018,9,8,14,25,Saturday,7 days,46516.121
ACC-1037050564,40,9.91,3104.09,1.0,CUS-1614226872,2018-09-08,Rhonda,F,-27.66,153.10,,d130e4ff-26ff-452c-9b15-e3bf30de9dec,-27.56,151.95,QLD,Toowoomba City,debit,authorized,55c04d6028e04ed08fbb9c269092ffbc,POS,30-40,2018,9,8,17,19,Saturday,7 days,46516.121
ACC-1037050564,40,23.91,3080.18,1.0,CUS-1614226872,2018-09-08,Rhonda,F,-27.66,153.10,,0ea7a1c2-55cc-4c4a-8c93-9d630266d869,-27.41,152.99,QLD,Everton Park,debit,authorized,571a7debd8264c7eba435ad68205ff87,POS,30-40,2018,9,8,17,42,Saturday,7 days,46516.121
ACC-1037050564,40,39.09,3041.09,0.0,CUS-1614226872,2018-09-08,Rhonda,F,-27.66,153.10,,d00e87ea-70f7-41ec-8328-eb2189f46f6c,-27.93,153.34,QLD,Helensvale,debit,authorized,117ccbbb5d334309b5ad76c7a655a705,SALES-POS,30-40,2018,9,8,19,51,Saturday,7 days,46516.121
ACC-1037050564,40,24.09,3017.0,1.0,CUS-1614226872,2018-09-09,Rhonda,F,-27.66,153.10,,052df87d-b3ab-4f75-b441-1b574e5e0880,-31.43,152.91,NSW,Port Macquarie,debit,authorized,2a9f2e57b840422891d96e52dfb56ae7,SALES-POS,30-40,2018,9,9,8,49,Sunday,7 days,46516.121
ACC-1037050564,40,50.16,2966.84,0.0,CUS-1614226872,2018-09-09,Rhonda,F,-27.66,153.10,,86c9064d-0486-4ca1-93d2-66d62243c1d0,-33.85,151.07,NSW,Sydney Olympic Park,debit,authorized,34d1bf0d986d45ea9c2058c1abd23fb5,SALES-POS,30-40,2018,9,9,9,19,Sunday,7 days,46516.121
ACC-1037050564,40,134.75,2832.09,1.0,CUS-1614226872,2018-09-09,Rhonda,F,-27.66,153.10,,1af9a7c3-8566-4e85-ac9e-2efd97bbae7e,-27.57,153.06,QLD,Sunnybank,debit,authorized,12fc30647aa6429f93b9ad9bf032a16e,SALES-POS,30-40,2018,9,9,9,24,Sunday,7 days,46516.121
ACC-1037050564,40,24.57,3699.61,1.0,CUS-1614226872,2018-09-11,Rhonda,F,-27.66,153.10,,be96bab8-7a1a-4783-adfb-901325016671,-27.95,153.41,QLD,Labrador,debit,authorized,5853ccb43719437698a26e48bd3e83b1,SALES-POS,30-40,2018,9,11,15,45,Tuesday,7 days,46516.121
ACC-1037050564,40,8.98,3690.63,1.0,CUS-1614226872,2018-09-11,Rhonda,F,-27.66,153.10,,d130e4ff-26ff-452c-9b15-e3bf30de9dec,-27.56,151.95,QLD,Toowoomba City,debit,authorized,c5d0fb607d754654ab912cbe1458d3f3,SALES-POS,30-40,2018,9,11,19,13,Tuesday,7 days,46516.121
ACC-1037050564,40,8.07,3682.56,1.0,CUS-1614226872,2018-09-11,Rhonda,F,-27.66,153.10,,26f2a4dc-e384-42fc-a159-f0e0d566f763,-27.7,153.06,QLD,Park Ridge,debit,authorized,17d4c86a18164fd2938402259c08e5a4,SALES-POS,30-40,2018,9,11,20,43,Tuesday,7 days,46516.121
ACC-1037050564,40,32.0,3650.56,,CUS-1614226872,2018-09-12,Rhonda,F,-27.66,153.10,,,,,,,debit,posted,3f6909566a9f4b7da2bac4b216f1e634,PAYMENT,30-40,2018,9,12,10,0,Wednesday,7 days,46516.121
ACC-1037050564,40,33.0,3552.3,,CUS-1614226872,2018-09-13,Rhonda,F,-27.66,153.10,,,,,,,debit,posted,2fc85e1a4e8c4191bcf9dc67ab9fe818,PAYMENT,30-40,2018,9,13,15,0,Thursday,7 days,46516.121
ACC-1037050564,40,65.26,3585.3,1.0,CUS-1614226872,2018-09-13,Rhonda,F,-27.66,153.10,,729321c9-17ac-4434-a6f3-7803f9a60904,-27.24,153.02,QLD,Mango Hill,debit,authorized,b6dcff2e53b1494e9ccd443cf296b292,POS,30-40,2018,9,13,15,53,Thursday,7 days,46516.121
ACC-1037050564,40,39.65,3512.65,1.0,CUS-1614226872,2018-09-13,Rhonda,F,-27.66,153.10,,f3c386d7-c74f-4eb5-ad11-71607fcdbb71,-33.87,151.21,NSW,Sydney,debit,authorized,db032b0e9d5a4e6b8bf482bba93f7c07,SALES-POS,30-40,2018,9,13,16,18,Thursday,7 days,46516.121
ACC-1037050564,40,10.76,3501.89,1.0,CUS-1614226872,2018-09-14,Rhonda,F,-27.66,153.10,,2c0feb7d-f8e5-4d26-a09e-eb1c4c179ae6,-27.56,152.89,QLD,Bellbowrie,debit,authorized,25ccd04883f54b859a2df07d3e60bd29,SALES-POS,30-40,2018,9,14,12,54,Friday,7 days,46516.121
ACC-1037050564,40,28.02,3473.87,0.0,CUS-1614226872,2018-09-15,Rhonda,F,-27.66,153.10,,aeb596f9-827d-4fb3-8082-dbe9df68cd16,-27.62,152.79,QLD,Booval,debit,authorized,8de6463f43c44994873aa89be23ea614,POS,30-40,2018,9,15,7,37,Saturday,7 days,46516.121
ACC-1037050564,40,34.83,3439.04,1.0,CUS-1614226872,2018-09-15,Rhonda,F,-27.66,153.10,,47cecb93-d416-4a4c-b557-b61f4e9b0976,-27.5,152.98,QLD,Indooroopilly,debit,authorized,714c9bf001224d1fa0578bf3935e9034,SALES-POS,30-40,2018,9,15,11,25,Saturday,7 days,46516.121
ACC-1037050564,40,15.41,3423.63,0.0,CUS-1614226872,2018-09-15,Rhonda,F,-27.66,153.10,,f0708d5e-588e-4a1f-96c8-af712a6c8f90,-27.97,153.41,QLD,Southport,debit,authorized,4230482ea2e14c5cbfa1d64ed0ad9048,SALES-POS,30-40,2018,9,15,12,15,Saturday,7 days,46516.121
ACC-1037050564,40,32.97,3390.66,1.0,CUS-1614226872,2018-09-16,Rhonda,F,-27.66,153.10,,86dde4fe-7852-4ea4-856e-46959a0d3796,-27.57,151.97,QLD,Toowoomba,debit,authorized,082821be47f94163b8f6b67f1d932484,POS,30-40,2018,9,16,9,30,Sunday,7 days,46516.121
ACC-1037050564,40,17.32,3373.34,1.0,CUS-1614226872,2018-09-16,Rhonda,F,-27.66,153.10,,d0e11775-c321-4caa-958b-8aa2d34d3b2c,-27.47,153.02,QLD,Brisbane City,debit,authorized,baa6225d8fdc4040a5ce17f2301d9802,SALES-POS,30-40,2018,9,16,11,35,Sunday,7 days,46516.121
ACC-1037050564,40,3.71,3369.63,1.0,CUS-1614226872,2018-09-16,Rhonda,F,-27.66,153.10,,606e59e2-285f-4955-83b1-de242970d5b5,-33.9,151.21,NSW,Waterloo,debit,authorized,25a5eafc80714d2c87bc8233ea64b311,POS,30-40,2018,9,16,15,1,Sunday,7 days,46516.121
ACC-1037050564,40,37.05,3332.58,1.0,CUS-1614226872,2018-09-16,Rhonda,F,-27.66,153.10,,bde416e5-779c-484a-9e04-415eb4c4087d,-26.8,153.12,QLD,Caloundra,debit,authorized,d843e63aa4794981bf93c4ea7422e43e,POS,30-40,2018,9,16,23,50,Sunday,7 days,46516.121
ACC-1037050564,40,41.97,3290.61,1.0,CUS-1614226872,2018-09-17,Rhonda,F,-27.66,153.10,,184b7275-e1cb-491c-a803-136657bd1012,-27.57,153.04,QLD,Coopers Plains,debit,authorized,4c5248e5ddb94f839617bca096b3536e,POS,30-40,2018,9,17,9,24,Monday,7 days,46516.121
ACC-1037050564,40,12.19,3278.42,1.0,CUS-1614226872,2018-09-17,Rhonda,F,-27.66,153.10,,3cdd3c05-8cb7-401b-97f1-363ee8334085,-27.55,152.97,QLD,Oxley,debit,authorized,1b9afce7a95746f5a23cfc93ad7a913d,POS,30-40,2018,9,17,10,1,Monday,7 days,46516.121
ACC-1037050564,40,10.12,3268.3,1.0,CUS-1614226872,2018-09-17,Rhonda,F,-27.66,153.10,,aca9e3fd-db81-42e3-a936-e6bfb4ffcb9e,-27.48,153.01,QLD,West End,debit,authorized,26c9c9c11fe2446e8c9c26e1d5758300,SALES-POS,30-40,2018,9,17,10,30,Monday,7 days,46516.121
ACC-1037050564,40,13.74,3254.56,1.0,CUS-1614226872,2018-09-17,Rhonda,F,-27.66,153.10,,e7a40758-f7b3-47ad-85b9-2528546aef23,-27.47,153.02,QLD,Brisbane City,debit,authorized,ab31f03526414f799ef71cebcd6f53e5,SALES-POS,30-40,2018,9,17,11,21,Monday,7 days,46516.121
ACC-1037050564,40,32.0,4114.65,,CUS-1614226872,2018-09-19,Rhonda,F,-27.66,153.10,,,,,,,debit,posted,0c7497c943844ce8aad30ad8338a939f,PAYMENT,30-40,2018,9,19,10,0,Wednesday,7 days,46516.121
ACC-1037050564,40,33.0,4081.65,,CUS-1614226872,2018-09-20,Rhonda,F,-27.66,153.10,,,,,,,debit,posted,bc442a3f4101451b8f420f37fc06853c,PAYMENT,30-40,2018,9,20,15,0,Thursday,7 days,46516.121
ACC-1037050564,40,9.76,4071.89,1.0,CUS-1614226872,2018-09-21,Rhonda,F,-27.66,153.10,,0d664706-a593-4876-9db5-2f453864913c,-27.57,153.06,QLD,Sunnybank,debit,authorized,c323db48e397454490fe38c46e18ed4f,SALES-POS,30-40,2018,9,21,7,29,Friday,7 days,46516.121
ACC-1037050564,40,59.29,4012.6,1.0,CUS-1614226872,2018-09-21,Rhonda,F,-27.66,153.10,,13578b5a-239e-4ff9-b704-3b4b30a83845,-27.48,152.99,QLD,Toowong,debit,authorized,885340579db7471ca84860d4f946efe1,SALES-POS,30-40,2018,9,21,9,9,Friday,7 days,46516.121
ACC-1037050564,40,26.22,3986.38,1.0,CUS-1614226872,2018-09-21,Rhonda,F,-27.66,153.10,,68eb023d-f10b-404c-9e15-2bb50fc44ad6,-27.5,153.07,QLD,Camp Hill,debit,authorized,b7ff0c5228754be6a25b4138fc8f8a5c,POS,30-40,2018,9,21,9,38,Friday,7 days,46516.121
ACC-1037050564,40,45.47,3940.91,1.0,CUS-1614226872,2018-09-21,Rhonda,F,-27.66,153.10,,ae191b3d-c7cd-4795-9ffa-3da841a76e35,-27.4,152.96,QLD,Arana Hills,debit,authorized,38f4aba470d641058bb08708c141cf10,POS,30-40,2018,9,21,10,3,Friday,7 days,46516.121
ACC-1037050564,40,38.7,3902.21,1.0,CUS-1614226872,2018-09-21,Rhonda,F,-27.66,153.10,,40d4861e-3cc9-428e-bf8f-e830aa593564,-27.47,153.02,QLD,Brisbane City,debit,authorized,a82bdd358250430d8d7949cf47723270,POS,30-40,2018,9,21,11,28,Friday,7 days,46516.121
ACC-1037050564,40,22.34,3879.87,1.0,CUS-1614226872,2018-09-21,Rhonda,F,-27.66,153.10,,00eed26c-aaf7-4b07-bd30-cd03f741c90d,-27.53,153.07,QLD,Mount Gravatt East,debit,authorized,189c72399b134a8791ce590465fb0f23,POS,30-40,2018,9,21,12,12,Friday,7 days,46516.121
ACC-1037050564,40,8.81,3871.06,0.0,CUS-1614226872,2018-09-21,Rhonda,F,-27.66,153.10,,a4d581b4-de41-47ae-9f1a-810a14dd318d,-27.49,152.97,QLD,Taringa,debit,authorized,308c535842a94ebda39c8ee5e540af76,SALES-POS,30-40,2018,9,21,12,45,Friday,7 days,46516.121
ACC-1037050564,40,60.45,3810.61,1.0,CUS-1614226872,2018-09-22,Rhonda,F,-27.66,153.10,,eabdc5f5-9090-455d-b65d-5d5e08800e98,-27.42,153.04,QLD,Wooloowin,debit,authorized,9609dd3d4e214abdae9773fb1c51b40d,SALES-POS,30-40,2018,9,22,4,21,Saturday,7 days,46516.121
ACC-1037050564,40,6.74,3803.87,1.0,CUS-1614226872,2018-09-22,Rhonda,F,-27.66,153.10,,be166397-db38-4c47-a672-ec0705ee4a6f,-27.47,153.02,QLD,Brisbane City,debit,authorized,ab2708ce847c48c18f62b3839d4f84d8,POS,30-40,2018,9,22,14,9,Saturday,7 days,46516.121
ACC-1037050564,40,42.37,3761.5,1.0,CUS-1614226872,2018-09-22,Rhonda,F,-27.66,153.10,,e3e28ad9-50a4-4a33-b675-bb611d49b517,-27.7,114.17,WA,Kalbarri,debit,authorized,8d79b5c071c54f00ad2f170c8ae5b8a5,SALES-POS,30-40,2018,9,22,19,35,Saturday,7 days,46516.121
ACC-1037050564,40,22.32,3739.18,1.0,CUS-1614226872,2018-09-22,Rhonda,F,-27.66,153.10,,abce0012-f66c-4c13-bd0f-2b572f34aed6,-27.47,153.03,QLD,Brisbane City,debit,authorized,93aec780c4404b6cb0ec0e6ca1ad481e,POS,30-40,2018,9,22,22,2,Saturday,7 days,46516.121
ACC-1037050564,40,20.02,3719.16,0.0,CUS-1614226872,2018-09-22,Rhonda,F,-27.66,153.10,,1aa74c24-a6ce-43a7-bb7f-db8ea3eab735,-27.5,152.97,QLD,Indooroopilly,debit,authorized,5717bc65626f4aa995d9b3f45fc26f19,POS,30-40,2018,9,22,23,50,Saturday,7 days,46516.121
ACC-1037050564,40,21.59,3697.57,1.0,CUS-1614226872,2018-09-23,Rhonda,F,-27.66,153.10,,d1914cd8-5226-4cb0-9adc-8c5eb35d07ce,-28.01,153.33,QLD,Highland Park,debit,authorized,e6d64a519331416192a6aa301dce4605,SALES-POS,30-40,2018,9,23,14,38,Sunday,7 days,46516.121
ACC-1037050564,40,34.26,3663.31,1.0,CUS-1614226872,2018-09-23,Rhonda,F,-27.66,153.10,,183dc18e-9e70-4603-bc77-7bc7f86478e2,-27.56,153.04,QLD,Salisbury,debit,authorized,239600a81db34145915a2f12d306793e,POS,30-40,2018,9,23,15,43,Sunday,7 days,46516.121
ACC-1037050564,40,83.68,3579.63,1.0,CUS-1614226872,2018-09-24,Rhonda,F,-27.66,153.10,,fc049c40-473f-4a92-8685-4d1c2999595b,-37.95,145.14,VIC,Springvale,debit,authorized,3691b70df7a146999995204c38b24fa5,SALES-POS,30-40,2018,9,24,9,13,Monday,7 days,46516.121
ACC-1037050564,40,6.16,3573.47,1.0,CUS-1614226872,2018-09-24,Rhonda,F,-27.66,153.10,,515d9f41-c812-48b0-8c00-9ee087aaa52e,-27.5,153.1,QLD,Carindale,debit,authorized,42c71be8fb034f3a83ab5ed75ace6f5a,SALES-POS,30-40,2018,9,24,11,51,Monday,7 days,46516.121
ACC-1037050564,40,17.42,4448.14,1.0,CUS-1614226872,2018-09-25,Rhonda,F,-27.66,153.10,,4d587304-5351-4474-97e4-443b727eeef5,-27.48,153.14,QLD,Tingalpa,debit,authorized,e9c2d702b31942c1a79faf77bb6ad640,SALES-POS,30-40,2018,9,25,1,44,Tuesday,7 days,46516.121
ACC-1037050564,40,6.25,4441.89,1.0,CUS-1614226872,2018-09-25,Rhonda,F,-27.66,153.10,,8c17f994-bf4e-4045-ad13-7cbf4173eea4,-28.77,114.61,WA,Geraldton,debit,authorized,de1fc7c86d754af9a2e7a965e8611c65,POS,30-40,2018,9,25,12,43,Tuesday,7 days,46516.121
ACC-1037050564,40,6.32,4435.57,1.0,CUS-1614226872,2018-09-25,Rhonda,F,-27.66,153.10,,cf6323ff-8be6-4d82-82b7-accfb93b3de7,-28,153.41,QLD,Bundall,debit,authorized,015cdd52dada4158bb078b93e6d5bf5f,SALES-POS,30-40,2018,9,25,14,8,Tuesday,7 days,46516.121
ACC-1037050564,40,172.57,4263.0,0.0,CUS-1614226872,2018-09-25,Rhonda,F,-27.66,153.10,,5375b001-92ed-4d0d-880d-e1703ca3bb05,-27.54,153.01,QLD,Rocklea,debit,authorized,c3e682a56ea44ef68b5bcbcec00a1858,SALES-POS,30-40,2018,9,25,15,22,Tuesday,7 days,46516.121
ACC-1037050564,40,9.66,4253.34,1.0,CUS-1614226872,2018-09-25,Rhonda,F,-27.66,153.10,,3b20294d-c94d-4e35-8745-136d7e4fb58e,-27.47,153.03,QLD,Brisbane City,debit,authorized,52aa41aed5824fe48bdb9e159475a029,POS,30-40,2018,9,25,15,59,Tuesday,7 days,46516.121
ACC-1037050564,40,17.24,4236.1,0.0,CUS-1614226872,2018-09-25,Rhonda,F,-27.66,153.10,,b27689af-4d1e-49b2-b3af-4139ac5d2b6c,-27.94,153.37,VIC,Arundel,debit,authorized,f844e9adf7354d90bf8611164a9b23a4,POS,30-40,2018,9,25,17,6,Tuesday,7 days,46516.121
ACC-1037050564,40,32.0,4204.1,,CUS-1614226872,2018-09-26,Rhonda,F,-27.66,153.10,,,,,,,debit,posted,2b9ef35e8a464a3fbff82e78f89fa942,PAYMENT,30-40,2018,9,26,10,0,Wednesday,7 days,46516.121
ACC-1037050564,40,7.72,4196.38,1.0,CUS-1614226872,2018-09-26,Rhonda,F,-27.66,153.10,,0cca9ccf-b6ba-41be-95b3-bf2c62cea1a8,-27.39,153.03,QLD,Chermside,debit,authorized,56cdcae8ce3a487bb5669465a4aab7bf,SALES-POS,30-40,2018,9,26,11,24,Wednesday,7 days,46516.121
ACC-1037050564,40,31.21,4165.17,1.0,CUS-1614226872,2018-09-26,Rhonda,F,-27.66,153.10,,a6dd3760-f55e-41bf-8d1f-278a1928a505,-28.12,153.45,QLD,Elanora,debit,authorized,513741ee0c424faa9b1fe15868407b62,POS,30-40,2018,9,26,11,44,Wednesday,7 days,46516.121
ACC-1037050564,40,22.79,4142.38,1.0,CUS-1614226872,2018-09-26,Rhonda,F,-27.66,153.10,,60726703-866e-4679-aa9f-91275fd03a58,-27.59,153.11,QLD,Underwood,debit,authorized,cdf2010da2c44fd9836a2f34150e6088,POS,30-40,2018,9,26,12,30,Wednesday,7 days,46516.121
ACC-1037050564,40,59.41,4082.97,1.0,CUS-1614226872,2018-09-27,Rhonda,F,-27.66,153.10,,9ffd3b45-7307-455d-a4a2-b9a3052f4b4e,-33.81,151.19,NSW,Artarmon,debit,authorized,bfdf29cb152242f6a13dc9d942457cbd,SALES-POS,30-40,2018,9,27,7,50,Thursday,7 days,46516.121
ACC-1037050564,40,33.0,4049.97,,CUS-1614226872,2018-09-27,Rhonda,F,-27.66,153.10,,,,,,,debit,posted,2f7336b81b074a82825964fbc00918de,PAYMENT,30-40,2018,9,27,15,0,Thursday,7 days,46516.121
ACC-1037050564,40,6.71,4043.26,1.0,CUS-1614226872,2018-09-28,Rhonda,F,-27.66,153.10,,41fb71c5-8af3-4330-be97-11c7334b694f,-26.8,153.15,QLD,Shelly Beach,debit,authorized,55ffa5a619e144cda18c091911b25deb,SALES-POS,30-40,2018,9,28,7,5,Friday,7 days,46516.121
ACC-1037050564,40,43.61,3999.65,0.0,CUS-1614226872,2018-09-29,Rhonda,F,-27.66,153.10,,68884f04-d661-4dfd-8eb2-4c9c27573bbb,-27.91,153.39,QLD,Runaway Bay,debit,authorized,b8a75407d2064984869eb1c94db7cf96,SALES-POS,30-40,2018,9,29,9,38,Saturday,7 days,46516.121
ACC-1037050564,40,11.05,3988.6,1.0,CUS-1614226872,2018-09-29,Rhonda,F,-27.66,153.10,,87a862c6-bf26-443a-9424-5f62562f96fe,-27.48,153.03,QLD,Brisbane City,debit,authorized,a0384c2626ec4162a83bc749fa99b66b,SALES-POS,30-40,2018,9,29,9,46,Saturday,7 days,46516.121
ACC-1037050564,40,16.99,3971.61,0.0,CUS-1614226872,2018-09-29,Rhonda,F,-27.66,153.10,,e27a3a9f-223b-4c98-ac9c-4e9add0926e8,-27.45,153.04,QLD,Fortitude Valley,debit,authorized,c6794f7745ff4ca1b0ff5fe86990f0bb,POS,30-40,2018,9,29,11,42,Saturday,7 days,46516.121
ACC-1037050564,40,48.89,3922.72,1.0,CUS-1614226872,2018-09-29,Rhonda,F,-27.66,153.10,,a5a25696-a39a-4e8b-b0c5-d30145fb6e68,-27.53,152.94,QLD,Jindalee,debit,authorized,3db2ba604e53440880a15a9988a10829,SALES-POS,30-40,2018,9,29,14,42,Saturday,7 days,46516.121
ACC-1037050564,40,48.16,3874.56,1.0,CUS-1614226872,2018-09-29,Rhonda,F,-27.66,153.10,,a25b2589-1591-4def-87bb-e392e30ae00a,-27.48,153.01,QLD,South Brisbane,debit,authorized,c5c27a7156ca40ed990c96ade871f209,SALES-POS,30-40,2018,9,29,19,16,Saturday,7 days,46516.121
ACC-1037050564,40,15.86,3858.7,0.0,CUS-1614226872,2018-09-29,Rhonda,F,-27.66,153.10,,a0de7aeb-c2f4-4e83-8b85-b9518425e7a8,-27.5,153.01,QLD,Saint Lucia,debit,authorized,ad6d069614b245faa811ae5b19340618,POS,30-40,2018,9,29,22,38,Saturday,7 days,46516.121
ACC-1037050564,40,14.41,3844.29,1.0,CUS-1614226872,2018-09-30,Rhonda,F,-27.66,153.10,,905df638-9513-4d5d-b5c2-65da440c19d0,-27.47,153.03,QLD,Brisbane City,debit,authorized,65e53aaefff64e7081bb461fb2b7722b,POS,30-40,2018,9,30,9,33,Sunday,7 days,46516.121
ACC-1037050564,40,36.11,3808.18,1.0,CUS-1614226872,2018-09-30,Rhonda,F,-27.66,153.10,,3edc8d7c-1632-4ba5-af30-ed59f811b569,-28.05,153.44,QLD,Mermaid Beach,debit,authorized,2963ca80f3a64c65b2c9404e67eaa853,SALES-POS,30-40,2018,9,30,13,8,Sunday,7 days,46516.121
ACC-1037050564,40,45.39,3762.79,1.0,CUS-1614226872,2018-09-30,Rhonda,F,-27.66,153.10,,1e7a6b56-59d3-47f2-b977-b3ff7774e3af,-27.55,152.98,QLD,Oxley,debit,authorized,5072ba9946884617848b95dc908027e6,SALES-POS,30-40,2018,9,30,14,5,Sunday,7 days,46516.121
ACC-1037050564,40,39.38,3723.41,1.0,CUS-1614226872,2018-09-30,Rhonda,F,-27.66,153.10,,6cac364e-7ee2-42f7-819a-18c6afaf0465,-27.59,153.28,QLD,Victoria Point,debit,authorized,bd4b3c9bfe74450da03a8f68c20027da,SALES-POS,30-40,2018,9,30,17,37,Sunday,7 days,46516.121
ACC-1037050564,40,18.29,3705.12,1.0,CUS-1614226872,2018-09-30,Rhonda,F,-27.66,153.10,,4c04d1fa-e17c-47ee-8a1e-418fdab1d7a3,-27.47,151.95,QLD,Highfields,debit,authorized,6796d39b0d0c42de96038f5c7ecf042b,SALES-POS,30-40,2018,9,30,17,55,Sunday,7 days,46516.121
ACC-1037050564,40,9.61,3695.51,0.0,CUS-1614226872,2018-09-30,Rhonda,F,-27.66,153.10,,a1c4c7aa-b7da-4064-8ed1-d4a236d772c6,-28.15,153.49,QLD,Tugun,debit,authorized,52acf7717e5d4ce5bd597ad7a01cb0e6,SALES-POS,30-40,2018,9,30,20,46,Sunday,7 days,46516.121
ACC-1037050564,40,22.12,3673.39,0.0,CUS-1614226872,2018-09-30,Rhonda,F,-27.66,153.10,,376fcedb-9e3e-4487-9777-00916db8412e,-27.64,153.12,QLD,Woodridge,debit,authorized,58a906bdbd694082a8adf79e48ae86a2,POS,30-40,2018,9,30,22,26,Sunday,7 days,46516.121
ACC-1037050564,40,10.17,3663.22,1.0,CUS-1614226872,2018-09-30,Rhonda,F,-27.66,153.10,,5a40d5a8-c40c-4c38-b402-790882c6f94a,-27.47,153.03,QLD,Brisbane City,debit,authorized,149d2b7cdedd467e99c35de5d2436b76,POS,30-40,2018,9,30,22,42,Sunday,7 days,46516.121
ACC-1037050564,40,21.62,3641.6,1.0,CUS-1614226872,2018-09-30,Rhonda,F,-27.66,153.10,,3505551c-2dfe-41a4-9c7b-d36bd70ea869,-37.9,145.09,VIC,Oakleigh,debit,authorized,c652d138d1d541d996b5c1c90bb41eb1,POS,30-40,2018,9,30,22,57,Sunday,7 days,46516.121
ACC-1037050564,40,20.12,3621.48,1.0,CUS-1614226872,2018-09-30,Rhonda,F,-27.66,153.10,,2bcf4f78-081b-4758-8c38-23c162ee36cd,-27.52,153.22,QLD,Alexandra Hills,debit,authorized,0c6e305d06c142f5b0d808ad5718c779,SALES-POS,30-40,2018,9,30,23,28,Sunday,7 days,46516.121
ACC-1037050564,40,18.93,3602.55,1.0,CUS-1614226872,2018-10-01,Rhonda,F,-27.66,153.10,,9f0ac63e-1791-4faf-a3a3-5fd1e12e82fb,-27.61,152.76,QLD,Ipswich,debit,authorized,7ac8202e24944466b99bc45e15fc998a,SALES-POS,30-40,2018,10,1,10,27,Monday,7 days,46516.121
ACC-1037050564,40,3.92,4490.72,0.0,CUS-1614226872,2018-10-02,Rhonda,F,-27.66,153.10,,ae7e3704-9613-419f-bc9d-68818dff2ef9,-27.47,153.02,QLD,South Brisbane,debit,authorized,00c3050482204244b73142fa53085e47,SALES-POS,30-40,2018,10,2,10,35,Tuesday,7 days,46516.121
ACC-1037050564,40,8.05,4482.67,1.0,CUS-1614226872,2018-10-02,Rhonda,F,-27.66,153.10,,28bd0038-37e2-49da-b419-d0ddf71835ca,-27.48,153.02,QLD,South Brisbane,debit,authorized,c615c72164b143fe9f11a37816ea0387,SALES-POS,30-40,2018,10,2,11,3,Tuesday,7 days,46516.121
ACC-1037050564,40,32.0,4450.67,,CUS-1614226872,2018-10-03,Rhonda,F,-27.66,153.10,,,,,,,debit,posted,ee17303be28643bfa0ff93b31c171ba3,PAYMENT,30-40,2018,10,3,10,0,Wednesday,7 days,46516.121
ACC-1037050564,40,8.15,4442.52,1.0,CUS-1614226872,2018-10-04,Rhonda,F,-27.66,153.10,,29e5a339-5070-4138-9da3-b9c57e903756,-27.39,153.12,QLD,Brisbane Airport,debit,authorized,9bef2160f9f74121b0a95c019e49813b,POS,30-40,2018,10,4,9,54,Thursday,7 days,46516.121
ACC-1037050564,40,21.96,4420.56,1.0,CUS-1614226872,2018-10-04,Rhonda,F,-27.66,153.10,,376fcedb-9e3e-4487-9777-00916db8412e,-27.64,153.12,QLD,Woodridge,debit,authorized,b67fb361b0bd4c3887202fdb6e257a45,POS,30-40,2018,10,4,10,23,Thursday,7 days,46516.121
ACC-1037050564,40,43.11,4377.45,0.0,CUS-1614226872,2018-10-04,Rhonda,F,-27.66,153.10,,8a2c577e-6d84-41ee-ba72-5148ad656792,-27.47,153.02,QLD,Brisbane City,debit,authorized,68460baf7e9743fc9aac550a959258d4,POS,30-40,2018,10,4,11,15,Thursday,7 days,46516.121
ACC-1037050564,40,16.09,4361.36,1.0,CUS-1614226872,2018-10-04,Rhonda,F,-27.66,153.10,,7eb82e22-2864-4224-a9d0-3a6d8d2422b4,-27.96,153.38,QLD,Southport,debit,authorized,b4afc3e82c3245528fe7a9c223891bb6,SALES-POS,30-40,2018,10,4,12,56,Thursday,7 days,46516.121
ACC-1037050564,40,20.78,4340.58,1.0,CUS-1614226872,2018-10-04,Rhonda,F,-27.66,153.10,,261655bd-b296-4612-9a3c-66077c818c3d,-31.43,152.91,NSW,Port Macquarie,debit,authorized,52e71ff2ac9d4f148385260eafd6ddb2,POS,30-40,2018,10,4,13,49,Thursday,7 days,46516.121
ACC-1037050564,40,33.0,4307.58,,CUS-1614226872,2018-10-04,Rhonda,F,-27.66,153.10,,,,,,,debit,posted,98b12af4c55f43d6b9cdb38a3ed6066b,PAYMENT,30-40,2018,10,4,15,0,Thursday,7 days,46516.121
ACC-1037050564,40,61.27,4246.31,0.0,CUS-1614226872,2018-10-04,Rhonda,F,-27.66,153.10,,4cd1f85e-c58a-4759-8d67-fd6e6339901c,-27.41,153.06,QLD,Toombul,debit,authorized,cf4d1467b80b4367af94a34e05b87bbb,POS,30-40,2018,10,4,16,6,Thursday,7 days,46516.121
ACC-1037050564,40,15.8,4230.51,1.0,CUS-1614226872,2018-10-04,Rhonda,F,-27.66,153.10,,e5a96301-17dc-403c-8833-33bb834cddae,-28.01,153.39,QLD,Sorrento,debit,authorized,bb7432231a8d464ab6783721f14f1764,SALES-POS,30-40,2018,10,4,21,42,Thursday,7 days,46516.121
ACC-1037050564,40,11.27,4219.24,1.0,CUS-1614226872,2018-10-04,Rhonda,F,-27.66,153.10,,d39f1bd2-b46c-47ac-9704-f17fc22e2e4c,-27.48,153.02,QLD,South Brisbane,debit,authorized,07493d2472bd491aa7676a535814be36,SALES-POS,30-40,2018,10,4,22,41,Thursday,7 days,46516.121
ACC-1037050564,40,49.38,4169.86,1.0,CUS-1614226872,2018-10-04,Rhonda,F,-27.66,153.10,,42f5fd46-be8a-4d50-8efb-4f3402ee2160,-27.57,151.96,QLD,Toowoomba City,debit,authorized,a12509013e6445ac94cbb3e89516aebb,POS,30-40,2018,10,4,23,12,Thursday,7 days,46516.121
ACC-1037050564,40,15.75,4154.11,0.0,CUS-1614226872,2018-10-05,Rhonda,F,-27.66,153.10,,71ade51d-d32b-4d70-8b68-599e781034f6,-28.01,153.39,QLD,Benowa,debit,authorized,f857844282e1474d886d0822dbca1860,POS,30-40,2018,10,5,9,20,Friday,7 days,46516.121
ACC-1037050564,40,10.45,4143.66,0.0,CUS-1614226872,2018-10-05,Rhonda,F,-27.66,153.10,,bc980229-9bf9-4031-92c3-e56462c56891,-27.97,153.42,QLD,Southport,debit,authorized,b7c609c38f0d4141b1995153c759ab86,POS,30-40,2018,10,5,12,4,Friday,7 days,46516.121
ACC-1037050564,40,34.11,4109.55,1.0,CUS-1614226872,2018-10-05,Rhonda,F,-27.66,153.10,,221043ab-2f9d-4c48-bac1-d38d48ca9432,-27.51,153.06,QLD,Coorparoo,debit,authorized,acf0750dcddb427196f0ee7b8f4dec4d,SALES-POS,30-40,2018,10,5,12,21,Friday,7 days,46516.121
ACC-1037050564,40,18.79,4090.76,1.0,CUS-1614226872,2018-10-05,Rhonda,F,-27.66,153.10,,b6845148-ff2f-48c3-99bf-c87ba19f297a,-27.48,153.04,QLD,East Brisbane,debit,authorized,70b0410539a14d0293ea84f760d1e413,SALES-POS,30-40,2018,10,5,12,54,Friday,7 days,46516.121
ACC-1037050564,40,36.96,4053.8,1.0,CUS-1614226872,2018-10-05,Rhonda,F,-27.66,153.10,,0dbb8b48-1058-4d39-b314-2ea00046a2ac,-27.78,153.01,QLD,North Maclean,debit,authorized,dfc9257835104dcea3875cb5f2ca2fff,POS,30-40,2018,10,5,19,24,Friday,7 days,46516.121
ACC-1037050564,40,97.87,3955.93,1.0,CUS-1614226872,2018-10-05,Rhonda,F,-27.66,153.10,,c28390c0-0ae3-4f8e-9c5b-f6f4ff2d87d0,-28.04,153.43,QLD,Broadbeach Waters,debit,authorized,b1d8ead7f9d44ffc9335a02b01acfc00,SALES-POS,30-40,2018,10,5,20,23,Friday,7 days,46516.121
ACC-1037050564,40,20.45,3935.48,1.0,CUS-1614226872,2018-10-06,Rhonda,F,-27.66,153.10,,ef56b5c0-4462-478d-a9d8-a4b4a1cffbc1,-27.47,153.03,QLD,Brisbane City,debit,authorized,683657699ffd4d0dbb32c387350b8108,POS,30-40,2018,10,6,1,15,Saturday,7 days,46516.121
ACC-1037050564,40,28.58,3906.9,1.0,CUS-1614226872,2018-10-06,Rhonda,F,-27.66,153.10,,944375b1-299b-4ea7-b0db-445c19046930,-27.57,151.98,QLD,Toowoomba,debit,authorized,3403c714678e493780c2639dad283c38,POS,30-40,2018,10,6,3,48,Saturday,7 days,46516.121
ACC-1037050564,40,13.26,3893.64,1.0,CUS-1614226872,2018-10-06,Rhonda,F,-27.66,153.10,,6f138cb0-4469-42fc-aa96-ae277bce8f77,-28.1,153.42,QLD,Burleigh Waters,debit,authorized,b3ab69ce37d141b59aded37d28b31e09,POS,30-40,2018,10,6,8,19,Saturday,7 days,46516.121
ACC-1037050564,40,58.07,3835.57,1.0,CUS-1614226872,2018-10-06,Rhonda,F,-27.66,153.10,,fa9e019d-037f-4d0e-8c55-29383b059b1f,-27.98,153.38,QLD,Ashmore,debit,authorized,c43801428e33451290e370ec0fdfe3a3,SALES-POS,30-40,2018,10,6,21,37,Saturday,7 days,46516.121
ACC-1037050564,40,43.62,3791.95,1.0,CUS-1614226872,2018-10-07,Rhonda,F,-27.66,153.10,,258f989d-1dc6-4455-ba67-56409320899e,-27.5,152.97,QLD,Indooroopilly,debit,authorized,e0895c55a93a4862b243b81a240f5cc8,POS,30-40,2018,10,7,0,10,Sunday,7 days,46516.121
ACC-1037050564,40,27.68,3764.27,1.0,CUS-1614226872,2018-10-07,Rhonda,F,-27.66,153.10,,e1318054-6edd-4607-b008-22200e86a315,-33.87,151.21,NSW,Sydney,debit,authorized,26158f5a8c9243cb8efe48873f39f0bf,SALES-POS,30-40,2018,10,7,8,22,Sunday,7 days,46516.121
ACC-1037050564,40,15.08,3749.19,1.0,CUS-1614226872,2018-10-07,Rhonda,F,-27.66,153.10,,ace23a98-572b-490c-a151-2bd1105db8ef,-27.57,151.95,QLD,Toowoomba,debit,authorized,77764b83f6b347bdb4247c50b50ce003,SALES-POS,30-40,2018,10,7,12,50,Sunday,7 days,46516.121
ACC-1037050564,40,12.63,3736.56,1.0,CUS-1614226872,2018-10-07,Rhonda,F,-27.66,153.10,,ccb8058d-99a8-42df-b040-431fd1283b1a,-27.36,153.01,QLD,Aspley,debit,authorized,64fc1e9cebee46e694df13e79c22514a,SALES-POS,30-40,2018,10,7,21,20,Sunday,7 days,46516.121
ACC-1037050564,40,35.62,3700.94,1.0,CUS-1614226872,2018-10-07,Rhonda,F,-27.66,153.10,,a1360283-370b-4de2-9c27-8c3452f7e4af,-37.82,144.97,VIC,Melbourne,debit,authorized,ac728d2d65424a47ac39493616e647b2,SALES-POS,30-40,2018,10,7,21,52,Sunday,7 days,46516.121
ACC-1037050564,40,47.26,3653.68,0.0,CUS-1614226872,2018-10-08,Rhonda,F,-27.66,153.10,,7163ba4e-86e2-4146-b5e1-033b0a1d43d2,-37.84,144.98,VIC,Melbourne,debit,authorized,2698adbacf984dacae24a1a26b11338a,SALES-POS,30-40,2018,10,8,6,26,Monday,7 days,46516.121
ACC-1037050564,40,32.0,4513.77,,CUS-1614226872,2018-10-10,Rhonda,F,-27.66,153.10,,,,,,,debit,posted,e0cbe4c516a242da972efd5a9e3a19e4,PAYMENT,30-40,2018,10,10,10,0,Wednesday,7 days,46516.121
ACC-1037050564,40,15.27,4498.5,1.0,CUS-1614226872,2018-10-10,Rhonda,F,-27.66,153.10,,ebb3087a-75c4-4dea-8354-9be1c746d6cb,-27.89,152.02,QLD,Pilton,debit,authorized,fc575a198c034c218ad8f9ffe235502e,POS,30-40,2018,10,10,19,10,Wednesday,7 days,46516.121
ACC-1037050564,40,32.63,4465.87,1.0,CUS-1614226872,2018-10-10,Rhonda,F,-27.66,153.10,,bbfd6dd5-1ec7-45b7-96bb-3c1461ebb146,-27.61,153.3,QLD,Redland Bay,debit,authorized,dee3ebff5edd4cc4a7599ac44a2b95b5,POS,30-40,2018,10,10,19,40,Wednesday,7 days,46516.121
ACC-1037050564,40,50.08,4415.79,1.0,CUS-1614226872,2018-10-10,Rhonda,F,-27.66,153.10,,ae0edeea-e833-42a8-92c1-c25e1513be47,-27.62,153.11,QLD,Underwood,debit,authorized,5165ae34482c49a299fc7e125f5226ac,SALES-POS,30-40,2018,10,10,20,17,Wednesday,7 days,46516.121
ACC-1037050564,40,33.0,4382.79,,CUS-1614226872,2018-10-11,Rhonda,F,-27.66,153.10,,,,,,,debit,posted,4100f5ab6df04539bea264d699e96079,PAYMENT,30-40,2018,10,11,15,0,Thursday,7 days,46516.121
ACC-1037050564,40,20.92,4361.87,1.0,CUS-1614226872,2018-10-11,Rhonda,F,-27.66,153.10,,04a51f1e-ee24-4bd2-8413-bb6a08030dbb,-27.59,151.95,QLD,Kearneys Spring,debit,authorized,fbb8157933334dc996a4dc4f1f70210d,SALES-POS,30-40,2018,10,11,19,9,Thursday,7 days,46516.121
ACC-1037050564,40,19.29,4342.58,0.0,CUS-1614226872,2018-10-12,Rhonda,F,-27.66,153.10,,44ecedc4-5754-41ce-8eae-a1c933b64186,-27.59,151.95,QLD,Kearneys Spring,debit,authorized,41952154dd02494588a76b502fd38ef7,SALES-POS,30-40,2018,10,12,15,45,Friday,7 days,46516.121
ACC-1037050564,40,25.38,4317.2,1.0,CUS-1614226872,2018-10-12,Rhonda,F,-27.66,153.10,,0bde4a33-7719-4033-8965-afa54b09e4d0,-27.77,153.11,QLD,Logan Village,debit,authorized,f03d58b9159048f7a87ba4355a9ea75b,POS,30-40,2018,10,12,22,35,Friday,7 days,46516.121
ACC-1037050564,40,14.17,4303.03,1.0,CUS-1614226872,2018-10-13,Rhonda,F,-27.66,153.10,,60e9b106-b850-43fd-bfcc-c66d5493f91a,-27.56,153.08,QLD,Upper Mount Gravatt,debit,authorized,6840a3ef50ad481e81e880780e550ccd,SALES-POS,30-40,2018,10,13,17,2,Saturday,7 days,46516.121
ACC-1037050564,40,26.22,4276.81,1.0,CUS-1614226872,2018-10-13,Rhonda,F,-27.66,153.10,,d0c7916f-8b9d-40b9-9b22-a284b23ba128,-27.47,153.07,QLD,Morningside,debit,authorized,59f05647f6e04dc6a44950cdfea6753b,POS,30-40,2018,10,13,20,41,Saturday,7 days,46516.121
ACC-1037050564,40,19.51,4257.3,1.0,CUS-1614226872,2018-10-13,Rhonda,F,-27.66,153.10,,2924b4f3-fcad-486e-98ec-928c1c1c60df,-27.59,153.28,QLD,Victoria Point,debit,authorized,e730df538d4c42f1b12d8012e2d2bd56,SALES-POS,30-40,2018,10,13,21,1,Saturday,7 days,46516.121
ACC-1037050564,40,17.97,4239.33,1.0,CUS-1614226872,2018-10-13,Rhonda,F,-27.66,153.10,,f72a23be-91b8-4e7a-8c4e-c35e1e951250,-27.53,153.27,QLD,Cleveland,debit,authorized,b0c501307f0844e9a624fa5721b52381,SALES-POS,30-40,2018,10,13,22,38,Saturday,7 days,46516.121
ACC-1037050564,40,17.55,5113.87,1.0,CUS-1614226872,2018-10-16,Rhonda,F,-27.66,153.10,,f615f510-c224-47c2-b90f-c3e9e0e21fbb,-27.53,153.27,QLD,Cleveland,debit,authorized,d64c39ca77bc453fabef37e6e5938b2b,SALES-POS,30-40,2018,10,16,13,27,Tuesday,7 days,46516.121
ACC-1037050564,40,6.37,5107.5,1.0,CUS-1614226872,2018-10-16,Rhonda,F,-27.66,153.10,,40e43616-d48e-4eae-8155-53c22d10f766,-27.47,153.02,QLD,Brisbane,debit,authorized,40a18204e6c740eca592d60ee203e876,SALES-POS,30-40,2018,10,16,13,54,Tuesday,7 days,46516.121
ACC-1037050564,40,32.0,5023.31,,CUS-1614226872,2018-10-17,Rhonda,F,-27.66,153.10,,,,,,,debit,posted,e157172307a848ff913cc6bbdd0f15ab,PAYMENT,30-40,2018,10,17,10,0,Wednesday,7 days,46516.121
ACC-1037050564,40,52.19,5055.31,1.0,CUS-1614226872,2018-10-17,Rhonda,F,-27.66,153.10,,8d9595b6-812e-4e32-8a58-fedbe856b2f2,-31.95,115.82,WA,Subiaco,debit,authorized,807e935c5e9b4e699380dbe42d43b03a,SALES-POS,30-40,2018,10,17,10,37,Wednesday,7 days,46516.121
ACC-1037050564,40,14.24,5009.07,1.0,CUS-1614226872,2018-10-17,Rhonda,F,-27.66,153.10,,8dfd8770-21e3-43f5-ba64-7d7b6cb5548c,-27.63,152.78,QLD,Raceview,debit,authorized,ff11e86e047948f19ab852d5fbe3cfaf,POS,30-40,2018,10,17,17,39,Wednesday,7 days,46516.121
ACC-1037050564,40,33.0,4976.07,,CUS-1614226872,2018-10-18,Rhonda,F,-27.66,153.10,,,,,,,debit,posted,757ab2e53fec4c93b0f445e3fbc53f05,PAYMENT,30-40,2018,10,18,15,0,Thursday,7 days,46516.121
ACC-1037050564,40,25.58,4950.49,1.0,CUS-1614226872,2018-10-19,Rhonda,F,-27.66,153.10,,fec186f5-66e5-4c1c-ab30-8433fd33ab70,-33.89,151.2,NSW,Chippendale,debit,authorized,5c33b65309c84393b33ce071b2194b30,SALES-POS,30-40,2018,10,19,4,5,Friday,7 days,46516.121
ACC-1037050564,40,24.54,4925.95,0.0,CUS-1614226872,2018-10-19,Rhonda,F,-27.66,153.10,,789529cd-d84d-4dcd-b900-d0179cd7f092,-27.47,153.01,QLD,Milton,debit,authorized,07052518b86b4e49b1521ca4e9c13e8a,POS,30-40,2018,10,19,7,19,Friday,7 days,46516.121
ACC-1037050564,40,13.88,4912.07,0.0,CUS-1614226872,2018-10-19,Rhonda,F,-27.66,153.10,,41fc5874-e10a-4671-9312-78e561c69efa,-27.5,152.97,QLD,Indooroopilly,debit,authorized,b82bcab3e9064e5e84b30394bfe0a19c,POS,30-40,2018,10,19,9,22,Friday,7 days,46516.121
ACC-1037050564,40,93.53,4818.54,0.0,CUS-1614226872,2018-10-19,Rhonda,F,-27.66,153.10,,4e04cb8b-7bfe-4515-aeb5-bb46a9aa332b,-27.42,153.05,QLD,Clayfield,debit,authorized,ae0389cfc3d74277b638618281728991,SALES-POS,30-40,2018,10,19,9,47,Friday,7 days,46516.121
ACC-1037050564,40,14.45,4804.09,0.0,CUS-1614226872,2018-10-19,Rhonda,F,-27.66,153.10,,c345718d-3592-4faf-b0ae-6cc32cefbc38,-27.47,153.01,QLD,Milton,debit,authorized,c6295a6fb7b24f8ca70b3f3995b1e8a3,SALES-POS,30-40,2018,10,19,9,52,Friday,7 days,46516.121
ACC-1037050564,40,36.51,4767.58,0.0,CUS-1614226872,2018-10-21,Rhonda,F,-27.66,153.10,,3974bac0-1e4a-4e81-a55d-91a19c905ad9,-27.49,153.04,QLD,Woolloongabba,debit,authorized,8153517231324625812f69dc7b9101c5,SALES-POS,30-40,2018,10,21,19,52,Sunday,7 days,46516.121
ACC-1037050564,40,17.67,4749.91,1.0,CUS-1614226872,2018-10-21,Rhonda,F,-27.66,153.10,,ee8da3ce-8019-4d4d-b7ea-5deab9b79046,-27.68,153.09,QLD,Crestmead,debit,authorized,8cad1b946427419eb243c4eab8a66eea,POS,30-40,2018,10,21,20,21,Sunday,7 days,46516.121
ACC-1037050564,40,63.24,4686.67,1.0,CUS-1614226872,2018-10-21,Rhonda,F,-27.66,153.10,,ea4c41e3-334e-476f-a78a-bb01917158d0,-30.3,153.12,NSW,Coffs Harbour,debit,authorized,017824b84f6c49779f28329b4276a947,POS,30-40,2018,10,21,21,18,Sunday,7 days,46516.121
ACC-1037050564,40,7.92,4678.75,0.0,CUS-1614226872,2018-10-21,Rhonda,F,-27.66,153.10,,ac77239d-b4ed-4e2c-a52a-98c393341cca,-27.49,152.98,QLD,Taringa,debit,authorized,ad65f54a4e4c434480419f7c9194b014,POS,30-40,2018,10,21,22,38,Sunday,7 days,46516.121
ACC-1037050564,40,10.29,4668.46,1.0,CUS-1614226872,2018-10-21,Rhonda,F,-27.66,153.10,,df271e23-5dfa-4d26-9a47-ed2441cdee3a,-27.56,151.95,QLD,Toowoomba City,debit,authorized,5854ab2647e74a22817a603858f3ed05,SALES-POS,30-40,2018,10,21,22,57,Sunday,7 days,46516.121
ACC-1037050564,40,13.48,4654.98,1.0,CUS-1614226872,2018-10-22,Rhonda,F,-27.66,153.10,,52c4dff2-fc03-4044-90a3-0355c8df3a3a,-27.48,153.04,QLD,Kangaroo Point,debit,authorized,081e0405da334288a6f97f970dfa00b8,POS,30-40,2018,10,22,9,51,Monday,7 days,46516.121
ACC-1037050564,40,22.21,4632.77,1.0,CUS-1614226872,2018-10-22,Rhonda,F,-27.66,153.10,,aef30de1-c67e-4ab7-8577-2931a4bf3c7e,-27.97,144.64,QLD,Yowah,debit,authorized,c37117b7166b43f68c10a6383b414017,POS,30-40,2018,10,22,11,35,Monday,7 days,46516.121
ACC-1037050564,40,154.96,5369.9,0.0,CUS-1614226872,2018-10-22,Rhonda,F,-27.66,153.10,,f66b8549-7586-4571-b7ec-7ddc5f8bd9af,-27.47,153.02,QLD,South Brisbane,debit,authorized,4fe25e2b01ae4d80b0a492d99ba44ce3,POS,30-40,2018,10,22,17,38,Monday,7 days,46516.121
ACC-1037050564,40,9.42,5360.48,1.0,CUS-1614226872,2018-10-24,Rhonda,F,-27.66,153.10,,fd879e84-6bd7-4559-8713-00a99a911606,-27.47,153.02,QLD,Brisbane City,debit,authorized,e92835318d53433a8b9f75c10fcf3691,POS,30-40,2018,10,24,2,19,Wednesday,7 days,46516.121
ACC-1037050564,40,32.0,5328.48,,CUS-1614226872,2018-10-24,Rhonda,F,-27.66,153.10,,,,,,,debit,posted,674f93920d434e5c96850cd63551a1c9,PAYMENT,30-40,2018,10,24,10,0,Wednesday,7 days,46516.121
ACC-1037050564,40,33.0,5295.48,,CUS-1614226872,2018-10-25,Rhonda,F,-27.66,153.10,,,,,,,debit,posted,7d53183d19544de99bcbb12fcc8f3272,PAYMENT,30-40,2018,10,25,15,0,Thursday,7 days,46516.121
ACC-1037050564,40,16.65,5278.83,1.0,CUS-1614226872,2018-10-25,Rhonda,F,-27.66,153.10,,2e61fcfd-9986-4926-bc9e-3977bae5a41b,-27.53,151.96,QLD,Harlaxton,debit,authorized,b5dba5f5fa6e45a8977c7a59d0a6f6c0,POS,30-40,2018,10,25,17,31,Thursday,7 days,46516.121
ACC-1037050564,40,40.96,5237.87,1.0,CUS-1614226872,2018-10-25,Rhonda,F,-27.66,153.10,,e12478ed-63bc-4625-96f9-ae5f94d84bb6,-27.51,152.94,QLD,Kenmore,debit,authorized,ad60eb068b8247aab2b18b15a82ed1b3,POS,30-40,2018,10,25,19,58,Thursday,7 days,46516.121
ACC-1037050564,40,50.91,5186.96,1.0,CUS-1614226872,2018-10-25,Rhonda,F,-27.66,153.10,,6a4cf7db-784c-40e2-91ba-391dbedb400b,-27.48,153.02,QLD,South Brisbane,debit,authorized,4dfb9dda8f1544718f9a083259bf55c8,POS,30-40,2018,10,25,21,39,Thursday,7 days,46516.121
ACC-1037050564,40,14.03,5172.93,1.0,CUS-1614226872,2018-10-26,Rhonda,F,-27.66,153.10,,4c63ec01-a539-4c39-9ea8-82af29368091,-27.5,152.97,QLD,Indooroopilly,debit,authorized,f50ba71adf6f4666a4cdd614dcc264db,POS,30-40,2018,10,26,4,5,Friday,7 days,46516.121
ACC-1037050564,40,32.0,6033.02,,CUS-1614226872,2018-10-31,Rhonda,F,-27.66,153.10,,,,,,,debit,posted,16b3296bec5b4f1190ada18cd02c0f2c,PAYMENT,30-40,2018,10,31,10,0,Wednesday,7 days,46516.121
ACC-1608363396,20,163.0,1705.43,,CUS-2688605418,2018-08-01,Robert,M,-33.87,151.22,,,,,,,debit,posted,1005b48a6eda4ffd85e9b649dc9467d3,PAYMENT,<20,2018,8,1,2,0,Wednesday,14 days,60493.536
ACC-1608363396,20,13.52,1691.91,1.0,CUS-2688605418,2018-08-01,Robert,M,-33.87,151.22,,0bf67b9f-7fa9-4458-8595-d1e738f26550,-33.9,151.18,NSW,Newtown,debit,authorized,0ae06c9043b94ad19fde3dd4524a738b,POS,<20,2018,8,1,16,12,Wednesday,14 days,60493.536
ACC-1608363396,20,24.0,1667.91,,CUS-2688605418,2018-08-02,Robert,M,-33.87,151.22,,,,,,,debit,posted,a95c03c7db314519b5ab0b67d24551dc,INTER BANK,<20,2018,8,2,11,0,Thursday,14 days,60493.536
ACC-1608363396,20,43.38,1624.53,1.0,CUS-2688605418,2018-08-03,Robert,M,-33.87,151.22,,e3a92a7a-0c39-4461-8899-25fb8a3843c2,-33.88,151.19,NSW,Ultimo,debit,authorized,0681d23d7bf8429e8764b171b0292a30,SALES-POS,<20,2018,8,3,15,49,Friday,14 days,60493.536
ACC-1608363396,20,25.83,1598.7,1.0,CUS-2688605418,2018-08-04,Robert,M,-33.87,151.22,,692862f7-68d5-4a19-a03f-13e4503e07e8,-33.82,151,NSW,Parramatta,debit,authorized,139e63a5772f44c68c4a23fe936ee308,POS,<20,2018,8,4,17,29,Saturday,14 days,60493.536
ACC-1608363396,20,10.48,1588.22,1.0,CUS-2688605418,2018-08-04,Robert,M,-33.87,151.22,,6457e617-f317-4fc2-be31-b44f41be1148,-33.69,151.29,NSW,Warriewood,debit,authorized,b3675d65a9724844861944872f62bffc,SALES-POS,<20,2018,8,4,21,15,Saturday,14 days,60493.536
ACC-1608363396,20,19.18,1569.04,1.0,CUS-2688605418,2018-08-05,Robert,M,-33.87,151.22,,32b40a6c-0864-4261-b2f0-dc02f5347df0,-33.86,121.89,WA,Esperance,debit,authorized,af4b826316d24ff285a0b46e64cf0bf2,POS,<20,2018,8,5,1,21,Sunday,14 days,60493.536
ACC-1608363396,20,40.62,1528.42,0.0,CUS-2688605418,2018-08-05,Robert,M,-33.87,151.22,,3fe374fe-179e-47a3-9a92-997c55313d30,-33.81,151.11,NSW,Ryde,debit,authorized,622f62a2c2d149bf845865746f4e1532,POS,<20,2018,8,5,6,17,Sunday,14 days,60493.536
ACC-1608363396,20,12.04,1516.38,1.0,CUS-2688605418,2018-08-06,Robert,M,-33.87,151.22,,3292fa36-15bf-4cd0-90bd-306aba55303f,-33.89,151.2,NSW,Redfern,debit,authorized,8a7121e4db0e4411a4e4664fc5a0d5e7,POS,<20,2018,8,6,0,13,Monday,14 days,60493.536
ACC-1608363396,20,25.09,1491.29,1.0,CUS-2688605418,2018-08-06,Robert,M,-33.87,151.22,,a026c1bc-863b-4e91-bc8f-c20d26a3f4a4,-33.89,151.25,NSW,Bondi Junction,debit,authorized,e412f2941e454ee69bad509ee037c44c,POS,<20,2018,8,6,9,15,Monday,14 days,60493.536
ACC-1608363396,20,16.75,1474.54,1.0,CUS-2688605418,2018-08-06,Robert,M,-33.87,151.22,,c1933bcd-b776-4b7c-8b7c-e3ca0511d413,-33.77,150.68,NSW,Penrith,debit,authorized,c2e35a2a2807481f8ea029d492e1511a,SALES-POS,<20,2018,8,6,11,16,Monday,14 days,60493.536
ACC-1608363396,20,15.19,1459.35,0.0,CUS-2688605418,2018-08-06,Robert,M,-33.87,151.22,,4274278d-fe8f-4bcc-ba89-6029e503fe2f,-33.72,151.12,NSW,Wahroonga,debit,authorized,4d4654d4d3e6441d845215e040d86acb,POS,<20,2018,8,6,11,40,Monday,14 days,60493.536
ACC-1608363396,20,10.13,1449.22,1.0,CUS-2688605418,2018-08-07,Robert,M,-33.87,151.22,,930eaba2-d053-421e-9a13-e6c349d4f679,-33.89,151.19,NSW,Darlington,debit,authorized,93374988502149db855dd167ccdd4561,SALES-POS,<20,2018,8,7,4,58,Tuesday,14 days,60493.536
ACC-1608363396,20,207.24,1241.98,1.0,CUS-2688605418,2018-08-07,Robert,M,-33.87,151.22,,c6ef8420-7cca-4837-b2c7-79c4a60c3835,-33.81,151.11,NSW,Ryde,debit,authorized,97640796867b4302ab3077872f13d4fe,SALES-POS,<20,2018,8,7,12,20,Tuesday,14 days,60493.536
ACC-1608363396,20,13.9,1228.08,1.0,CUS-2688605418,2018-08-07,Robert,M,-33.87,151.22,,20f0ff72-de7b-4466-84f5-71a07a1cbf1e,-33.87,151.21,NSW,Sydney,debit,authorized,c7d90824752d4ddfaca30bed1ed18ef1,SALES-POS,<20,2018,8,7,17,26,Tuesday,14 days,60493.536
ACC-1608363396,20,24.0,1204.08,,CUS-2688605418,2018-08-09,Robert,M,-33.87,151.22,,,,,,,debit,posted,c78cb75e5a214edeb0e00344f5d10377,INTER BANK,<20,2018,8,9,11,0,Thursday,14 days,60493.536
ACC-1608363396,20,11.43,1192.65,0.0,CUS-2688605418,2018-08-09,Robert,M,-33.87,151.22,,20c38ece-fa16-4810-afe4-cb995896fc02,-33.79,151.26,NSW,Balgowlah,debit,authorized,e2b5fa6d63424336b9d3eb0206a32515,POS,<20,2018,8,9,14,21,Thursday,14 days,60493.536
ACC-1608363396,20,88.87,3424.08,1.0,CUS-2688605418,2018-08-12,Robert,M,-33.87,151.22,,561bf892-15a5-4bc7-b9c3-262df4acf0b1,-33.87,150.96,NSW,Fairfield,debit,authorized,5b1dd5f65da14f5b9264858f06d171c8,SALES-POS,<20,2018,8,12,21,27,Sunday,14 days,60493.536
ACC-1608363396,20,135.0,3289.08,,CUS-2688605418,2018-08-13,Robert,M,-33.87,151.22,,,,,,,debit,posted,4304f69e485c44d8b04e60da777a4c63,PAYMENT,<20,2018,8,13,6,0,Monday,14 days,60493.536
ACC-1608363396,20,13.24,3275.84,1.0,CUS-2688605418,2018-08-15,Robert,M,-33.87,151.22,,ef365880-ada2-4e64-967a-e00c9d55b129,-33.77,150.81,NSW,Mount Druitt,debit,authorized,0233378dd985497da45dd38332b6a287,SALES-POS,<20,2018,8,15,0,1,Wednesday,14 days,60493.536
ACC-1608363396,20,283.31,2992.53,1.0,CUS-2688605418,2018-08-15,Robert,M,-33.87,151.22,,459b7f58-9ff1-4ff7-b626-d60d14833ec4,-33.92,151.2,NSW,Rosebery,debit,authorized,301a9fd3a6e248bc9072426f94f6095f,POS,<20,2018,8,15,8,52,Wednesday,14 days,60493.536
ACC-1608363396,20,13.89,2978.64,1.0,CUS-2688605418,2018-08-15,Robert,M,-33.87,151.22,,5f830402-b690-4812-9b9b-480bc58bed08,-33.84,151,NSW,Granville,debit,authorized,2615bf9aead34129a0cb2667762f84b5,POS,<20,2018,8,15,21,34,Wednesday,14 days,60493.536
ACC-1608363396,20,12.63,2942.01,1.0,CUS-2688605418,2018-08-17,Robert,M,-33.87,151.22,,3c5792dc-ccd0-4761-b8b1-8904406a002b,-33.77,151.27,NSW,Brookvale,debit,authorized,24c95528da1e4a9e8d129a4600723dea,POS,<20,2018,8,17,15,49,Friday,14 days,60493.536
ACC-1608363396,20,18.24,2923.77,1.0,CUS-2688605418,2018-08-18,Robert,M,-33.87,151.22,,feed6385-8a93-430d-bed2-ba5d01c50f2d,-33.77,150.83,NSW,Mount Druitt,debit,authorized,ef3198e2644d47818ee661f155f0bb1c,SALES-POS,<20,2018,8,18,4,37,Saturday,14 days,60493.536
ACC-1608363396,20,21.43,2902.34,1.0,CUS-2688605418,2018-08-19,Robert,M,-33.87,151.22,,2d419c94-838c-46cf-ae6d-002df43438b1,-33.77,150.82,NSW,Mount Druitt,debit,authorized,7c11afa1eaee46dc9f3fe4fe1c65bee7,POS,<20,2018,8,19,14,58,Sunday,14 days,60493.536
ACC-1608363396,20,10.11,2892.23,0.0,CUS-2688605418,2018-08-21,Robert,M,-33.87,151.22,,78fdf0b7-9078-4e78-b39f-9f2094e7a714,-33.76,151.21,NSW,Forestville,debit,authorized,1bda233c91364c7b95d66d7cdb87aafb,SALES-POS,<20,2018,8,21,10,56,Tuesday,14 days,60493.536
ACC-1608363396,20,9.66,2882.57,0.0,CUS-2688605418,2018-08-22,Robert,M,-33.87,151.22,,989aec6b-e224-4f1c-95e0-0572a1f6de28,-33.82,151.2,NSW,Crows Nest,debit,authorized,0474af2a5832432ca7ea3458fc7e18de,SALES-POS,<20,2018,8,22,9,2,Wednesday,14 days,60493.536
ACC-1608363396,20,100.16,2782.41,1.0,CUS-2688605418,2018-08-22,Robert,M,-33.87,151.22,,0101c0d9-6a4b-4dbd-9f59-91e376d584bb,-31.87,115.82,WA,Balcatta,debit,authorized,315a4cad9bd44dfb8d3c2f62dbf4bf53,SALES-POS,<20,2018,8,22,11,49,Wednesday,14 days,60493.536
ACC-1608363396,20,4.96,2777.45,1.0,CUS-2688605418,2018-08-22,Robert,M,-33.87,151.22,,1e48b1a9-5fe2-408f-92f2-1b0406edb2c8,-33.97,151.08,NSW,Mortdale,debit,authorized,824ea1b71c504e668fc63978d067bd7a,SALES-POS,<20,2018,8,22,23,45,Wednesday,14 days,60493.536
ACC-1608363396,20,12.29,2765.16,1.0,CUS-2688605418,2018-08-23,Robert,M,-33.87,151.22,,8aa42e6e-6d31-4aa9-90c1-3d552e57aee3,-33.74,150.81,NSW,Emerton,debit,authorized,fa50b258bf994a649f9b306e7fe65b4f,SALES-POS,<20,2018,8,23,2,48,Thursday,14 days,60493.536
ACC-1608363396,20,12.06,2753.1,1.0,CUS-2688605418,2018-08-23,Robert,M,-33.87,151.22,,53600579-c983-47ff-8f6c-fbaf4b90f63c,-33.96,151.1,NSW,Hurstville,debit,authorized,861726d4e05a4aff880f9d42b26a6770,POS,<20,2018,8,23,9,39,Thursday,14 days,60493.536
ACC-1608363396,20,24.0,2729.1,,CUS-2688605418,2018-08-23,Robert,M,-33.87,151.22,,,,,,,debit,posted,c45c3783119c46118dcd840396060938,INTER BANK,<20,2018,8,23,11,0,Thursday,14 days,60493.536
ACC-1608363396,20,79.47,2649.63,1.0,CUS-2688605418,2018-08-23,Robert,M,-33.87,151.22,,f0ae3f23-1564-4a89-bb6e-c020b7a3e5a7,-33.82,151,NSW,Parramatta,debit,authorized,7250cb4855884e55bc5400342d7c2694,SALES-POS,<20,2018,8,23,12,11,Thursday,14 days,60493.536
ACC-1608363396,20,125.81,4844.12,1.0,CUS-2688605418,2018-08-23,Robert,M,-33.87,151.22,,7feaa300-dc83-4f40-98ae-0525f5ca0fd2,-33.88,151.21,NSW,Haymarket,debit,authorized,07eb6ee1c66e431693c700572be2efd4,SALES-POS,<20,2018,8,23,19,13,Thursday,14 days,60493.536
ACC-1608363396,20,38.18,4805.94,1.0,CUS-2688605418,2018-08-23,Robert,M,-33.87,151.22,,6ed0387f-6c26-4f65-b966-ba8c59f58ba0,-33.82,151.01,NSW,Harris Park,debit,authorized,27c1ba9fcbe948be840b714d38fe41c3,SALES-POS,<20,2018,8,23,21,3,Thursday,14 days,60493.536
ACC-1608363396,20,17.2,4788.74,1.0,CUS-2688605418,2018-08-23,Robert,M,-33.87,151.22,,c6dbb5f1-dd6d-49e4-b4cf-68e9680d544e,-33.81,151.11,NSW,Ryde,debit,authorized,29cf5399a11d4bd08cb3f3a060e01871,SALES-POS,<20,2018,8,23,23,15,Thursday,14 days,60493.536
ACC-1608363396,20,9.45,4779.29,1.0,CUS-2688605418,2018-08-24,Robert,M,-33.87,151.22,,66cd44ce-0dd4-4d34-bb49-61c658b9530c,-33.81,151.16,NSW,Lane Cove North,debit,authorized,15a8f33e34844216868a9f3907e9f21d,POS,<20,2018,8,24,8,26,Friday,14 days,60493.536
ACC-1608363396,20,4.74,4774.55,1.0,CUS-2688605418,2018-08-24,Robert,M,-33.87,151.22,,fbf660a4-8d1c-4235-abb7-bf2a1501b7bc,-33.84,151.2,NSW,North Sydney,debit,authorized,2f7d117b25f3407583897e881b865985,POS,<20,2018,8,24,10,0,Friday,14 days,60493.536
ACC-1608363396,20,8.23,4766.32,1.0,CUS-2688605418,2018-08-25,Robert,M,-33.87,151.22,,5646c071-7d25-4c6c-a19e-5a71f4e0a9c1,-33.93,151.03,NSW,Bankstown,debit,authorized,b2882ad906f9435597dcf3cff700f177,SALES-POS,<20,2018,8,25,13,2,Saturday,14 days,60493.536
ACC-1608363396,20,17.46,4748.86,1.0,CUS-2688605418,2018-08-25,Robert,M,-33.87,151.22,,de440092-1855-4457-9f2f-746d3a78dfcd,-33.93,137.63,SA,Wallaroo,debit,authorized,6ef9d902c54b4e7c8603a272f6582aea,SALES-POS,<20,2018,8,25,13,28,Saturday,14 days,60493.536
ACC-1608363396,20,183.0,4565.86,,CUS-2688605418,2018-08-26,Robert,M,-33.87,151.22,,,,,,,debit,posted,0176840120a742978a4e33a38e8ef8ed,INTER BANK,<20,2018,8,26,11,0,Sunday,14 days,60493.536
ACC-1608363396,20,12.8,4553.06,1.0,CUS-2688605418,2018-08-27,Robert,M,-33.87,151.22,,6989c34c-4fb7-425b-8f94-e708d2317ba4,-33.74,151.07,NSW,Thornleigh,debit,authorized,c62f38eee53a4214bcb5f5c5937d37ef,POS,<20,2018,8,27,16,55,Monday,14 days,60493.536
ACC-1608363396,20,38.08,4514.98,1.0,CUS-2688605418,2018-08-27,Robert,M,-33.87,151.22,,48541d51-046c-4ffc-a0fe-146be5de2ff2,-33.81,151.17,NSW,Lane Cove,debit,authorized,3215950c52dc447a88904bc2a4cdc3e1,SALES-POS,<20,2018,8,27,22,1,Monday,14 days,60493.536
ACC-1608363396,20,13.11,4501.87,0.0,CUS-2688605418,2018-08-29,Robert,M,-33.87,151.22,,be1e4323-5323-418f-ab84-8dc7dcecb6a6,-33.93,150.95,NSW,Chipping Norton,debit,authorized,03aed02f74f344349ef1a770ee2556c4,POS,<20,2018,8,29,11,1,Wednesday,14 days,60493.536
ACC-1608363396,20,24.0,4477.87,,CUS-2688605418,2018-08-30,Robert,M,-33.87,151.22,,,,,,,debit,posted,ec0bf1cf1f5b4d87b690bedc7573a620,INTER BANK,<20,2018,8,30,11,0,Thursday,14 days,60493.536
ACC-1608363396,20,163.0,4314.87,,CUS-2688605418,2018-09-01,Robert,M,-33.87,151.22,,,,,,,debit,posted,acef22a46f714087a7cbb07f1d68bd91,PAYMENT,<20,2018,9,1,2,0,Saturday,14 days,60493.536
ACC-1608363396,20,25.02,4289.85,1.0,CUS-2688605418,2018-09-04,Robert,M,-33.87,151.22,,c12c2990-6a60-4b91-9a80-be35e15fdf84,-33.97,150.82,NSW,Leppington,debit,authorized,6951a9f309e7466d8e7e59959e998e58,POS,<20,2018,9,4,13,13,Tuesday,14 days,60493.536
ACC-1608363396,20,20.45,4269.4,1.0,CUS-2688605418,2018-09-04,Robert,M,-33.87,151.22,,ee0f0044-e842-45c6-a0ad-0e8c05286842,-33.86,121.88,WA,Nulsen,debit,authorized,ab8617d741a842cfa963225ecfc74b1a,POS,<20,2018,9,4,19,51,Tuesday,14 days,60493.536
ACC-1608363396,20,444.28,3825.12,1.0,CUS-2688605418,2018-09-04,Robert,M,-33.87,151.22,,ed811994-4222-4011-9444-c1fb2f1321d3,-33.87,151.21,NSW,Sydney,debit,authorized,f2fb349015874452afc0ff6f44c1fbba,SALES-POS,<20,2018,9,4,23,52,Tuesday,14 days,60493.536
ACC-1608363396,20,24.64,3800.48,1.0,CUS-2688605418,2018-09-05,Robert,M,-33.87,151.22,,4bfc58e3-fc06-401b-8fe4-2dbe994c0538,-33.73,151.08,NSW,Thornleigh,debit,authorized,1b5478e6226b4b0aaa6ebfff784bca99,SALES-POS,<20,2018,9,5,14,21,Wednesday,14 days,60493.536
ACC-1608363396,20,10.99,3789.49,1.0,CUS-2688605418,2018-09-05,Robert,M,-33.87,151.22,,f20a65ea-0777-4392-b0ea-402208a49d98,-33.73,151.13,NSW,Turramurra,debit,authorized,a046e669a9674df1a19474452ef73d5e,SALES-POS,<20,2018,9,5,23,58,Wednesday,14 days,60493.536
ACC-1608363396,20,16.62,3772.87,1.0,CUS-2688605418,2018-09-06,Robert,M,-33.87,151.22,,ec718e17-3b09-4e05-aa63-cd4d48b3f615,-33.7,150.56,NSW,Springwood,debit,authorized,8fdeec26eefd4d799e9ce97d0e9f91e5,POS,<20,2018,9,6,7,31,Thursday,14 days,60493.536
ACC-1608363396,20,24.0,3748.87,,CUS-2688605418,2018-09-06,Robert,M,-33.87,151.22,,,,,,,debit,posted,c3fc68af29454f0996ca89df8da2228a,INTER BANK,<20,2018,9,6,11,0,Thursday,14 days,60493.536
ACC-1608363396,20,42.89,6026.28,1.0,CUS-2688605418,2018-09-07,Robert,M,-33.87,151.22,,40b42e86-858f-4874-8f77-0d5d044dc7be,-33.91,151.1,NSW,Campsie,debit,authorized,bda1ba216bd342faa48b1001027e8701,POS,<20,2018,9,7,16,24,Friday,14 days,60493.536
ACC-1608363396,20,73.88,5952.4,1.0,CUS-2688605418,2018-09-09,Robert,M,-33.87,151.22,,0d40d160-af20-47eb-a715-c90935884964,-33.96,151.15,NSW,Brighton-Le-Sands,debit,authorized,49fee088ce5c4c1d87f13e82431df4be,SALES-POS,<20,2018,9,9,18,3,Sunday,14 days,60493.536
ACC-1608363396,20,24.35,5928.05,1.0,CUS-2688605418,2018-09-10,Robert,M,-33.87,151.22,,91d95d67-9ba7-4a80-8aee-e8b1440f8a43,-33.91,151.17,NSW,Marrickville,debit,authorized,61945737016047009893a5b08db832c0,SALES-POS,<20,2018,9,10,9,36,Monday,14 days,60493.536
ACC-1608363396,20,9.53,5918.52,0.0,CUS-2688605418,2018-09-10,Robert,M,-33.87,151.22,,882b949a-5f55-4fd9-8ed0-2c761889ed1b,-33.91,151.17,NSW,Marrickville,debit,authorized,b0002a0e895e49629311d462561f5f2f,SALES-POS,<20,2018,9,10,12,34,Monday,14 days,60493.536
ACC-1608363396,20,135.0,5783.52,,CUS-2688605418,2018-09-13,Robert,M,-33.87,151.22,,,,,,,debit,posted,1bfd69aa10c7478295e7a9b8f9d170a3,PAYMENT,<20,2018,9,13,6,0,Thursday,14 days,60493.536
ACC-1608363396,20,24.0,5759.52,,CUS-2688605418,2018-09-13,Robert,M,-33.87,151.22,,,,,,,debit,posted,fe0fd9b735b84bd2aa1836ead1bd37d9,INTER BANK,<20,2018,9,13,11,0,Thursday,14 days,60493.536
ACC-1608363396,20,26.98,5732.54,0.0,CUS-2688605418,2018-09-15,Robert,M,-33.87,151.22,,4890e28b-05ec-44f2-9ab0-bb2e7348c756,-33.92,151.04,NSW,Bankstown,debit,authorized,3b50a2ce35024579a97562c8f864845b,POS,<20,2018,9,15,19,0,Saturday,14 days,60493.536
ACC-1608363396,20,27.99,5704.55,1.0,CUS-2688605418,2018-09-16,Robert,M,-33.87,151.22,,7ed117ba-3dbb-4530-ac42-3ebb112694fd,-31.91,115.81,WA,Osborne Park,debit,authorized,70d8662a4bd74cbf8a61b4de35579cea,SALES-POS,<20,2018,9,16,9,9,Sunday,14 days,60493.536
ACC-1608363396,20,9.28,5695.27,0.0,CUS-2688605418,2018-09-16,Robert,M,-33.87,151.22,,916600e4-49dd-4527-9833-a802b7fc9fdd,-33.89,151.26,NSW,Bondi,debit,authorized,27bc518f545b4cb0933bbf5c41c77bad,SALES-POS,<20,2018,9,16,21,21,Sunday,14 days,60493.536
ACC-1608363396,20,15.07,5680.2,1.0,CUS-2688605418,2018-09-16,Robert,M,-33.87,151.22,,a134e9d1-4da3-44e2-af08-54423c3560e9,-33.93,151.19,NSW,Mascot,debit,authorized,70782b3792af453296f00cf69bf77862,SALES-POS,<20,2018,9,16,21,41,Sunday,14 days,60493.536
ACC-1608363396,20,63.57,5616.63,1.0,CUS-2688605418,2018-09-17,Robert,M,-33.87,151.22,,58d637f3-175f-4a23-9aac-375f5575b289,-33.77,150.77,NSW,Saint Marys,debit,authorized,8787e6b6fca04e06afcb7853a3bb53c8,SALES-POS,<20,2018,9,17,10,7,Monday,14 days,60493.536
ACC-1608363396,20,39.51,5577.12,1.0,CUS-2688605418,2018-09-19,Robert,M,-33.87,151.22,,d2372bc1-5983-4d93-8759-489362ab5377,-33.96,137.72,SA,Kadina,debit,authorized,42f6cf930fd840669408d650eae35033,SALES-POS,<20,2018,9,19,7,32,Wednesday,14 days,60493.536
ACC-1608363396,20,145.3,5431.82,1.0,CUS-2688605418,2018-09-19,Robert,M,-33.87,151.22,,699e62c6-1ee3-4051-affb-b8032953afd8,-33.85,151.16,NSW,Drummoyne,debit,authorized,6eaaa234f1404ae58424cff01db32d26,SALES-POS,<20,2018,9,19,10,27,Wednesday,14 days,60493.536
ACC-1608363396,20,21.62,5410.2,1.0,CUS-2688605418,2018-09-19,Robert,M,-33.87,151.22,,1494b559-da20-4557-a0ba-cf1859f42748,-33.91,151.21,NSW,Zetland,debit,authorized,d21423e15cb142a0a31ba1b1a637b80a,POS,<20,2018,9,19,11,14,Wednesday,14 days,60493.536
ACC-1608363396,20,38.68,5371.52,1.0,CUS-2688605418,2018-09-19,Robert,M,-33.87,151.22,,bc51596f-a3e1-4601-bf5f-89c26e4272ee,-33.82,151.2,NSW,Naremburn,debit,authorized,1057130a3b4e4304b7f538b55e051cba,SALES-POS,<20,2018,9,19,16,18,Wednesday,14 days,60493.536
ACC-1608363396,20,26.32,5345.2,1.0,CUS-2688605418,2018-09-19,Robert,M,-33.87,151.22,,ddf730bc-ba3a-43ea-a891-767447ddd563,-37.81,144.96,VIC,Melbourne,debit,authorized,14c85b369c444557bdd2d8d1150527ef,POS,<20,2018,9,19,17,46,Wednesday,14 days,60493.536
ACC-1608363396,20,19.7,5325.5,1.0,CUS-2688605418,2018-09-19,Robert,M,-33.87,151.22,,13ff2a38-4834-4779-9a11-18bd91063e7e,-33.78,151.12,NSW,Macquarie Park,debit,authorized,2b71d97b4fb046d38b112df4be38f210,POS,<20,2018,9,19,19,8,Wednesday,14 days,60493.536
ACC-1608363396,20,54.93,5270.57,1.0,CUS-2688605418,2018-09-19,Robert,M,-33.87,151.22,,52be1d52-533e-45ec-8f27-7721f9535c87,-33.91,150.87,NSW,Green Valley,debit,authorized,434ac9c6270e4271bf9d832138640794,POS,<20,2018,9,19,23,21,Wednesday,14 days,60493.536
ACC-1608363396,20,37.17,5233.4,0.0,CUS-2688605418,2018-09-20,Robert,M,-33.87,151.22,,4c7213c1-8e71-4c8a-917f-cea08a5cf4db,-33.93,150.9,NSW,Lurnea,debit,authorized,1dd3cc3317604e39acea6fea506d8bf6,SALES-POS,<20,2018,9,20,10,49,Thursday,14 days,60493.536
ACC-1608363396,20,24.0,5209.4,,CUS-2688605418,2018-09-20,Robert,M,-33.87,151.22,,,,,,,debit,posted,a04235a6a1ff473db6e10b4651c717b1,INTER BANK,<20,2018,9,20,11,0,Thursday,14 days,60493.536
ACC-1608363396,20,197.67,7332.03,1.0,CUS-2688605418,2018-09-20,Robert,M,-33.87,151.22,,dfaa4def-1abc-479f-8bb4-06670a1fa5be,-33.76,150.99,NSW,Baulkham Hills,debit,authorized,90e72b9bda1b4ac09f75073c4378f32e,SALES-POS,<20,2018,9,20,20,24,Thursday,14 days,60493.536
ACC-1608363396,20,14.56,7317.47,0.0,CUS-2688605418,2018-09-20,Robert,M,-33.87,151.22,,a6709743-af53-4d35-a5ae-d529b9ad399d,-33.86,151.21,NSW,Sydney,debit,authorized,cb39ccc078df4367a9f23cc9503960ef,SALES-POS,<20,2018,9,20,23,26,Thursday,14 days,60493.536
ACC-1608363396,20,31.37,7286.1,0.0,CUS-2688605418,2018-09-21,Robert,M,-33.87,151.22,,d49851c6-4f52-4118-aa58-52a8bf1465fe,-33.86,151.21,NSW,Sydney,debit,authorized,55cbb422603a46019a8cbec531b9abab,SALES-POS,<20,2018,9,21,13,2,Friday,14 days,60493.536
ACC-1608363396,20,22.16,7263.94,1.0,CUS-2688605418,2018-09-22,Robert,M,-33.87,151.22,,ab618380-61c1-445f-9d55-d316681884ec,-33.95,151.23,NSW,Eastgardens,debit,authorized,6b729d8c46254324a617d641c8f27229,POS,<20,2018,9,22,21,57,Saturday,14 days,60493.536
ACC-1608363396,20,22.11,7241.83,1.0,CUS-2688605418,2018-09-23,Robert,M,-33.87,151.22,,b6fc7027-f291-4a0a-8cbb-d68a036040bd,-33.83,117.16,WA,Kojonup,debit,authorized,b0bc4e57ccec48f6918c18cad56fc385,POS,<20,2018,9,23,9,9,Sunday,14 days,60493.536
ACC-1608363396,20,26.76,7215.07,1.0,CUS-2688605418,2018-09-23,Robert,M,-33.87,151.22,,b21820e2-c98c-4f04-914f-7492254f7067,-33.93,137.62,SA,Wallaroo,debit,authorized,296fa541c0ec4c558d1eb788b0863833,SALES-POS,<20,2018,9,23,9,41,Sunday,14 days,60493.536
ACC-1608363396,20,42.78,7172.29,1.0,CUS-2688605418,2018-09-24,Robert,M,-33.87,151.22,,2f409df7-15b1-44e2-856e-ea88b0aa11f8,-33.75,150.92,NSW,Blacktown,debit,authorized,f1fe3f44748f402db0600d257dbcee62,SALES-POS,<20,2018,9,24,15,9,Monday,14 days,60493.536
ACC-1608363396,20,183.0,6989.29,,CUS-2688605418,2018-09-26,Robert,M,-33.87,151.22,,,,,,,debit,posted,688831f00ccb4175b94d559f585c8cf1,INTER BANK,<20,2018,9,26,11,0,Wednesday,14 days,60493.536
ACC-1608363396,20,24.0,6965.29,,CUS-2688605418,2018-09-27,Robert,M,-33.87,151.22,,,,,,,debit,posted,e3c09fc7e2a94317bbe074f7b9d79c23,INTER BANK,<20,2018,9,27,11,0,Thursday,14 days,60493.536
ACC-1608363396,20,14.25,6951.04,1.0,CUS-2688605418,2018-09-28,Robert,M,-33.87,151.22,,ce1e49bc-2086-478a-a945-7770f196651c,-33.87,150.98,NSW,Old Guildford,debit,authorized,36342d3d208e495381c3982441c6cce5,SALES-POS,<20,2018,9,28,12,0,Friday,14 days,60493.536
ACC-1608363396,20,52.64,6898.4,1.0,CUS-2688605418,2018-09-28,Robert,M,-33.87,151.22,,db0c062d-3e4c-4bde-8996-91f2e74e125b,-33.87,151.21,NSW,Sydney,debit,authorized,c03cdaaddb7a4b5ca6d446e79ebb43fa,POS,<20,2018,9,28,21,45,Friday,14 days,60493.536
ACC-1608363396,20,7.94,6890.46,1.0,CUS-2688605418,2018-09-28,Robert,M,-33.87,151.22,,c791c707-2472-4ac0-9fa1-33a47d2b608b,-33.87,151.03,NSW,Berala,debit,authorized,07d921b737ef4f0e84f4345c0a8f4a98,SALES-POS,<20,2018,9,28,23,38,Friday,14 days,60493.536
ACC-1608363396,20,53.14,6837.32,1.0,CUS-2688605418,2018-09-29,Robert,M,-33.87,151.22,,b20919fc-410c-4264-9dce-c29d69a5a5af,-33.84,151.04,NSW,Silverwater,debit,authorized,d5a4f4ad98e64e04a5258f3c58ec8a0a,SALES-POS,<20,2018,9,29,22,20,Saturday,14 days,60493.536
ACC-1608363396,20,163.0,6674.32,,CUS-2688605418,2018-10-01,Robert,M,-33.87,151.22,,,,,,,debit,posted,ba88c103199c4464adc354c940c5b4c0,PAYMENT,<20,2018,10,1,2,0,Monday,14 days,60493.536
ACC-1608363396,20,31.31,6643.01,1.0,CUS-2688605418,2018-10-03,Robert,M,-33.87,151.22,,5ab9b646-527f-4b02-ba50-8a55574d8b9f,-33.79,150.67,NSW,Glenmore Park,debit,authorized,7098e0366b3e4890bc8bc14006ea5ec5,SALES-POS,<20,2018,10,3,9,54,Wednesday,14 days,60493.536
ACC-1608363396,20,24.0,6619.01,,CUS-2688605418,2018-10-04,Robert,M,-33.87,151.22,,,,,,,debit,posted,c335b2a006d142fdb92b390fe35eea03,INTER BANK,<20,2018,10,4,11,0,Thursday,14 days,60493.536
ACC-1608363396,20,31.28,8908.03,1.0,CUS-2688605418,2018-10-06,Robert,M,-33.87,151.22,,5f030ee3-7d34-41d2-bbc9-8e7d72861aeb,-33.91,151.17,NSW,Marrickville,debit,authorized,733206f10caa40d6bde3c6e3b519dfbd,POS,<20,2018,10,6,22,21,Saturday,14 days,60493.536
ACC-1608363396,20,80.3,8827.73,1.0,CUS-2688605418,2018-10-07,Robert,M,-33.87,151.22,,12cd51f7-6cfb-487d-8c67-1c55a3ca3e39,-33.95,151.08,NSW,Beverly Hills,debit,authorized,832b66c04a3947bf840727ced5299912,SALES-POS,<20,2018,10,7,16,28,Sunday,14 days,60493.536
ACC-1608363396,20,24.0,8803.73,,CUS-2688605418,2018-10-11,Robert,M,-33.87,151.22,,,,,,,debit,posted,caccc8f422cb4661bd15a916693d43f0,INTER BANK,<20,2018,10,11,11,0,Thursday,14 days,60493.536
ACC-1608363396,20,11.71,8792.02,0.0,CUS-2688605418,2018-10-12,Robert,M,-33.87,151.22,,c1b6555e-3e0d-4c1f-9ae7-587ec86b68ba,-33.89,151.25,NSW,Woollahra,debit,authorized,966866faeaff44ff9023683d2994b2ce,POS,<20,2018,10,12,11,28,Friday,14 days,60493.536
ACC-1608363396,20,19.57,8772.45,1.0,CUS-2688605418,2018-10-12,Robert,M,-33.87,151.22,,feaf928b-e0ae-43df-ac8f-e8d1daa7256b,-33.98,151.11,NSW,South Hurstville,debit,authorized,0bc507ea527642abb52c82cedc3d76ce,POS,<20,2018,10,12,14,7,Friday,14 days,60493.536
ACC-1608363396,20,25.58,8746.87,1.0,CUS-2688605418,2018-10-12,Robert,M,-33.87,151.22,,85d18c6c-df5a-4319-899a-3f498f14afff,-33.97,151.11,NSW,Hurstville,debit,authorized,afee8938261d478694ffa3cfcff5b8c7,POS,<20,2018,10,12,15,35,Friday,14 days,60493.536
ACC-1608363396,20,16.17,8730.7,0.0,CUS-2688605418,2018-10-12,Robert,M,-33.87,151.22,,4ba2eae7-2e63-44ae-b63f-88b7c2a520c8,-33.81,151.04,NSW,Rydalmere,debit,authorized,297ba142bdda4e5db3fe9d28fe5798b8,POS,<20,2018,10,12,18,14,Friday,14 days,60493.536
ACC-1608363396,20,53.26,8677.44,0.0,CUS-2688605418,2018-10-12,Robert,M,-33.87,151.22,,f3b4bd0d-e7c0-4f4f-b826-e32a1b92ee61,-33.99,150.89,NSW,Macquarie Fields,debit,authorized,c4cc2347b8e749bb8e776080cdb478c6,SALES-POS,<20,2018,10,12,20,33,Friday,14 days,60493.536
ACC-1608363396,20,11.74,8665.7,1.0,CUS-2688605418,2018-10-12,Robert,M,-33.87,151.22,,e584a39f-cb3b-4fee-9339-77e0c3891804,-33.92,150.85,NSW,Hoxton Park,debit,authorized,67d058e5ee8b43c39c8fa17b55eb9518,SALES-POS,<20,2018,10,12,23,55,Friday,14 days,60493.536
ACC-1608363396,20,12.02,8653.68,1.0,CUS-2688605418,2018-10-13,Robert,M,-33.87,151.22,,611783f0-977f-45d3-a38e-2d8640ff3491,-33.96,137.69,SA,New Town,debit,authorized,c9a22ba287a348c6a2cc2201fcb5b99c,POS,<20,2018,10,13,0,38,Saturday,14 days,60493.536
ACC-1608363396,20,135.0,8518.68,,CUS-2688605418,2018-10-13,Robert,M,-33.87,151.22,,,,,,,debit,posted,9e53bdae658b486c937853fb6d131035,PAYMENT,<20,2018,10,13,6,0,Saturday,14 days,60493.536
ACC-1608363396,20,788.0,7730.68,,CUS-2688605418,2018-10-13,Robert,M,-33.87,151.22,,,,,,,debit,posted,f491ffb2ab114df8b2142eb6e8fbb460,PAYMENT,<20,2018,10,13,20,0,Saturday,14 days,60493.536
ACC-1608363396,20,23.33,7707.35,0.0,CUS-2688605418,2018-10-14,Robert,M,-33.87,151.22,,b6fc7027-f291-4a0a-8cbb-d68a036040bd,-33.83,117.16,WA,Kojonup,debit,authorized,51df44b42ea1475ea19051c5b611ebc4,POS,<20,2018,10,14,11,1,Sunday,14 days,60493.536
ACC-1608363396,20,11.91,7695.44,1.0,CUS-2688605418,2018-10-14,Robert,M,-33.87,151.22,,b7771d5f-e430-48ee-8671-9db06345ec35,-33.8,150.99,NSW,Westmead,debit,authorized,354e7a57e31e424ea161853fcaf2c00b,SALES-POS,<20,2018,10,14,12,12,Sunday,14 days,60493.536
ACC-1608363396,20,19.02,7676.42,1.0,CUS-2688605418,2018-10-14,Robert,M,-33.87,151.22,,e31d02b0-524f-4d7c-8966-608a5f81ae85,-33.99,151.15,NSW,Ramsgate,debit,authorized,2a9cd5dbc54842fa879c35910a6bc4ee,SALES-POS,<20,2018,10,14,20,44,Sunday,14 days,60493.536
ACC-1608363396,20,132.08,7544.34,1.0,CUS-2688605418,2018-10-15,Robert,M,-33.87,151.22,,5e30d5e8-c4e0-4bd5-843c-63cb2e1db2bf,-33.93,151.19,NSW,Mascot,debit,authorized,356cfd8ddc4d40f7a38f54e0faea923a,POS,<20,2018,10,15,9,40,Monday,14 days,60493.536
ACC-1608363396,20,27.66,7516.68,1.0,CUS-2688605418,2018-10-15,Robert,M,-33.87,151.22,,0359e1a0-5efd-4921-8c41-89f1f0783aa1,-33.86,151.2,NSW,Sydney,debit,authorized,df886ed03b064479b8a372bb9807969c,SALES-POS,<20,2018,10,15,10,12,Monday,14 days,60493.536
ACC-1608363396,20,20.92,7495.76,1.0,CUS-2688605418,2018-10-15,Robert,M,-33.87,151.22,,32b40a6c-0864-4261-b2f0-dc02f5347df0,-33.86,121.89,WA,Esperance,debit,authorized,11367932c90e4da8a70a9a0b3de4d388,SALES-POS,<20,2018,10,15,16,36,Monday,14 days,60493.536
ACC-1608363396,20,52.18,7443.58,1.0,CUS-2688605418,2018-10-18,Robert,M,-33.87,151.22,,c517e9ce-fba4-4269-ac69-739d51ef969b,-30.52,151.67,NSW,Armidale,debit,authorized,931ddf63989d463bbccf2193bd5f9e4a,SALES-POS,<20,2018,10,18,2,13,Thursday,14 days,60493.536
ACC-1608363396,20,24.0,7419.58,,CUS-2688605418,2018-10-18,Robert,M,-33.87,151.22,,,,,,,debit,posted,037fa598955a4678b321d11ed0632305,INTER BANK,<20,2018,10,18,11,0,Thursday,14 days,60493.536
ACC-1608363396,20,20.01,9719.87,1.0,CUS-2688605418,2018-10-18,Robert,M,-33.87,151.22,,45e5d618-4430-47a8-b50f-24759c469e60,-33.87,151.22,NSW,Potts Point,debit,authorized,8ddd986a53054e128f3e0c8693d11377,SALES-POS,<20,2018,10,18,17,36,Thursday,14 days,60493.536
ACC-1608363396,20,8.93,9710.94,0.0,CUS-2688605418,2018-10-20,Robert,M,-33.87,151.22,,7c95bbd5-8846-47b7-ad12-d5548c08907c,-33.91,151.1,NSW,Campsie,debit,authorized,7e37851b3ddc4595bf141f92997703d7,POS,<20,2018,10,20,3,46,Saturday,14 days,60493.536
ACC-1608363396,20,100.91,9610.03,1.0,CUS-2688605418,2018-10-20,Robert,M,-33.87,151.22,,26c92de4-4848-4c65-aba4-f33884e7545a,-27.99,153.39,QLD,Ashmore,debit,authorized,d85ae84af8634143bc2c3c482757dd51,SALES-POS,<20,2018,10,20,20,43,Saturday,14 days,60493.536
ACC-1608363396,20,7.63,9602.4,1.0,CUS-2688605418,2018-10-20,Robert,M,-33.87,151.22,,5a856249-6d46-4c0e-b5dd-f75561a22575,-33.76,151.28,NSW,Dee Why,debit,authorized,a86fc9c45a0e44beab283cdcde0f7420,POS,<20,2018,10,20,21,19,Saturday,14 days,60493.536
ACC-1608363396,20,25.93,9576.47,0.0,CUS-2688605418,2018-10-21,Robert,M,-33.87,151.22,,346cfe2d-980c-4625-a2bc-4eb772e3b1d3,-33.78,150.89,NSW,Blacktown,debit,authorized,1f2b84f02bce416bafaba1b97d0257bc,SALES-POS,<20,2018,10,21,6,19,Sunday,14 days,60493.536
ACC-1608363396,20,60.98,9515.49,1.0,CUS-2688605418,2018-10-21,Robert,M,-33.87,151.22,,97cf6689-55c4-4f14-9418-293e2e224e4e,-33.89,151.21,NSW,Surry Hills,debit,authorized,21ddfe34ccf64166a70f700749f9c6e3,SALES-POS,<20,2018,10,21,11,40,Sunday,14 days,60493.536
ACC-1608363396,20,23.52,9491.97,1.0,CUS-2688605418,2018-10-22,Robert,M,-33.87,151.22,,b2ba4056-175b-4216-90d8-e6663de0a6aa,-33.79,151.27,NSW,Manly Vale,debit,authorized,dd12970143a2465e96aed6ec1d9a58e5,SALES-POS,<20,2018,10,22,21,30,Monday,14 days,60493.536
ACC-1608363396,20,24.0,9467.97,,CUS-2688605418,2018-10-25,Robert,M,-33.87,151.22,,,,,,,debit,posted,e10b46abc1734aba92b0ae82076ebad1,INTER BANK,<20,2018,10,25,11,0,Thursday,14 days,60493.536
ACC-1608363396,20,183.0,9284.97,,CUS-2688605418,2018-10-26,Robert,M,-33.87,151.22,,,,,,,debit,posted,22ee567e213d41c4b5754365e61f969f,INTER BANK,<20,2018,10,26,11,0,Friday,14 days,60493.536
ACC-1608363396,20,43.38,9241.59,0.0,CUS-2688605418,2018-10-27,Robert,M,-33.87,151.22,,9e80ab72-b313-459a-8783-283550726f05,-33.74,150.92,NSW,Kings Langley,debit,authorized,a976eb2bb1e04e38b7a705d1a2f25043,SALES-POS,<20,2018,10,27,11,28,Saturday,14 days,60493.536
ACC-1608363396,20,9.68,9231.91,1.0,CUS-2688605418,2018-10-30,Robert,M,-33.87,151.22,,38805c4d-62ab-49e8-886f-5b1aea35b5dd,-33.91,151.06,NSW,Greenacre,debit,authorized,096d93503f424c75825d4fdd3886e49c,POS,<20,2018,10,30,11,3,Tuesday,14 days,60493.536
ACC-1608363396,20,11.5,9220.41,1.0,CUS-2688605418,2018-10-30,Robert,M,-33.87,151.22,,a0c55860-cd4f-48ad-a7a8-58a28b5d537b,-33.86,151.28,NSW,Vaucluse,debit,authorized,8a82242d8af842afbe25c1082a5248cc,POS,<20,2018,10,30,12,1,Tuesday,14 days,60493.536
ACC-1608363396,20,18.75,9201.66,1.0,CUS-2688605418,2018-10-31,Robert,M,-33.87,151.22,,0d3b3d02-c442-4d3c-a934-c78788c73fb4,-33.87,151.08,NSW,Homebush,debit,authorized,2dca2cca2f054825b84c666a6dab6fc2,SALES-POS,<20,2018,10,31,16,54,Wednesday,14 days,60493.536
ACC-1608363396,20,63.87,9137.79,1.0,CUS-2688605418,2018-10-31,Robert,M,-33.87,151.22,,296a0500-8552-48ac-ac81-ec37065b568e,-33.96,150.88,NSW,Casula,debit,authorized,56e147e5485f4683b9076fcaaed76640,SALES-POS,<20,2018,10,31,23,21,Wednesday,14 days,60493.536
ACC-2776252858,43,61.06,1248.36,1.0,CUS-4123612273,2018-08-01,Kristin,F,-37.76,144.95,,3aa18033-a0a9-4190-a117-b7caaf4d07e3,-37.53,144.95,VIC,Kalkallo,debit,authorized,b79ca208099c4c28aa5dae966096d842,SALES-POS,40-50,2018,8,1,2,23,Wednesday,7 days,55690.657
ACC-2776252858,43,15.61,1232.75,1.0,CUS-4123612273,2018-08-01,Kristin,F,-37.76,144.95,,ee58145d-26e8-4b01-9cd9-62378014f21d,-37.81,144.96,VIC,Melbourne,debit,authorized,e1c4a50d6a0549cbb3710a62a2fa00d5,POS,40-50,2018,8,1,4,11,Wednesday,7 days,55690.657
ACC-2776252858,43,29.0,1203.75,,CUS-4123612273,2018-08-01,Kristin,F,-37.76,144.95,,,,,,,debit,posted,78a1b6c3a5534d48828d8ed266ba9c2e,PAYMENT,40-50,2018,8,1,6,0,Wednesday,7 days,55690.657
ACC-2776252858,43,197.0,2074.79,,CUS-4123612273,2018-08-02,Kristin,F,-37.76,144.95,,,,,,,debit,posted,c49d9fe530a94268ba3e5855981f5d7a,INTER BANK,40-50,2018,8,2,7,0,Thursday,7 days,55690.657
ACC-2776252858,43,43.0,2031.79,,CUS-4123612273,2018-08-02,Kristin,F,-37.76,144.95,,,,,,,debit,posted,852826a213da4102980e23b6cacdaaa1,PAYMENT,40-50,2018,8,2,8,0,Thursday,7 days,55690.657
ACC-2776252858,43,17.22,2014.57,1.0,CUS-4123612273,2018-08-03,Kristin,F,-37.76,144.95,,c32a2089-a6d9-4a51-880a-e4e9a55cf86e,-37.76,144.99,VIC,Thornbury,debit,authorized,0f80cf9011684cf78fdaf23be7fb272c,SALES-POS,40-50,2018,8,3,4,17,Friday,7 days,55690.657
ACC-2776252858,43,28.56,1986.01,1.0,CUS-4123612273,2018-08-03,Kristin,F,-37.76,144.95,,df08814b-3453-493e-8e5f-067ea52e1c22,-37.75,145.35,VIC,Lilydale,debit,authorized,2a248613cafd418ba7184bb2f90f587c,SALES-POS,40-50,2018,8,3,14,0,Friday,7 days,55690.657
ACC-2776252858,43,23.44,1962.57,0.0,CUS-4123612273,2018-08-03,Kristin,F,-37.76,144.95,,bf84c95e-b2ea-4c0b-a651-2fa3f686a890,-37.83,145.06,VIC,Camberwell,debit,authorized,06c3ff70d8db4b3491d13603d58cf279,POS,40-50,2018,8,3,20,11,Friday,7 days,55690.657
ACC-2776252858,43,760.27,1202.3,0.0,CUS-4123612273,2018-08-03,Kristin,F,-37.76,144.95,,7b4deb71-0e46-4da6-b2fa-7c718273f157,-37.83,140.78,SA,Mount Gambier,debit,authorized,42dca86c3f3c412287e3c7e890db1407,POS,40-50,2018,8,3,20,28,Friday,7 days,55690.657
ACC-2776252858,43,225.2,977.1,0.0,CUS-4123612273,2018-08-03,Kristin,F,-37.76,144.95,,902e65c5-23f8-4322-9d59-a8a103a54d3f,-33.87,151.2,NSW,Pyrmont,debit,authorized,bf204d293c5943e6bef9579e0f47b7a7,POS,40-50,2018,8,3,21,20,Friday,7 days,55690.657
ACC-2776252858,43,52.88,924.22,1.0,CUS-4123612273,2018-08-03,Kristin,F,-37.76,144.95,,12523792-58f8-4d10-bb7c-bdf0b3096ce5,-37.77,144.96,VIC,Brunswick,debit,authorized,a10bd7152b7542b4a20340f2b0c36f8d,POS,40-50,2018,8,3,21,33,Friday,7 days,55690.657
ACC-2776252858,43,124.0,800.22,,CUS-4123612273,2018-08-05,Kristin,F,-37.76,144.95,,,,,,,debit,posted,a53005e1cd3f4fccbca1fab3ff432ffd,PAYMENT,40-50,2018,8,5,18,0,Sunday,7 days,55690.657
ACC-2776252858,43,15.95,784.27,1.0,CUS-4123612273,2018-08-06,Kristin,F,-37.76,144.95,,f1408890-303c-49ea-b5c8-5a6d47f98044,-37.76,145.07,VIC,Heidelberg,debit,authorized,05d1f18ed2944f23979f11f9e5387e3c,SALES-POS,40-50,2018,8,6,13,15,Monday,7 days,55690.657
ACC-2776252858,43,16.11,768.16,1.0,CUS-4123612273,2018-08-07,Kristin,F,-37.76,144.95,,5339751c-b477-4416-a7f3-5dff4b79ee72,-37.75,144.76,VIC,Deer Park,debit,authorized,602f7176b3214c0ea978ecaa0fd213e7,POS,40-50,2018,8,7,14,47,Tuesday,7 days,55690.657
ACC-2776252858,43,33.26,734.9,0.0,CUS-4123612273,2018-08-07,Kristin,F,-37.76,144.95,,36e40441-b1f1-4c05-ac66-25fcde8d5918,-37.77,144.89,VIC,Maribyrnong,debit,authorized,bdb8c6a20a1a4d2b8cc9d001f5f88989,POS,40-50,2018,8,7,15,1,Tuesday,7 days,55690.657
ACC-2776252858,43,555.77,179.13,0.0,CUS-4123612273,2018-08-07,Kristin,F,-37.76,144.95,,f8796207-ee07-40bc-9e06-3f4031bd4145,-37.79,145.13,VIC,Doncaster,debit,authorized,41dfb5445e5b42e99168ffcf6626b051,SALES-POS,40-50,2018,8,7,15,9,Tuesday,7 days,55690.657
ACC-2776252858,43,29.47,149.66,1.0,CUS-4123612273,2018-08-07,Kristin,F,-37.76,144.95,,52caf85e-43d7-4bbe-a9b4-c4296ddfc28a,-37.83,140.77,SA,Mount Gambier,debit,authorized,e7fdac06f8be4fc9a935e1d46b59de40,POS,40-50,2018,8,7,16,46,Tuesday,7 days,55690.657
ACC-2776252858,43,18.22,131.44,1.0,CUS-4123612273,2018-08-07,Kristin,F,-37.76,144.95,,2d167481-2549-49f7-9c7b-ab304183cde7,-37.82,144.96,VIC,Melbourne,debit,authorized,940a280f78a047bd91754bd51faff646,SALES-POS,40-50,2018,8,7,17,7,Tuesday,7 days,55690.657
ACC-2776252858,43,29.0,102.44,,CUS-4123612273,2018-08-08,Kristin,F,-37.76,144.95,,,,,,,debit,posted,8baa3e3e68124bcdaf12f84c0cb10ffd,PAYMENT,40-50,2018,8,8,6,0,Wednesday,7 days,55690.657
ACC-2776252858,43,18.74,83.7,1.0,CUS-4123612273,2018-08-08,Kristin,F,-37.76,144.95,,d61d7ca9-e029-4516-90a9-f3c5a37348f0,-37.76,145.36,VIC,Lilydale,debit,authorized,2a67391aba9f4f2f93345ef4394679f7,SALES-POS,40-50,2018,8,8,9,11,Wednesday,7 days,55690.657
ACC-2776252858,43,43.0,498.39,,CUS-4123612273,2018-08-09,Kristin,F,-37.76,144.95,,,,,,,debit,posted,ba5ffb57e9d747b38236d1c10c59341e,PAYMENT,40-50,2018,8,9,8,0,Thursday,7 days,55690.657
ACC-2776252858,43,218.86,932.88,1.0,CUS-4123612273,2018-08-09,Kristin,F,-37.76,144.95,,39b7084c-a744-4a51-8a37-379b2f787840,-37.76,145.34,VIC,Lilydale,debit,authorized,ab2ea373de914222b9bcdfed016f92f7,POS,40-50,2018,8,9,8,13,Thursday,7 days,55690.657
ACC-2776252858,43,56.82,876.06,1.0,CUS-4123612273,2018-08-09,Kristin,F,-37.76,144.95,,a9991dc2-85d5-4139-aee5-c1563fa32de6,-37.79,145.13,VIC,Doncaster,debit,authorized,bc3ae8e1dc71439bb03a597ea0275df5,POS,40-50,2018,8,9,8,21,Thursday,7 days,55690.657
ACC-2776252858,43,316.3,559.76,1.0,CUS-4123612273,2018-08-09,Kristin,F,-37.76,144.95,,01e137c0-b908-42e5-a904-0eaf8f12326f,-37.76,145.17,VIC,Doncaster East,debit,authorized,c8f3d4ac30d846d089334a4a5ba325d4,POS,40-50,2018,8,9,8,28,Thursday,7 days,55690.657
ACC-2776252858,43,18.37,541.39,1.0,CUS-4123612273,2018-08-09,Kristin,F,-37.76,144.95,,e3567b45-cf99-414e-a58f-db379644d8c6,-37.76,145.17,VIC,Doncaster East,debit,authorized,ed939782d3c544c5862479d58328002d,POS,40-50,2018,8,9,8,36,Thursday,7 days,55690.657
ACC-2776252858,43,21.42,476.97,1.0,CUS-4123612273,2018-08-09,Kristin,F,-37.76,144.95,,0dfec121-872f-475c-bba9-2d3632e5945d,-37.76,145.35,VIC,Lilydale,debit,authorized,0cfc83792f4c4c81a6f7b4414b11f95c,SALES-POS,40-50,2018,8,9,9,4,Thursday,7 days,55690.657
ACC-2776252858,43,9.56,467.41,0.0,CUS-4123612273,2018-08-09,Kristin,F,-37.76,144.95,,f1a70067-5e7c-41b9-b493-ed17ef3ba4a4,-37.82,144.96,VIC,Melbourne,debit,authorized,6e9d976f497847d1ac89d500dcdc5bbd,POS,40-50,2018,8,9,21,42,Thursday,7 days,55690.657
ACC-2776252858,43,15.51,451.9,1.0,CUS-4123612273,2018-08-09,Kristin,F,-37.76,144.95,,d39ef731-28df-4327-af7a-8ef42b3d80ed,-37.83,144.97,VIC,South Melbourne,debit,authorized,ff5077c2fe084b1a93cd8248bf930e46,POS,40-50,2018,8,9,21,55,Thursday,7 days,55690.657
ACC-2776252858,43,22.02,429.88,1.0,CUS-4123612273,2018-08-09,Kristin,F,-37.76,144.95,,f113f8ba-fb0a-4517-b231-7cda3ec8b3fb,-37.77,145.3,VIC,Chirnside Park,debit,authorized,adad7c7f42484a1c8a7cb0868f0d2537,SALES-POS,40-50,2018,8,9,22,53,Thursday,7 days,55690.657
ACC-2776252858,43,28.29,401.59,1.0,CUS-4123612273,2018-08-10,Kristin,F,-37.76,144.95,,813e61e6-1586-49d6-bcd0-69ef27cfae36,-37.77,144.89,VIC,Maribyrnong,debit,authorized,0324addabacc40088025903da69ffe39,POS,40-50,2018,8,10,11,6,Friday,7 days,55690.657
ACC-2776252858,43,46.93,354.66,0.0,CUS-4123612273,2018-08-10,Kristin,F,-37.76,144.95,,1d7c7609-e834-44f4-9d0c-6c542cf2be73,-37.79,145.16,VIC,Doncaster East,debit,authorized,86cdd7fb516c4c78ad9594471101d757,POS,40-50,2018,8,10,14,21,Friday,7 days,55690.657
ACC-2776252858,43,178.0,176.66,,CUS-4123612273,2018-08-12,Kristin,F,-37.76,144.95,,,,,,,debit,posted,827e5f07de924c8fb8a8220d552acb97,PAYMENT,40-50,2018,8,12,19,0,Sunday,7 days,55690.657
ACC-2776252858,43,29.0,147.66,,CUS-4123612273,2018-08-15,Kristin,F,-37.76,144.95,,,,,,,debit,posted,ccf1a90b4f254cc9bac621b700595f67,PAYMENT,40-50,2018,8,15,6,0,Wednesday,7 days,55690.657
ACC-2776252858,43,29.0,1143.7,,CUS-4123612273,2018-08-22,Kristin,F,-37.76,144.95,,,,,,,debit,posted,e5a2a2161be2400581514c0a7727449d,PAYMENT,40-50,2018,8,22,6,0,Wednesday,7 days,55690.657
ACC-2776252858,43,43.0,2100.98,,CUS-4123612273,2018-08-23,Kristin,F,-37.76,144.95,,,,,,,debit,posted,8ed616f3c7594b94a81227975fe7f78c,PAYMENT,40-50,2018,8,23,8,0,Thursday,7 days,55690.657
ACC-2776252858,43,44.38,2167.36,1.0,CUS-4123612273,2018-08-23,Kristin,F,-37.76,144.95,,5461492e-4dc2-4a5d-a625-56ab0602eaf3,-37.78,144.88,VIC,Maidstone,debit,authorized,49675219ace5401da84f23c3798c7f57,SALES-POS,40-50,2018,8,23,8,43,Thursday,7 days,55690.657
ACC-2776252858,43,23.38,2143.98,1.0,CUS-4123612273,2018-08-23,Kristin,F,-37.76,144.95,,0dfec121-872f-475c-bba9-2d3632e5945d,-37.76,145.35,VIC,Lilydale,debit,authorized,14670846440d4823918719f9e743ecfb,POS,40-50,2018,8,23,8,49,Thursday,7 days,55690.657
ACC-2776252858,43,29.0,2071.98,,CUS-4123612273,2018-08-29,Kristin,F,-37.76,144.95,,,,,,,debit,posted,123f5352535f40fe842044ef66aae59d,PAYMENT,40-50,2018,8,29,6,0,Wednesday,7 days,55690.657
ACC-2776252858,43,43.0,3097.02,,CUS-4123612273,2018-08-30,Kristin,F,-37.76,144.95,,,,,,,debit,posted,2c6a7fe791a4493a8ba09f2bb53d5b6b,PAYMENT,40-50,2018,8,30,8,0,Thursday,7 days,55690.657
ACC-2776252858,43,197.0,2900.02,,CUS-4123612273,2018-09-02,Kristin,F,-37.76,144.95,,,,,,,debit,posted,19c9fab5e4b54d0ab0bd3af4cb580756,INTER BANK,40-50,2018,9,2,7,0,Sunday,7 days,55690.657
ACC-2776252858,43,22.66,2877.36,1.0,CUS-4123612273,2018-09-04,Kristin,F,-37.76,144.95,,c34c9907-80a5-4302-a842-b67a4a729e87,-37.89,145.08,VIC,Chadstone,debit,authorized,23e76ecc0fb642f2b2d7d04119ef4d41,SALES-POS,40-50,2018,9,4,10,23,Tuesday,7 days,55690.657
ACC-2776252858,43,21.19,2856.17,1.0,CUS-4123612273,2018-09-04,Kristin,F,-37.76,144.95,,d2b99dd2-ee51-45a9-bdbe-f966d3336ff6,-37.85,144.96,VIC,Middle Park,debit,authorized,4a5cd17aac014128b6d86261ba62fd98,POS,40-50,2018,9,4,17,14,Tuesday,7 days,55690.657
ACC-2776252858,43,44.31,2811.86,1.0,CUS-4123612273,2018-09-04,Kristin,F,-37.76,144.95,,833b3b69-626f-4ec0-a770-b56bb3d95b4d,-37.75,144.77,VIC,Deer Park,debit,authorized,5ac6da477b5f442695cbccc811cc2b8b,POS,40-50,2018,9,4,23,7,Tuesday,7 days,55690.657
ACC-2776252858,43,29.0,2782.86,,CUS-4123612273,2018-09-05,Kristin,F,-37.76,144.95,,,,,,,debit,posted,b45107b754204e51891319fee6a3651c,PAYMENT,40-50,2018,9,5,6,0,Wednesday,7 days,55690.657
ACC-2776252858,43,24.86,2758.0,1.0,CUS-4123612273,2018-09-05,Kristin,F,-37.76,144.95,,ba72418f-5d6f-48a5-b76f-ce25bb88dee4,-37.76,145.23,VIC,Warrandyte,debit,authorized,e8d6e634262447738787bd28f457561a,SALES-POS,40-50,2018,9,5,10,39,Wednesday,7 days,55690.657
ACC-2776252858,43,10.11,2747.89,1.0,CUS-4123612273,2018-09-05,Kristin,F,-37.76,144.95,,70888dcf-ddff-473a-ac0b-fb3d93ca8913,-37.76,145.06,VIC,Heidelberg,debit,authorized,08aad64428814d3d96ab54935527ccb7,SALES-POS,40-50,2018,9,5,11,4,Wednesday,7 days,55690.657
ACC-2776252858,43,124.0,3691.93,,CUS-4123612273,2018-09-05,Kristin,F,-37.76,144.95,,,,,,,debit,posted,734fa304599c4d9f907d191128b26334,PAYMENT,40-50,2018,9,5,18,0,Wednesday,7 days,55690.657
ACC-2776252858,43,43.0,3648.93,,CUS-4123612273,2018-09-06,Kristin,F,-37.76,144.95,,,,,,,debit,posted,f4521c4ba8af49fab8652efa94b7bb65,PAYMENT,40-50,2018,9,6,8,0,Thursday,7 days,55690.657
ACC-2776252858,43,13.2,3635.73,0.0,CUS-4123612273,2018-09-08,Kristin,F,-37.76,144.95,,5e3fdc60-650f-4013-b6b4-4c5d772d255c,-37.87,144.98,VIC,Saint Kilda,debit,authorized,283021f8dec24bc4914fa463f67929c4,POS,40-50,2018,9,8,8,35,Saturday,7 days,55690.657
ACC-2776252858,43,25.9,3609.83,1.0,CUS-4123612273,2018-09-08,Kristin,F,-37.76,144.95,,b7d877e6-8ba8-4aa8-bfba-81e84adfa8b1,-37.87,145.24,VIC,Wantirna South,debit,authorized,9a92374ad1554b2ab59f56d198dadaf5,SALES-POS,40-50,2018,9,8,9,19,Saturday,7 days,55690.657
ACC-2776252858,43,17.66,3592.17,1.0,CUS-4123612273,2018-09-12,Kristin,F,-37.76,144.95,,e070c852-72fd-4f77-8931-24c90fc36ef2,-37.77,144.91,VIC,Ascot Vale,debit,authorized,5cf4830e9a9342e7bf14b7238aea8126,POS,40-50,2018,9,12,2,5,Wednesday,7 days,55690.657
ACC-2776252858,43,29.0,3563.17,,CUS-4123612273,2018-09-12,Kristin,F,-37.76,144.95,,,,,,,debit,posted,7a86723fd5814749a07aee8a901e1f31,PAYMENT,40-50,2018,9,12,6,0,Wednesday,7 days,55690.657
ACC-2776252858,43,28.34,3534.83,1.0,CUS-4123612273,2018-09-12,Kristin,F,-37.76,144.95,,0bd73d69-e579-4761-9a56-aa79e8366632,-37.75,145.36,VIC,Lilydale,debit,authorized,ca4399f9d4c347de919eb98c825e9058,POS,40-50,2018,9,12,8,11,Wednesday,7 days,55690.657
ACC-2776252858,43,178.0,4424.87,,CUS-4123612273,2018-09-12,Kristin,F,-37.76,144.95,,,,,,,debit,posted,4d87c035f7e54386b9aac2b0daf7d2a2,PAYMENT,40-50,2018,9,12,19,0,Wednesday,7 days,55690.657
ACC-2776252858,43,43.0,4381.87,,CUS-4123612273,2018-09-13,Kristin,F,-37.76,144.95,,,,,,,debit,posted,98e7900065044cc39f4575df078d7a6c,PAYMENT,40-50,2018,9,13,8,0,Thursday,7 days,55690.657
ACC-2776252858,43,29.0,4352.87,,CUS-4123612273,2018-09-19,Kristin,F,-37.76,144.95,,,,,,,debit,posted,65da4d270b1749eaa25bc6c95b27f089,PAYMENT,40-50,2018,9,19,6,0,Wednesday,7 days,55690.657
ACC-2776252858,43,43.0,5377.91,,CUS-4123612273,2018-09-20,Kristin,F,-37.76,144.95,,,,,,,debit,posted,e599c8af4ab143adae121150ad7f10cc,PAYMENT,40-50,2018,9,20,8,0,Thursday,7 days,55690.657
ACC-2776252858,43,29.0,5348.91,,CUS-4123612273,2018-09-26,Kristin,F,-37.76,144.95,,,,,,,debit,posted,40716da015144222af3cf045b1ba4801,PAYMENT,40-50,2018,9,26,6,0,Wednesday,7 days,55690.657
ACC-2776252858,43,43.0,6373.95,,CUS-4123612273,2018-09-27,Kristin,F,-37.76,144.95,,,,,,,debit,posted,aa78da1989b24270a63f6198ec0ab0be,PAYMENT,40-50,2018,9,27,8,0,Thursday,7 days,55690.657
ACC-2776252858,43,197.0,6176.95,,CUS-4123612273,2018-10-02,Kristin,F,-37.76,144.95,,,,,,,debit,posted,248b2b9400f047d19144de2b5e59b32a,INTER BANK,40-50,2018,10,2,7,0,Tuesday,7 days,55690.657
ACC-2776252858,43,29.0,6147.95,,CUS-4123612273,2018-10-03,Kristin,F,-37.76,144.95,,,,,,,debit,posted,6a26aa99c0b74c45aa5c40b3f279931f,PAYMENT,40-50,2018,10,3,6,0,Wednesday,7 days,55690.657
ACC-2776252858,43,43.0,7172.99,,CUS-4123612273,2018-10-04,Kristin,F,-37.76,144.95,,,,,,,debit,posted,479710ad21514466b2963328cefc9d64,PAYMENT,40-50,2018,10,4,8,0,Thursday,7 days,55690.657
ACC-2776252858,43,28.35,7144.64,1.0,CUS-4123612273,2018-10-05,Kristin,F,-37.76,144.95,,2bdbc3a1-f120-4a70-879f-f4817a8a72fb,-37.89,145.09,VIC,Oakleigh,debit,authorized,b6df96593b2b41d29bb6119e2c2dc005,POS,40-50,2018,10,5,9,31,Friday,7 days,55690.657
ACC-2776252858,43,34.37,7110.27,0.0,CUS-4123612273,2018-10-05,Kristin,F,-37.76,144.95,,42786090-6d1c-49fc-aad2-ddd82c1075a6,-37.86,144.99,VIC,Windsor,debit,authorized,910761accddc4dee9c0352f454992948,SALES-POS,40-50,2018,10,5,9,55,Friday,7 days,55690.657
ACC-2776252858,43,124.0,6986.27,,CUS-4123612273,2018-10-05,Kristin,F,-37.76,144.95,,,,,,,debit,posted,d25b8b7d371e43f3afd56074fad364b4,PAYMENT,40-50,2018,10,5,18,0,Friday,7 days,55690.657
ACC-2776252858,43,7.94,6978.33,0.0,CUS-4123612273,2018-10-06,Kristin,F,-37.76,144.95,,7941c931-b86c-420b-b820-9ebf0c4effb9,-37.81,144.98,VIC,Collingwood,debit,authorized,1a6c6eb644f84bcc90c9eec5b75dfe48,SALES-POS,40-50,2018,10,6,15,22,Saturday,7 days,55690.657
ACC-2776252858,43,19.14,6959.19,0.0,CUS-4123612273,2018-10-06,Kristin,F,-37.76,144.95,,489d0f87-45fe-4b48-9899-d85d30d621f5,-37.77,144.89,VIC,Maribyrnong,debit,authorized,8fb3cecd618f4849aeff43401f42dc17,SALES-POS,40-50,2018,10,6,17,46,Saturday,7 days,55690.657
ACC-2776252858,43,29.0,6930.19,,CUS-4123612273,2018-10-10,Kristin,F,-37.76,144.95,,,,,,,debit,posted,71d90b1147fb4a6bb70c22adcbe9cd7e,PAYMENT,40-50,2018,10,10,6,0,Wednesday,7 days,55690.657
ACC-2776252858,43,43.0,7955.23,,CUS-4123612273,2018-10-11,Kristin,F,-37.76,144.95,,,,,,,debit,posted,f6f38f5f068d4bfd8736f3c9a8ff663a,PAYMENT,40-50,2018,10,11,8,0,Thursday,7 days,55690.657
ACC-2776252858,43,178.0,7777.23,,CUS-4123612273,2018-10-12,Kristin,F,-37.76,144.95,,,,,,,debit,posted,e4633a539e684d3eb278f1529b9702a7,PAYMENT,40-50,2018,10,12,19,0,Friday,7 days,55690.657
ACC-2776252858,43,29.0,7748.23,,CUS-4123612273,2018-10-17,Kristin,F,-37.76,144.95,,,,,,,debit,posted,ab33cb9d44654e56b6b9ef1196609923,PAYMENT,40-50,2018,10,17,6,0,Wednesday,7 days,55690.657
ACC-2776252858,43,43.0,8773.27,,CUS-4123612273,2018-10-18,Kristin,F,-37.76,144.95,,,,,,,debit,posted,a3bb8d9cfeac4081bfbd02acdb7514f7,PAYMENT,40-50,2018,10,18,8,0,Thursday,7 days,55690.657
ACC-2776252858,43,29.0,8744.27,,CUS-4123612273,2018-10-24,Kristin,F,-37.76,144.95,,,,,,,debit,posted,ffcb83fc26b14b1fa859449ef69330a5,PAYMENT,40-50,2018,10,24,6,0,Wednesday,7 days,55690.657
ACC-2776252858,43,43.0,9769.31,,CUS-4123612273,2018-10-25,Kristin,F,-37.76,144.95,,,,,,,debit,posted,d34af01583e6438cbc0dc850eaa95f9d,PAYMENT,40-50,2018,10,25,8,0,Thursday,7 days,55690.657
ACC-2776252858,43,25.1,9744.21,1.0,CUS-4123612273,2018-10-26,Kristin,F,-37.76,144.95,,56ab0ba2-6cad-47af-9805-5487aac6381c,-37.88,145.08,VIC,Chadstone,debit,authorized,343395be1de7448e8147355a187db574,POS,40-50,2018,10,26,12,10,Friday,7 days,55690.657
ACC-2776252858,43,22.28,9721.93,1.0,CUS-4123612273,2018-10-26,Kristin,F,-37.76,144.95,,2735c3d5-de46-422e-a7ca-d7c55067f463,-37.77,144.92,VIC,Ascot Vale,debit,authorized,0e0b7d6ff20640e8aa1bfd415d2b9d57,SALES-POS,40-50,2018,10,26,13,43,Friday,7 days,55690.657
ACC-2776252858,43,230.87,9491.06,1.0,CUS-4123612273,2018-10-26,Kristin,F,-37.76,144.95,,39b7084c-a744-4a51-8a37-379b2f787840,-37.76,145.34,VIC,Lilydale,debit,authorized,9c0d93fddec743b0bbb4eaef19345679,POS,40-50,2018,10,26,14,9,Friday,7 days,55690.657
ACC-2776252858,43,5.69,9485.37,1.0,CUS-4123612273,2018-10-26,Kristin,F,-37.76,144.95,,ad76709f-5c58-4d80-bca9-01383e3686d9,-37.75,144.75,VIC,Burnside,debit,authorized,4d67d4944b13459897b9686b0151fd0d,SALES-POS,40-50,2018,10,26,14,26,Friday,7 days,55690.657
ACC-2776252858,43,27.26,9458.11,0.0,CUS-4123612273,2018-10-26,Kristin,F,-37.76,144.95,,97c7c248-0737-4906-b710-29fe04f36e5b,-37.59,140.35,SA,Millicent,debit,authorized,2371e9f7c9524daba603d9ae9d2c0ace,SALES-POS,40-50,2018,10,26,14,44,Friday,7 days,55690.657
ACC-2776252858,43,33.28,9424.83,1.0,CUS-4123612273,2018-10-26,Kristin,F,-37.76,144.95,,a063e596-233a-4c00-a910-8dfbf146ecca,-37.76,145.31,VIC,Chirnside Park,debit,authorized,5d9ffc8b749942fca133c6926935246a,POS,40-50,2018,10,26,14,52,Friday,7 days,55690.657
ACC-2776252858,43,46.03,9378.8,1.0,CUS-4123612273,2018-10-26,Kristin,F,-37.76,144.95,,9b1722df-eefd-4789-94d5-9b436c2524f4,-37.77,144.89,VIC,Maribyrnong,debit,authorized,cff49d1ae1e647c19a1398c821a1c448,POS,40-50,2018,10,26,15,40,Friday,7 days,55690.657
ACC-2776252858,43,51.42,9327.38,1.0,CUS-4123612273,2018-10-26,Kristin,F,-37.76,144.95,,cd32bde7-1b61-404e-b093-3ba8ed7f5ebf,-37.83,140.79,SA,Mount Gambier,debit,authorized,9bb95b1504c649ffa55e89ca052cf7c2,SALES-POS,40-50,2018,10,26,16,17,Friday,7 days,55690.657
ACC-2776252858,43,30.85,9296.53,1.0,CUS-4123612273,2018-10-26,Kristin,F,-37.76,144.95,,a91d611a-3bf1-4eec-9c7f-640426690c37,-37.79,145.13,VIC,Doncaster,debit,authorized,e30ea99df5354cb282b663c8e640b06a,POS,40-50,2018,10,26,16,51,Friday,7 days,55690.657
ACC-2776252858,43,12.98,9283.55,0.0,CUS-4123612273,2018-10-26,Kristin,F,-37.76,144.95,,c1a1ae9e-b5c1-4982-ac03-2f129f909a1f,-37.82,144.96,VIC,Melbourne,debit,authorized,7582ca8951964c3f9c3c4c679de4eb19,POS,40-50,2018,10,26,17,25,Friday,7 days,55690.657
ACC-2776252858,43,46.46,9237.09,1.0,CUS-4123612273,2018-10-26,Kristin,F,-37.76,144.95,,5b6c51c7-5794-46d6-98cb-a6fbf53fb1a4,-37.82,144.96,VIC,Melbourne,debit,authorized,2e2c0c19aa464d6685e2139696b965d6,SALES-POS,40-50,2018,10,26,18,59,Friday,7 days,55690.657
ACC-2776252858,43,16.97,9220.12,1.0,CUS-4123612273,2018-10-26,Kristin,F,-37.76,144.95,,d39ef731-28df-4327-af7a-8ef42b3d80ed,-37.83,144.97,VIC,South Melbourne,debit,authorized,73bb2244f42349fd95afcd8d9104d4b7,POS,40-50,2018,10,26,19,59,Friday,7 days,55690.657
ACC-2776252858,43,145.54,9074.58,1.0,CUS-4123612273,2018-10-26,Kristin,F,-37.76,144.95,,3d9139b3-bca9-4de6-a061-5d1a19c297d4,-37.89,145.08,VIC,Chadstone,debit,authorized,2272263419ba46c99d7798fab4738490,SALES-POS,40-50,2018,10,26,20,38,Friday,7 days,55690.657
ACC-2776252858,43,42.82,9031.76,1.0,CUS-4123612273,2018-10-26,Kristin,F,-37.76,144.95,,cff268f2-26d4-4dcc-bb01-f2063c3b4f5f,-37.89,145.08,VIC,Chadstone,debit,authorized,8e1ee1dc0fbf4770a8be78b5cf6a1547,POS,40-50,2018,10,26,21,11,Friday,7 days,55690.657
ACC-2776252858,43,9.06,9022.7,1.0,CUS-4123612273,2018-10-27,Kristin,F,-37.76,144.95,,7bbab947-6acd-4cea-a213-bbea93fcb2df,-37.76,144.8,VIC,Saint Albans,debit,authorized,90800f0b66e74aa9b833af8de15d8e94,SALES-POS,40-50,2018,10,27,20,35,Saturday,7 days,55690.657
ACC-2776252858,43,13.64,9009.06,1.0,CUS-4123612273,2018-10-27,Kristin,F,-37.76,144.95,,bfae0e11-02bb-4610-b23b-d537c40a5cbc,-37.82,144.96,VIC,Southbank,debit,authorized,e0d88dce2bc04a278484997dcaf9dba9,POS,40-50,2018,10,27,20,48,Saturday,7 days,55690.657
ACC-2776252858,43,18.59,8990.47,1.0,CUS-4123612273,2018-10-27,Kristin,F,-37.76,144.95,,e3240976-c27a-481f-9776-cd22137192c8,-37.88,145.17,VIC,Glen Waverley,debit,authorized,0ddd16bbb45a412398007d61387af64b,POS,40-50,2018,10,27,21,15,Saturday,7 days,55690.657
ACC-2776252858,43,17.07,8973.4,0.0,CUS-4123612273,2018-10-27,Kristin,F,-37.76,144.95,,f0ece916-5c91-422d-8492-aedcb18f5503,-37.84,145.09,VIC,Surrey Hills,debit,authorized,b7974ddaea864cc992598cdc8c6e1633,POS,40-50,2018,10,27,21,33,Saturday,7 days,55690.657
ACC-2776252858,43,21.15,8952.25,1.0,CUS-4123612273,2018-10-28,Kristin,F,-37.76,144.95,,2bb83608-ef9b-4d99-be40-c432adba2589,-37.79,145.14,VIC,Doncaster,debit,authorized,be5346cee55e4714a7554095e45596e9,SALES-POS,40-50,2018,10,28,3,27,Sunday,7 days,55690.657
ACC-2776252858,43,33.29,8918.96,1.0,CUS-4123612273,2018-10-28,Kristin,F,-37.76,144.95,,f26401e1-93c1-4dc9-92e2-79cd25e902e2,-33.77,151.26,NSW,Brookvale,debit,authorized,a83b4d90dc62453095b41de825ae0e99,SALES-POS,40-50,2018,10,28,5,39,Sunday,7 days,55690.657
ACC-2776252858,43,323.75,8595.21,1.0,CUS-4123612273,2018-10-28,Kristin,F,-37.76,144.95,,74df394f-b073-43a8-9156-92c99cfd5f8c,-37.76,145.31,VIC,Chirnside Park,debit,authorized,e16885e6b43e47cc911fb25ad09704b0,SALES-POS,40-50,2018,10,28,9,21,Sunday,7 days,55690.657
ACC-2776252858,43,8.15,8587.06,1.0,CUS-4123612273,2018-10-28,Kristin,F,-37.76,144.95,,fbf100b9-eee6-4319-a630-37e7026ccec1,-37.79,145.13,VIC,Doncaster,debit,authorized,785972c146cb416c8077849a7e4d0d04,SALES-POS,40-50,2018,10,28,17,38,Sunday,7 days,55690.657
ACC-2776252858,43,33.75,8553.31,1.0,CUS-4123612273,2018-10-28,Kristin,F,-37.76,144.95,,ced48b22-c1bd-4e46-a5f9-2c38832081df,-37.75,144.91,VIC,Essendon,debit,authorized,657c4427b7b146b7a50cbea5aa6effa5,SALES-POS,40-50,2018,10,28,17,57,Sunday,7 days,55690.657
ACC-2776252858,43,79.7,8473.61,0.0,CUS-4123612273,2018-10-28,Kristin,F,-37.76,144.95,,2761b4f0-0f3e-4771-9f13-f2e4ff54bc4e,-37.76,144.92,VIC,Moonee Ponds,debit,authorized,e8a2cdce9f524175bd4f3c9a22c8acc4,SALES-POS,40-50,2018,10,28,19,13,Sunday,7 days,55690.657
ACC-2776252858,43,16.89,8456.72,1.0,CUS-4123612273,2018-10-28,Kristin,F,-37.76,144.95,,f10a94c3-f85d-41f8-82f3-a92bc26a7e35,-37.79,145.28,VIC,Croydon,debit,authorized,c6e97a13c42048c785884f0218b67049,POS,40-50,2018,10,28,19,38,Sunday,7 days,55690.657
ACC-2776252858,43,18.7,8438.02,1.0,CUS-4123612273,2018-10-28,Kristin,F,-37.76,144.95,,888ec897-4dcc-4725-9ea2-26956c7dfd1f,-37.78,145,VIC,Northcote,debit,authorized,2dcc6679ba3e4f9c834e95206805c9f8,SALES-POS,40-50,2018,10,28,19,51,Sunday,7 days,55690.657
ACC-2776252858,43,29.35,8408.67,1.0,CUS-4123612273,2018-10-28,Kristin,F,-37.76,144.95,,41d4cf17-1cd8-4b2c-a8d0-1e3bad86aef5,-37.79,145.13,VIC,Doncaster,debit,authorized,3b6c74cf102c414b85346be1da490abe,SALES-POS,40-50,2018,10,28,20,15,Sunday,7 days,55690.657
ACC-2776252858,43,74.57,8334.1,0.0,CUS-4123612273,2018-10-28,Kristin,F,-37.76,144.95,,fd372897-1e23-436a-9a72-92a685570e3f,-37.76,145.3,VIC,Chirnside Park,debit,authorized,d0961a5bd3a44f99bfad505eb086ca4a,POS,40-50,2018,10,28,20,28,Sunday,7 days,55690.657
ACC-2776252858,43,18.37,8315.73,1.0,CUS-4123612273,2018-10-28,Kristin,F,-37.76,144.95,,80e385f5-f9c6-459e-9b35-84fa988fd982,-37.76,145.36,VIC,Lilydale,debit,authorized,a28ff4a553934502839d42d42231a038,SALES-POS,40-50,2018,10,28,20,41,Sunday,7 days,55690.657
ACC-2776252858,43,35.28,8280.45,0.0,CUS-4123612273,2018-10-28,Kristin,F,-37.76,144.95,,783984fa-44e9-49e0-abda-9101b10a4e2c,-37.87,145.17,VIC,Glen Waverley,debit,authorized,18b3e3334a954de9a9cdc6d9de98673b,SALES-POS,40-50,2018,10,28,20,48,Sunday,7 days,55690.657
ACC-2776252858,43,15.64,8264.81,1.0,CUS-4123612273,2018-10-28,Kristin,F,-37.76,144.95,,e6ee50e6-09fe-4ee6-9fbc-c9e8f7376a03,-37.89,145.08,VIC,Chadstone,debit,authorized,f65cdd20a6874caa89d30d04aedb67ae,POS,40-50,2018,10,28,21,0,Sunday,7 days,55690.657
ACC-2776252858,43,12.04,8252.77,1.0,CUS-4123612273,2018-10-28,Kristin,F,-37.76,144.95,,6eb62c10-2845-4d88-900a-4be92df6646d,-37.76,145.35,VIC,Lilydale,debit,authorized,54068866fac64bcdab7dd55c588cdabc,POS,40-50,2018,10,28,21,5,Sunday,7 days,55690.657
ACC-2776252858,43,12.55,8240.22,0.0,CUS-4123612273,2018-10-29,Kristin,F,-37.76,144.95,,bf86eded-cb96-44ca-8af1-8f0d30ef874c,-37.81,145.23,VIC,Ringwood,debit,authorized,f9fc2a5aac664e14986ebb48c993a872,SALES-POS,40-50,2018,10,29,11,19,Monday,7 days,55690.657
ACC-2776252858,43,15.9,8224.32,1.0,CUS-4123612273,2018-10-29,Kristin,F,-37.76,144.95,,66c00c79-11a0-4c11-af28-a31a40931a90,-37.78,145.13,VIC,Doncaster,debit,authorized,717ea62e94ed45c7a91d39500e5ae8cf,POS,40-50,2018,10,29,11,41,Monday,7 days,55690.657
ACC-2776252858,43,47.12,8177.2,1.0,CUS-4123612273,2018-10-29,Kristin,F,-37.76,144.95,,635f047e-65f0-4c24-8596-9ef6c1df36fb,-37.85,145.06,VIC,Camberwell,debit,authorized,9ee2ff5b9cd445cba81f185fa18db36e,SALES-POS,40-50,2018,10,29,20,59,Monday,7 days,55690.657
ACC-2776252858,43,25.76,8151.44,0.0,CUS-4123612273,2018-10-30,Kristin,F,-37.76,144.95,,90f629b8-20c4-42ee-b4b3-20e2bad655c3,-37.74,145.03,VIC,Preston,debit,authorized,c3525a6bddef481f877c7135060339d1,SALES-POS,40-50,2018,10,30,8,37,Tuesday,7 days,55690.657
ACC-2776252858,43,111.3,8040.14,1.0,CUS-4123612273,2018-10-30,Kristin,F,-37.76,144.95,,7a9c57e3-5d01-430c-bd41-6a6ff7739d49,-37.76,145.31,VIC,Vic,debit,authorized,d08703d9f71a4253a32d75ad4c29ac9d,POS,40-50,2018,10,30,9,0,Tuesday,7 days,55690.657
ACC-2776252858,43,29.45,8010.69,1.0,CUS-4123612273,2018-10-30,Kristin,F,-37.76,144.95,,df08814b-3453-493e-8e5f-067ea52e1c22,-37.75,145.35,VIC,Lilydale,debit,authorized,81df97dbf7054b0697ca96202fc37c50,POS,40-50,2018,10,30,9,37,Tuesday,7 days,55690.657
ACC-2776252858,43,8.32,8002.37,1.0,CUS-4123612273,2018-10-30,Kristin,F,-37.76,144.95,,a4092296-7e77-40fb-937a-8f65b784ba31,-37.85,144.99,VIC,South Yarra,debit,authorized,dbe53aa647b74ea187a69fc2ecaa0336,POS,40-50,2018,10,30,9,46,Tuesday,7 days,55690.657
ACC-2776252858,43,12.92,7989.45,1.0,CUS-4123612273,2018-10-30,Kristin,F,-37.76,144.95,,5f2ebd5a-90e6-4da5-abbe-c793ad5249cb,-37.8,144.96,VIC,Carlton,debit,authorized,9831957b818f4b4798007a2bf73ad5c0,SALES-POS,40-50,2018,10,30,20,22,Tuesday,7 days,55690.657
ACC-2776252858,43,29.0,7960.45,,CUS-4123612273,2018-10-31,Kristin,F,-37.76,144.95,,,,,,,debit,posted,dfd2eaea5b144450bf43561a13523cc4,PAYMENT,40-50,2018,10,31,6,0,Wednesday,7 days,55690.657
ACC-2776252858,43,79.92,7880.53,1.0,CUS-4123612273,2018-10-31,Kristin,F,-37.76,144.95,,f2111cef-4de4-45c7-8bb5-17639c3d5662,-37.82,144.96,VIC,Melbourne,debit,authorized,60006099046646f4b7d114cbe6356dda,SALES-POS,40-50,2018,10,31,7,48,Wednesday,7 days,55690.657
ACC-2776252858,43,14.08,7866.45,1.0,CUS-4123612273,2018-10-31,Kristin,F,-37.76,144.95,,3b720485-62cb-4403-b4ad-393db5710178,-37.82,145.12,VIC,Box Hill,debit,authorized,cda42b6871614b48887116d39dc76c35,SALES-POS,40-50,2018,10,31,9,7,Wednesday,7 days,55690.657
ACC-2776252858,43,29.84,7836.61,0.0,CUS-4123612273,2018-10-31,Kristin,F,-37.76,144.95,,1c251a8c-fe61-46bf-a244-cbee5c10c059,-37.75,145.34,VIC,Lilydale,debit,authorized,2a9ed360e4524a2591a52c41f3cf82d9,SALES-POS,40-50,2018,10,31,9,24,Wednesday,7 days,55690.657
ACC-2776252858,43,21.06,7815.55,0.0,CUS-4123612273,2018-10-31,Kristin,F,-37.76,144.95,,5cfe3257-cb88-41cd-8033-8294080612f6,-37.82,145.04,VIC,Hawthorn,debit,authorized,296a176435d04983914f0cb5aac0b6e6,SALES-POS,40-50,2018,10,31,9,36,Wednesday,7 days,55690.657
ACC-2776252858,43,24.17,7791.38,0.0,CUS-4123612273,2018-10-31,Kristin,F,-37.76,144.95,,74611835-59f8-439f-a409-15436fb64d57,-37.89,145.08,VIC,Chadstone,debit,authorized,6ce420de43fc442bbaa7dee472b881d1,SALES-POS,40-50,2018,10,31,9,41,Wednesday,7 days,55690.657
ACC-182446574,27,19.25,213.16,1.0,CUS-3026014945,2018-08-01,Tonya,F,-32.00,116.06,,cfbf535e-caa8-499f-9d41-bbdc2b836d85,-31.9,115.85,WA,Yokine,debit,authorized,799e39eb2c1b411185424b0f2cd18bda,POS,20-30,2018,8,1,4,40,Wednesday,14 days,74046.768
ACC-182446574,27,6.08,207.08,1.0,CUS-3026014945,2018-08-01,Tonya,F,-32.00,116.06,,33952b07-859c-4c0a-8b1d-813a5f6b444c,-32.13,115.86,WA,Cockburn Central,debit,authorized,9ba4928260b24fbb8fb00f1f8d86b868,SALES-POS,20-30,2018,8,1,6,6,Wednesday,14 days,74046.768
ACC-182446574,27,57.0,150.08,,CUS-3026014945,2018-08-01,Tonya,F,-32.00,116.06,,,,,,,debit,posted,f14720cc84d24bac8b9987a127c07842,INTER BANK,20-30,2018,8,1,12,0,Wednesday,14 days,74046.768
ACC-182446574,27,33.0,117.08,,CUS-3026014945,2018-08-01,Tonya,F,-32.00,116.06,,,,,,,debit,posted,11493f0afc4348139f996e154f61a98b,INTER BANK,20-30,2018,8,1,20,0,Wednesday,14 days,74046.768
ACC-182446574,27,50.93,66.15,1.0,CUS-3026014945,2018-08-02,Tonya,F,-32.00,116.06,,7e0fa6aa-b48a-4d55-afed-ff2034fda51c,-27.39,153.07,QLD,Northgate,debit,authorized,7d7a3ecfe31d48c9af9d48da3c066a3f,POS,20-30,2018,8,2,14,33,Thursday,14 days,74046.768
ACC-182446574,27,16.4,49.75,0.0,CUS-3026014945,2018-08-03,Tonya,F,-32.00,116.06,,326be4c0-2e6d-4b4a-bc3d-c26abe723c9f,-32.06,115.78,WA,Hilton,debit,authorized,8508fae48e0b4a00992af6c96e6e7674,SALES-POS,20-30,2018,8,3,15,22,Friday,14 days,74046.768
ACC-182446574,27,87.5,2802.4,1.0,CUS-3026014945,2018-08-03,Tonya,F,-32.00,116.06,,fea17a61-9938-4b3a-9dd4-60f242f132ff,-32.02,115.94,WA,Cannington,debit,authorized,c3874e3166ad4b2e9e27a6066e023f4a,SALES-POS,20-30,2018,8,3,17,19,Friday,14 days,74046.768
ACC-182446574,27,27.26,2775.14,1.0,CUS-3026014945,2018-08-04,Tonya,F,-32.00,116.06,,7a696b6f-7586-4d4d-a2c6-e32904de84dd,-32.13,133.67,SA,Ceduna,debit,authorized,416d3f1306bc4b92bcd10f10e81244a1,SALES-POS,20-30,2018,8,4,10,54,Saturday,14 days,74046.768
ACC-182446574,27,25.07,2750.07,1.0,CUS-3026014945,2018-08-04,Tonya,F,-32.00,116.06,,efa1497d-0e04-4af4-a0da-155d4986fc62,-32.01,115.87,WA,Manning,debit,authorized,a4afc2964ffb43f2b510d3a25af8e436,POS,20-30,2018,8,4,16,37,Saturday,14 days,74046.768
ACC-182446574,27,12.19,2737.88,1.0,CUS-3026014945,2018-08-04,Tonya,F,-32.00,116.06,,92ca67e5-9685-4f4f-b6b3-31e5aa2d929b,-31.85,115.88,WA,Ballajura,debit,authorized,f43fd9a45a3941d3966420c55a0ee864,POS,20-30,2018,8,4,17,40,Saturday,14 days,74046.768
ACC-182446574,27,13.99,2723.89,0.0,CUS-3026014945,2018-08-04,Tonya,F,-32.00,116.06,,e6514a3f-0474-4dc3-9362-2d194de84bb2,-31.94,115.86,WA,West Perth,debit,authorized,8bdf71f66d6449aa9d9dd79eadff7c92,POS,20-30,2018,8,4,20,7,Saturday,14 days,74046.768
ACC-182446574,27,1.9,2721.99,1.0,CUS-3026014945,2018-08-04,Tonya,F,-32.00,116.06,,0573359a-48af-4d38-a1a0-00d115cb2654,-31.91,152.46,NSW,Taree,debit,authorized,a516e15ef543435f9f59e3d667e9f8b1,SALES-POS,20-30,2018,8,4,21,6,Saturday,14 days,74046.768
ACC-182446574,27,11.61,2710.38,0.0,CUS-3026014945,2018-08-04,Tonya,F,-32.00,116.06,,04492b94-5be6-42f0-a8fa-93bc4c0f0e56,-32.13,115.86,WA,Success,debit,authorized,75117376f5254db3be85f238f49263a7,SALES-POS,20-30,2018,8,4,21,54,Saturday,14 days,74046.768
ACC-182446574,27,17.32,2693.06,1.0,CUS-3026014945,2018-08-04,Tonya,F,-32.00,116.06,,4d1c882d-8b38-4de0-8b1d-c486d2202d2e,-32.01,151.96,NSW,Gloucester,debit,authorized,ed8ce184b93e40ca95ee9ebb542f41cb,POS,20-30,2018,8,4,22,48,Saturday,14 days,74046.768
ACC-182446574,27,13.43,2679.63,1.0,CUS-3026014945,2018-08-05,Tonya,F,-32.00,116.06,,1c79244e-7971-4812-9454-9f59f86e8abe,-31.96,115.93,WA,Perth,debit,authorized,6483b048fa28401a8cc80aff929eb4da,POS,20-30,2018,8,5,8,16,Sunday,14 days,74046.768
ACC-182446574,27,19.31,2660.32,1.0,CUS-3026014945,2018-08-05,Tonya,F,-32.00,116.06,,6642cf46-39c7-4ba7-b569-48b009167efb,-31.93,115.77,WA,City Beach,debit,authorized,334f90e8f2b142f3b0b0aa4b518b3da2,SALES-POS,20-30,2018,8,5,10,55,Sunday,14 days,74046.768
ACC-182446574,27,23.46,2636.86,0.0,CUS-3026014945,2018-08-07,Tonya,F,-32.00,116.06,,44576f00-435b-40e4-8b09-f28c74bbd6fb,-31.9,115.8,WA,Innaloo,debit,authorized,de4a700d10dc4fccacf3994e6e35fdf2,SALES-POS,20-30,2018,8,7,9,46,Tuesday,14 days,74046.768
ACC-182446574,27,23.15,2613.71,1.0,CUS-3026014945,2018-08-07,Tonya,F,-32.00,116.06,,c4c29ae3-f5a9-425d-a0a5-89a6bd2e1602,-32.13,115.86,WA,Success,debit,authorized,7e4faa2308eb47609086a312845db9a2,POS,20-30,2018,8,7,10,47,Tuesday,14 days,74046.768
ACC-182446574,27,9.63,2604.08,1.0,CUS-3026014945,2018-08-07,Tonya,F,-32.00,116.06,,cec1a590-3bfa-476d-a9bb-3bb1b3b9b334,-31.95,141.46,NSW,Broken Hill,debit,authorized,d62c167b992c4b0dbcb36050fda8dcac,POS,20-30,2018,8,7,11,59,Tuesday,14 days,74046.768
ACC-182446574,27,7.26,2596.82,0.0,CUS-3026014945,2018-08-07,Tonya,F,-32.00,116.06,,cc7d0bfd-af8f-4acf-8f86-e135efff15c0,-31.97,115.82,WA,Nedlands,debit,authorized,221a27afee3f4a7d972e9fef1817025f,SALES-POS,20-30,2018,8,7,14,19,Tuesday,14 days,74046.768
ACC-182446574,27,24.24,2572.58,0.0,CUS-3026014945,2018-08-08,Tonya,F,-32.00,116.06,,8903276f-a31e-4df4-9f40-9c8e62d69a87,-32.15,116.01,WA,Armadale,debit,authorized,674d298ac94e4c06846ce2bfa722ed08,POS,20-30,2018,8,8,11,44,Wednesday,14 days,74046.768
ACC-182446574,27,57.0,2515.58,,CUS-3026014945,2018-08-08,Tonya,F,-32.00,116.06,,,,,,,debit,posted,53a8e67dcbbd43f5af96e05e6dbd5af3,INTER BANK,20-30,2018,8,8,12,0,Wednesday,14 days,74046.768
ACC-182446574,27,11.87,2503.71,1.0,CUS-3026014945,2018-08-08,Tonya,F,-32.00,116.06,,bd203b6a-c5d6-405b-8ecf-525851911ccc,-31.96,115.94,WA,Cloverdale,debit,authorized,e1e9982b080f41c2866caf09d13b2d62,SALES-POS,20-30,2018,8,8,15,54,Wednesday,14 days,74046.768
ACC-182446574,27,20.74,2482.97,1.0,CUS-3026014945,2018-08-08,Tonya,F,-32.00,116.06,,eb626c02-dcce-4c1b-9227-4866494b8c37,-32.01,116.05,WA,Lesmurdie,debit,authorized,998d9f0377764dca87edee6ad8a847b7,SALES-POS,20-30,2018,8,8,18,31,Wednesday,14 days,74046.768
ACC-182446574,27,33.0,2449.97,,CUS-3026014945,2018-08-08,Tonya,F,-32.00,116.06,,,,,,,debit,posted,646f7696d308490b90ead8a8f9c53295,INTER BANK,20-30,2018,8,8,20,0,Wednesday,14 days,74046.768
ACC-182446574,27,16.52,2433.45,1.0,CUS-3026014945,2018-08-09,Tonya,F,-32.00,116.06,,428f9cbe-9d7a-41b8-af5b-a9fa0cf63866,-31.79,132.23,SA,Coorabie,debit,authorized,9d049acc04ad4df59e28284b91a9a7dc,SALES-POS,20-30,2018,8,9,23,38,Thursday,14 days,74046.768
ACC-182446574,27,26.8,2406.65,1.0,CUS-3026014945,2018-08-10,Tonya,F,-32.00,116.06,,7a696b6f-7586-4d4d-a2c6-e32904de84dd,-32.13,133.67,SA,Ceduna,debit,authorized,1893dfe26c2e48cb900b3a3cb11c28e6,POS,20-30,2018,8,10,8,10,Friday,14 days,74046.768
ACC-182446574,27,27.81,2378.84,1.0,CUS-3026014945,2018-08-10,Tonya,F,-32.00,116.06,,1cd50a6b-6654-4371-b16d-30db7e692030,-31.89,115.76,WA,Scarborough,debit,authorized,a47a2f752ec94c4792669cacc9018b6a,SALES-POS,20-30,2018,8,10,11,14,Friday,14 days,74046.768
ACC-182446574,27,8.49,2370.35,0.0,CUS-3026014945,2018-08-10,Tonya,F,-32.00,116.06,,468874b6-36c3-4159-a16e-347654ab3553,-32.08,115.78,WA,Hamilton Hill,debit,authorized,6b76537987d44a0db3c50a4aee4cdcf2,SALES-POS,20-30,2018,8,10,11,30,Friday,14 days,74046.768
ACC-182446574,27,22.76,2347.59,1.0,CUS-3026014945,2018-08-10,Tonya,F,-32.00,116.06,,f0f1080d-6b9b-4667-9e9f-49293bc413d3,-32.21,115.98,WA,Byford,debit,authorized,d32599a5fd904fd2aaa55b812a9785cc,SALES-POS,20-30,2018,8,10,12,5,Friday,14 days,74046.768
ACC-182446574,27,16.63,2330.96,1.0,CUS-3026014945,2018-08-10,Tonya,F,-32.00,116.06,,57f9b86b-93ea-424e-8321-1a1bad8271b1,-31.98,115.79,WA,Nedlands,debit,authorized,f9142cc5129245d5a5bcf32f6452d784,POS,20-30,2018,8,10,18,35,Friday,14 days,74046.768
ACC-182446574,27,30.15,2300.81,0.0,CUS-3026014945,2018-08-10,Tonya,F,-32.00,116.06,,4e38139b-8dcf-4969-9abc-d9393b008c19,-31.99,115.75,WA,Cottesloe,debit,authorized,75fb65cc10954976916b8c0291b0d019,SALES-POS,20-30,2018,8,10,19,8,Friday,14 days,74046.768
ACC-182446574,27,28.55,2272.26,1.0,CUS-3026014945,2018-08-10,Tonya,F,-32.00,116.06,,b2bfeb0c-0b50-493e-a1e4-bd6c571b22a6,-37.81,144.97,VIC,Melbourne,debit,authorized,d223b6d76080491e911886dcc0ac006c,SALES-POS,20-30,2018,8,10,19,28,Friday,14 days,74046.768
ACC-182446574,27,29.96,2242.3,1.0,CUS-3026014945,2018-08-11,Tonya,F,-32.00,116.06,,b5dafea0-f033-4a58-9fdf-3dc6f0d9943f,-31.88,115.87,WA,Dianella,debit,authorized,e855d89bbff54c3aa606db2566d70fc3,POS,20-30,2018,8,11,1,11,Saturday,14 days,74046.768
ACC-182446574,27,68.97,2173.33,1.0,CUS-3026014945,2018-08-11,Tonya,F,-32.00,116.06,,9633dc31-66bc-4b99-b578-fba71694452c,-31.96,115.91,WA,Rivervale,debit,authorized,f2bd6176af454db9920cf44876b56118,SALES-POS,20-30,2018,8,11,9,2,Saturday,14 days,74046.768
ACC-182446574,27,24.54,2148.79,1.0,CUS-3026014945,2018-08-11,Tonya,F,-32.00,116.06,,655d968f-8957-44c9-a141-3097cfaf012e,-32.01,115.84,WA,Applecross,debit,authorized,c11887140d974023a260f12aee57306e,POS,20-30,2018,8,11,10,13,Saturday,14 days,74046.768
ACC-182446574,27,41.26,2107.53,1.0,CUS-3026014945,2018-08-11,Tonya,F,-32.00,116.06,,4a795fd2-a97a-4300-b7ba-454721ff265a,-31.97,115.85,WA,South Perth,debit,authorized,c119871bb2ce41d7a0caa36b028da4a3,POS,20-30,2018,8,11,17,8,Saturday,14 days,74046.768
ACC-182446574,27,27.09,2080.44,1.0,CUS-3026014945,2018-08-11,Tonya,F,-32.00,116.06,,bdd85de6-7375-49ba-8d1a-a00dc57c3d11,-32.16,150.89,NSW,Aberdeen,debit,authorized,ad2b8f0d69e340999f5b347f96c8cb11,SALES-POS,20-30,2018,8,11,17,53,Saturday,14 days,74046.768
ACC-182446574,27,20.95,2059.49,1.0,CUS-3026014945,2018-08-12,Tonya,F,-32.00,116.06,,ffa1638b-1de3-4d9c-a6dc-b5fe51d1a650,-32.04,115.88,WA,Willetton,debit,authorized,e9ede7b1d7a74748850040d88f43da10,SALES-POS,20-30,2018,8,12,4,24,Sunday,14 days,74046.768
ACC-182446574,27,10.9,2048.59,1.0,CUS-3026014945,2018-08-12,Tonya,F,-32.00,116.06,,958e5157-eb40-48a4-a6dc-8e049cdbddb4,-31.97,115.9,WA,East Victoria Park,debit,authorized,e98b8a57747f469c8474ccfa4c5707a0,SALES-POS,20-30,2018,8,12,9,2,Sunday,14 days,74046.768
ACC-182446574,27,22.46,2026.13,1.0,CUS-3026014945,2018-08-14,Tonya,F,-32.00,116.06,,d5d59058-2871-478d-9329-1ae2fd171cc9,-32.09,115.87,WA,Jandakot,debit,authorized,0ad8b7dad0f64a1ea2904aa096b48b1b,POS,20-30,2018,8,14,8,8,Tuesday,14 days,74046.768
ACC-182446574,27,8.31,2017.82,1.0,CUS-3026014945,2018-08-14,Tonya,F,-32.00,116.06,,0f87c224-7ca0-4b59-b160-d064713a5fe6,-31.86,115.76,WA,North Beach,debit,authorized,60b3e835c5df48e8b0f75c6edecd4a4d,POS,20-30,2018,8,14,15,15,Tuesday,14 days,74046.768
ACC-182446574,27,6.86,2010.96,1.0,CUS-3026014945,2018-08-14,Tonya,F,-32.00,116.06,,d0a5e33c-4a72-49db-b9bd-67e9f45453c2,-32.01,151.96,NSW,Gloucester,debit,authorized,9e8c6fcab89f431a9c83440bac1d461c,POS,20-30,2018,8,14,17,57,Tuesday,14 days,74046.768
ACC-182446574,27,57.0,1953.96,,CUS-3026014945,2018-08-15,Tonya,F,-32.00,116.06,,,,,,,debit,posted,72aca8ec345f4641b6c843a35eee4b51,INTER BANK,20-30,2018,8,15,12,0,Wednesday,14 days,74046.768
ACC-182446574,27,33.0,1920.96,,CUS-3026014945,2018-08-15,Tonya,F,-32.00,116.06,,,,,,,debit,posted,dcd2f60612864d469fe2d6dbc904b958,INTER BANK,20-30,2018,8,15,20,0,Wednesday,14 days,74046.768
ACC-182446574,27,21.76,1899.2,1.0,CUS-3026014945,2018-08-17,Tonya,F,-32.00,116.06,,5d340b94-d239-4bab-934e-28015baadb08,-31.91,152.46,NSW,Taree,debit,authorized,b9331c8e1041479ea87e0b16abfa7aea,SALES-POS,20-30,2018,8,17,11,9,Friday,14 days,74046.768
ACC-182446574,27,14.79,4724.56,1.0,CUS-3026014945,2018-08-17,Tonya,F,-32.00,116.06,,3e2442b6-9e5c-4c09-9782-a7139d4bfe49,-31.96,115.93,WA,Belmont,debit,authorized,beec6e40d91b4e1cb3afe60775ceda46,SALES-POS,20-30,2018,8,17,19,11,Friday,14 days,74046.768
ACC-182446574,27,6.42,4718.14,1.0,CUS-3026014945,2018-08-17,Tonya,F,-32.00,116.06,,90bb6f66-a4c7-449e-9242-a0e26209f94f,-32.12,115.92,WA,Piara Waters,debit,authorized,ead1c068504c4d0eaa1c6c06506c694d,SALES-POS,20-30,2018,8,17,20,26,Friday,14 days,74046.768
ACC-182446574,27,152.0,4548.47,,CUS-3026014945,2018-08-17,Tonya,F,-32.00,116.06,,,,,,,debit,posted,2d0c95c5acdb4fa0921ea468e4fe745f,INTER BANK,20-30,2018,8,17,23,0,Friday,14 days,74046.768
ACC-182446574,27,17.67,4700.47,1.0,CUS-3026014945,2018-08-17,Tonya,F,-32.00,116.06,,e04a7611-573b-4a2b-a954-febef3fb597e,-32.12,133.69,SA,Ceduna,debit,authorized,c3377a7ab5ed41f3a71f5903536db5ef,POS,20-30,2018,8,17,23,55,Friday,14 days,74046.768
ACC-182446574,27,25.36,4523.11,1.0,CUS-3026014945,2018-08-18,Tonya,F,-32.00,116.06,,bdd85de6-7375-49ba-8d1a-a00dc57c3d11,-32.16,150.89,NSW,Aberdeen,debit,authorized,e2c18f150cd7455680ae09bc5a78734d,POS,20-30,2018,8,18,0,6,Saturday,14 days,74046.768
ACC-182446574,27,15.56,4507.55,1.0,CUS-3026014945,2018-08-18,Tonya,F,-32.00,116.06,,69faaa73-3311-42dd-841d-0162aebf1662,-31.94,115.84,WA,Leederville,debit,authorized,5c29e2c3ccdd4beea8ac5c80a9d956a0,SALES-POS,20-30,2018,8,18,0,50,Saturday,14 days,74046.768
ACC-182446574,27,31.59,4475.96,1.0,CUS-3026014945,2018-08-18,Tonya,F,-32.00,116.06,,79b26d70-74d5-4f1c-a5d0-91650431eeac,-31.96,141.46,NSW,Broken Hill,debit,authorized,58f4dd0437d144b1a80348c2a789f52f,POS,20-30,2018,8,18,3,11,Saturday,14 days,74046.768
ACC-182446574,27,121.0,4354.96,,CUS-3026014945,2018-08-18,Tonya,F,-32.00,116.06,,,,,,,debit,posted,753af5de2c764428a67cf5787ea0c4a5,PAYMENT,20-30,2018,8,18,7,0,Saturday,14 days,74046.768
ACC-182446574,27,9.79,4345.17,1.0,CUS-3026014945,2018-08-18,Tonya,F,-32.00,116.06,,242bac79-ed26-4407-9119-6ddda7dcd18b,-31.88,115.8,WA,Gwelup,debit,authorized,65e5d196798b40d0806489ec52220d83,SALES-POS,20-30,2018,8,18,9,32,Saturday,14 days,74046.768
ACC-182446574,27,8.38,4336.79,1.0,CUS-3026014945,2018-08-18,Tonya,F,-32.00,116.06,,e41f586a-06bd-4abb-84f7-d6687b68e745,-31.93,115.84,WA,Leederville,debit,authorized,5671f9aa90d54dd29e81400bae5322f1,POS,20-30,2018,8,18,14,21,Saturday,14 days,74046.768
ACC-182446574,27,12.16,4324.63,1.0,CUS-3026014945,2018-08-18,Tonya,F,-32.00,116.06,,148877ad-7021-4558-a5a0-87fff5a0277e,-31.78,115.79,WA,Woodvale,debit,authorized,6cc11f85804a432abfb60c277f29e89b,POS,20-30,2018,8,18,20,18,Saturday,14 days,74046.768
ACC-182446574,27,17.84,4306.79,1.0,CUS-3026014945,2018-08-19,Tonya,F,-32.00,116.06,,a7a5a71f-ff43-4132-b171-d43544ed6192,-32.13,115.86,WA,Success,debit,authorized,ff246d7944104ad8b4fd12189346f56a,POS,20-30,2018,8,19,12,53,Sunday,14 days,74046.768
ACC-182446574,27,13.41,4293.38,1.0,CUS-3026014945,2018-08-19,Tonya,F,-32.00,116.06,,de9e8d67-1e9e-4964-8b10-c2b4f65135b1,-32.13,133.68,SA,Ceduna,debit,authorized,786d35d829c241d48c7e7ef24c47894f,POS,20-30,2018,8,19,14,46,Sunday,14 days,74046.768
ACC-182446574,27,23.38,4270.0,1.0,CUS-3026014945,2018-08-20,Tonya,F,-32.00,116.06,,3dc3aebb-8715-48de-9772-ce64f14da41f,-31.89,116.01,WA,Midland,debit,authorized,83b19227d7c9468cb87492e6d9f38ba1,POS,20-30,2018,8,20,9,40,Monday,14 days,74046.768
ACC-182446574,27,91.87,4178.13,1.0,CUS-3026014945,2018-08-20,Tonya,F,-32.00,116.06,,660f5b62-2cd1-44d1-93b3-5934909c059a,-38.14,145.12,VIC,Frankston,debit,authorized,a4fdf5e136e146dcbb6bc4a98321b222,POS,20-30,2018,8,20,12,33,Monday,14 days,74046.768
ACC-182446574,27,12.36,4165.77,1.0,CUS-3026014945,2018-08-21,Tonya,F,-32.00,116.06,,162b53e8-7a5c-4ca6-9e23-e05526f7313b,-31.87,115.95,WA,Beechboro,debit,authorized,6f0d2fe5ae224316bbb61d7ab860421e,POS,20-30,2018,8,21,11,5,Tuesday,14 days,74046.768
ACC-182446574,27,9.75,4156.02,0.0,CUS-3026014945,2018-08-21,Tonya,F,-32.00,116.06,,830c021b-15f5-4e7b-9369-c0071b1d8f4a,-32.02,115.84,WA,Applecross,debit,authorized,ec9f91ca94c9443baa7c2131b69a2770,SALES-POS,20-30,2018,8,21,11,30,Tuesday,14 days,74046.768
ACC-182446574,27,50.68,4105.34,1.0,CUS-3026014945,2018-08-21,Tonya,F,-32.00,116.06,,8031a689-9713-4470-a637-89f8a185c143,-31.95,115.86,WA,Perth,debit,authorized,bea5125bb7444e8e9e496a0a8c2495f2,SALES-POS,20-30,2018,8,21,13,16,Tuesday,14 days,74046.768
ACC-182446574,27,23.82,4081.52,1.0,CUS-3026014945,2018-08-21,Tonya,F,-32.00,116.06,,1fd35358-52e0-4acf-bf59-44cbff312462,-31.93,115.84,WA,Leederville,debit,authorized,3e1a516542b74e6ea31b208b9c1b1d54,POS,20-30,2018,8,21,14,38,Tuesday,14 days,74046.768
ACC-182446574,27,189.76,3891.76,1.0,CUS-3026014945,2018-08-21,Tonya,F,-32.00,116.06,,55ba0571-8c96-4c1e-abca-9deb8286569a,-31.94,115.82,WA,Wembley,debit,authorized,d3deda965e0040b7a4f8de0e64e8984e,SALES-POS,20-30,2018,8,21,16,8,Tuesday,14 days,74046.768
ACC-182446574,27,15.06,3876.7,0.0,CUS-3026014945,2018-08-21,Tonya,F,-32.00,116.06,,bb5733f6-ee08-4449-b446-d11b511c07f8,-31.99,115.91,WA,Saint James,debit,authorized,449af05edf5842069b2f04a550acbd54,SALES-POS,20-30,2018,8,21,16,30,Tuesday,14 days,74046.768
ACC-182446574,27,5.13,3871.57,0.0,CUS-3026014945,2018-08-22,Tonya,F,-32.00,116.06,,05fc9271-850d-4e62-86d0-664347d73af2,-31.94,115.85,WA,Leederville,debit,authorized,b05b675a08524860b058ffbd30997ef7,SALES-POS,20-30,2018,8,22,8,23,Wednesday,14 days,74046.768
ACC-182446574,27,13.66,3857.91,1.0,CUS-3026014945,2018-08-22,Tonya,F,-32.00,116.06,,12f91afb-c3a2-4cbf-97cf-96b7c26be0fb,-32.02,115.89,WA,Waterford,debit,authorized,0646bfd3e1ae4918a3bd243595373767,SALES-POS,20-30,2018,8,22,9,36,Wednesday,14 days,74046.768
ACC-182446574,27,57.0,3800.91,,CUS-3026014945,2018-08-22,Tonya,F,-32.00,116.06,,,,,,,debit,posted,37063b45d21b49c39507978238b00a41,INTER BANK,20-30,2018,8,22,12,0,Wednesday,14 days,74046.768
ACC-182446574,27,33.0,3767.91,,CUS-3026014945,2018-08-22,Tonya,F,-32.00,116.06,,,,,,,debit,posted,7e125579ddbf4851a1cf832b7b1ff67b,INTER BANK,20-30,2018,8,22,20,0,Wednesday,14 days,74046.768
ACC-182446574,27,22.44,3745.47,1.0,CUS-3026014945,2018-08-23,Tonya,F,-32.00,116.06,,6c84c219-96ea-4c6f-9de5-0a28bcaec62f,-32.01,152.47,NSW,Rainbow Flat,debit,authorized,b66a68ad7d5646659256d627b454cf0b,POS,20-30,2018,8,23,8,24,Thursday,14 days,74046.768
ACC-182446574,27,8.51,3736.96,0.0,CUS-3026014945,2018-08-23,Tonya,F,-32.00,116.06,,8790c38f-d212-4d49-8623-4fa698117e25,-31.85,115.87,WA,Mirrabooka,debit,authorized,f43292dd4a14487fa8804e6b43959cda,SALES-POS,20-30,2018,8,23,9,23,Thursday,14 days,74046.768
ACC-182446574,27,12.97,3723.99,1.0,CUS-3026014945,2018-08-23,Tonya,F,-32.00,116.06,,a49c26e2-89b2-423a-9efe-f9d74545fa5e,-32.03,115.84,WA,Booragoon,debit,authorized,5b75a9dd10fd406f80d562a66398e9d9,POS,20-30,2018,8,23,9,50,Thursday,14 days,74046.768
ACC-182446574,27,8.75,3715.24,0.0,CUS-3026014945,2018-08-23,Tonya,F,-32.00,116.06,,912c1695-41e4-408e-828b-1afe812d48fa,-31.9,116.17,WA,Perth,debit,authorized,8f5c62d8ab014353b65a9460c667145c,SALES-POS,20-30,2018,8,23,11,3,Thursday,14 days,74046.768
ACC-182446574,27,19.11,3696.13,1.0,CUS-3026014945,2018-08-23,Tonya,F,-32.00,116.06,,328d2ca7-f0fa-42ad-9d16-a088618fb7f8,-31.99,115.9,WA,East Victoria Park,debit,authorized,cf4906e273994c90a1c5700131c0fd51,SALES-POS,20-30,2018,8,23,15,14,Thursday,14 days,74046.768
ACC-182446574,27,298.18,3397.95,1.0,CUS-3026014945,2018-08-23,Tonya,F,-32.00,116.06,,d00d2c9a-883a-4564-806f-54b6533d5472,-33.87,151.21,NSW,Sydney,debit,authorized,9aee8945243e49aab9a694acef07059b,POS,20-30,2018,8,23,19,3,Thursday,14 days,74046.768
ACC-182446574,27,12.6,3385.35,1.0,CUS-3026014945,2018-08-23,Tonya,F,-32.00,116.06,,46afb5cd-cbea-4d31-afb9-19fe85a72bc5,-31.99,115.8,WA,Dalkeith,debit,authorized,883dd63cf3b04024b6627b69215251fc,POS,20-30,2018,8,23,22,25,Thursday,14 days,74046.768
ACC-182446574,27,25.72,3359.63,1.0,CUS-3026014945,2018-08-24,Tonya,F,-32.00,116.06,,a110d5b8-126f-494c-9231-71640252c2dc,-33.86,151.21,NSW,Dawes Point,debit,authorized,03b6a8bc5d6d4af7972ff4532601af96,SALES-POS,20-30,2018,8,24,0,39,Friday,14 days,74046.768
ACC-182446574,27,9.5,3350.13,0.0,CUS-3026014945,2018-08-24,Tonya,F,-32.00,116.06,,84c4cc4f-b4d5-488f-a381-a934a0af378e,-32.04,115.83,WA,Booragoon,debit,authorized,058e694ec59940e49e39a31bf2c910f6,SALES-POS,20-30,2018,8,24,17,19,Friday,14 days,74046.768
ACC-182446574,27,29.31,3320.82,1.0,CUS-3026014945,2018-08-24,Tonya,F,-32.00,116.06,,8f49e7a9-c5ca-4c7a-81dc-911ec5e52ba6,-37.71,145.15,VIC,Ringwood,debit,authorized,0234219695724af89dec2de4478f93a6,POS,20-30,2018,8,24,19,11,Friday,14 days,74046.768
ACC-182446574,27,32.29,3288.53,1.0,CUS-3026014945,2018-08-24,Tonya,F,-32.00,116.06,,637958b7-c372-4c38-a893-c9717e4a6ac5,-31.84,115.81,WA,Warwick,debit,authorized,47415f46230b41c5b0b251752dfc8bef,SALES-POS,20-30,2018,8,24,21,34,Friday,14 days,74046.768
ACC-182446574,27,14.96,3273.57,0.0,CUS-3026014945,2018-08-24,Tonya,F,-32.00,116.06,,eb266d38-70e2-4dc1-837b-f851512ee253,-32.02,115.84,WA,Applecross,debit,authorized,78e4eef4c4374112a928016664a75d0a,POS,20-30,2018,8,24,21,59,Friday,14 days,74046.768
ACC-182446574,27,27.58,3245.99,1.0,CUS-3026014945,2018-08-25,Tonya,F,-32.00,116.06,,b54967e0-175f-45e5-b657-264f9fe52f8e,-31.97,116.06,WA,Kalamunda,debit,authorized,49be760990f44fd9b5ae9769fb4bc812,SALES-POS,20-30,2018,8,25,4,22,Saturday,14 days,74046.768
ACC-182446574,27,17.67,3228.32,1.0,CUS-3026014945,2018-08-25,Tonya,F,-32.00,116.06,,9d639f5d-bba4-42f2-8fb6-e256127e36d6,-32.08,115.86,WA,Leeming,debit,authorized,6ed1c46431a145d9bb186aa0d07a3c40,POS,20-30,2018,8,25,14,21,Saturday,14 days,74046.768
ACC-182446574,27,27.62,3200.7,1.0,CUS-3026014945,2018-08-25,Tonya,F,-32.00,116.06,,e6bf85e7-6498-4c96-b8be-9634e444ad49,-32.03,115.84,WA,Booragoon,debit,authorized,87e632b8036345a6b4922115efb19cfb,SALES-POS,20-30,2018,8,25,17,25,Saturday,14 days,74046.768
ACC-182446574,27,57.51,3143.19,1.0,CUS-3026014945,2018-08-26,Tonya,F,-32.00,116.06,,6d81850f-bac3-4f42-b06d-c4960ef9a4e4,-31.97,115.94,WA,Belmont,debit,authorized,74ab0262419e4d559653a86f3e8ab120,POS,20-30,2018,8,26,17,29,Sunday,14 days,74046.768
ACC-182446574,27,19.52,3123.67,1.0,CUS-3026014945,2018-08-27,Tonya,F,-32.00,116.06,,cb31ac7e-24f0-48d2-bfca-0fcdac531c45,-32.08,115.81,WA,Coolbellup,debit,authorized,39d8dc3e2e6345b8b5e87082e857ded2,POS,20-30,2018,8,27,9,57,Monday,14 days,74046.768
ACC-182446574,27,194.0,2929.67,,CUS-3026014945,2018-08-27,Tonya,F,-32.00,116.06,,,,,,,debit,posted,639c44f6b4d040eebd17551a014aac3d,PAYMENT,20-30,2018,8,27,10,0,Monday,14 days,74046.768
ACC-182446574,27,20.67,2909.0,1.0,CUS-3026014945,2018-08-27,Tonya,F,-32.00,116.06,,6a994815-187b-4c67-9dd8-b51ff0292ca8,-31.87,115.81,WA,Balcatta,debit,authorized,9a717d72b1b441ecb57d5720eeabe5eb,SALES-POS,20-30,2018,8,27,11,40,Monday,14 days,74046.768
ACC-182446574,27,12.74,2896.26,1.0,CUS-3026014945,2018-08-27,Tonya,F,-32.00,116.06,,162b53e8-7a5c-4ca6-9e23-e05526f7313b,-31.87,115.95,WA,Beechboro,debit,authorized,532c73a1f1f24d029fc9e917309d8e3f,POS,20-30,2018,8,27,20,36,Monday,14 days,74046.768
ACC-182446574,27,34.48,2861.78,1.0,CUS-3026014945,2018-08-29,Tonya,F,-32.00,116.06,,f5446956-20a9-4c2f-8df8-3d93ce458ccf,-32.13,133.67,SA,Ceduna,debit,authorized,a29ddc960d804ab2a2e553f3013e530a,POS,20-30,2018,8,29,4,2,Wednesday,14 days,74046.768
ACC-182446574,27,8.93,2852.85,1.0,CUS-3026014945,2018-08-29,Tonya,F,-32.00,116.06,,36db97dd-4053-4fa2-8a4e-b2641cc236f6,-31.93,115.8,WA,Churchlands,debit,authorized,1f51ffd89c73460fb18cefbf7c23ea13,POS,20-30,2018,8,29,9,12,Wednesday,14 days,74046.768
ACC-182446574,27,19.0,2833.85,0.0,CUS-3026014945,2018-08-29,Tonya,F,-32.00,116.06,,d4819848-a051-4abd-84d3-52fe3e636292,-31.93,115.77,WA,City Beach,debit,authorized,188d57f5e589496f8eaccfb688a65b11,SALES-POS,20-30,2018,8,29,11,33,Wednesday,14 days,74046.768
ACC-182446574,27,57.0,2776.85,,CUS-3026014945,2018-08-29,Tonya,F,-32.00,116.06,,,,,,,debit,posted,9c2091f57d934f759193bb2245c6a8ec,INTER BANK,20-30,2018,8,29,12,0,Wednesday,14 days,74046.768
ACC-182446574,27,10.69,2766.16,1.0,CUS-3026014945,2018-08-29,Tonya,F,-32.00,116.06,,786bc81f-6dbf-4f71-9d70-8278c5db4028,-32.05,115.75,WA,Fremantle,debit,authorized,599beb6dc1ea4c69b24f4b7c02203a25,POS,20-30,2018,8,29,13,49,Wednesday,14 days,74046.768
ACC-182446574,27,18.02,2748.14,0.0,CUS-3026014945,2018-08-29,Tonya,F,-32.00,116.06,,4e532832-a349-4cbf-8427-8f8e698170ae,-32.13,115.86,WA,Success,debit,authorized,070a25158d12445982847fe45bba2010,POS,20-30,2018,8,29,17,48,Wednesday,14 days,74046.768
ACC-182446574,27,33.0,2715.14,,CUS-3026014945,2018-08-29,Tonya,F,-32.00,116.06,,,,,,,debit,posted,7ecbe8e8ce1149ea86cf99a699149c14,INTER BANK,20-30,2018,8,29,20,0,Wednesday,14 days,74046.768
ACC-182446574,27,13.38,2701.76,1.0,CUS-3026014945,2018-08-29,Tonya,F,-32.00,116.06,,6ecb4267-d0d9-4a3d-8336-6c41b3d4d941,-32.02,115.83,WA,Applecross,debit,authorized,31b550d3fce648dea6b2e23340a7bd3c,SALES-POS,20-30,2018,8,29,23,13,Wednesday,14 days,74046.768
ACC-182446574,27,25.73,2676.03,1.0,CUS-3026014945,2018-08-30,Tonya,F,-32.00,116.06,,c1138a8b-f026-4c0d-9c98-5c40823b0965,-31.78,115.81,WA,Wanneroo,debit,authorized,d453999c51194685ad753aeac7274f5d,SALES-POS,20-30,2018,8,30,8,47,Thursday,14 days,74046.768
ACC-182446574,27,86.63,2589.4,1.0,CUS-3026014945,2018-08-30,Tonya,F,-32.00,116.06,,a97f43c9-3ba8-4050-8242-63c80574c1af,-31.98,115.78,WA,Claremont,debit,authorized,7a31a21e0d0648f49626bf7c58c2d3d5,POS,20-30,2018,8,30,9,29,Thursday,14 days,74046.768
ACC-182446574,27,9.97,2579.43,1.0,CUS-3026014945,2018-08-30,Tonya,F,-32.00,116.06,,dd3d267a-e825-412c-b49b-650cd341f6f1,-32.09,115.92,WA,Canning Vale,debit,authorized,87a531ffd16d45228b3338c4840c2c21,POS,20-30,2018,8,30,12,22,Thursday,14 days,74046.768
ACC-182446574,27,13.52,2565.91,1.0,CUS-3026014945,2018-08-30,Tonya,F,-32.00,116.06,,de9e8d67-1e9e-4964-8b10-c2b4f65135b1,-32.13,133.68,SA,Ceduna,debit,authorized,398ce12c27954d8ab83be6aac1c20ccd,POS,20-30,2018,8,30,15,50,Thursday,14 days,74046.768
ACC-182446574,27,2.79,2563.12,1.0,CUS-3026014945,2018-08-30,Tonya,F,-32.00,116.06,,84812265-9b6e-4c7c-a438-d89ce74c9e61,-32.08,152.54,NSW,Black Head,debit,authorized,c8a56a26b1e741d48fdb4affb54bbccd,POS,20-30,2018,8,30,16,29,Thursday,14 days,74046.768
ACC-182446574,27,11.06,2552.06,1.0,CUS-3026014945,2018-08-30,Tonya,F,-32.00,116.06,,89642d1f-df43-46dc-81ba-b443a1ee32ea,-31.95,115.85,WA,Perth,debit,authorized,b5faedcfa489475c8b786195a569b4f6,SALES-POS,20-30,2018,8,30,16,56,Thursday,14 days,74046.768
ACC-182446574,27,16.34,5375.87,1.0,CUS-3026014945,2018-08-31,Tonya,F,-32.00,116.06,,8ae15cfd-7ffc-4987-8e62-c75c1b555bbd,-31.87,115.81,WA,Balcatta,debit,authorized,a7fe40ec41e34eec9e1c584cc872e570,SALES-POS,20-30,2018,8,31,16,34,Friday,14 days,74046.768
ACC-182446574,27,13.96,5361.91,1.0,CUS-3026014945,2018-08-31,Tonya,F,-32.00,116.06,,1e06835d-e4ea-4aa1-9d5c-b92692e00f39,-32.03,115.84,WA,Booragoon,debit,authorized,090d2cf257fb406488cc386aa021b59f,POS,20-30,2018,8,31,17,33,Friday,14 days,74046.768
ACC-182446574,27,20.77,5341.14,1.0,CUS-3026014945,2018-08-31,Tonya,F,-32.00,116.06,,6c84c219-96ea-4c6f-9de5-0a28bcaec62f,-32.01,152.47,NSW,Rainbow Flat,debit,authorized,dc9a439aaffa487898098795cbb4b542,SALES-POS,20-30,2018,8,31,18,17,Friday,14 days,74046.768
ACC-182446574,27,38.29,5302.85,1.0,CUS-3026014945,2018-09-01,Tonya,F,-32.00,116.06,,c6f1642d-7309-4970-a380-da4656c569ed,-31.77,115.78,WA,Edgewater,debit,authorized,8c6a446fe9ba40e38e322104e740d852,POS,20-30,2018,9,1,9,27,Saturday,14 days,74046.768
ACC-182446574,27,25.04,5277.81,1.0,CUS-3026014945,2018-09-01,Tonya,F,-32.00,116.06,,51f03efa-4903-425b-b27e-c7ecfbc7789d,-33.81,151.02,NSW,Parramatta,debit,authorized,463d007840ac44fc9947645828b77732,POS,20-30,2018,9,1,14,30,Saturday,14 days,74046.768
ACC-182446574,27,11.46,5266.35,1.0,CUS-3026014945,2018-09-01,Tonya,F,-32.00,116.06,,7fbd6363-a171-4ce6-ad92-c59fd7991396,-33.86,151.06,NSW,Lidcombe,debit,authorized,6674f480b3ea427f946081efd3bdf2a5,POS,20-30,2018,9,1,15,39,Saturday,14 days,74046.768
ACC-182446574,27,37.41,5228.94,1.0,CUS-3026014945,2018-09-01,Tonya,F,-32.00,116.06,,58cd3120-ac03-4968-9c6d-0f3523469769,-31.97,152.58,NSW,Old Bar,debit,authorized,d8878f885e3a434688ddd27e9e4e5df6,POS,20-30,2018,9,1,21,18,Saturday,14 days,74046.768
ACC-182446574,27,57.0,5171.94,,CUS-3026014945,2018-09-05,Tonya,F,-32.00,116.06,,,,,,,debit,posted,3f088da273434f02a74289ad0db67fe1,INTER BANK,20-30,2018,9,5,12,0,Wednesday,14 days,74046.768
ACC-182446574,27,33.0,5138.94,,CUS-3026014945,2018-09-05,Tonya,F,-32.00,116.06,,,,,,,debit,posted,6ccdacd304d54ae4aa835a9457eaa4b7,INTER BANK,20-30,2018,9,5,20,0,Wednesday,14 days,74046.768
ACC-182446574,27,28.05,5110.89,0.0,CUS-3026014945,2018-09-07,Tonya,F,-32.00,116.06,,f4685410-ba79-41cc-9ee0-4f73c96e5dbf,-31.9,115.8,WA,Innaloo,debit,authorized,8a72794a8095487ab77ecec693afc91d,SALES-POS,20-30,2018,9,7,10,57,Friday,14 days,74046.768
ACC-182446574,27,8.79,5102.1,1.0,CUS-3026014945,2018-09-08,Tonya,F,-32.00,116.06,,e758ba3a-533a-4896-8a7b-43497923f393,-32.05,115.75,WA,Fremantle,debit,authorized,182645e7fa2e4fd5bdfb698533963db7,SALES-POS,20-30,2018,9,8,19,29,Saturday,14 days,74046.768
ACC-182446574,27,11.34,5090.76,1.0,CUS-3026014945,2018-09-09,Tonya,F,-32.00,116.06,,cb0c671a-61ef-4a8c-b9d1-32b0a0b7da7c,-32.15,116.01,WA,Armadale,debit,authorized,cadd6245af594f79959ba3bd76393b83,POS,20-30,2018,9,9,5,45,Sunday,14 days,74046.768
ACC-182446574,27,13.74,5077.02,1.0,CUS-3026014945,2018-09-09,Tonya,F,-32.00,116.06,,8ef27717-927e-4c96-ac19-e804a24c8126,-33.8,151.18,NSW,Chatswood,debit,authorized,6edea1aed43f42d7b316402b7142ce74,POS,20-30,2018,9,9,12,14,Sunday,14 days,74046.768
ACC-182446574,27,7.49,5069.53,1.0,CUS-3026014945,2018-09-09,Tonya,F,-32.00,116.06,,94a713a1-6e24-43f1-8047-2e30814df00b,-32.02,115.94,WA,Cannington,debit,authorized,4195b98bd4df415791a6d2b68f40b35b,POS,20-30,2018,9,9,19,52,Sunday,14 days,74046.768
ACC-182446574,27,6.96,5062.57,0.0,CUS-3026014945,2018-09-09,Tonya,F,-32.00,116.06,,8cdc5d3d-e647-475c-ba80-19ebe23ab527,-32.05,115.82,WA,Myaree,debit,authorized,6a9287630e96453b9c12db7ffc02221a,POS,20-30,2018,9,9,20,39,Sunday,14 days,74046.768
ACC-182446574,27,20.12,5042.45,0.0,CUS-3026014945,2018-09-10,Tonya,F,-32.00,116.06,,7447ec2b-9c66-45cc-8554-cf86ff651978,-31.9,115.89,WA,Morley,debit,authorized,45deadbaa6594be791e458b9f20ae22a,SALES-POS,20-30,2018,9,10,10,49,Monday,14 days,74046.768
ACC-182446574,27,16.65,5025.8,1.0,CUS-3026014945,2018-09-10,Tonya,F,-32.00,116.06,,d211ad69-9481-4da9-b532-c4a314917c0b,-31.87,115.95,WA,Beechboro,debit,authorized,180be6af36534c87a3c030b98862633d,SALES-POS,20-30,2018,9,10,11,20,Monday,14 days,74046.768
ACC-182446574,27,13.21,5012.59,1.0,CUS-3026014945,2018-09-10,Tonya,F,-32.00,116.06,,0cc03d95-bf40-41a7-9248-2d7c42e95c04,-32.13,133.67,SA,Ceduna,debit,authorized,d4c073e39ca247729bd416a60900d1c0,SALES-POS,20-30,2018,9,10,12,10,Monday,14 days,74046.768
ACC-182446574,27,22.81,4989.78,1.0,CUS-3026014945,2018-09-10,Tonya,F,-32.00,116.06,,60d6e26e-08cf-4a3e-bd1b-ad3e4794c127,-31.87,115.95,WA,Beechboro,debit,authorized,73775e5033e74756b068ae3515be5500,POS,20-30,2018,9,10,14,11,Monday,14 days,74046.768
ACC-182446574,27,100.06,4889.72,1.0,CUS-3026014945,2018-09-10,Tonya,F,-32.00,116.06,,4f640c8c-498f-49ea-902b-cc8837e95db2,-31.87,115.86,WA,Mirrabooka,debit,authorized,962a86a8dd6540d190e3779d7db1be1c,POS,20-30,2018,9,10,15,43,Monday,14 days,74046.768
ACC-182446574,27,11.31,4878.41,1.0,CUS-3026014945,2018-09-10,Tonya,F,-32.00,116.06,,6738d671-5dbc-4016-a941-9bbb15bdbff8,-31.86,115.88,WA,Malaga,debit,authorized,62e448a3f1bf40c6ac05ca3d32ae89ee,POS,20-30,2018,9,10,21,18,Monday,14 days,74046.768
ACC-182446574,27,16.09,4862.32,1.0,CUS-3026014945,2018-09-10,Tonya,F,-32.00,116.06,,d58901fe-d2b6-471a-a8bb-2c27ce1d81f7,-32.1,115.78,WA,Spearwood,debit,authorized,c6de26667fb54ed1840754fd972a991a,POS,20-30,2018,9,10,21,31,Monday,14 days,74046.768
ACC-182446574,27,8.86,4853.46,0.0,CUS-3026014945,2018-09-10,Tonya,F,-32.00,116.06,,7bffd4eb-3bc8-4ed0-b357-428f10dd69f8,-31.95,115.84,WA,West Perth,debit,authorized,a505bf5bc74548208a22aadda47f0e27,SALES-POS,20-30,2018,9,10,22,20,Monday,14 days,74046.768
ACC-182446574,27,57.0,4796.46,,CUS-3026014945,2018-09-12,Tonya,F,-32.00,116.06,,,,,,,debit,posted,30b2863b06484f118d99386ec75f02f7,INTER BANK,20-30,2018,9,12,12,0,Wednesday,14 days,74046.768
ACC-182446574,27,38.23,4758.23,1.0,CUS-3026014945,2018-09-12,Tonya,F,-32.00,116.06,,11af824a-7388-4ff2-b0b0-666e22c1325b,-31.96,141.46,NSW,Broken Hill,debit,authorized,f333bb5ee06045ea967f7c193ce6fb75,POS,20-30,2018,9,12,19,38,Wednesday,14 days,74046.768
ACC-182446574,27,33.0,4725.23,,CUS-3026014945,2018-09-12,Tonya,F,-32.00,116.06,,,,,,,debit,posted,a6d48e2e30324a8899c6d31415d879f3,INTER BANK,20-30,2018,9,12,20,0,Wednesday,14 days,74046.768
ACC-182446574,27,6.37,4718.86,1.0,CUS-3026014945,2018-09-12,Tonya,F,-32.00,116.06,,c9da73d1-9d5e-4617-84c0-745f303de973,-31.99,116.01,WA,Forrestfield,debit,authorized,180c3ddcbc7e480a92f64ba0a0c5291b,SALES-POS,20-30,2018,9,12,21,46,Wednesday,14 days,74046.768
ACC-182446574,27,18.06,4700.8,1.0,CUS-3026014945,2018-09-13,Tonya,F,-32.00,116.06,,5388e492-3862-47fe-96e1-127e2a31505d,-31.89,116.77,WA,York,debit,authorized,db0cd0bae0644d97a1cf9cd60126e0cd,POS,20-30,2018,9,13,13,0,Thursday,14 days,74046.768
ACC-182446574,27,9.51,4691.29,0.0,CUS-3026014945,2018-09-13,Tonya,F,-32.00,116.06,,8790c38f-d212-4d49-8623-4fa698117e25,-31.85,115.87,WA,Mirrabooka,debit,authorized,9d445e2eb3ae4fcc95600153f1b9389e,POS,20-30,2018,9,13,15,30,Thursday,14 days,74046.768
ACC-182446574,27,27.35,4663.94,0.0,CUS-3026014945,2018-09-13,Tonya,F,-32.00,116.06,,0faf8d6e-f204-4abe-b7c1-21ff8e657828,-31.9,115.83,WA,Osborne Park,debit,authorized,889484bd1145420bb33c916b329a930b,POS,20-30,2018,9,13,20,18,Thursday,14 days,74046.768
ACC-182446574,27,22.01,4641.93,0.0,CUS-3026014945,2018-09-14,Tonya,F,-32.00,116.06,,d8cc78c6-57c3-4992-8311-7501247ed962,-31.89,116,WA,Midland,debit,authorized,f59c17704ce347238e4b704d33ff337e,SALES-POS,20-30,2018,9,14,11,19,Friday,14 days,74046.768
ACC-182446574,27,10.14,4631.79,1.0,CUS-3026014945,2018-09-14,Tonya,F,-32.00,116.06,,ef36d4a3-17a8-4f6a-917f-671bc7eac67c,-37.88,145.13,VIC,Mount Waverley,debit,authorized,655ab23b2b084762a3c49cc7f4b7367b,POS,20-30,2018,9,14,12,36,Friday,14 days,74046.768
ACC-182446574,27,18.21,4613.58,1.0,CUS-3026014945,2018-09-14,Tonya,F,-32.00,116.06,,b606056b-040d-4a6c-99c3-72601545a0d6,-31.93,115.87,WA,Mount Lawley,debit,authorized,763a29be95c546f7a75b1807067ce77e,SALES-POS,20-30,2018,9,14,15,54,Friday,14 days,74046.768
ACC-182446574,27,265.84,7187.89,1.0,CUS-3026014945,2018-09-14,Tonya,F,-32.00,116.06,,80af2780-67d7-4e46-aaa0-93b10a2113ce,-31.95,115.83,WA,Subiaco,debit,authorized,49b29ab7594b49e88cece4544d9fdb5f,SALES-POS,20-30,2018,9,14,16,37,Friday,14 days,74046.768
ACC-182446574,27,12.51,7175.38,1.0,CUS-3026014945,2018-09-14,Tonya,F,-32.00,116.06,,e2591002-0bb4-4adc-a30a-49e3505355b5,-31.85,115.81,WA,Warwick,debit,authorized,b8c87c8fc0f54135b38007340e9df841,POS,20-30,2018,9,14,19,39,Friday,14 days,74046.768
ACC-182446574,27,87.98,7087.4,1.0,CUS-3026014945,2018-09-14,Tonya,F,-32.00,116.06,,7c0ed0d1-0976-4859-9793-49e2083165a5,-31.95,141.47,NSW,Broken Hill,debit,authorized,187d78614fc54071ab80f2779ad92c0f,POS,20-30,2018,9,14,22,39,Friday,14 days,74046.768
ACC-182446574,27,32.91,7054.49,1.0,CUS-3026014945,2018-09-15,Tonya,F,-32.00,116.06,,0fc83e0d-c2a1-4a6d-a5d0-fdc4ac5c446c,-32.1,115.78,WA,Spearwood,debit,authorized,6351751e593f47ba9c881831bf698e2f,POS,20-30,2018,9,15,13,5,Saturday,14 days,74046.768
ACC-182446574,27,30.46,7024.03,1.0,CUS-3026014945,2018-09-15,Tonya,F,-32.00,116.06,,ed79169c-d268-4884-a82f-f9d2a7317e79,-31.86,115.89,WA,Malaga,debit,authorized,9242a0a3e76f48c8837f02f0c938fa71,SALES-POS,20-30,2018,9,15,14,23,Saturday,14 days,74046.768
ACC-182446574,27,23.46,7000.57,1.0,CUS-3026014945,2018-09-15,Tonya,F,-32.00,116.06,,1e9a42ab-d3d1-4586-a898-e26c81007352,-31.99,116.01,WA,Forrestfield,debit,authorized,f22ea860a1e449868bf8e202bb29bdda,POS,20-30,2018,9,15,16,39,Saturday,14 days,74046.768
ACC-182446574,27,16.13,6984.44,1.0,CUS-3026014945,2018-09-15,Tonya,F,-32.00,116.06,,8422eb4b-b489-458c-b07f-7e6561ebf63c,-31.92,115.88,WA,Inglewood,debit,authorized,20da0921c227458d95f6327a2504ee84,POS,20-30,2018,9,15,17,6,Saturday,14 days,74046.768
ACC-182446574,27,11.28,6973.16,1.0,CUS-3026014945,2018-09-15,Tonya,F,-32.00,116.06,,eec019fb-c920-47fa-beeb-0195ef0bc036,-32.03,115.84,WA,Booragoon,debit,authorized,3fe5baabc43049e394fe79b13f4ba593,POS,20-30,2018,9,15,17,24,Saturday,14 days,74046.768
ACC-182446574,27,14.84,6958.32,0.0,CUS-3026014945,2018-09-15,Tonya,F,-32.00,116.06,,bba8e2ac-2918-4b75-8f5f-a6d2548f8de0,-32.14,116.01,WA,Kelmscott,debit,authorized,03bd184a803b44f79ab30d675f1b25a6,SALES-POS,20-30,2018,9,15,20,58,Saturday,14 days,74046.768
ACC-182446574,27,13.46,6944.86,0.0,CUS-3026014945,2018-09-17,Tonya,F,-32.00,116.06,,f7f1a4c4-9947-47f5-a461-2fed2ca3324c,-37.82,144.96,VIC,Melbourne,debit,authorized,20a93d4184b64373a2513ff0a3e28122,SALES-POS,20-30,2018,9,17,11,0,Monday,14 days,74046.768
ACC-182446574,27,152.0,6792.86,,CUS-3026014945,2018-09-17,Tonya,F,-32.00,116.06,,,,,,,debit,posted,c3c9c858d61546819403953ab3d62292,INTER BANK,20-30,2018,9,17,23,0,Monday,14 days,74046.768
ACC-182446574,27,121.0,6671.86,,CUS-3026014945,2018-09-18,Tonya,F,-32.00,116.06,,,,,,,debit,posted,96eec4e642e64a9cbafd9ffd7a9e25e8,PAYMENT,20-30,2018,9,18,7,0,Tuesday,14 days,74046.768
ACC-182446574,27,20.97,6650.89,1.0,CUS-3026014945,2018-09-18,Tonya,F,-32.00,116.06,,6c84c219-96ea-4c6f-9de5-0a28bcaec62f,-32.01,152.47,NSW,Rainbow Flat,debit,authorized,00825d89031a49f29f116b1f30d9edfd,POS,20-30,2018,9,18,11,38,Tuesday,14 days,74046.768
ACC-182446574,27,10.98,6639.91,1.0,CUS-3026014945,2018-09-18,Tonya,F,-32.00,116.06,,0af0f388-4465-4178-8b23-1f86aac4f98b,-32.01,115.86,WA,Como,debit,authorized,4b02f4dadcbc4c20b6436a2970ca1596,POS,20-30,2018,9,18,13,16,Tuesday,14 days,74046.768
ACC-182446574,27,18.62,6621.29,1.0,CUS-3026014945,2018-09-19,Tonya,F,-32.00,116.06,,326be4c0-2e6d-4b4a-bc3d-c26abe723c9f,-32.06,115.78,WA,Hilton,debit,authorized,67d0cc749a934e03a5a6ec44f7469c6b,POS,20-30,2018,9,19,8,2,Wednesday,14 days,74046.768
ACC-182446574,27,39.37,6581.92,0.0,CUS-3026014945,2018-09-19,Tonya,F,-32.00,116.06,,e957b3e1-e8d7-49a4-98a9-e5feba8b1a74,-33.89,151.25,NSW,Bondi Junction,debit,authorized,6b3660da179440a891fb08cfc6025a68,SALES-POS,20-30,2018,9,19,9,12,Wednesday,14 days,74046.768
ACC-182446574,27,13.38,6568.54,0.0,CUS-3026014945,2018-09-19,Tonya,F,-32.00,116.06,,ed58e1b1-e3b9-4159-8ca5-01a64eae3580,-32.03,115.84,WA,Booragoon,debit,authorized,236a9a878fe04956a4f11eaa3f62a532,SALES-POS,20-30,2018,9,19,11,2,Wednesday,14 days,74046.768
ACC-182446574,27,18.39,6550.15,0.0,CUS-3026014945,2018-09-19,Tonya,F,-32.00,116.06,,8b80dbad-10e8-4ad3-a491-d0d94f318be7,-32.15,116.01,WA,Armadale,debit,authorized,2f0288696e2844379b647157eaf45916,SALES-POS,20-30,2018,9,19,11,39,Wednesday,14 days,74046.768
ACC-182446574,27,57.0,6493.15,,CUS-3026014945,2018-09-19,Tonya,F,-32.00,116.06,,,,,,,debit,posted,e841a5883a10484b82620bdb9a3584f9,INTER BANK,20-30,2018,9,19,12,0,Wednesday,14 days,74046.768
ACC-182446574,27,14.73,6478.42,1.0,CUS-3026014945,2018-09-19,Tonya,F,-32.00,116.06,,576dc70d-eaf7-43e8-9382-09fd22a66854,-31.9,115.8,WA,Woodlands,debit,authorized,469ba70cf1ce40a88adce5f46160c5f5,SALES-POS,20-30,2018,9,19,16,36,Wednesday,14 days,74046.768
ACC-182446574,27,33.0,6445.42,,CUS-3026014945,2018-09-19,Tonya,F,-32.00,116.06,,,,,,,debit,posted,20c73f7c5cd246599271b604a8c4cc8f,INTER BANK,20-30,2018,9,19,20,0,Wednesday,14 days,74046.768
ACC-182446574,27,21.3,6424.12,1.0,CUS-3026014945,2018-09-19,Tonya,F,-32.00,116.06,,eb39df03-0b99-4c7f-b34a-8d65813a53d1,-31.92,115.89,WA,Inglewood,debit,authorized,bc9abf4c781a457f9f34d9898a3a5fec,POS,20-30,2018,9,19,21,37,Wednesday,14 days,74046.768
ACC-182446574,27,14.72,6409.4,1.0,CUS-3026014945,2018-09-20,Tonya,F,-32.00,116.06,,9a717cc8-4f70-4f9f-98b7-66e1c124839a,-32.15,116.02,WA,Armadale,debit,authorized,e1c3fea273944ec0950fe5e3b3cb2c8b,POS,20-30,2018,9,20,9,52,Thursday,14 days,74046.768
ACC-182446574,27,20.62,6388.78,1.0,CUS-3026014945,2018-09-20,Tonya,F,-32.00,116.06,,806ef382-e4c5-4279-8492-cc1197def784,-32.09,115.84,WA,Bibra Lake,debit,authorized,fdced9c901734cc2b10fad2921f0dde1,POS,20-30,2018,9,20,11,10,Thursday,14 days,74046.768
ACC-182446574,27,7.71,6381.07,0.0,CUS-3026014945,2018-09-22,Tonya,F,-32.00,116.06,,33952b07-859c-4c0a-8b1d-813a5f6b444c,-32.13,115.86,WA,Cockburn Central,debit,authorized,77f4145950d9453886bcff5cb96a460c,SALES-POS,20-30,2018,9,22,9,50,Saturday,14 days,74046.768
ACC-182446574,27,17.9,6363.17,1.0,CUS-3026014945,2018-09-22,Tonya,F,-32.00,116.06,,702740d3-39eb-41db-8047-dd0ed8402256,-32.06,115.75,WA,Fremantle,debit,authorized,33f9594fdefe4791a23b1e5bb577b323,POS,20-30,2018,9,22,14,34,Saturday,14 days,74046.768
ACC-182446574,27,36.27,6326.9,1.0,CUS-3026014945,2018-09-22,Tonya,F,-32.00,116.06,,9223d7eb-268f-41d4-a975-3378517186e6,-31.95,115.82,WA,Subiaco,debit,authorized,422d838dd1334f3a8a1ae4308ca269b9,SALES-POS,20-30,2018,9,22,17,17,Saturday,14 days,74046.768
ACC-182446574,27,17.01,6309.89,1.0,CUS-3026014945,2018-09-22,Tonya,F,-32.00,116.06,,b32d32d7-556f-43f3-a069-8ffec3f4e6f5,-32.14,115.97,WA,Forrestdale,debit,authorized,29d86b82dd6e491697be21f5eba4dd2f,SALES-POS,20-30,2018,9,22,22,59,Saturday,14 days,74046.768
ACC-182446574,27,24.6,6285.29,1.0,CUS-3026014945,2018-09-23,Tonya,F,-32.00,116.06,,728e9e20-c242-44fa-9da3-ac6ae8930cc7,-31.88,115.81,WA,Stirling,debit,authorized,29f641e0b3e5445a91e4d8f648785bd9,SALES-POS,20-30,2018,9,23,8,29,Sunday,14 days,74046.768
ACC-182446574,27,24.41,6260.88,1.0,CUS-3026014945,2018-09-23,Tonya,F,-32.00,116.06,,628590ed-7c27-4424-a5cf-d956aa151836,-31.87,115.86,WA,Mirrabooka,debit,authorized,e7fd4bc4b0d04560b6e363183d1f3593,POS,20-30,2018,9,23,12,22,Sunday,14 days,74046.768
ACC-182446574,27,30.3,6230.58,1.0,CUS-3026014945,2018-09-23,Tonya,F,-32.00,116.06,,158d70af-303b-48ab-8ac4-d2bd7b8707cc,-31.89,115.76,WA,Scarborough,debit,authorized,1e27bc4bba254b92a11cfc0f59d60394,SALES-POS,20-30,2018,9,23,22,34,Sunday,14 days,74046.768
ACC-182446574,27,16.15,6214.43,0.0,CUS-3026014945,2018-09-24,Tonya,F,-32.00,116.06,,2b443b2d-b994-4f31-add2-17d6c5d9e911,-32.03,115.84,WA,Booragoon,debit,authorized,2b236d8c93b44ebb850ac46cbf4e2348,POS,20-30,2018,9,24,1,53,Monday,14 days,74046.768
ACC-182446574,27,10.19,6204.24,1.0,CUS-3026014945,2018-09-24,Tonya,F,-32.00,116.06,,4ad307c4-9cfe-44e5-b717-2ea8a1ee8b9a,-31.93,115.9,WA,Maylands,debit,authorized,4ec58bc689aa45a78c102cfb95ca9dec,SALES-POS,20-30,2018,9,24,22,48,Monday,14 days,74046.768
ACC-182446574,27,8.01,6196.23,1.0,CUS-3026014945,2018-09-25,Tonya,F,-32.00,116.06,,e133d191-28de-44a7-8cdd-6f193fcc0b3c,-33.87,151.21,NSW,Sydney,debit,authorized,97509a8d6e354b4da0598a48531379fa,SALES-POS,20-30,2018,9,25,1,13,Tuesday,14 days,74046.768
ACC-182446574,27,57.0,6139.23,,CUS-3026014945,2018-09-26,Tonya,F,-32.00,116.06,,,,,,,debit,posted,6d030e2a72bf411daaab738b3a0c2d7e,INTER BANK,20-30,2018,9,26,12,0,Wednesday,14 days,74046.768
ACC-182446574,27,33.0,6106.23,,CUS-3026014945,2018-09-26,Tonya,F,-32.00,116.06,,,,,,,debit,posted,154b898136294de7bc39c4e61b4374dc,INTER BANK,20-30,2018,9,26,20,0,Wednesday,14 days,74046.768
ACC-182446574,27,194.0,5912.23,,CUS-3026014945,2018-09-27,Tonya,F,-32.00,116.06,,,,,,,debit,posted,735889e8eaed4d42aaff32e616edead9,PAYMENT,20-30,2018,9,27,10,0,Thursday,14 days,74046.768
ACC-182446574,27,37.75,5874.48,1.0,CUS-3026014945,2018-09-27,Tonya,F,-32.00,116.06,,6d8a8621-6a7a-4e0b-9bd3-299da15f03f7,-32.03,115.84,WA,Booragoon,debit,authorized,7f020140fafe497ea7cfbf3905f842b6,SALES-POS,20-30,2018,9,27,17,51,Thursday,14 days,74046.768
ACC-182446574,27,5.49,5868.99,0.0,CUS-3026014945,2018-09-27,Tonya,F,-32.00,116.06,,94b47426-4004-400b-b52e-a6918431670d,-32.05,115.81,WA,Myaree,debit,authorized,b0830fdd64564950992cc6a22674411c,SALES-POS,20-30,2018,9,27,22,35,Thursday,14 days,74046.768
ACC-182446574,27,385.87,5483.12,1.0,CUS-3026014945,2018-09-28,Tonya,F,-32.00,116.06,,2b61c02f-02a3-4402-8074-53e6d20cc8f1,-31.99,115.93,WA,Welshpool,debit,authorized,ef55e996b7344f2b8a76fe581a8ea9a3,POS,20-30,2018,9,28,13,21,Friday,14 days,74046.768
ACC-182446574,27,21.89,5461.23,1.0,CUS-3026014945,2018-09-28,Tonya,F,-32.00,116.06,,46081d22-7d66-4666-8994-0a9082c0a5cb,-31.89,115.95,WA,Eden Hill,debit,authorized,cac0e95789684a50a8b88993da154887,SALES-POS,20-30,2018,9,28,14,6,Friday,14 days,74046.768
ACC-182446574,27,14.31,5446.92,1.0,CUS-3026014945,2018-09-28,Tonya,F,-32.00,116.06,,c130a12f-4c13-44e4-9947-cbca5d64c7b0,-31.89,116.77,WA,York,debit,authorized,65ec9d69a13e438387cdc91025878593,SALES-POS,20-30,2018,9,28,15,40,Friday,14 days,74046.768
ACC-182446574,27,57.68,8229.39,0.0,CUS-3026014945,2018-09-28,Tonya,F,-32.00,116.06,,7e0fa6aa-b48a-4d55-afed-ff2034fda51c,-27.39,153.07,QLD,Northgate,debit,authorized,496f09cb218645d7b0f89b101bd18512,POS,20-30,2018,9,28,17,49,Friday,14 days,74046.768
ACC-182446574,27,13.82,8215.57,1.0,CUS-3026014945,2018-09-28,Tonya,F,-32.00,116.06,,c8650eba-a179-4da3-bf36-561c86e6b4a6,-31.9,115.83,WA,Osborne Park,debit,authorized,8d0585f951034750949349e722d06c6e,SALES-POS,20-30,2018,9,28,21,7,Friday,14 days,74046.768
ACC-182446574,27,9.44,8206.13,1.0,CUS-3026014945,2018-09-28,Tonya,F,-32.00,116.06,,b8b3703b-611c-4920-a7f2-82ed479abde1,-31.87,115.86,WA,Perth,debit,authorized,fdabe271e6294f35870d1e5d04ac84f0,SALES-POS,20-30,2018,9,28,21,37,Friday,14 days,74046.768
ACC-182446574,27,24.91,8181.22,1.0,CUS-3026014945,2018-09-28,Tonya,F,-32.00,116.06,,ef7e3b57-4065-428f-b75e-75316798b3df,-31.95,115.82,WA,Subiaco,debit,authorized,335f6e3de89b47639856c26881a05270,SALES-POS,20-30,2018,9,28,22,7,Friday,14 days,74046.768
ACC-182446574,27,12.89,8168.33,1.0,CUS-3026014945,2018-09-29,Tonya,F,-32.00,116.06,,01a1edb2-3ed1-4743-961a-53249ee0b92e,-32.14,115.79,WA,Beeliar,debit,authorized,c187e70e67f94237a3c5091ace5c11d9,SALES-POS,20-30,2018,9,29,12,20,Saturday,14 days,74046.768
ACC-182446574,27,62.69,8105.64,0.0,CUS-3026014945,2018-09-30,Tonya,F,-32.00,116.06,,d8c43a7e-a509-4a25-8070-3a7e18425571,-31.88,115.78,WA,Karrinyup,debit,authorized,5f65d5b26b0148a78b3d0d5c4775a1ae,SALES-POS,20-30,2018,9,30,14,28,Sunday,14 days,74046.768
ACC-182446574,27,19.16,8086.48,1.0,CUS-3026014945,2018-09-30,Tonya,F,-32.00,116.06,,3af66b5d-fe6d-4dbb-bb91-3c26a80a5a63,-31.97,115.85,WA,South Perth,debit,authorized,b1b68750e3924e8c981c23b41afc007e,SALES-POS,20-30,2018,9,30,15,16,Sunday,14 days,74046.768
ACC-182446574,27,10.75,8075.73,1.0,CUS-3026014945,2018-10-01,Tonya,F,-32.00,116.06,,256eb126-d47d-44bd-8696-e324950ca522,-32.11,133.67,SA,Ceduna,debit,authorized,b6683377c1df4b8a860f4cb0d26e71aa,SALES-POS,20-30,2018,10,1,9,46,Monday,14 days,74046.768
ACC-182446574,27,104.0,7971.73,1.0,CUS-3026014945,2018-10-01,Tonya,F,-32.00,116.06,,b6de0992-2609-47ec-b6a5-d6e4f65a51a0,-31.86,115.81,WA,Balcatta,debit,authorized,1cbd6bc0653e42a1836ade8c1e8c16fc,SALES-POS,20-30,2018,10,1,13,49,Monday,14 days,74046.768
ACC-182446574,27,21.72,7950.01,1.0,CUS-3026014945,2018-10-01,Tonya,F,-32.00,116.06,,67a29937-53b9-493d-bcaa-5f8a7c651cd9,-31.89,115.79,WA,Innaloo,debit,authorized,6b3ed99b2936435fb4219cce87448774,SALES-POS,20-30,2018,10,1,21,45,Monday,14 days,74046.768
ACC-182446574,27,33.21,7916.8,1.0,CUS-3026014945,2018-10-01,Tonya,F,-32.00,116.06,,0fc83e0d-c2a1-4a6d-a5d0-fdc4ac5c446c,-32.1,115.78,WA,Spearwood,debit,authorized,e1e0b8f49ceb4383939699d36db9cf36,POS,20-30,2018,10,1,22,13,Monday,14 days,74046.768
ACC-182446574,27,1.79,7915.01,1.0,CUS-3026014945,2018-10-02,Tonya,F,-32.00,116.06,,6ea10976-582a-43c5-8bb9-0662f0217237,-28.03,153.43,QLD,Broadbeach,debit,authorized,ba2c07d7069644b184214c4c7e532a71,POS,20-30,2018,10,2,11,38,Tuesday,14 days,74046.768
ACC-182446574,27,25.07,7889.94,1.0,CUS-3026014945,2018-10-02,Tonya,F,-32.00,116.06,,e4218e69-eb22-43a5-9a3b-43e9fafc5a2c,-31.89,115.77,WA,Scarborough,debit,authorized,ccdeed2f5a7c46138d91d749d07788bf,POS,20-30,2018,10,2,18,36,Tuesday,14 days,74046.768
ACC-182446574,27,15.77,7874.17,1.0,CUS-3026014945,2018-10-03,Tonya,F,-32.00,116.06,,f792a1fe-6ece-4ac3-8af0-f75da75851c6,-31.87,115.86,WA,Mirrabooka,debit,authorized,a88d1aa8e1fd4d4980b4e944494cef32,POS,20-30,2018,10,3,8,34,Wednesday,14 days,74046.768
ACC-182446574,27,57.0,7817.17,,CUS-3026014945,2018-10-03,Tonya,F,-32.00,116.06,,,,,,,debit,posted,e417266dac4b4dc8bc59230861074a44,INTER BANK,20-30,2018,10,3,12,0,Wednesday,14 days,74046.768
ACC-182446574,27,20.91,7796.26,0.0,CUS-3026014945,2018-10-03,Tonya,F,-32.00,116.06,,5388e492-3862-47fe-96e1-127e2a31505d,-31.89,116.77,WA,York,debit,authorized,da11a48bbe994619ae18394978567be0,POS,20-30,2018,10,3,15,29,Wednesday,14 days,74046.768
ACC-182446574,27,15.64,7780.62,0.0,CUS-3026014945,2018-10-03,Tonya,F,-32.00,116.06,,4d7010bc-5922-46ba-b5ff-aa2d67d62907,-31.87,115.86,WA,Mirrabooka,debit,authorized,97256a7f165b43639880ac1e79bd0d96,POS,20-30,2018,10,3,17,30,Wednesday,14 days,74046.768
ACC-182446574,27,20.5,7760.12,1.0,CUS-3026014945,2018-10-03,Tonya,F,-32.00,116.06,,4ed797fd-da03-4aca-ae4a-a975adbd11e4,-31.89,116.01,WA,Midland,debit,authorized,03bacc3f77574bd8875ab8f0c388a125,POS,20-30,2018,10,3,19,13,Wednesday,14 days,74046.768
ACC-182446574,27,33.0,7727.12,,CUS-3026014945,2018-10-03,Tonya,F,-32.00,116.06,,,,,,,debit,posted,2b534dda2a9247c7aa3043eb242a36d7,INTER BANK,20-30,2018,10,3,20,0,Wednesday,14 days,74046.768
ACC-182446574,27,18.58,7708.54,1.0,CUS-3026014945,2018-10-03,Tonya,F,-32.00,116.06,,c5345585-1f1f-4235-bcb9-aa991bf1cf8f,-31.95,115.82,WA,Subiaco,debit,authorized,fc25b05113f1464fa987acb71f95adaf,SALES-POS,20-30,2018,10,3,23,49,Wednesday,14 days,74046.768
ACC-182446574,27,13.95,7694.59,1.0,CUS-3026014945,2018-10-04,Tonya,F,-32.00,116.06,,4c28d42b-d6ce-4a81-a3ed-8d69611b5bd4,-34.94,138.61,SA,Parkside,debit,authorized,9ddab70c91af4687853ff42757bc20ba,SALES-POS,20-30,2018,10,4,1,27,Thursday,14 days,74046.768
ACC-182446574,27,8.95,7685.64,1.0,CUS-3026014945,2018-10-05,Tonya,F,-32.00,116.06,,8f9e406e-0213-4137-bd13-25c663ce966c,-31.88,115.78,WA,Karrinyup,debit,authorized,2cc7a099cecf45cb952abecbed4350b7,POS,20-30,2018,10,5,15,26,Friday,14 days,74046.768
ACC-182446574,27,68.27,7617.37,0.0,CUS-3026014945,2018-10-06,Tonya,F,-32.00,116.06,,cb66f9bd-3d5a-4d4c-8ef0-62d9cf973723,-31.9,115.9,WA,Morley,debit,authorized,009d8e6d221e46a9a7b677fe9e38275d,POS,20-30,2018,10,6,0,54,Saturday,14 days,74046.768
ACC-182446574,27,16.89,7600.48,1.0,CUS-3026014945,2018-10-06,Tonya,F,-32.00,116.06,,65c70256-9c0c-46f7-aba1-5065fbcc350a,-31.98,115.78,WA,Claremont,debit,authorized,63e524f794b44cbbab9411fa3a0caf61,POS,20-30,2018,10,6,15,11,Saturday,14 days,74046.768
ACC-182446574,27,6.83,7593.65,0.0,CUS-3026014945,2018-10-06,Tonya,F,-32.00,116.06,,b59f20e4-9e0d-4b4a-b3ae-094a6235ffe4,-31.95,115.83,WA,Subiaco,debit,authorized,750ba1d2228247a7a1306ee02675e6e3,POS,20-30,2018,10,6,21,23,Saturday,14 days,74046.768
ACC-182446574,27,13.58,7580.07,0.0,CUS-3026014945,2018-10-06,Tonya,F,-32.00,116.06,,bedfaec0-2483-449c-9d0f-b8492469a4a2,-31.91,152.46,NSW,Taree,debit,authorized,c57610c4b7ea4775a0db96bad9472aec,SALES-POS,20-30,2018,10,6,22,3,Saturday,14 days,74046.768
ACC-182446574,27,222.32,7357.75,1.0,CUS-3026014945,2018-10-07,Tonya,F,-32.00,116.06,,7233a229-a9c0-41a4-b5a3-efa04a2bc9a9,-31.9,115.9,WA,Morley,debit,authorized,c0cd55a4711444358d0029efee6fa581,SALES-POS,20-30,2018,10,7,6,47,Sunday,14 days,74046.768
ACC-182446574,27,21.42,7336.33,1.0,CUS-3026014945,2018-10-07,Tonya,F,-32.00,116.06,,46081d22-7d66-4666-8994-0a9082c0a5cb,-31.89,115.95,WA,Eden Hill,debit,authorized,885f6a996f194660a9ff2b05245b341a,SALES-POS,20-30,2018,10,7,20,33,Sunday,14 days,74046.768
ACC-182446574,27,24.09,7312.24,1.0,CUS-3026014945,2018-10-07,Tonya,F,-32.00,116.06,,0c9fc6af-908c-43c9-9fbf-fc6cfb927cb7,-31.9,115.81,WA,Osborne Park,debit,authorized,13a968bc5c4b47ffa69ebfc021a1c7ce,POS,20-30,2018,10,7,21,14,Sunday,14 days,74046.768
ACC-182446574,27,23.27,7288.97,0.0,CUS-3026014945,2018-10-08,Tonya,F,-32.00,116.06,,35f860db-ab81-4d83-827f-216d5eb95ce7,-31.9,115.85,WA,Yokine,debit,authorized,e6bff0d7c81f458d8f4c98cb7b995f81,SALES-POS,20-30,2018,10,8,1,36,Monday,14 days,74046.768
ACC-182446574,27,14.12,7274.85,1.0,CUS-3026014945,2018-10-08,Tonya,F,-32.00,116.06,,3814a278-6030-4aa6-8ec7-b1ccfb8ccced,-32.1,115.78,WA,Spearwood,debit,authorized,1e472cb3621a48ff8e1560ea0b03a177,POS,20-30,2018,10,8,13,58,Monday,14 days,74046.768
ACC-182446574,27,18.76,7256.09,1.0,CUS-3026014945,2018-10-08,Tonya,F,-32.00,116.06,,77d64894-f8f6-4d4d-b250-b87c82b01194,-32.05,115.75,WA,Fremantle,debit,authorized,c6206e60f933487fbce5ac92471e3f0f,SALES-POS,20-30,2018,10,8,16,8,Monday,14 days,74046.768
ACC-182446574,27,9.33,7246.76,0.0,CUS-3026014945,2018-10-08,Tonya,F,-32.00,116.06,,c70b0732-6b39-496e-b4fb-182eb04b74aa,-31.9,115.8,WA,Innaloo,debit,authorized,bf7b8f5ea4b64501935380f512776cd6,SALES-POS,20-30,2018,10,8,16,38,Monday,14 days,74046.768
ACC-182446574,27,10.63,7236.13,1.0,CUS-3026014945,2018-10-08,Tonya,F,-32.00,116.06,,04492b94-5be6-42f0-a8fa-93bc4c0f0e56,-32.13,115.86,WA,Success,debit,authorized,497027f11af34b14b047d5b3f263206f,SALES-POS,20-30,2018,10,8,20,1,Monday,14 days,74046.768
ACC-182446574,27,81.31,7154.82,1.0,CUS-3026014945,2018-10-09,Tonya,F,-32.00,116.06,,98cf449f-37ff-4b94-84e6-52e6b0d31d25,-31.89,116.02,WA,Midland,debit,authorized,e3db4eb301354b66a99e446b898c5ccd,POS,20-30,2018,10,9,8,29,Tuesday,14 days,74046.768
ACC-182446574,27,27.77,7127.05,0.0,CUS-3026014945,2018-10-09,Tonya,F,-32.00,116.06,,c4c92c60-380c-45de-a8b6-12c6e6a97c59,-31.9,116.02,WA,Bellevue,debit,authorized,ba3706416fed4353bc0242206f34e03f,POS,20-30,2018,10,9,14,32,Tuesday,14 days,74046.768
ACC-182446574,27,5.99,7121.06,1.0,CUS-3026014945,2018-10-09,Tonya,F,-32.00,116.06,,c779eef1-9c7e-4b3d-beab-34c4c44add73,-32.05,115.75,WA,Fremantle,debit,authorized,e5eb5887d00349f8a0257ed76ac1b203,POS,20-30,2018,10,9,20,21,Tuesday,14 days,74046.768
ACC-182446574,27,14.26,7106.8,0.0,CUS-3026014945,2018-10-09,Tonya,F,-32.00,116.06,,29d4f89d-e0bc-4ade-bdcc-a8f66b912e8b,-32.1,115.95,WA,Southern River,debit,authorized,f5259d0fabaf4cf888cd77fbeb46a766,POS,20-30,2018,10,9,23,30,Tuesday,14 days,74046.768
ACC-182446574,27,57.0,7049.8,,CUS-3026014945,2018-10-10,Tonya,F,-32.00,116.06,,,,,,,debit,posted,194909ac871e40b4b1a45bbb104a8e9d,INTER BANK,20-30,2018,10,10,12,0,Wednesday,14 days,74046.768
ACC-182446574,27,19.36,7030.44,1.0,CUS-3026014945,2018-10-10,Tonya,F,-32.00,116.06,,ac4ad64c-e8b5-4a7d-9b7d-7fff2ae86718,-32.02,115.94,WA,Cannington,debit,authorized,6b40a297412a453e8a066acde526ee56,SALES-POS,20-30,2018,10,10,14,33,Wednesday,14 days,74046.768
ACC-182446574,27,6.16,7024.28,1.0,CUS-3026014945,2018-10-10,Tonya,F,-32.00,116.06,,1fd58be1-408c-4a0c-b1b3-37d048014cea,-31.97,115.78,WA,Claremont,debit,authorized,5dcbdbef043a41a7a62587682cd075e3,SALES-POS,20-30,2018,10,10,18,22,Wednesday,14 days,74046.768
ACC-182446574,27,44.8,6979.48,0.0,CUS-3026014945,2018-10-10,Tonya,F,-32.00,116.06,,cf06d446-80d2-48c4-9406-aed3eeb8147e,-31.98,115.87,WA,South Perth,debit,authorized,efd71295ab25480b80e5873df832c866,POS,20-30,2018,10,10,19,55,Wednesday,14 days,74046.768
ACC-182446574,27,33.0,6946.48,,CUS-3026014945,2018-10-10,Tonya,F,-32.00,116.06,,,,,,,debit,posted,802d56c6decb4887aeae410ca22c7149,INTER BANK,20-30,2018,10,10,20,0,Wednesday,14 days,74046.768
ACC-182446574,27,9.38,6937.1,1.0,CUS-3026014945,2018-10-12,Tonya,F,-32.00,116.06,,73537afa-855c-4747-845f-7fbd112cac70,-31.95,115.92,WA,Belmont,debit,authorized,54158f8d191b4464ab6668b938020f45,POS,20-30,2018,10,12,0,54,Friday,14 days,74046.768
ACC-182446574,27,25.64,6911.46,1.0,CUS-3026014945,2018-10-12,Tonya,F,-32.00,116.06,,3d5e8965-9ae9-49e3-a625-b7d2579b9327,-31.9,115.76,WA,Scarborough,debit,authorized,7635bd27e8c2491299adb4fa6d92ba14,SALES-POS,20-30,2018,10,12,4,35,Friday,14 days,74046.768
ACC-182446574,27,20.57,6890.89,1.0,CUS-3026014945,2018-10-12,Tonya,F,-32.00,116.06,,8030f388-1454-46c6-8307-7d449613318e,-31.86,115.88,WA,Malaga,debit,authorized,90cbcd7ec99f4a939f6f5ab0f7a07fca,SALES-POS,20-30,2018,10,12,8,18,Friday,14 days,74046.768
ACC-182446574,27,9.27,6881.62,1.0,CUS-3026014945,2018-10-12,Tonya,F,-32.00,116.06,,7dbc5ec6-0230-48c8-9d27-92183e3c3c17,-31.87,115.86,WA,Mirrabooka,debit,authorized,07278c4e185c41319a8fa074e9be2598,SALES-POS,20-30,2018,10,12,9,24,Friday,14 days,74046.768
ACC-182446574,27,14.24,6867.38,1.0,CUS-3026014945,2018-10-12,Tonya,F,-32.00,116.06,,576dc70d-eaf7-43e8-9382-09fd22a66854,-31.9,115.8,WA,Woodlands,debit,authorized,49f3a503579049389adfa9396377b8e1,SALES-POS,20-30,2018,10,12,11,2,Friday,14 days,74046.768
ACC-182446574,27,31.01,9676.52,1.0,CUS-3026014945,2018-10-16,Tonya,F,-32.00,116.06,,7e2d1c13-5e8b-479a-9654-a927787c2688,-31.86,115.81,WA,Balcatta,debit,authorized,b7d8e3da7ea04554b127550773489f2d,SALES-POS,20-30,2018,10,16,21,4,Tuesday,14 days,74046.768
ACC-182446574,27,5.82,9670.7,1.0,CUS-3026014945,2018-10-17,Tonya,F,-32.00,116.06,,ee098a44-5d1d-4e28-a009-462b3ee33f84,-31.94,115.83,WA,Subiaco,debit,authorized,624c258b723f4a92a5de0c8494f96235,POS,20-30,2018,10,17,1,19,Wednesday,14 days,74046.768
ACC-182446574,27,57.0,9613.7,,CUS-3026014945,2018-10-17,Tonya,F,-32.00,116.06,,,,,,,debit,posted,469d6c47f29e49199ff1cf3f5aa23da1,INTER BANK,20-30,2018,10,17,12,0,Wednesday,14 days,74046.768
ACC-182446574,27,33.0,9580.7,,CUS-3026014945,2018-10-17,Tonya,F,-32.00,116.06,,,,,,,debit,posted,aa5935192912414abc411bcddf32b25b,INTER BANK,20-30,2018,10,17,20,0,Wednesday,14 days,74046.768
ACC-182446574,27,152.0,9428.7,,CUS-3026014945,2018-10-17,Tonya,F,-32.00,116.06,,,,,,,debit,posted,441062835a75426183207d2429176dc6,INTER BANK,20-30,2018,10,17,23,0,Wednesday,14 days,74046.768
ACC-182446574,27,121.0,9307.7,,CUS-3026014945,2018-10-18,Tonya,F,-32.00,116.06,,,,,,,debit,posted,3f9d00702dc64de9836fb478be9148f4,PAYMENT,20-30,2018,10,18,7,0,Thursday,14 days,74046.768
ACC-182446574,27,9.53,9298.17,1.0,CUS-3026014945,2018-10-18,Tonya,F,-32.00,116.06,,c26ab0bb-074b-4424-b53c-cdcf73c7d18b,-32.04,115.82,WA,Myaree,debit,authorized,04df5c842df34dc3b537bbdd8c4a3e3d,SALES-POS,20-30,2018,10,18,15,31,Thursday,14 days,74046.768
ACC-182446574,27,10.75,9287.42,1.0,CUS-3026014945,2018-10-18,Tonya,F,-32.00,116.06,,9550a2b5-7803-43af-b84f-856c9cee2455,-27.58,153.09,QLD,Eight Mile Plains,debit,authorized,a375cfa8d06e4c9fa7745fa4eaccb22d,SALES-POS,20-30,2018,10,18,18,5,Thursday,14 days,74046.768
ACC-182446574,27,10.43,9276.99,1.0,CUS-3026014945,2018-10-20,Tonya,F,-32.00,116.06,,ac52f8d3-161a-4bc7-92a3-f4beb57bb9dd,-31.99,115.88,WA,Kensington,debit,authorized,6eed411022b444649ce690697dd9e9d4,POS,20-30,2018,10,20,2,48,Saturday,14 days,74046.768
ACC-182446574,27,14.5,9262.49,1.0,CUS-3026014945,2018-10-20,Tonya,F,-32.00,116.06,,de9e8d67-1e9e-4964-8b10-c2b4f65135b1,-32.13,133.68,SA,Ceduna,debit,authorized,ae0014f2b8b94ec29c3e1275e3a2f427,SALES-POS,20-30,2018,10,20,8,23,Saturday,14 days,74046.768
ACC-182446574,27,32.98,9229.51,1.0,CUS-3026014945,2018-10-20,Tonya,F,-32.00,116.06,,79b26d70-74d5-4f1c-a5d0-91650431eeac,-31.96,141.46,NSW,Broken Hill,debit,authorized,46d71a238f7c41c1a8cc8146994424a5,SALES-POS,20-30,2018,10,20,13,58,Saturday,14 days,74046.768
ACC-182446574,27,20.38,9209.13,1.0,CUS-3026014945,2018-10-20,Tonya,F,-32.00,116.06,,6c84c219-96ea-4c6f-9de5-0a28bcaec62f,-32.01,152.47,NSW,Rainbow Flat,debit,authorized,0461afb65bf2498bb610cc2f17b1c19a,SALES-POS,20-30,2018,10,20,14,32,Saturday,14 days,74046.768
ACC-182446574,27,15.97,9193.16,1.0,CUS-3026014945,2018-10-20,Tonya,F,-32.00,116.06,,a1393fa3-196b-4b47-bc66-91e287c25733,-33.84,151.21,NSW,North Sydney,debit,authorized,c14ba8110f61428ca71607c68e98ab63,SALES-POS,20-30,2018,10,20,14,48,Saturday,14 days,74046.768
ACC-182446574,27,16.73,9176.43,1.0,CUS-3026014945,2018-10-20,Tonya,F,-32.00,116.06,,f8dcccf4-6ce1-4e04-94de-8390572e59e4,-31.9,115.8,WA,Innaloo,debit,authorized,787f69011e794c6da444aae34ee01c9e,SALES-POS,20-30,2018,10,20,21,58,Saturday,14 days,74046.768
ACC-182446574,27,14.06,9162.37,1.0,CUS-3026014945,2018-10-21,Tonya,F,-32.00,116.06,,e431b193-ae23-4cd0-87f0-878a042070bd,-31.86,115.92,WA,Bennett Springs,debit,authorized,04dd598280364c66947d7619057e5bab,SALES-POS,20-30,2018,10,21,3,4,Sunday,14 days,74046.768
ACC-182446574,27,14.71,9147.66,1.0,CUS-3026014945,2018-10-21,Tonya,F,-32.00,116.06,,65124281-f65d-4b9d-9e45-8a6a4dada399,-31.88,115.78,WA,Karrinyup,debit,authorized,379c5b4bc85748ca9d8412279076bf4e,POS,20-30,2018,10,21,9,56,Sunday,14 days,74046.768
ACC-182446574,27,18.89,9128.77,1.0,CUS-3026014945,2018-10-21,Tonya,F,-32.00,116.06,,36a1a359-3c31-4938-93ed-ec0a85c79654,-31.94,115.82,WA,Subiaco,debit,authorized,cf115f3ebff945ba8208c23571eea094,SALES-POS,20-30,2018,10,21,11,7,Sunday,14 days,74046.768
ACC-182446574,27,77.1,9051.67,1.0,CUS-3026014945,2018-10-21,Tonya,F,-32.00,116.06,,fbb901d4-6d0d-4b7a-9b4e-82cd9ec119d5,-31.87,115.86,WA,Mirrabooka,debit,authorized,27a10d70e8f743cab2d1b8c4e35da6b7,POS,20-30,2018,10,21,14,16,Sunday,14 days,74046.768
ACC-182446574,27,13.02,9038.65,1.0,CUS-3026014945,2018-10-21,Tonya,F,-32.00,116.06,,256ca061-7997-468c-a278-0e21bb3fff68,-31.99,115.93,WA,Welshpool,debit,authorized,916db39ab79c44b3ae0c2368f4f4f00a,SALES-POS,20-30,2018,10,21,16,36,Sunday,14 days,74046.768
ACC-182446574,27,10.73,9027.92,1.0,CUS-3026014945,2018-10-21,Tonya,F,-32.00,116.06,,84fd2f0d-1cb8-471e-9033-0cc2f4e465e8,-31.97,115.81,WA,Nedlands,debit,authorized,6371d344cd9c4d9888ad9dc9f0562ba3,SALES-POS,20-30,2018,10,21,21,23,Sunday,14 days,74046.768
ACC-182446574,27,13.27,9014.65,0.0,CUS-3026014945,2018-10-23,Tonya,F,-32.00,116.06,,2c7850af-0a3e-4287-b471-05c190412937,-31.84,115.81,WA,Warwick,debit,authorized,130495c0a4a74f2c8f096d161473d096,POS,20-30,2018,10,23,9,21,Tuesday,14 days,74046.768
ACC-182446574,27,6.02,9008.63,1.0,CUS-3026014945,2018-10-23,Tonya,F,-32.00,116.06,,6f6848ab-1b4d-429a-a201-0a30830b0e33,-31.99,115.75,WA,Cottesloe,debit,authorized,3f883dc856ec44728c3772a64175be07,POS,20-30,2018,10,23,12,33,Tuesday,14 days,74046.768
ACC-182446574,27,7.33,9001.3,1.0,CUS-3026014945,2018-10-23,Tonya,F,-32.00,116.06,,4fe3642e-1e41-409c-80f7-444a531ba62f,-31.57,129.96,SA,Nullarbor,debit,authorized,f477dd33a6e44c08ae2b05059169e526,SALES-POS,20-30,2018,10,23,14,23,Tuesday,14 days,74046.768
ACC-182446574,27,12.54,8988.76,0.0,CUS-3026014945,2018-10-23,Tonya,F,-32.00,116.06,,cc9d4dc9-b76d-4dc9-98ed-a2baa0de78c1,-31.93,115.88,WA,Mt Lawley,debit,authorized,32550ece9ddc4770850cc184d0533416,SALES-POS,20-30,2018,10,23,15,31,Tuesday,14 days,74046.768
ACC-182446574,27,5.4,8983.36,1.0,CUS-3026014945,2018-10-24,Tonya,F,-32.00,116.06,,a59f8ca4-2ddd-4e26-a907-29093ba5961d,-31.85,115.88,WA,Malaga,debit,authorized,d97137f8fea140bfbe2c30886ebcaee7,POS,20-30,2018,10,24,9,35,Wednesday,14 days,74046.768
ACC-182446574,27,57.0,8920.08,,CUS-3026014945,2018-10-24,Tonya,F,-32.00,116.06,,,,,,,debit,posted,4f87101e2db54f66bc53bdf7e84da440,INTER BANK,20-30,2018,10,24,12,0,Wednesday,14 days,74046.768
ACC-182446574,27,6.28,8977.08,1.0,CUS-3026014945,2018-10-24,Tonya,F,-32.00,116.06,,7cdb62b5-6632-4d1d-8e28-a4d26f5cbb74,-32.11,133.67,SA,Ceduna,debit,authorized,1ece77a4cd96420b88b95b65d1443345,POS,20-30,2018,10,24,12,26,Wednesday,14 days,74046.768
ACC-182446574,27,32.41,8887.67,1.0,CUS-3026014945,2018-10-24,Tonya,F,-32.00,116.06,,da5702cd-7e57-4415-81a0-0d1ccda9f8c7,-32.03,115.83,WA,Ardross,debit,authorized,dd404cf2a6e84410bad5201cd40b86a9,SALES-POS,20-30,2018,10,24,15,50,Wednesday,14 days,74046.768
ACC-182446574,27,10.93,8876.74,1.0,CUS-3026014945,2018-10-24,Tonya,F,-32.00,116.06,,d2b3ea9f-e96e-46ca-b761-a0605dbbbd1b,-31.96,115.88,WA,East Perth,debit,authorized,cf4118c53bd3489b9af38a496394c5a0,POS,20-30,2018,10,24,19,38,Wednesday,14 days,74046.768
ACC-182446574,27,33.0,8814.78,,CUS-3026014945,2018-10-24,Tonya,F,-32.00,116.06,,,,,,,debit,posted,049428485a6848ff8893e207219a255b,INTER BANK,20-30,2018,10,24,20,0,Wednesday,14 days,74046.768
ACC-182446574,27,28.96,8847.78,0.0,CUS-3026014945,2018-10-24,Tonya,F,-32.00,116.06,,f920b7a2-ccb6-4df8-b203-a6bf5e013423,-32.02,115.94,WA,Cannington,debit,authorized,8ad596c18c2a43c1873fbe7c70b175e9,POS,20-30,2018,10,24,20,41,Wednesday,14 days,74046.768
ACC-182446574,27,8.89,8805.89,0.0,CUS-3026014945,2018-10-24,Tonya,F,-32.00,116.06,,d0a5e33c-4a72-49db-b9bd-67e9f45453c2,-32.01,151.96,NSW,Gloucester,debit,authorized,c73b397faee2428ba26c8b73064f6562,SALES-POS,20-30,2018,10,24,23,41,Wednesday,14 days,74046.768
ACC-182446574,27,21.36,8784.53,1.0,CUS-3026014945,2018-10-25,Tonya,F,-32.00,116.06,,9d25e263-200f-42a4-98b2-aa84ad6e5034,-32.02,115.83,WA,Applecross,debit,authorized,498effa60e254601b65c79a5b2d85a58,SALES-POS,20-30,2018,10,25,8,51,Thursday,14 days,74046.768
ACC-182446574,27,20.64,8763.89,1.0,CUS-3026014945,2018-10-25,Tonya,F,-32.00,116.06,,1442095a-d3ee-4536-9d80-2ddc67f4836a,-31.91,115.95,WA,Bassendean,debit,authorized,20ab27399e464ec58f3fda114bb42c13,POS,20-30,2018,10,25,10,47,Thursday,14 days,74046.768
ACC-182446574,27,13.94,8749.95,1.0,CUS-3026014945,2018-10-25,Tonya,F,-32.00,116.06,,bb11bbea-1c3f-4b71-b146-f5fecf468970,-31.87,115.86,WA,Mirrabooka,debit,authorized,0b8add9b96e642199dc82f12a92dbd37,POS,20-30,2018,10,25,12,0,Thursday,14 days,74046.768
ACC-182446574,27,8.32,8741.63,0.0,CUS-3026014945,2018-10-25,Tonya,F,-32.00,116.06,,c8102c73-8f6a-4c5d-a452-797d9aaba5d4,-31.87,115.76,WA,Trigg,debit,authorized,52b4b28dc535406ab7b36b5cbc7045ec,SALES-POS,20-30,2018,10,25,15,5,Thursday,14 days,74046.768
ACC-182446574,27,8.03,8733.6,1.0,CUS-3026014945,2018-10-25,Tonya,F,-32.00,116.06,,c8102c73-8f6a-4c5d-a452-797d9aaba5d4,-31.87,115.76,WA,Trigg,debit,authorized,07556b09e2ac4b2e8308bb293807d0db,POS,20-30,2018,10,25,21,23,Thursday,14 days,74046.768
ACC-182446574,27,12.78,8720.82,1.0,CUS-3026014945,2018-10-26,Tonya,F,-32.00,116.06,,294193ff-d76e-445f-b240-dea59df2caf8,-31.94,141.47,NSW,Broken Hill,debit,authorized,96a8b992d1e140d9860692ede0c3a42d,SALES-POS,20-30,2018,10,26,1,54,Friday,14 days,74046.768
ACC-182446574,27,7.66,8713.16,1.0,CUS-3026014945,2018-10-26,Tonya,F,-32.00,116.06,,28f19ff8-59dc-4c40-b942-602707872786,-31.92,115.85,WA,North Perth,debit,authorized,4afe85fa90794b0bb288a188d782d505,POS,20-30,2018,10,26,2,53,Friday,14 days,74046.768
ACC-182446574,27,21.54,11531.77,1.0,CUS-3026014945,2018-10-27,Tonya,F,-32.00,116.06,,e8e3598a-d91c-4aab-ae01-61196aa23bc5,-31.78,115.97,WA,Ellenbrook,debit,authorized,e75e7127b9af401fac2b094796d7308d,POS,20-30,2018,10,27,4,31,Saturday,14 days,74046.768
ACC-182446574,27,32.52,11499.25,1.0,CUS-3026014945,2018-10-27,Tonya,F,-32.00,116.06,,f3714c41-be33-4e0f-bfb8-b0d32e2de2e8,-31.89,138.42,SA,Hawker,debit,authorized,f1a5f71083d44cd3936588b8ef30f604,POS,20-30,2018,10,27,9,18,Saturday,14 days,74046.768
ACC-182446574,27,18.65,11480.6,1.0,CUS-3026014945,2018-10-27,Tonya,F,-32.00,116.06,,4d1c882d-8b38-4de0-8b1d-c486d2202d2e,-32.01,151.96,NSW,Gloucester,debit,authorized,d5f9edf6b5204b75b464228ff46caa8f,SALES-POS,20-30,2018,10,27,9,44,Saturday,14 days,74046.768
ACC-182446574,27,194.0,11286.6,,CUS-3026014945,2018-10-27,Tonya,F,-32.00,116.06,,,,,,,debit,posted,22026dc26528435bb1759ef54827a21a,PAYMENT,20-30,2018,10,27,10,0,Saturday,14 days,74046.768
ACC-182446574,27,27.59,11259.01,1.0,CUS-3026014945,2018-10-27,Tonya,F,-32.00,116.06,,1cd50a6b-6654-4371-b16d-30db7e692030,-31.89,115.76,WA,Scarborough,debit,authorized,4565f48cd8cc47b0b4e4c224d5bd6a68,SALES-POS,20-30,2018,10,27,12,37,Saturday,14 days,74046.768
ACC-182446574,27,22.63,11236.38,1.0,CUS-3026014945,2018-10-27,Tonya,F,-32.00,116.06,,6c84c219-96ea-4c6f-9de5-0a28bcaec62f,-32.01,152.47,NSW,Rainbow Flat,debit,authorized,a73727493f8148238b6d2f03fa006237,POS,20-30,2018,10,27,19,18,Saturday,14 days,74046.768
ACC-182446574,27,18.23,11218.15,0.0,CUS-3026014945,2018-10-27,Tonya,F,-32.00,116.06,,ac700702-1643-4175-a33c-43e64db4d973,-32.02,115.94,WA,Cannington,debit,authorized,a9111817fc2c491b84375b362068b7fe,POS,20-30,2018,10,27,20,14,Saturday,14 days,74046.768
ACC-182446574,27,32.68,11185.47,1.0,CUS-3026014945,2018-10-27,Tonya,F,-32.00,116.06,,f3714c41-be33-4e0f-bfb8-b0d32e2de2e8,-31.89,138.42,SA,Hawker,debit,authorized,0f6c661e5bc94a6b9b9516f16ac3455c,SALES-POS,20-30,2018,10,27,23,55,Saturday,14 days,74046.768
ACC-182446574,27,22.45,11163.02,1.0,CUS-3026014945,2018-10-28,Tonya,F,-32.00,116.06,,1c29ee1f-36b8-416d-b7f3-57585cf77222,-32.03,115.84,WA,Booragoon,debit,authorized,b99c1b38168b442c8cba88aeb0574e3e,POS,20-30,2018,10,28,8,14,Sunday,14 days,74046.768
ACC-182446574,27,5.55,11157.47,0.0,CUS-3026014945,2018-10-28,Tonya,F,-32.00,116.06,,da6c07a2-edee-4201-8b0e-fab491789f09,-31.89,116.01,WA,Midland,debit,authorized,33fd997f739f45aba984cafabf423d67,POS,20-30,2018,10,28,14,44,Sunday,14 days,74046.768
ACC-182446574,27,63.02,11094.45,1.0,CUS-3026014945,2018-10-28,Tonya,F,-32.00,116.06,,c906b450-c9bc-4dd4-9539-ef5c86f6481b,-33.91,151.2,NSW,Alexandria,debit,authorized,083115f0a2a247c79b3d6c572a1b9cf9,POS,20-30,2018,10,28,15,45,Sunday,14 days,74046.768
ACC-182446574,27,14.36,11080.09,0.0,CUS-3026014945,2018-10-28,Tonya,F,-32.00,116.06,,41b90cfc-01e1-4771-8d3a-6914f8b165a9,-31.98,141.46,NSW,Broken Hill,debit,authorized,cf4d43d54f1a4bdab7317e774203024d,POS,20-30,2018,10,28,21,42,Sunday,14 days,74046.768
ACC-182446574,27,26.56,11053.53,1.0,CUS-3026014945,2018-10-29,Tonya,F,-32.00,116.06,,c4c92c60-380c-45de-a8b6-12c6e6a97c59,-31.9,116.02,WA,Bellevue,debit,authorized,1d72a9d23e2d4d2490c324090f4f67ae,POS,20-30,2018,10,29,22,48,Monday,14 days,74046.768
ACC-182446574,27,12.38,11041.15,1.0,CUS-3026014945,2018-10-30,Tonya,F,-32.00,116.06,,01a1edb2-3ed1-4743-961a-53249ee0b92e,-32.14,115.79,WA,Beeliar,debit,authorized,58106d17012841198b96b30d84fdba66,SALES-POS,20-30,2018,10,30,10,3,Tuesday,14 days,74046.768
ACC-182446574,27,18.47,11022.68,0.0,CUS-3026014945,2018-10-30,Tonya,F,-32.00,116.06,,5ee09cfd-c05e-4489-8a4e-911c16c68f0c,-32.02,115.94,WA,Cannington,debit,authorized,9e02feaf5b0445b09d5f8fc7e5dae056,SALES-POS,20-30,2018,10,30,10,22,Tuesday,14 days,74046.768
ACC-182446574,27,12.51,11010.17,1.0,CUS-3026014945,2018-10-30,Tonya,F,-32.00,116.06,,7fbd6363-a171-4ce6-ad92-c59fd7991396,-33.86,151.06,NSW,Lidcombe,debit,authorized,727ebe0c209342f5ae10338b5b3c97d8,POS,20-30,2018,10,30,15,31,Tuesday,14 days,74046.768
ACC-182446574,27,57.0,10953.17,,CUS-3026014945,2018-10-31,Tonya,F,-32.00,116.06,,,,,,,debit,posted,9581e449fc0e42eba678b84e6818d4c8,INTER BANK,20-30,2018,10,31,12,0,Wednesday,14 days,74046.768
ACC-182446574,27,33.0,10920.17,,CUS-3026014945,2018-10-31,Tonya,F,-32.00,116.06,,,,,,,debit,posted,2ecd88fa9fd34a33937ac860e320df7a,INTER BANK,20-30,2018,10,31,20,0,Wednesday,14 days,74046.768
ACC-602667573,40,21.0,466.58,,CUS-2031327464,2018-08-01,Michael,M,-33.96,151.23,,,,,,,debit,posted,798a77869014441b840a7a8a23408332,INTER BANK,30-40,2018,8,1,6,0,Wednesday,7 days,118904.486
ACC-602667573,40,11.64,454.94,1.0,CUS-2031327464,2018-08-01,Michael,M,-33.96,151.23,,a1ca1b7e-a737-4fc8-b070-3e606f52c0d6,-33.95,115.07,WA,Margaret River,debit,authorized,f43f13d2a2d64627bd7849e55076d5ad,POS,30-40,2018,8,1,11,4,Wednesday,7 days,118904.486
ACC-602667573,40,14.28,440.66,1.0,CUS-2031327464,2018-08-01,Michael,M,-33.96,151.23,,1c6feb54-37a6-47b4-ae0a-a2f3005e7087,-33.8,151.18,NSW,Chatswood,debit,authorized,18a79fa1895146598803550daf9b8f5d,SALES-POS,30-40,2018,8,1,11,25,Wednesday,7 days,118904.486
ACC-602667573,40,11.46,429.2,0.0,CUS-2031327464,2018-08-01,Michael,M,-33.96,151.23,,89556e0f-b593-4b89-adb4-8f279923bb24,-33.77,151.27,NSW,Brookvale,debit,authorized,06232e1cf77744ccb2ecb302de8dadc3,SALES-POS,30-40,2018,8,1,14,45,Wednesday,7 days,118904.486
ACC-602667573,40,41.0,388.2,,CUS-2031327464,2018-08-03,Michael,M,-33.96,151.23,,,,,,,debit,posted,7ccf8016037d480a8a4090cff14ad81a,PAYMENT,30-40,2018,8,3,16,0,Friday,7 days,118904.486
ACC-602667573,40,25.0,363.2,,CUS-2031327464,2018-08-05,Michael,M,-33.96,151.23,,,,,,,debit,posted,176e0e721b824cfb807809eb55b89990,PAYMENT,30-40,2018,8,5,22,0,Sunday,7 days,118904.486
ACC-602667573,40,189.0,174.2,,CUS-2031327464,2018-08-06,Michael,M,-33.96,151.23,,,,,,,debit,posted,22e877cbf2ae43e2b102ca562c742ef2,PAYMENT,30-40,2018,8,6,4,0,Monday,7 days,118904.486
ACC-602667573,40,21.0,2433.56,,CUS-2031327464,2018-08-08,Michael,M,-33.96,151.23,,,,,,,debit,posted,fcdc7a297fca4b27b588d3fab99a8ea3,INTER BANK,30-40,2018,8,8,6,0,Wednesday,7 days,118904.486
ACC-602667573,40,51.31,2382.25,1.0,CUS-2031327464,2018-08-09,Michael,M,-33.96,151.23,,d5cb98a1-2a78-4abd-8da5-378b2169f9cc,-33.81,151.11,NSW,Ryde,debit,authorized,1fa35d8985cc454baa0ebe54b0ffc399,POS,30-40,2018,8,9,15,49,Thursday,7 days,118904.486
ACC-602667573,40,49.05,2333.2,1.0,CUS-2031327464,2018-08-10,Michael,M,-33.96,151.23,,c6717cc7-5c1e-4779-b147-d59ecd7f3827,-33.82,151,NSW,Parramatta,debit,authorized,88789c20996c469887cff5c908de3b4f,SALES-POS,30-40,2018,8,10,4,9,Friday,7 days,118904.486
ACC-602667573,40,20.09,2313.11,1.0,CUS-2031327464,2018-08-10,Michael,M,-33.96,151.23,,51ee6c01-47b5-4065-863f-44663035cac6,-37.8,144.96,VIC,Carlton,debit,authorized,3069dc5933bc4db58048e1e6750f931a,SALES-POS,30-40,2018,8,10,8,2,Friday,7 days,118904.486
ACC-602667573,40,10.76,2302.35,1.0,CUS-2031327464,2018-08-10,Michael,M,-33.96,151.23,,add48011-b368-4229-bacd-63436e0bfa60,-33.8,151.18,NSW,Chatswood,debit,authorized,0297e7313c9046ea9700f679b44c4f52,SALES-POS,30-40,2018,8,10,8,44,Friday,7 days,118904.486
ACC-602667573,40,17.97,2284.38,1.0,CUS-2031327464,2018-08-10,Michael,M,-33.96,151.23,,41d47294-3574-44c1-bbed-0d44650b2832,-33.91,151.24,NSW,Randwick,debit,authorized,c6ef5c47f86e4303bfec1d921be5b193,SALES-POS,30-40,2018,8,10,11,38,Friday,7 days,118904.486
ACC-602667573,40,41.0,2243.38,,CUS-2031327464,2018-08-10,Michael,M,-33.96,151.23,,,,,,,debit,posted,a8dd87c395ce4d439a2b3150bafd42e3,PAYMENT,30-40,2018,8,10,16,0,Friday,7 days,118904.486
ACC-602667573,40,85.0,2158.38,,CUS-2031327464,2018-08-12,Michael,M,-33.96,151.23,,,,,,,debit,posted,f28cc30640804c6cae054cb56f4f514f,PAYMENT,30-40,2018,8,12,16,0,Sunday,7 days,118904.486
ACC-602667573,40,25.0,2133.38,,CUS-2031327464,2018-08-12,Michael,M,-33.96,151.23,,,,,,,debit,posted,da4e549315dc4870be634b71faf2cd4c,PAYMENT,30-40,2018,8,12,22,0,Sunday,7 days,118904.486
ACC-602667573,40,21.0,4392.74,,CUS-2031327464,2018-08-15,Michael,M,-33.96,151.23,,,,,,,debit,posted,95d6433a0c5645c49e32f03420c95aa3,INTER BANK,30-40,2018,8,15,6,0,Wednesday,7 days,118904.486
ACC-602667573,40,208.55,4184.19,0.0,CUS-2031327464,2018-08-15,Michael,M,-33.96,151.23,,261c71f5-4ed6-4661-b95d-84855a34227d,-33.92,151.03,NSW,Bankstown,debit,authorized,18c2a8b5719e4e2295bddd08d563b56e,POS,30-40,2018,8,15,15,8,Wednesday,7 days,118904.486
ACC-602667573,40,22.08,4162.11,0.0,CUS-2031327464,2018-08-15,Michael,M,-33.96,151.23,,08f4f809-fafc-4123-8a7d-a0ab650b27cd,-33.79,151.12,NSW,Ryde,debit,authorized,a4fbe9e7cb0c41299b425a9efbde14da,SALES-POS,30-40,2018,8,15,15,33,Wednesday,7 days,118904.486
ACC-602667573,40,17.42,4144.69,1.0,CUS-2031327464,2018-08-15,Michael,M,-33.96,151.23,,16f0ab84-0c98-415c-8314-a72bd05cced1,-33.78,151.12,NSW,Macquarie Park,debit,authorized,1aa0fe0e66de4ee5a52479ff8149399b,POS,30-40,2018,8,15,18,56,Wednesday,7 days,118904.486
ACC-602667573,40,10.25,4134.44,1.0,CUS-2031327464,2018-08-17,Michael,M,-33.96,151.23,,7136175d-4f8a-466f-83fd-36705ceb8cf6,-33.92,151.23,NSW,Kensington,debit,authorized,b3111c17a96347c6949081ce303419cf,SALES-POS,30-40,2018,8,17,0,1,Friday,7 days,118904.486
ACC-602667573,40,97.0,4037.44,,CUS-2031327464,2018-08-17,Michael,M,-33.96,151.23,,,,,,,debit,posted,2c9e9f93521540819ad45625e8c3bddb,INTER BANK,30-40,2018,8,17,2,0,Friday,7 days,118904.486
ACC-602667573,40,17.29,4020.15,1.0,CUS-2031327464,2018-08-17,Michael,M,-33.96,151.23,,47d798c2-0259-4648-93cd-6f173464cf93,-33.87,151.22,NSW,Potts Point,debit,authorized,39906b9c20a74af0b89d146c586bab66,SALES-POS,30-40,2018,8,17,5,21,Friday,7 days,118904.486
ACC-602667573,40,41.0,3979.15,,CUS-2031327464,2018-08-17,Michael,M,-33.96,151.23,,,,,,,debit,posted,0fe27d6ba6b14f07bce79958c80123f3,PAYMENT,30-40,2018,8,17,16,0,Friday,7 days,118904.486
ACC-602667573,40,78.0,3901.15,,CUS-2031327464,2018-08-18,Michael,M,-33.96,151.23,,,,,,,debit,posted,c9724ea95d214f2eb2e8012bf40ab55b,INTER BANK,30-40,2018,8,18,16,0,Saturday,7 days,118904.486
ACC-602667573,40,16.96,3884.19,1.0,CUS-2031327464,2018-08-19,Michael,M,-33.96,151.23,,e9569816-7d10-403a-8ca2-4ae5fffe10bb,-33.92,150.92,NSW,Liverpool,debit,authorized,15e19e92601a411686c63daebf699980,SALES-POS,30-40,2018,8,19,11,39,Sunday,7 days,118904.486
ACC-602667573,40,25.0,3859.19,,CUS-2031327464,2018-08-19,Michael,M,-33.96,151.23,,,,,,,debit,posted,a6d724d6a33b40b5a7c3fba95b3df3bf,PAYMENT,30-40,2018,8,19,22,0,Sunday,7 days,118904.486
ACC-602667573,40,12.12,6127.43,1.0,CUS-2031327464,2018-08-21,Michael,M,-33.96,151.23,,710218fc-ebb5-4b61-84a2-6fa35591534c,-33.81,151.22,NSW,Northbridge,debit,authorized,524e581a4cd94a17a813c0dd3113e835,POS,30-40,2018,8,21,9,35,Tuesday,7 days,118904.486
ACC-602667573,40,17.54,6109.89,1.0,CUS-2031327464,2018-08-21,Michael,M,-33.96,151.23,,6e6f2cef-3a18-4af7-8e82-c6ba3e7aae7b,-33.93,150.88,NSW,Prestons,debit,authorized,41b41ac340304e09898570f1e931486a,SALES-POS,30-40,2018,8,21,9,39,Tuesday,7 days,118904.486
ACC-602667573,40,35.09,6074.8,1.0,CUS-2031327464,2018-08-21,Michael,M,-33.96,151.23,,830a451c-316e-4a6a-bf25-e37caedca49e,-33.87,151.21,NSW,Sydney,debit,authorized,821b862dad0640369d9f1058f8bdb632,POS,30-40,2018,8,21,11,47,Tuesday,7 days,118904.486
ACC-602667573,40,21.0,6053.8,,CUS-2031327464,2018-08-22,Michael,M,-33.96,151.23,,,,,,,debit,posted,39192f098e0a4390b7f8667a098abe34,INTER BANK,30-40,2018,8,22,6,0,Wednesday,7 days,118904.486
ACC-602667573,40,112.0,5941.8,,CUS-2031327464,2018-08-23,Michael,M,-33.96,151.23,,,,,,,debit,posted,9f29a57cd6504676966cba92ef124c34,INTER BANK,30-40,2018,8,23,6,0,Thursday,7 days,118904.486
ACC-602667573,40,887.0,5054.8,,CUS-2031327464,2018-08-23,Michael,M,-33.96,151.23,,,,,,,debit,posted,a19215dbf80140f6b4d8ac39b75f89a5,PAYMENT,30-40,2018,8,23,22,0,Thursday,7 days,118904.486
ACC-602667573,40,41.0,5013.8,,CUS-2031327464,2018-08-24,Michael,M,-33.96,151.23,,,,,,,debit,posted,b0e440f3c36345738f45ebfbcf8d783f,PAYMENT,30-40,2018,8,24,16,0,Friday,7 days,118904.486
ACC-602667573,40,144.0,4869.8,,CUS-2031327464,2018-08-25,Michael,M,-33.96,151.23,,,,,,,debit,posted,14a812ddcd494bc99aacbdaf73d31114,PAYMENT,30-40,2018,8,25,12,0,Saturday,7 days,118904.486
ACC-602667573,40,25.0,4844.8,,CUS-2031327464,2018-08-26,Michael,M,-33.96,151.23,,,,,,,debit,posted,8118e92c3a574d128def4cb295356c23,PAYMENT,30-40,2018,8,26,22,0,Sunday,7 days,118904.486
ACC-602667573,40,21.0,7104.16,,CUS-2031327464,2018-08-29,Michael,M,-33.96,151.23,,,,,,,debit,posted,e9ed2100900f44979bbfafaa9ac3a1b3,INTER BANK,30-40,2018,8,29,6,0,Wednesday,7 days,118904.486
ACC-602667573,40,41.0,7063.16,,CUS-2031327464,2018-08-31,Michael,M,-33.96,151.23,,,,,,,debit,posted,15fcd2ff034d4f28a3e12161baa50848,PAYMENT,30-40,2018,8,31,16,0,Friday,7 days,118904.486
ACC-602667573,40,25.0,7038.16,,CUS-2031327464,2018-09-02,Michael,M,-33.96,151.23,,,,,,,debit,posted,264f21839a034308990ca21a8fb6bb60,PAYMENT,30-40,2018,9,2,22,0,Sunday,7 days,118904.486
ACC-602667573,40,21.0,9297.52,,CUS-2031327464,2018-09-05,Michael,M,-33.96,151.23,,,,,,,debit,posted,ffabea360bf74c968f98a0ae6c93cb80,INTER BANK,30-40,2018,9,5,6,0,Wednesday,7 days,118904.486
ACC-602667573,40,189.0,9108.52,,CUS-2031327464,2018-09-06,Michael,M,-33.96,151.23,,,,,,,debit,posted,35a2b09ec88740efa4ce748b3ad95242,PAYMENT,30-40,2018,9,6,4,0,Thursday,7 days,118904.486
ACC-602667573,40,41.0,9067.52,,CUS-2031327464,2018-09-07,Michael,M,-33.96,151.23,,,,,,,debit,posted,84aa76cbccf34bcf91e31618579e9af4,PAYMENT,30-40,2018,9,7,16,0,Friday,7 days,118904.486
ACC-602667573,40,25.0,9042.52,,CUS-2031327464,2018-09-09,Michael,M,-33.96,151.23,,,,,,,debit,posted,680ca42b320c40f7a4969bfae997e06e,PAYMENT,30-40,2018,9,9,22,0,Sunday,7 days,118904.486
ACC-602667573,40,21.0,11301.88,,CUS-2031327464,2018-09-12,Michael,M,-33.96,151.23,,,,,,,debit,posted,80e1b91abd704ab6a488d909dc9c72a5,INTER BANK,30-40,2018,9,12,6,0,Wednesday,7 days,118904.486
ACC-602667573,40,85.0,11216.88,,CUS-2031327464,2018-09-12,Michael,M,-33.96,151.23,,,,,,,debit,posted,2090f281fcdd4d50814302448a691af4,PAYMENT,30-40,2018,9,12,16,0,Wednesday,7 days,118904.486
ACC-602667573,40,41.0,11175.88,,CUS-2031327464,2018-09-14,Michael,M,-33.96,151.23,,,,,,,debit,posted,54119634d21840cb81737455d817d26c,PAYMENT,30-40,2018,9,14,16,0,Friday,7 days,118904.486
ACC-602667573,40,25.0,11150.88,,CUS-2031327464,2018-09-16,Michael,M,-33.96,151.23,,,,,,,debit,posted,489867d75a48456785f40ed9a344699e,PAYMENT,30-40,2018,9,16,22,0,Sunday,7 days,118904.486
ACC-602667573,40,97.0,11053.88,,CUS-2031327464,2018-09-17,Michael,M,-33.96,151.23,,,,,,,debit,posted,08f0900f7b5241b98b33a9809da22b9f,INTER BANK,30-40,2018,9,17,2,0,Monday,7 days,118904.486
ACC-602667573,40,78.0,13256.24,,CUS-2031327464,2018-09-18,Michael,M,-33.96,151.23,,,,,,,debit,posted,275ba337818d44e38b05a7ef9c97c91c,INTER BANK,30-40,2018,9,18,16,0,Tuesday,7 days,118904.486
ACC-602667573,40,21.0,13235.24,,CUS-2031327464,2018-09-19,Michael,M,-33.96,151.23,,,,,,,debit,posted,531ff2d2829a4af8bb12e75d6386defb,INTER BANK,30-40,2018,9,19,6,0,Wednesday,7 days,118904.486
ACC-602667573,40,41.0,13194.24,,CUS-2031327464,2018-09-21,Michael,M,-33.96,151.23,,,,,,,debit,posted,b7bc48d15a0341a2bd253763f83a41da,PAYMENT,30-40,2018,9,21,16,0,Friday,7 days,118904.486
ACC-602667573,40,112.0,13082.24,,CUS-2031327464,2018-09-23,Michael,M,-33.96,151.23,,,,,,,debit,posted,1426d8f1b1cf40878c9b8c23ae110003,INTER BANK,30-40,2018,9,23,6,0,Sunday,7 days,118904.486
ACC-602667573,40,25.0,13057.24,,CUS-2031327464,2018-09-23,Michael,M,-33.96,151.23,,,,,,,debit,posted,29e874c86bad4dfba5c98fb2ef9dd118,PAYMENT,30-40,2018,9,23,22,0,Sunday,7 days,118904.486
ACC-602667573,40,144.0,15193.6,,CUS-2031327464,2018-09-25,Michael,M,-33.96,151.23,,,,,,,debit,posted,2bdabb778efa497ab3b0e1b4e8f567c2,PAYMENT,30-40,2018,9,25,12,0,Tuesday,7 days,118904.486
ACC-602667573,40,21.0,15172.6,,CUS-2031327464,2018-09-26,Michael,M,-33.96,151.23,,,,,,,debit,posted,bc8d22e7322b4e3c8443d8143e6d39c0,INTER BANK,30-40,2018,9,26,6,0,Wednesday,7 days,118904.486
ACC-602667573,40,51.27,15121.33,1.0,CUS-2031327464,2018-09-27,Michael,M,-33.96,151.23,,04f6fd28-3bc9-430b-8c6c-c55d5e74fcc2,-33.81,150.97,NSW,Wentworthville,debit,authorized,06707e9810434f9c9bf47e24427f4eb6,POS,30-40,2018,9,27,11,58,Thursday,7 days,118904.486
ACC-602667573,40,9.5,15111.83,1.0,CUS-2031327464,2018-09-27,Michael,M,-33.96,151.23,,806f2063-1850-48d7-88b9-7e89a8300ae1,-33.81,151.09,NSW,West Ryde,debit,authorized,2588b3427f8f4a04a5376fe57de0f3da,SALES-POS,30-40,2018,9,27,14,30,Thursday,7 days,118904.486
ACC-602667573,40,13.62,15098.21,1.0,CUS-2031327464,2018-09-28,Michael,M,-33.96,151.23,,0a38cb03-1115-4dfe-91e4-88da1e2f5437,-33.86,151.16,NSW,Drummoyne,debit,authorized,db83c24bd4c440bb82a1278cc4785259,SALES-POS,30-40,2018,9,28,12,47,Friday,7 days,118904.486
ACC-602667573,40,41.0,15057.21,,CUS-2031327464,2018-09-28,Michael,M,-33.96,151.23,,,,,,,debit,posted,e93d22abb12845d99f4223078c39fe2d,PAYMENT,30-40,2018,9,28,16,0,Friday,7 days,118904.486
ACC-602667573,40,97.08,14960.13,1.0,CUS-2031327464,2018-09-28,Michael,M,-33.96,151.23,,9ce00882-f927-41b8-a030-c286f9c478e7,-37.81,145.04,VIC,Kew,debit,authorized,9a0ce3cb6cdf4d32a86efe3aad48d98a,SALES-POS,30-40,2018,9,28,20,37,Friday,7 days,118904.486
ACC-602667573,40,25.0,14935.13,,CUS-2031327464,2018-09-30,Michael,M,-33.96,151.23,,,,,,,debit,posted,59295795d77d473c8d76a2778575f486,PAYMENT,30-40,2018,9,30,22,0,Sunday,7 days,118904.486
ACC-602667573,40,21.0,17194.49,,CUS-2031327464,2018-10-03,Michael,M,-33.96,151.23,,,,,,,debit,posted,d1d4ef9f2c6645ec9d72f885cfd43bce,INTER BANK,30-40,2018,10,3,6,0,Wednesday,7 days,118904.486
ACC-602667573,40,613.0,16581.49,,CUS-2031327464,2018-10-05,Michael,M,-33.96,151.23,,,,,,,debit,posted,b17184ecbf69498d8d43849fb118c94c,PAYMENT,30-40,2018,10,5,8,0,Friday,7 days,118904.486
ACC-602667573,40,41.0,16540.49,,CUS-2031327464,2018-10-05,Michael,M,-33.96,151.23,,,,,,,debit,posted,3841b18dcc9146c0bcb3d91169b83039,PAYMENT,30-40,2018,10,5,16,0,Friday,7 days,118904.486
ACC-602667573,40,189.0,16351.49,,CUS-2031327464,2018-10-06,Michael,M,-33.96,151.23,,,,,,,debit,posted,06a516e43a00431e910c942a8478a4ec,PAYMENT,30-40,2018,10,6,4,0,Saturday,7 days,118904.486
ACC-602667573,40,25.0,16326.49,,CUS-2031327464,2018-10-07,Michael,M,-33.96,151.23,,,,,,,debit,posted,80715eba0e774adaa54b6c842c0fc495,PAYMENT,30-40,2018,10,7,22,0,Sunday,7 days,118904.486
ACC-602667573,40,15.32,18591.53,1.0,CUS-2031327464,2018-10-09,Michael,M,-33.96,151.23,,b9f56be0-1eda-448d-b3a3-d2cbfa2eed03,-33.91,151.1,NSW,Campsie,debit,authorized,780f97c4181640d8852e3e3183012704,POS,30-40,2018,10,9,16,35,Tuesday,7 days,118904.486
ACC-602667573,40,21.0,18570.53,,CUS-2031327464,2018-10-10,Michael,M,-33.96,151.23,,,,,,,debit,posted,25142842173e4c9ba97c191e11056de5,INTER BANK,30-40,2018,10,10,6,0,Wednesday,7 days,118904.486
ACC-602667573,40,7.32,18563.21,1.0,CUS-2031327464,2018-10-10,Michael,M,-33.96,151.23,,e118860c-9ef3-491e-87f4-1d38bada2366,-33.84,150.92,NSW,Wetherill Park,debit,authorized,b7bf4c54286a4d5cbe5ee2e6a6c4d405,SALES-POS,30-40,2018,10,10,9,1,Wednesday,7 days,118904.486
ACC-602667573,40,13.47,18549.74,0.0,CUS-2031327464,2018-10-10,Michael,M,-33.96,151.23,,af1b174c-7267-4868-81a4-97e9c3340a11,-33.84,151.21,NSW,North Sydney,debit,authorized,31a476c8db7b430fa20137f0af64e1e6,SALES-POS,30-40,2018,10,10,9,9,Wednesday,7 days,118904.486
ACC-602667573,40,167.21,18382.53,1.0,CUS-2031327464,2018-10-10,Michael,M,-33.96,151.23,,3075b265-3b29-4d54-a38e-c379113f73bf,-33.79,115.97,WA,Balingup,debit,authorized,6cf658be75cd47b9a8fa8dccd7cf9763,SALES-POS,30-40,2018,10,10,9,41,Wednesday,7 days,118904.486
ACC-602667573,40,22.09,18360.44,1.0,CUS-2031327464,2018-10-10,Michael,M,-33.96,151.23,,527f86cc-7ecb-467a-9cfd-744ad2456954,-33.78,151.12,NSW,North Ryde,debit,authorized,709e1d05db5b4dcea810b187033cb434,SALES-POS,30-40,2018,10,10,9,54,Wednesday,7 days,118904.486
ACC-602667573,40,41.0,18319.44,,CUS-2031327464,2018-10-12,Michael,M,-33.96,151.23,,,,,,,debit,posted,4a40398f68dd48908e9f3ccb68b48de1,PAYMENT,30-40,2018,10,12,16,0,Friday,7 days,118904.486
ACC-602667573,40,85.0,18234.44,,CUS-2031327464,2018-10-12,Michael,M,-33.96,151.23,,,,,,,debit,posted,db9ba7dfd2054b1b88ab2612f9a84e19,PAYMENT,30-40,2018,10,12,16,0,Friday,7 days,118904.486
ACC-602667573,40,5.11,18229.33,0.0,CUS-2031327464,2018-10-14,Michael,M,-33.96,151.23,,440aadf4-f844-4bae-bb38-1f728c78a00d,-33.84,151.21,NSW,North Sydney,debit,authorized,f931d00f442a42668fafff487c7689ba,SALES-POS,30-40,2018,10,14,11,9,Sunday,7 days,118904.486
ACC-602667573,40,48.41,18180.92,1.0,CUS-2031327464,2018-10-14,Michael,M,-33.96,151.23,,917cd761-d5c5-45c8-a607-3fc2e75b00c5,-33.95,151.22,NSW,Hillsdale,debit,authorized,ecc3c0a99f2942b79734b3cf1ea4a895,SALES-POS,30-40,2018,10,14,11,25,Sunday,7 days,118904.486
ACC-602667573,40,18.08,18162.84,0.0,CUS-2031327464,2018-10-14,Michael,M,-33.96,151.23,,dafef863-245b-47b6-9e0b-e94a31e52a03,-33.91,151.21,NSW,Zetland,debit,authorized,ae79b58e994c4d8791d4c79eb29d1e67,SALES-POS,30-40,2018,10,14,14,6,Sunday,7 days,118904.486
ACC-602667573,40,39.47,18123.37,1.0,CUS-2031327464,2018-10-14,Michael,M,-33.96,151.23,,2cb3a2dd-1d71-461e-9d0e-24e67be4624a,-33.75,151.15,NSW,Pymble,debit,authorized,93aff40ad7954110ae1847c9fb33b148,SALES-POS,30-40,2018,10,14,17,2,Sunday,7 days,118904.486
ACC-602667573,40,18.95,18104.42,1.0,CUS-2031327464,2018-10-14,Michael,M,-33.96,151.23,,3a834bd8-21d8-4e37-a908-b91f81704863,-33.8,151.29,NSW,Manly,debit,authorized,637b13f563f74ce18132a7332a8efb93,POS,30-40,2018,10,14,18,57,Sunday,7 days,118904.486
ACC-602667573,40,25.0,18079.42,,CUS-2031327464,2018-10-14,Michael,M,-33.96,151.23,,,,,,,debit,posted,9a13f7c0940d448eac102446081dbdf3,PAYMENT,30-40,2018,10,14,22,0,Sunday,7 days,118904.486
ACC-602667573,40,16.38,20343.4,1.0,CUS-2031327464,2018-10-16,Michael,M,-33.96,151.23,,39d7df49-d246-45c6-bb90-5e4b3a3b003b,-33.87,151.21,NSW,Sydney,debit,authorized,accb32223c16499d8bd4a38276e3c1f6,SALES-POS,30-40,2018,10,16,10,15,Tuesday,7 days,118904.486
ACC-602667573,40,6.49,20336.91,1.0,CUS-2031327464,2018-10-16,Michael,M,-33.96,151.23,,b1a88e2a-7b07-4cb0-bc9b-547dd5d70f85,-33.95,115.07,WA,Margaret River,debit,authorized,22690c60f461469c86f4f416153fd7fc,SALES-POS,30-40,2018,10,16,20,42,Tuesday,7 days,118904.486
ACC-602667573,40,97.0,20239.91,,CUS-2031327464,2018-10-17,Michael,M,-33.96,151.23,,,,,,,debit,posted,495c3824d4de4a7c899a04d4744fdf7f,INTER BANK,30-40,2018,10,17,2,0,Wednesday,7 days,118904.486
ACC-602667573,40,21.0,20218.91,,CUS-2031327464,2018-10-17,Michael,M,-33.96,151.23,,,,,,,debit,posted,45b7998190a941e5b396aad47974b6d5,INTER BANK,30-40,2018,10,17,6,0,Wednesday,7 days,118904.486
ACC-602667573,40,78.0,20140.91,,CUS-2031327464,2018-10-18,Michael,M,-33.96,151.23,,,,,,,debit,posted,0c998bb590ea41f5a005055429b38a85,INTER BANK,30-40,2018,10,18,16,0,Thursday,7 days,118904.486
ACC-602667573,40,41.0,20099.91,,CUS-2031327464,2018-10-19,Michael,M,-33.96,151.23,,,,,,,debit,posted,e992bc5e72dd4ec6bfe2a812eaa6ef52,PAYMENT,30-40,2018,10,19,16,0,Friday,7 days,118904.486
ACC-602667573,40,58.76,20041.15,1.0,CUS-2031327464,2018-10-19,Michael,M,-33.96,151.23,,644526b1-01bf-4666-b476-f5b0a7f197aa,-33.92,151.04,NSW,Bankstown,debit,authorized,a9324ada9d3b4984802f48edcc8b6dcd,POS,30-40,2018,10,19,21,59,Friday,7 days,118904.486
ACC-602667573,40,25.0,20016.15,,CUS-2031327464,2018-10-21,Michael,M,-33.96,151.23,,,,,,,debit,posted,6ba6e9285a044d86ab04a4d9e3281a1f,PAYMENT,30-40,2018,10,21,22,0,Sunday,7 days,118904.486
ACC-602667573,40,10.09,20006.06,1.0,CUS-2031327464,2018-10-22,Michael,M,-33.96,151.23,,32aa73dc-b7c2-4161-b14d-6271b96ce792,-37.81,145.23,VIC,Ringwood,debit,authorized,c59f32a32e784a9fab94b69512e67363,POS,30-40,2018,10,22,10,43,Monday,7 days,118904.486
ACC-602667573,40,112.0,22174.42,,CUS-2031327464,2018-10-23,Michael,M,-33.96,151.23,,,,,,,debit,posted,160039829926429fbea15015d33b8595,INTER BANK,30-40,2018,10,23,6,0,Tuesday,7 days,118904.486
ACC-602667573,40,21.0,22153.42,,CUS-2031327464,2018-10-24,Michael,M,-33.96,151.23,,,,,,,debit,posted,319ce0a5d63748c2915139a95afd330b,INTER BANK,30-40,2018,10,24,6,0,Wednesday,7 days,118904.486
ACC-602667573,40,111.37,22042.05,0.0,CUS-2031327464,2018-10-24,Michael,M,-33.96,151.23,,e83070b0-ae4f-4f55-8cc1-b0964d5bf730,-33.91,151.18,NSW,Newtown,debit,authorized,ac312f07d3a4468b8bd8efb8d1e14ff7,SALES-POS,30-40,2018,10,24,15,38,Wednesday,7 days,118904.486
ACC-602667573,40,26.77,22015.28,1.0,CUS-2031327464,2018-10-24,Michael,M,-33.96,151.23,,6d5a36a7-9f83-40c2-94b9-4fb9e5f2dc23,-35.32,149.18,ACT,Fyshwick,debit,authorized,981bc0c4e92e44c897d8a0869e5510b3,SALES-POS,30-40,2018,10,24,18,21,Wednesday,7 days,118904.486
ACC-602667573,40,30.73,21984.55,1.0,CUS-2031327464,2018-10-24,Michael,M,-33.96,151.23,,ddf730bc-ba3a-43ea-a891-767447ddd563,-37.81,144.96,VIC,Melbourne,debit,authorized,2fcbb181eb904a0e9156faa23b314fbe,SALES-POS,30-40,2018,10,24,19,53,Wednesday,7 days,118904.486
ACC-602667573,40,50.07,21934.48,1.0,CUS-2031327464,2018-10-24,Michael,M,-33.96,151.23,,3ca1545b-9b43-412b-af36-b57407c970b3,-33.79,151.09,NSW,Denistone East,debit,authorized,5a2a807864bb4efea1512a54daaf03a2,POS,30-40,2018,10,24,23,19,Wednesday,7 days,118904.486
ACC-602667573,40,13.99,21920.49,0.0,CUS-2031327464,2018-10-25,Michael,M,-33.96,151.23,,6b7bc24c-90dc-449e-9e3a-77846113bfbd,-33.72,150.31,NSW,Katoomba,debit,authorized,406237e6e8c1478196bf1c509b27c18f,SALES-POS,30-40,2018,10,25,1,49,Thursday,7 days,118904.486
ACC-602667573,40,25.88,21894.61,1.0,CUS-2031327464,2018-10-25,Michael,M,-33.96,151.23,,142d45ab-8d51-47d2-87ad-cb2bbf7e23fc,-33.95,115.07,WA,Margaret River,debit,authorized,b993bbcf0c19461a869b32c1bf06c714,SALES-POS,30-40,2018,10,25,7,44,Thursday,7 days,118904.486
ACC-602667573,40,144.0,21750.61,,CUS-2031327464,2018-10-25,Michael,M,-33.96,151.23,,,,,,,debit,posted,58cac4ce5c0a4ebf9979c7b93fc51981,PAYMENT,30-40,2018,10,25,12,0,Thursday,7 days,118904.486
ACC-602667573,40,41.0,21709.61,,CUS-2031327464,2018-10-26,Michael,M,-33.96,151.23,,,,,,,debit,posted,2d56241a0af741ebb33c2059c820666c,PAYMENT,30-40,2018,10,26,16,0,Friday,7 days,118904.486
ACC-602667573,40,25.0,21684.61,,CUS-2031327464,2018-10-28,Michael,M,-33.96,151.23,,,,,,,debit,posted,cf59833839f341c69704dc4f71de0fb3,PAYMENT,30-40,2018,10,28,22,0,Sunday,7 days,118904.486
ACC-602667573,40,21.0,23943.97,,CUS-2031327464,2018-10-31,Michael,M,-33.96,151.23,,,,,,,debit,posted,7deec725aba54be8b1a6b9a91028a675,INTER BANK,30-40,2018,10,31,6,0,Wednesday,7 days,118904.486
ACC-2171593283,19,27.0,4348.5,,CUS-2317998716,2018-08-01,Fernando,M,-36.04,146.94,,,,,,,debit,posted,baff17b27b2643c48c84fca7129e9611,PAYMENT,<20,2018,8,1,6,0,Wednesday,14 days,68822.314
ACC-2171593283,19,17.0,4331.5,,CUS-2317998716,2018-08-01,Fernando,M,-36.04,146.94,,,,,,,debit,posted,5ffdc96d3c9f4335b3c58b8876bde9ed,PAYMENT,<20,2018,8,1,20,0,Wednesday,14 days,68822.314
ACC-2171593283,19,33.0,4298.5,,CUS-2317998716,2018-08-02,Fernando,M,-36.04,146.94,,,,,,,debit,posted,98c392ba9a4b47339a969e7199c5e4b4,PAYMENT,<20,2018,8,2,5,0,Thursday,14 days,68822.314
ACC-2171593283,19,40.0,4258.5,,CUS-2317998716,2018-08-03,Fernando,M,-36.04,146.94,,,,,,,debit,posted,6f2d9482b7bb441c836f8d35ff36861d,PAYMENT,<20,2018,8,3,19,0,Friday,14 days,68822.314
ACC-2171593283,19,50.0,4208.5,,CUS-2317998716,2018-08-03,Fernando,M,-36.04,146.94,,,,,,,debit,posted,ac10c2b0dfa84321940ba484ef61049b,PAYMENT,<20,2018,8,3,21,0,Friday,14 days,68822.314
ACC-2171593283,19,54.79,4153.71,1.0,CUS-2317998716,2018-08-04,Fernando,M,-36.04,146.94,,47d4a2f6-62f6-40d4-b518-857feeb02d33,-42.78,147.06,TAS,New Norfolk,debit,authorized,0b5a6454757544f894982a7177cdaa62,POS,<20,2018,8,4,9,2,Saturday,14 days,68822.314
ACC-2171593283,19,14.08,4139.63,1.0,CUS-2317998716,2018-08-05,Fernando,M,-36.04,146.94,,87bca611-8db5-4837-9c6a-ae892790c0fb,-37.96,146.99,VIC,Maffra,debit,authorized,a44189c2ef0f4828b0091679c28ce28f,POS,<20,2018,8,5,11,29,Sunday,14 days,68822.314
ACC-2171593283,19,18.71,4120.92,0.0,CUS-2317998716,2018-08-07,Fernando,M,-36.04,146.94,,3864ffa9-f43a-40cc-84b6-bb4cf8abb286,-41.65,146.94,TAS,Bracknell,debit,authorized,5235df098104434dafaac34de3f26829,POS,<20,2018,8,7,9,8,Tuesday,14 days,68822.314
ACC-2171593283,19,27.0,4093.92,,CUS-2317998716,2018-08-08,Fernando,M,-36.04,146.94,,,,,,,debit,posted,db2bf3989bdf4ce3a9dceb0338feaea4,PAYMENT,<20,2018,8,8,6,0,Wednesday,14 days,68822.314
ACC-2171593283,19,41.97,4051.95,1.0,CUS-2317998716,2018-08-08,Fernando,M,-36.04,146.94,,63f0a68d-e19e-4637-b425-fcefa2d27229,-37.91,145.16,VIC,Mulgrave,debit,authorized,75327fbf9026418181a759bc85b3c7d8,POS,<20,2018,8,8,15,48,Wednesday,14 days,68822.314
ACC-2171593283,19,17.0,6674.71,,CUS-2317998716,2018-08-08,Fernando,M,-36.04,146.94,,,,,,,debit,posted,808f99f1168745eea9a45f3185130893,PAYMENT,<20,2018,8,8,20,0,Wednesday,14 days,68822.314
ACC-2171593283,19,33.0,6641.71,,CUS-2317998716,2018-08-09,Fernando,M,-36.04,146.94,,,,,,,debit,posted,07200bb64b324396b39a71ceee1cbf28,PAYMENT,<20,2018,8,9,5,0,Thursday,14 days,68822.314
ACC-2171593283,19,40.0,6601.71,,CUS-2317998716,2018-08-10,Fernando,M,-36.04,146.94,,,,,,,debit,posted,e3a3681fe4624e0b8f3755ccb1e48348,PAYMENT,<20,2018,8,10,19,0,Friday,14 days,68822.314
ACC-2171593283,19,50.0,6551.71,,CUS-2317998716,2018-08-10,Fernando,M,-36.04,146.94,,,,,,,debit,posted,9aa36b52f7054babbafc3178fda7ef48,PAYMENT,<20,2018,8,10,21,0,Friday,14 days,68822.314
ACC-2171593283,19,27.0,6524.71,,CUS-2317998716,2018-08-15,Fernando,M,-36.04,146.94,,,,,,,debit,posted,472c34c9949a4f3b9b258b025a1da16a,PAYMENT,<20,2018,8,15,6,0,Wednesday,14 days,68822.314
ACC-2171593283,19,17.0,6507.71,,CUS-2317998716,2018-08-15,Fernando,M,-36.04,146.94,,,,,,,debit,posted,2218fee467394469ac58eed92a197e0d,PAYMENT,<20,2018,8,15,20,0,Wednesday,14 days,68822.314
ACC-2171593283,19,40.0,6434.71,,CUS-2317998716,2018-08-17,Fernando,M,-36.04,146.94,,,,,,,debit,posted,325209f9003e4edd8eb1834006b51d12,PAYMENT,<20,2018,8,17,19,0,Friday,14 days,68822.314
ACC-2171593283,19,50.0,6384.71,,CUS-2317998716,2018-08-17,Fernando,M,-36.04,146.94,,,,,,,debit,posted,363f8e6c800149c1b0fa0ca1fe3f049f,PAYMENT,<20,2018,8,17,21,0,Friday,14 days,68822.314
ACC-2171593283,19,27.0,6357.71,,CUS-2317998716,2018-08-22,Fernando,M,-36.04,146.94,,,,,,,debit,posted,3498bee8824d4fbf9d13a64492c0fbdd,PAYMENT,<20,2018,8,22,6,0,Wednesday,14 days,68822.314
ACC-2171593283,19,17.0,8980.47,,CUS-2317998716,2018-08-22,Fernando,M,-36.04,146.94,,,,,,,debit,posted,3437ed87c5164d6195a1ee46d0a38d83,PAYMENT,<20,2018,8,22,20,0,Wednesday,14 days,68822.314
ACC-2171593283,19,33.0,8947.47,,CUS-2317998716,2018-08-23,Fernando,M,-36.04,146.94,,,,,,,debit,posted,7d8083fbbf664897a0bf0fc5c11cb03e,PAYMENT,<20,2018,8,23,5,0,Thursday,14 days,68822.314
ACC-2171593283,19,40.0,8907.47,,CUS-2317998716,2018-08-24,Fernando,M,-36.04,146.94,,,,,,,debit,posted,bc3d06cf3b484ccab77d86977e9f1491,PAYMENT,<20,2018,8,24,19,0,Friday,14 days,68822.314
ACC-2171593283,19,50.0,8857.47,,CUS-2317998716,2018-08-24,Fernando,M,-36.04,146.94,,,,,,,debit,posted,ffbe752776264993b7a98c34394f15df,PAYMENT,<20,2018,8,24,21,0,Friday,14 days,68822.314
ACC-2171593283,19,27.0,8830.47,,CUS-2317998716,2018-08-29,Fernando,M,-36.04,146.94,,,,,,,debit,posted,54a871e037e64e87bd81d6212fe65997,PAYMENT,<20,2018,8,29,6,0,Wednesday,14 days,68822.314
ACC-2171593283,19,17.0,8813.47,,CUS-2317998716,2018-08-29,Fernando,M,-36.04,146.94,,,,,,,debit,posted,630d0ebec553426e923a3ede48273225,PAYMENT,<20,2018,8,29,20,0,Wednesday,14 days,68822.314
ACC-2171593283,19,33.0,8780.47,,CUS-2317998716,2018-08-30,Fernando,M,-36.04,146.94,,,,,,,debit,posted,c82c4aae461f43379a09f39c025efa86,PAYMENT,<20,2018,8,30,5,0,Thursday,14 days,68822.314
ACC-2171593283,19,40.0,8740.47,,CUS-2317998716,2018-08-31,Fernando,M,-36.04,146.94,,,,,,,debit,posted,5a3a9b068c7048d18637b48fe16e3c15,PAYMENT,<20,2018,8,31,19,0,Friday,14 days,68822.314
ACC-2171593283,19,50.0,8690.47,,CUS-2317998716,2018-08-31,Fernando,M,-36.04,146.94,,,,,,,debit,posted,ca1e80e7bb7c445db19cd003ff91ec74,PAYMENT,<20,2018,8,31,21,0,Friday,14 days,68822.314
ACC-2171593283,19,29.76,8660.71,1.0,CUS-2317998716,2018-09-02,Fernando,M,-36.04,146.94,,cafe47f2-556a-4080-895b-f2adf7c0b8b3,-37.83,144.85,VIC,Altona North,debit,authorized,8a82c6cc537b44bca88babf90f7266cd,SALES-POS,<20,2018,9,2,17,22,Sunday,14 days,68822.314
ACC-2171593283,19,46.2,8614.51,0.0,CUS-2317998716,2018-09-02,Fernando,M,-36.04,146.94,,3c5e8df8-2981-4586-b358-47f813797b8d,-19.32,146.79,QLD,Annandale,debit,authorized,1014a0889d5f4f69ba6c8657294734e3,SALES-POS,<20,2018,9,2,22,27,Sunday,14 days,68822.314
ACC-2171593283,19,8.46,8606.05,0.0,CUS-2317998716,2018-09-03,Fernando,M,-36.04,146.94,,c34d1bb1-04b3-407e-b7e6-45ef0b497902,-37.93,145.16,VIC,Springvale,debit,authorized,e29ebb2de35d415c88b4d47b9c3c0b86,POS,<20,2018,9,3,12,23,Monday,14 days,68822.314
ACC-2171593283,19,27.0,8579.05,,CUS-2317998716,2018-09-05,Fernando,M,-36.04,146.94,,,,,,,debit,posted,30feb786e2124ee7a65422fa10c5947a,PAYMENT,<20,2018,9,5,6,0,Wednesday,14 days,68822.314
ACC-2171593283,19,17.0,11201.81,,CUS-2317998716,2018-09-05,Fernando,M,-36.04,146.94,,,,,,,debit,posted,aba547210e3f4b6f8b10e08e86ae9da8,PAYMENT,<20,2018,9,5,20,0,Wednesday,14 days,68822.314
ACC-2171593283,19,33.0,11168.81,,CUS-2317998716,2018-09-06,Fernando,M,-36.04,146.94,,,,,,,debit,posted,a4154a29a5d642ca9643b402a87e39d3,PAYMENT,<20,2018,9,6,5,0,Thursday,14 days,68822.314
ACC-2171593283,19,40.0,11128.81,,CUS-2317998716,2018-09-07,Fernando,M,-36.04,146.94,,,,,,,debit,posted,b1d543c7132641199cc13423ac6218d7,PAYMENT,<20,2018,9,7,19,0,Friday,14 days,68822.314
ACC-2171593283,19,50.0,11078.81,,CUS-2317998716,2018-09-07,Fernando,M,-36.04,146.94,,,,,,,debit,posted,84df94c76f374ac5910cb15e9cd68d5d,PAYMENT,<20,2018,9,7,21,0,Friday,14 days,68822.314
ACC-2171593283,19,27.0,11051.81,,CUS-2317998716,2018-09-12,Fernando,M,-36.04,146.94,,,,,,,debit,posted,89d224fdd41d4bdcb76681ea200c4b89,PAYMENT,<20,2018,9,12,6,0,Wednesday,14 days,68822.314
ACC-2171593283,19,17.0,11034.81,,CUS-2317998716,2018-09-12,Fernando,M,-36.04,146.94,,,,,,,debit,posted,21a752b17ca0485bbfaccb0946586e1a,PAYMENT,<20,2018,9,12,20,0,Wednesday,14 days,68822.314
ACC-2171593283,19,33.0,11001.81,,CUS-2317998716,2018-09-13,Fernando,M,-36.04,146.94,,,,,,,debit,posted,5bc7cc9373664dc8b33c0028277be4f8,PAYMENT,<20,2018,9,13,5,0,Thursday,14 days,68822.314
ACC-2171593283,19,40.0,10943.66,,CUS-2317998716,2018-09-14,Fernando,M,-36.04,146.94,,,,,,,debit,posted,ccbfed47f4e549a58118b7e1bddd2292,PAYMENT,<20,2018,9,14,19,0,Friday,14 days,68822.314
ACC-2171593283,19,18.15,10983.66,0.0,CUS-2317998716,2018-09-14,Fernando,M,-36.04,146.94,,720cfee4-fd57-4f9c-8e20-360bb27dacd5,-37.77,144.97,VIC,Brunswick East,debit,authorized,aaeabb27a53746a1ae10459bdc1c50d4,POS,<20,2018,9,14,19,49,Friday,14 days,68822.314
ACC-2171593283,19,50.0,10893.66,,CUS-2317998716,2018-09-14,Fernando,M,-36.04,146.94,,,,,,,debit,posted,7f1c75f9bb4748048b275233c1ab5ce6,PAYMENT,<20,2018,9,14,21,0,Friday,14 days,68822.314
ACC-2171593283,19,27.24,10866.42,1.0,CUS-2317998716,2018-09-16,Fernando,M,-36.04,146.94,,1b9ea2a4-61fe-4134-9042-b9b6d92aea7a,-19.25,146.81,QLD,North Ward,debit,authorized,59049c82456840d899bfe1d0e1654050,SALES-POS,<20,2018,9,16,16,49,Sunday,14 days,68822.314
ACC-2171593283,19,22.28,10844.14,1.0,CUS-2317998716,2018-09-18,Fernando,M,-36.04,146.94,,35b95b67-37cd-43e1-9df8-0e59db28f6c1,-37.91,145.19,VIC,Wheelers Hill,debit,authorized,96f17c201db04a11b5579e762d74bfdf,POS,<20,2018,9,18,12,55,Tuesday,14 days,68822.314
ACC-2171593283,19,27.0,10817.14,,CUS-2317998716,2018-09-19,Fernando,M,-36.04,146.94,,,,,,,debit,posted,36be5698b8a44274a9d906863447d903,PAYMENT,<20,2018,9,19,6,0,Wednesday,14 days,68822.314
ACC-2171593283,19,17.0,13439.9,,CUS-2317998716,2018-09-19,Fernando,M,-36.04,146.94,,,,,,,debit,posted,bea644a71d534061ae5b94482a5694bd,PAYMENT,<20,2018,9,19,20,0,Wednesday,14 days,68822.314
ACC-2171593283,19,33.0,13406.9,,CUS-2317998716,2018-09-20,Fernando,M,-36.04,146.94,,,,,,,debit,posted,b1b423ff90724d448ee853741a3004f0,PAYMENT,<20,2018,9,20,5,0,Thursday,14 days,68822.314
ACC-2171593283,19,40.0,13366.9,,CUS-2317998716,2018-09-21,Fernando,M,-36.04,146.94,,,,,,,debit,posted,12ceb23840b749278bc0021a7793a1c7,PAYMENT,<20,2018,9,21,19,0,Friday,14 days,68822.314
ACC-2171593283,19,50.0,13316.9,,CUS-2317998716,2018-09-21,Fernando,M,-36.04,146.94,,,,,,,debit,posted,a5ce0dfd3a5d4684931b512bf2794830,PAYMENT,<20,2018,9,21,21,0,Friday,14 days,68822.314
ACC-2171593283,19,26.21,13290.69,1.0,CUS-2317998716,2018-09-23,Fernando,M,-36.04,146.94,,6b0a8d80-9b7a-410e-823d-f9300e69d44d,-19.27,146.81,QLD,Townsville City,debit,authorized,c2492e0630f74987afea021f5154e3e9,POS,<20,2018,9,23,6,7,Sunday,14 days,68822.314
ACC-2171593283,19,27.0,13263.69,,CUS-2317998716,2018-09-26,Fernando,M,-36.04,146.94,,,,,,,debit,posted,2dd62f658c69427da9a1950a9f79a0b1,PAYMENT,<20,2018,9,26,6,0,Wednesday,14 days,68822.314
ACC-2171593283,19,17.0,13246.69,,CUS-2317998716,2018-09-26,Fernando,M,-36.04,146.94,,,,,,,debit,posted,b4876683fe77464487f63631e963314f,PAYMENT,<20,2018,9,26,20,0,Wednesday,14 days,68822.314
ACC-2171593283,19,33.0,13213.69,,CUS-2317998716,2018-09-27,Fernando,M,-36.04,146.94,,,,,,,debit,posted,e26e341de468406b9c4fd9c7df9f8463,PAYMENT,<20,2018,9,27,5,0,Thursday,14 days,68822.314
ACC-2171593283,19,40.0,13173.69,,CUS-2317998716,2018-09-28,Fernando,M,-36.04,146.94,,,,,,,debit,posted,0028689910604c789532e8c7104403d4,PAYMENT,<20,2018,9,28,19,0,Friday,14 days,68822.314
ACC-2171593283,19,50.0,13123.69,,CUS-2317998716,2018-09-28,Fernando,M,-36.04,146.94,,,,,,,debit,posted,ecae61deb0fe4e4691492ac856d46c5f,PAYMENT,<20,2018,9,28,21,0,Friday,14 days,68822.314
ACC-2171593283,19,74.1,13049.59,1.0,CUS-2317998716,2018-10-02,Fernando,M,-36.04,146.94,,22ac6a8b-b831-4184-9130-be8ed0b92fa5,-38.15,144.35,VIC,Geelong,debit,authorized,72a4167f43bb480093435cadfbc17466,SALES-POS,<20,2018,10,2,10,15,Tuesday,14 days,68822.314
ACC-2171593283,19,27.0,13022.59,,CUS-2317998716,2018-10-03,Fernando,M,-36.04,146.94,,,,,,,debit,posted,0c6392074a1c4152ae73909270c85410,PAYMENT,<20,2018,10,3,6,0,Wednesday,14 days,68822.314
ACC-2171593283,19,14.82,13007.77,1.0,CUS-2317998716,2018-10-03,Fernando,M,-36.04,146.94,,b089249d-62de-4762-8373-dc70ad8d49ae,-38.15,145.17,VIC,Frankston,debit,authorized,4808902aea904fc097a275c99c4bce6f,SALES-POS,<20,2018,10,3,9,23,Wednesday,14 days,68822.314
ACC-2171593283,19,15.54,12992.23,1.0,CUS-2317998716,2018-10-03,Fernando,M,-36.04,146.94,,81311004-3420-4476-85d2-576e74dd11cb,-37.86,145.03,VIC,Malvern,debit,authorized,9a66e3acd5e14b6f9b94ac5920f8117b,POS,<20,2018,10,3,17,54,Wednesday,14 days,68822.314
ACC-2171593283,19,17.0,15614.99,,CUS-2317998716,2018-10-03,Fernando,M,-36.04,146.94,,,,,,,debit,posted,beeafc73cea848ad8903f625369c3da1,PAYMENT,<20,2018,10,3,20,0,Wednesday,14 days,68822.314
ACC-2171593283,19,33.0,15581.99,,CUS-2317998716,2018-10-04,Fernando,M,-36.04,146.94,,,,,,,debit,posted,49799f79594f453fb2c33e128bad4e96,PAYMENT,<20,2018,10,4,5,0,Thursday,14 days,68822.314
ACC-2171593283,19,5.49,15576.5,1.0,CUS-2317998716,2018-10-04,Fernando,M,-36.04,146.94,,50ff2393-0290-42f4-ba1c-06ac4be220b1,-38.15,144.36,VIC,Geelong,debit,authorized,7dd7b096365d4e9ebba8138d09c35357,SALES-POS,<20,2018,10,4,13,31,Thursday,14 days,68822.314
ACC-2171593283,19,16.53,15559.97,1.0,CUS-2317998716,2018-10-05,Fernando,M,-36.04,146.94,,8e83c95f-f8d1-44c1-8cc1-a06fc34b5482,-27.5,153.03,QLD,Annerley,debit,authorized,8cdc8763ed9743d7a8b25c2ac07757ca,POS,<20,2018,10,5,17,43,Friday,14 days,68822.314
ACC-2171593283,19,40.0,15519.97,,CUS-2317998716,2018-10-05,Fernando,M,-36.04,146.94,,,,,,,debit,posted,3e5a176ca8654f958c49a133e2d389a9,PAYMENT,<20,2018,10,5,19,0,Friday,14 days,68822.314
ACC-2171593283,19,50.0,15469.97,,CUS-2317998716,2018-10-05,Fernando,M,-36.04,146.94,,,,,,,debit,posted,f80d8f680a38413bbdd59e20f9042ad6,PAYMENT,<20,2018,10,5,21,0,Friday,14 days,68822.314
ACC-2171593283,19,50.96,15419.01,1.0,CUS-2317998716,2018-10-07,Fernando,M,-36.04,146.94,,939bffd8-e25b-48c5-b847-c0533eb188a3,-33.87,151.21,NSW,Sydney,debit,authorized,59b7e9fe0b6741728138dc0aff42e7b2,SALES-POS,<20,2018,10,7,13,29,Sunday,14 days,68822.314
ACC-2171593283,19,27.0,15392.01,,CUS-2317998716,2018-10-10,Fernando,M,-36.04,146.94,,,,,,,debit,posted,ca3272e36beb4a7da45cb6f2ee7820a7,PAYMENT,<20,2018,10,10,6,0,Wednesday,14 days,68822.314
ACC-2171593283,19,23.67,15368.34,1.0,CUS-2317998716,2018-10-10,Fernando,M,-36.04,146.94,,ced48b22-c1bd-4e46-a5f9-2c38832081df,-37.75,144.91,VIC,Essendon,debit,authorized,8edb1cafdb9b4877a2deda3cde0ea84b,POS,<20,2018,10,10,15,58,Wednesday,14 days,68822.314
ACC-2171593283,19,17.0,15351.34,,CUS-2317998716,2018-10-10,Fernando,M,-36.04,146.94,,,,,,,debit,posted,36aac4d189b14f58a217dfa72f2b1521,PAYMENT,<20,2018,10,10,20,0,Wednesday,14 days,68822.314
ACC-2171593283,19,33.0,15318.34,,CUS-2317998716,2018-10-11,Fernando,M,-36.04,146.94,,,,,,,debit,posted,12cfb775b8db41ad83e5493bf1590b9d,PAYMENT,<20,2018,10,11,5,0,Thursday,14 days,68822.314
ACC-2171593283,19,40.0,15278.34,,CUS-2317998716,2018-10-12,Fernando,M,-36.04,146.94,,,,,,,debit,posted,da0272ba6c4c443181eaaef1dabca551,PAYMENT,<20,2018,10,12,19,0,Friday,14 days,68822.314
ACC-2171593283,19,50.0,15228.34,,CUS-2317998716,2018-10-12,Fernando,M,-36.04,146.94,,,,,,,debit,posted,7508f2ba4af6445dbbb1930d10d3a311,PAYMENT,<20,2018,10,12,21,0,Friday,14 days,68822.314
ACC-2171593283,19,27.0,15201.34,,CUS-2317998716,2018-10-17,Fernando,M,-36.04,146.94,,,,,,,debit,posted,2d48bbfc2e6741358bc8d5480020e36b,PAYMENT,<20,2018,10,17,6,0,Wednesday,14 days,68822.314
ACC-2171593283,19,17.0,17824.1,,CUS-2317998716,2018-10-17,Fernando,M,-36.04,146.94,,,,,,,debit,posted,af15d098ae6741b8a6c4ed0187859270,PAYMENT,<20,2018,10,17,20,0,Wednesday,14 days,68822.314
ACC-2171593283,19,33.0,17791.1,,CUS-2317998716,2018-10-18,Fernando,M,-36.04,146.94,,,,,,,debit,posted,a25e540fcaf04213ada320d440f2d6e5,PAYMENT,<20,2018,10,18,5,0,Thursday,14 days,68822.314
ACC-2171593283,19,40.0,17751.1,,CUS-2317998716,2018-10-19,Fernando,M,-36.04,146.94,,,,,,,debit,posted,fefff06b12094c0784ae95fa4261b775,PAYMENT,<20,2018,10,19,19,0,Friday,14 days,68822.314
ACC-2171593283,19,50.0,17701.1,,CUS-2317998716,2018-10-19,Fernando,M,-36.04,146.94,,,,,,,debit,posted,cabc96cc5e924cf2924d8add1b9d30a6,PAYMENT,<20,2018,10,19,21,0,Friday,14 days,68822.314
ACC-2171593283,19,48.16,17652.94,1.0,CUS-2317998716,2018-10-21,Fernando,M,-36.04,146.94,,d2f34121-afbd-4082-90ce-6607213ead1d,-37.78,144.78,VIC,Derrimut,debit,authorized,d6199a13bba6436b8df33152d4f502a0,SALES-POS,<20,2018,10,21,2,37,Sunday,14 days,68822.314
ACC-2171593283,19,33.94,17619.0,1.0,CUS-2317998716,2018-10-22,Fernando,M,-36.04,146.94,,c8750382-8e65-4892-94be-5df15266ab82,-38.02,145.3,VIC,Narre Warren,debit,authorized,50fbe6b0ec36478b9e9050f2f6ce9988,SALES-POS,<20,2018,10,22,16,38,Monday,14 days,68822.314
ACC-2171593283,19,27.0,17592.0,,CUS-2317998716,2018-10-24,Fernando,M,-36.04,146.94,,,,,,,debit,posted,386bec7bcfc24563826963714f824ca8,PAYMENT,<20,2018,10,24,6,0,Wednesday,14 days,68822.314
ACC-2171593283,19,17.0,17575.0,,CUS-2317998716,2018-10-24,Fernando,M,-36.04,146.94,,,,,,,debit,posted,1eaa2a568c994378a7ad72468ab97577,PAYMENT,<20,2018,10,24,20,0,Wednesday,14 days,68822.314
ACC-2171593283,19,33.0,17542.0,,CUS-2317998716,2018-10-25,Fernando,M,-36.04,146.94,,,,,,,debit,posted,37a54115870f48068b3d4bb130b4682c,PAYMENT,<20,2018,10,25,5,0,Thursday,14 days,68822.314
ACC-2171593283,19,40.0,17502.0,,CUS-2317998716,2018-10-26,Fernando,M,-36.04,146.94,,,,,,,debit,posted,e308f43e54bf4d73bd813918fb6de669,PAYMENT,<20,2018,10,26,19,0,Friday,14 days,68822.314
ACC-2171593283,19,50.0,17452.0,,CUS-2317998716,2018-10-26,Fernando,M,-36.04,146.94,,,,,,,debit,posted,f6da9688b3014fdbaeee0c43801992fe,PAYMENT,<20,2018,10,26,21,0,Friday,14 days,68822.314
ACC-2171593283,19,21.76,17430.24,1.0,CUS-2317998716,2018-10-27,Fernando,M,-36.04,146.94,,9f435d17-c3ef-492f-b8a9-48e2c663f57a,-36.01,146.38,NSW,Corowa,debit,authorized,0bd990fa70524c47b540ebbad35f2a57,SALES-POS,<20,2018,10,27,9,26,Saturday,14 days,68822.314
ACC-2171593283,19,3.31,17426.93,1.0,CUS-2317998716,2018-10-28,Fernando,M,-36.04,146.94,,aeaaa4c4-4a2a-4cb5-b7d5-3a67a1ca4743,-37.89,145.17,VIC,Glen Waverley,debit,authorized,b2500907f36a4476aa8a7f86c84a2d09,POS,<20,2018,10,28,22,1,Sunday,14 days,68822.314
ACC-2171593283,19,27.0,17399.93,,CUS-2317998716,2018-10-31,Fernando,M,-36.04,146.94,,,,,,,debit,posted,b24c76d858c84c0194607356219fcbca,PAYMENT,<20,2018,10,31,6,0,Wednesday,14 days,68822.314
ACC-2171593283,19,107.97,17291.96,1.0,CUS-2317998716,2018-10-31,Fernando,M,-36.04,146.94,,789f4f77-735c-41d4-b2dc-b9c4b5bee7d6,-33.94,151.18,NSW,Sydney,debit,authorized,fbfac76b8166477c95812306069e9e1c,SALES-POS,<20,2018,10,31,10,47,Wednesday,14 days,68822.314
ACC-2171593283,19,38.27,17253.69,1.0,CUS-2317998716,2018-10-31,Fernando,M,-36.04,146.94,,d5b4b0fe-b691-4681-9998-a0442ae08fea,-37.81,144.97,VIC,Melbourne,debit,authorized,71805eead39d4f91964cc4e0f1a3268f,POS,<20,2018,10,31,12,1,Wednesday,14 days,68822.314
ACC-2171593283,19,17.0,19876.45,,CUS-2317998716,2018-10-31,Fernando,M,-36.04,146.94,,,,,,,debit,posted,a8fa469424984c04a4da7cf94bc86976,PAYMENT,<20,2018,10,31,20,0,Wednesday,14 days,68822.314
ACC-588564840,23,25.0,4438.16,,CUS-1462656821,2018-08-01,Isaiah,M,-33.76,151.27,,,,,,,debit,posted,eaafa602902b4f4194efb96a105dd7ab,INTER BANK,20-30,2018,8,1,7,0,Wednesday,14 days,101781.554
ACC-588564840,23,35.99,8306.12,1.0,CUS-1462656821,2018-08-02,Isaiah,M,-33.76,151.27,,b6dadbf2-868f-475a-bc9c-c4eed397090d,-33.97,151.06,NSW,Mortdale,debit,authorized,1f01f82de1664dfda7c4ab8dad0dafe5,SALES-POS,20-30,2018,8,2,1,52,Thursday,14 days,101781.554
ACC-588564840,23,117.0,8189.12,,CUS-1462656821,2018-08-02,Isaiah,M,-33.76,151.27,,,,,,,debit,posted,6d238aa5eee44618b88bed8647ef9966,INTER BANK,20-30,2018,8,2,13,0,Thursday,14 days,101781.554
ACC-588564840,23,44.88,8144.24,0.0,CUS-1462656821,2018-08-02,Isaiah,M,-33.76,151.27,,d2372bc1-5983-4d93-8759-489362ab5377,-33.96,137.72,SA,Kadina,debit,authorized,71952cd706bd4b4bb26aee543a6ff8aa,POS,20-30,2018,8,2,16,56,Thursday,14 days,101781.554
ACC-588564840,23,181.0,7963.24,,CUS-1462656821,2018-08-02,Isaiah,M,-33.76,151.27,,,,,,,debit,posted,786626f09e35494e8cbd31b6e91ecfa1,PAYMENT,20-30,2018,8,2,17,0,Thursday,14 days,101781.554
ACC-588564840,23,41.0,7922.24,,CUS-1462656821,2018-08-02,Isaiah,M,-33.76,151.27,,,,,,,debit,posted,54671e0a7bbd4a73965206f39ed88ea2,PAYMENT,20-30,2018,8,2,18,0,Thursday,14 days,101781.554
ACC-588564840,23,29.72,7892.52,1.0,CUS-1462656821,2018-08-04,Isaiah,M,-33.76,151.27,,d62043e3-70e5-4118-aeb5-1817c846538a,-37.82,144.96,VIC,Melbourne,debit,authorized,3b029b3fb1b647ee8b0cc79b94e34d0b,POS,20-30,2018,8,4,19,49,Saturday,14 days,101781.554
ACC-588564840,23,10.9,7881.62,0.0,CUS-1462656821,2018-08-05,Isaiah,M,-33.76,151.27,,f31f7f0d-dc00-405b-8aed-060dcf40c409,-33.9,151.14,NSW,Dulwich Hill,debit,authorized,d4231d8a88c54503b14c24670d70f728,SALES-POS,20-30,2018,8,5,9,38,Sunday,14 days,101781.554
ACC-588564840,23,14.04,7867.58,1.0,CUS-1462656821,2018-08-06,Isaiah,M,-33.76,151.27,,1b13b1a8-9e98-4f6c-9928-c606ec3ce13d,-33.81,151.01,NSW,Parramatta,debit,authorized,98d3e7751a5e40c798b072b81f668a37,SALES-POS,20-30,2018,8,6,9,37,Monday,14 days,101781.554
ACC-588564840,23,101.0,7766.58,,CUS-1462656821,2018-08-06,Isaiah,M,-33.76,151.27,,,,,,,debit,posted,13148ed9058c4f919c8ad04f0425d1a3,PAYMENT,20-30,2018,8,6,12,0,Monday,14 days,101781.554
ACC-588564840,23,523.9,7242.68,1.0,CUS-1462656821,2018-08-07,Isaiah,M,-33.76,151.27,,4f379cad-d380-4426-b39d-32132f77fe27,-33.87,151.21,NSW,Sydney,debit,authorized,21f2a2f8fb7b456f8d0e82c44ed40d9f,POS,20-30,2018,8,7,7,34,Tuesday,14 days,101781.554
ACC-588564840,23,25.0,7217.68,,CUS-1462656821,2018-08-08,Isaiah,M,-33.76,151.27,,,,,,,debit,posted,93888b5c6d3d47f78c1587a172603259,INTER BANK,20-30,2018,8,8,7,0,Wednesday,14 days,101781.554
ACC-588564840,23,22.38,7195.3,1.0,CUS-1462656821,2018-08-08,Isaiah,M,-33.76,151.27,,45e5d618-4430-47a8-b50f-24759c469e60,-33.87,151.22,NSW,Potts Point,debit,authorized,c79523aeb57a435eae00321064f0d63d,POS,20-30,2018,8,8,15,1,Wednesday,14 days,101781.554
ACC-588564840,23,25.15,7170.15,0.0,CUS-1462656821,2018-08-09,Isaiah,M,-33.76,151.27,,90c69f85-ffc3-4346-ace8-51207cf1d7b5,-33.7,150.87,NSW,Schofields,debit,authorized,e407aa919d9a4abf80e51ad9467cfae6,SALES-POS,20-30,2018,8,9,0,23,Thursday,14 days,101781.554
ACC-588564840,23,24.69,7145.46,1.0,CUS-1462656821,2018-08-09,Isaiah,M,-33.76,151.27,,d31e7b0a-33e3-4c5b-86dd-0e2bd027fb19,-33.95,151.25,NSW,Maroubra,debit,authorized,80ada0297ac0421e8f25586c3be36655,POS,20-30,2018,8,9,8,58,Thursday,14 days,101781.554
ACC-588564840,23,51.79,7093.67,0.0,CUS-1462656821,2018-08-09,Isaiah,M,-33.76,151.27,,38874d3f-3836-4661-8b96-9bfd64f27180,-33.91,151.22,NSW,KENSINGTON,debit,authorized,2aa2d00d7d4b43e4aead1c0b985cdb96,POS,20-30,2018,8,9,9,56,Thursday,14 days,101781.554
ACC-588564840,23,29.75,7063.92,1.0,CUS-1462656821,2018-08-09,Isaiah,M,-33.76,151.27,,69c5ddca-4ad6-4b7c-b291-6943093c7563,-33.76,151.15,NSW,Gordon,debit,authorized,6b1628893cab4e66b2637bc41ab89d26,SALES-POS,20-30,2018,8,9,11,4,Thursday,14 days,101781.554
ACC-588564840,23,41.0,7022.92,,CUS-1462656821,2018-08-09,Isaiah,M,-33.76,151.27,,,,,,,debit,posted,8d95d11ddd0548669037f47b92b82813,PAYMENT,20-30,2018,8,9,18,0,Thursday,14 days,101781.554
ACC-588564840,23,177.0,6845.92,,CUS-1462656821,2018-08-12,Isaiah,M,-33.76,151.27,,,,,,,debit,posted,f7fc9f6a15294325836d693ea98af5e4,PAYMENT,20-30,2018,8,12,6,0,Sunday,14 days,101781.554
ACC-588564840,23,25.0,6820.92,,CUS-1462656821,2018-08-15,Isaiah,M,-33.76,151.27,,,,,,,debit,posted,dcaef71f8c4049a484f6c319dac9e9d0,INTER BANK,20-30,2018,8,15,7,0,Wednesday,14 days,101781.554
ACC-588564840,23,47.49,10378.28,1.0,CUS-1462656821,2018-08-17,Isaiah,M,-33.76,151.27,,011c51e1-953f-4600-87b6-9414d0675422,-33.91,151.25,NSW,Randwick,debit,authorized,878f1040d50a44febccdd1d6a06103c9,POS,20-30,2018,8,17,3,2,Friday,14 days,101781.554
ACC-588564840,23,15.18,10363.1,0.0,CUS-1462656821,2018-08-17,Isaiah,M,-33.76,151.27,,4bc0e750-4818-4aec-af42-3be72ef0de7b,-33.75,150.69,NSW,Penrith,debit,authorized,6b7300833ad742c5a5bbe65ee011244f,SALES-POS,20-30,2018,8,17,6,5,Friday,14 days,101781.554
ACC-588564840,23,97.0,10266.1,,CUS-1462656821,2018-08-17,Isaiah,M,-33.76,151.27,,,,,,,debit,posted,3c9441e24dc64df49812593d3c4d2d0f,PAYMENT,20-30,2018,8,17,7,0,Friday,14 days,101781.554
ACC-588564840,23,14.24,10251.86,1.0,CUS-1462656821,2018-08-17,Isaiah,M,-33.76,151.27,,2ad77476-1279-414b-9793-7744c8c19306,-33.89,151.21,NSW,Surry Hills,debit,authorized,e3e2af743caa4529ab19ced8f8c0cac5,POS,20-30,2018,8,17,9,55,Friday,14 days,101781.554
ACC-588564840,23,44.49,10207.37,1.0,CUS-1462656821,2018-08-17,Isaiah,M,-33.76,151.27,,84335287-a509-4a8f-836a-f71fa050bf4d,-37.83,145,VIC,Richmond,debit,authorized,3c4d312e80624744baa6fa726dc50635,SALES-POS,20-30,2018,8,17,10,26,Friday,14 days,101781.554
ACC-588564840,23,25.26,10182.11,1.0,CUS-1462656821,2018-08-17,Isaiah,M,-33.76,151.27,,fa43d725-c2db-4cd7-ad02-330a82df07d8,-33.92,151.04,NSW,Bankstown,debit,authorized,f5fb5b432d974723bcfb5e252a346946,SALES-POS,20-30,2018,8,17,11,39,Friday,14 days,101781.554
ACC-588564840,23,17.27,10164.84,1.0,CUS-1462656821,2018-08-17,Isaiah,M,-33.76,151.27,,8f271d41-1e27-4514-9cec-4d1290f729eb,-33.92,150.88,NSW,Busby,debit,authorized,53b3ea210f4747a2849a53d48110310c,SALES-POS,20-30,2018,8,17,12,19,Friday,14 days,101781.554
ACC-588564840,23,57.35,10107.49,1.0,CUS-1462656821,2018-08-17,Isaiah,M,-33.76,151.27,,725a8e6a-b84b-4de0-95ec-b877ab323fee,-37.85,145.07,VIC,Camberwell,debit,authorized,7ee2f884c5f143849eed2da75938d498,SALES-POS,20-30,2018,8,17,13,11,Friday,14 days,101781.554
ACC-588564840,23,14.66,10092.83,1.0,CUS-1462656821,2018-08-18,Isaiah,M,-33.76,151.27,,9980b7fe-3d5f-4aee-9ed0-74f4b050a175,-33.92,151.04,NSW,Bankstown,debit,authorized,559135cbcd84442881e1a41a6f485a3f,POS,20-30,2018,8,18,13,35,Saturday,14 days,101781.554
ACC-588564840,23,26.84,10065.99,1.0,CUS-1462656821,2018-08-18,Isaiah,M,-33.76,151.27,,3f201977-ebb7-486c-870f-65bbd2686d92,-33.93,151.06,NSW,Punchbowl,debit,authorized,f9692a87fcca49219371c0be2a2ba394,SALES-POS,20-30,2018,8,18,21,22,Saturday,14 days,101781.554
ACC-588564840,23,17.29,10048.7,0.0,CUS-1462656821,2018-08-19,Isaiah,M,-33.76,151.27,,4b2355f0-146a-4441-b748-ae22335fbd53,-33.72,150.31,NSW,Katoomba,debit,authorized,f35ecb85d36040cf83253a389e9488ac,SALES-POS,20-30,2018,8,19,0,35,Sunday,14 days,101781.554
ACC-588564840,23,326.69,9722.01,1.0,CUS-1462656821,2018-08-19,Isaiah,M,-33.76,151.27,,293fb8f1-9c16-4271-a64d-7fc03b56f673,-33.89,151.12,NSW,Ashfield,debit,authorized,7140b19e010941fa86b57e0d4745b788,POS,20-30,2018,8,19,18,30,Sunday,14 days,101781.554
ACC-588564840,23,39.0,9683.01,1.0,CUS-1462656821,2018-08-20,Isaiah,M,-33.76,151.27,,a397420b-f7e2-4349-b5ec-6054fda30a13,-33.87,151.21,NSW,Sydney,debit,authorized,121f78fdf1d04ebdb5c1eaf7219704f9,POS,20-30,2018,8,20,9,2,Monday,14 days,101781.554
ACC-588564840,23,105.0,9578.01,1.0,CUS-1462656821,2018-08-20,Isaiah,M,-33.76,151.27,,c6d2e23e-abb7-452b-a336-463448d99e47,-33.92,151.04,NSW,Bankstown,debit,authorized,809555ab6e534a56b09af6f02405fb3d,SALES-POS,20-30,2018,8,20,9,32,Monday,14 days,101781.554
ACC-588564840,23,208.0,9370.01,1.0,CUS-1462656821,2018-08-21,Isaiah,M,-33.76,151.27,,253fa40e-505f-4e87-b982-5b82e8233784,-33.93,151.16,NSW,Tempe,debit,authorized,95d2ed3655c047cda4e81966cf48fd6c,SALES-POS,20-30,2018,8,21,8,13,Tuesday,14 days,101781.554
ACC-588564840,23,5.47,9364.54,1.0,CUS-1462656821,2018-08-21,Isaiah,M,-33.76,151.27,,155b0711-026f-464e-9640-d38da87add09,-33.75,150.7,NSW,Penrith,debit,authorized,b91c84f8720b4719931841caf4ee0490,POS,20-30,2018,8,21,9,6,Tuesday,14 days,101781.554
ACC-588564840,23,19.01,9345.53,1.0,CUS-1462656821,2018-08-21,Isaiah,M,-33.76,151.27,,5f4ff647-685c-45b8-a89c-e2dc269bad58,-33.91,151.22,NSW,Kensington,debit,authorized,c2f99dd355c04bc1b8ba4d86bafc64f7,POS,20-30,2018,8,21,10,23,Tuesday,14 days,101781.554
ACC-588564840,23,38.26,9307.27,1.0,CUS-1462656821,2018-08-21,Isaiah,M,-33.76,151.27,,56b15b33-6dff-457b-967c-e32379d6c8fc,-33.92,151.19,NSW,Mascot,debit,authorized,43449e79de57475585c001db084739ef,POS,20-30,2018,8,21,12,54,Tuesday,14 days,101781.554
ACC-588564840,23,25.0,9282.27,,CUS-1462656821,2018-08-22,Isaiah,M,-33.76,151.27,,,,,,,debit,posted,9f3cfd111da0463a8ad1c71b8647e9d5,INTER BANK,20-30,2018,8,22,7,0,Wednesday,14 days,101781.554
ACC-588564840,23,41.0,9241.27,,CUS-1462656821,2018-08-23,Isaiah,M,-33.76,151.27,,,,,,,debit,posted,7142d63c002c426b96d9f8729a2eedb9,PAYMENT,20-30,2018,8,23,18,0,Thursday,14 days,101781.554
ACC-588564840,23,77.0,9164.27,,CUS-1462656821,2018-08-25,Isaiah,M,-33.76,151.27,,,,,,,debit,posted,1e474336dcc048d4b1bf06b50b57f255,PAYMENT,20-30,2018,8,25,6,0,Saturday,14 days,101781.554
ACC-588564840,23,12.48,9151.79,1.0,CUS-1462656821,2018-08-28,Isaiah,M,-33.76,151.27,,08f3e3e9-7877-4b52-ae5c-72670002b78b,-33.73,150.95,NSW,Bella Vista,debit,authorized,16e7c79f58d84664ae68984315cca12f,POS,20-30,2018,8,28,9,28,Tuesday,14 days,101781.554
ACC-588564840,23,25.0,9126.79,,CUS-1462656821,2018-08-29,Isaiah,M,-33.76,151.27,,,,,,,debit,posted,f88d1f8059e84f46a1a7e7ac7cf0bb58,INTER BANK,20-30,2018,8,29,7,0,Wednesday,14 days,101781.554
ACC-588564840,23,194.4,12836.34,1.0,CUS-1462656821,2018-08-30,Isaiah,M,-33.76,151.27,,5678dcd2-c857-4297-9387-4a7f677fa5a1,-33.87,151.21,NSW,Sydney,debit,authorized,36f170716eea4691ab0f519c573f69c4,SALES-POS,20-30,2018,8,30,11,53,Thursday,14 days,101781.554
ACC-588564840,23,148.76,12687.58,1.0,CUS-1462656821,2018-08-30,Isaiah,M,-33.76,151.27,,0b4f8b86-7164-4f05-9745-554d900ecaf9,-33.91,151.2,NSW,Alexandria,debit,authorized,6a40ea14cf4a4eeda88b66e749c3218c,SALES-POS,20-30,2018,8,30,15,24,Thursday,14 days,101781.554
ACC-588564840,23,41.0,12646.58,,CUS-1462656821,2018-08-30,Isaiah,M,-33.76,151.27,,,,,,,debit,posted,ae58e431ce204233a94d5824f4dd43ee,PAYMENT,20-30,2018,8,30,18,0,Thursday,14 days,101781.554
ACC-588564840,23,21.86,12624.72,1.0,CUS-1462656821,2018-08-31,Isaiah,M,-33.76,151.27,,edadc46b-f158-4c81-a040-7f615aaf9c4d,-33.73,151.01,NSW,Castle Hill,debit,authorized,4291ddcf81c54f5b9a420289f679f0a1,SALES-POS,20-30,2018,8,31,23,1,Friday,14 days,101781.554
ACC-588564840,23,32.44,12592.28,1.0,CUS-1462656821,2018-09-01,Isaiah,M,-33.76,151.27,,e3f89d2c-ee69-46cf-a77f-909926fdda0f,-33.76,150.94,NSW,Kings Langley,debit,authorized,197d785554c146c09ac1d67f5c4ec9c9,SALES-POS,20-30,2018,9,1,6,46,Saturday,14 days,101781.554
ACC-588564840,23,153.18,12439.1,1.0,CUS-1462656821,2018-09-01,Isaiah,M,-33.76,151.27,,5e30d5e8-c4e0-4bd5-843c-63cb2e1db2bf,-33.93,151.19,NSW,Mascot,debit,authorized,2be801fa85a947d98a670d1610f76150,POS,20-30,2018,9,1,8,2,Saturday,14 days,101781.554
ACC-588564840,23,117.0,12322.1,,CUS-1462656821,2018-09-02,Isaiah,M,-33.76,151.27,,,,,,,debit,posted,a17d310a9ec649e8a0150e48e3ac21d3,INTER BANK,20-30,2018,9,2,13,0,Sunday,14 days,101781.554
ACC-588564840,23,181.0,12141.1,,CUS-1462656821,2018-09-02,Isaiah,M,-33.76,151.27,,,,,,,debit,posted,f05c43542c514c3bb79c05aac38a8a16,PAYMENT,20-30,2018,9,2,17,0,Sunday,14 days,101781.554
ACC-588564840,23,16.6,12124.5,0.0,CUS-1462656821,2018-09-04,Isaiah,M,-33.76,151.27,,56b36fb3-fc10-444d-a1d5-b4e2fa33aafa,-33.77,150.82,NSW,Mount Druitt,debit,authorized,1a9369d0871445a68bbc66046ed5bc40,POS,20-30,2018,9,4,9,51,Tuesday,14 days,101781.554
ACC-588564840,23,25.0,12099.5,,CUS-1462656821,2018-09-05,Isaiah,M,-33.76,151.27,,,,,,,debit,posted,0e4ecbcdb0d64bfd8c0b6ac2e9edb988,INTER BANK,20-30,2018,9,5,7,0,Wednesday,14 days,101781.554
ACC-588564840,23,11.22,12088.28,1.0,CUS-1462656821,2018-09-06,Isaiah,M,-33.76,151.27,,0769e4f0-260c-40f4-96bd-916ddc783e6b,-33.76,150.99,NSW,Baulkham Hills,debit,authorized,a84323746ac34391a631902137472822,POS,20-30,2018,9,6,9,35,Thursday,14 days,101781.554
ACC-588564840,23,101.0,11987.28,,CUS-1462656821,2018-09-06,Isaiah,M,-33.76,151.27,,,,,,,debit,posted,a8fe7c56b5e74173b12340980efdd0c7,PAYMENT,20-30,2018,9,6,12,0,Thursday,14 days,101781.554
ACC-588564840,23,10.87,11976.41,1.0,CUS-1462656821,2018-09-06,Isaiah,M,-33.76,151.27,,bf39a2fe-b3bc-49b8-a7bd-e83950918654,-33.71,151.3,NSW,Narrabeen,debit,authorized,00fc0d09e1024d45ae9b3c34bb1b09db,POS,20-30,2018,9,6,14,50,Thursday,14 days,101781.554
ACC-588564840,23,28.53,11947.88,0.0,CUS-1462656821,2018-09-06,Isaiah,M,-33.76,151.27,,8c06dd8f-8def-47ef-b3d9-00ba37c7e7e5,-33.87,151.2,NSW,Sydney,debit,authorized,7285a9b7ff9e4c0eb1a281f83571dcd3,POS,20-30,2018,9,6,15,13,Thursday,14 days,101781.554
ACC-588564840,23,14.95,11932.93,1.0,CUS-1462656821,2018-09-06,Isaiah,M,-33.76,151.27,,145ebb98-1574-4fea-8869-e4b7e0ce02f8,-33.87,150.92,NSW,Fairfield West,debit,authorized,9511e236e7fd4dd5b60e52bf4be638ca,POS,20-30,2018,9,6,17,3,Thursday,14 days,101781.554
ACC-588564840,23,41.0,11891.93,,CUS-1462656821,2018-09-06,Isaiah,M,-33.76,151.27,,,,,,,debit,posted,dc5e3f6d901746b990a85034889a7554,PAYMENT,20-30,2018,9,6,18,0,Thursday,14 days,101781.554
ACC-588564840,23,11.78,11880.15,1.0,CUS-1462656821,2018-09-06,Isaiah,M,-33.76,151.27,,9e9a1420-b700-47c7-b195-3c91d99ead90,-33.79,151.13,NSW,North Ryde,debit,authorized,e1021ae347d84a6dbaa9e0f01e151cb0,POS,20-30,2018,9,6,23,1,Thursday,14 days,101781.554
ACC-588564840,23,10.53,11869.62,1.0,CUS-1462656821,2018-09-08,Isaiah,M,-33.76,151.27,,a1ca1b7e-a737-4fc8-b070-3e606f52c0d6,-33.95,115.07,WA,Margaret River,debit,authorized,686893529db84fd3bf30ca1e3c9a14f7,POS,20-30,2018,9,8,4,45,Saturday,14 days,101781.554
ACC-588564840,23,9.26,11860.36,1.0,CUS-1462656821,2018-09-11,Isaiah,M,-33.76,151.27,,c272fe53-ea6b-479d-961b-7ffa44470ea6,-33.91,151.22,NSW,Kensington,debit,authorized,d7f8b294c98e403d816456aebe03af7d,POS,20-30,2018,9,11,11,4,Tuesday,14 days,101781.554
ACC-588564840,23,14.91,11845.45,1.0,CUS-1462656821,2018-09-11,Isaiah,M,-33.76,151.27,,0629ad0d-f85a-4cf4-9efc-82c6c59b5817,-33.89,151.2,NSW,Darlington,debit,authorized,276fac6ecf2240a8953e62c968c002cd,POS,20-30,2018,9,11,11,22,Tuesday,14 days,101781.554
ACC-588564840,23,23.71,11821.74,0.0,CUS-1462656821,2018-09-11,Isaiah,M,-33.76,151.27,,a5a19f64-ed9a-4e49-9e20-66f2ac96b81f,-33.95,115.07,WA,Margaret River,debit,authorized,fd77b177c67d44b0a0aec48ca72154fe,POS,20-30,2018,9,11,11,58,Tuesday,14 days,101781.554
ACC-588564840,23,177.0,11644.74,,CUS-1462656821,2018-09-12,Isaiah,M,-33.76,151.27,,,,,,,debit,posted,3accb964197d40e8be497eceeb522f7b,PAYMENT,20-30,2018,9,12,6,0,Wednesday,14 days,101781.554
ACC-588564840,23,25.0,11619.74,,CUS-1462656821,2018-09-12,Isaiah,M,-33.76,151.27,,,,,,,debit,posted,d548c735a22d41e5be99d45f9f96eb8f,INTER BANK,20-30,2018,9,12,7,0,Wednesday,14 days,101781.554
ACC-588564840,23,41.0,15482.69,,CUS-1462656821,2018-09-13,Isaiah,M,-33.76,151.27,,,,,,,debit,posted,499770f554d741c48502a4d807e9145d,PAYMENT,20-30,2018,9,13,18,0,Thursday,14 days,101781.554
ACC-588564840,23,29.86,15452.83,1.0,CUS-1462656821,2018-09-13,Isaiah,M,-33.76,151.27,,4e7e4cae-50fb-41e3-84a5-567fd66d6a19,-33.93,151.05,NSW,Punchbowl,debit,authorized,1e989d2afdd04d4eab47269f7cc86d73,POS,20-30,2018,9,13,20,37,Thursday,14 days,101781.554
ACC-588564840,23,7.74,15445.09,1.0,CUS-1462656821,2018-09-13,Isaiah,M,-33.76,151.27,,f4de8077-1282-4a9d-89ec-faf918885e57,-33.96,151.13,NSW,Kogarah,debit,authorized,0194c67dba9b4439973074c4ef18850d,SALES-POS,20-30,2018,9,13,21,39,Thursday,14 days,101781.554
ACC-588564840,23,38.87,15406.22,1.0,CUS-1462656821,2018-09-16,Isaiah,M,-33.76,151.27,,c436f00a-0bdb-4639-b9f2-438ee9ae97c6,-33.71,150.38,NSW,Wentworth Falls,debit,authorized,5df00ff2eb7c49c7a1c892665e0d789e,POS,20-30,2018,9,16,17,42,Sunday,14 days,101781.554
ACC-588564840,23,97.0,15309.22,,CUS-1462656821,2018-09-17,Isaiah,M,-33.76,151.27,,,,,,,debit,posted,de85cc2aeecb4f88ba443e9596e25ea4,PAYMENT,20-30,2018,9,17,7,0,Monday,14 days,101781.554
ACC-588564840,23,25.0,15284.22,,CUS-1462656821,2018-09-19,Isaiah,M,-33.76,151.27,,,,,,,debit,posted,140698c9cfaa47488365d2d21ba2ab36,INTER BANK,20-30,2018,9,19,7,0,Wednesday,14 days,101781.554
ACC-588564840,23,41.0,15243.22,,CUS-1462656821,2018-09-20,Isaiah,M,-33.76,151.27,,,,,,,debit,posted,cc197e0c392d4b9caf3c47d2b2f65ac8,PAYMENT,20-30,2018,9,20,18,0,Thursday,14 days,101781.554
ACC-588564840,23,876.0,14367.22,,CUS-1462656821,2018-09-20,Isaiah,M,-33.76,151.27,,,,,,,debit,posted,091b750d41c84a8fb3794aec580e7660,PAYMENT,20-30,2018,9,20,22,0,Thursday,14 days,101781.554
ACC-588564840,23,77.0,14290.22,,CUS-1462656821,2018-09-25,Isaiah,M,-33.76,151.27,,,,,,,debit,posted,59078dbb3747411483c2cc8327a35e96,PAYMENT,20-30,2018,9,25,6,0,Tuesday,14 days,101781.554
ACC-588564840,23,24.57,14265.65,1.0,CUS-1462656821,2018-09-25,Isaiah,M,-33.76,151.27,,bf5d890d-8ab6-4fe8-849a-8fbef41641f6,-33.92,151.08,NSW,Lakemba,debit,authorized,746063f343084060b6a3fc3812810228,SALES-POS,20-30,2018,9,25,20,57,Tuesday,14 days,101781.554
ACC-588564840,23,17.25,14248.4,1.0,CUS-1462656821,2018-09-25,Isaiah,M,-33.76,151.27,,b6abc197-cae9-4406-83c0-8e4dc16745cb,-33.8,151.18,NSW,Chatswood,debit,authorized,e3a031fd6d5f4537aae0bc1c5b9a797d,POS,20-30,2018,9,25,22,57,Tuesday,14 days,101781.554
ACC-588564840,23,11.17,14237.23,0.0,CUS-1462656821,2018-09-25,Isaiah,M,-33.76,151.27,,68c05695-d552-4a40-b4a8-cc9f8d88b18f,-33.97,139,SA,Robertson,debit,authorized,2f5286d1ce94422aae1dd0880bfceb61,SALES-POS,20-30,2018,9,25,23,31,Tuesday,14 days,101781.554
ACC-588564840,23,209.87,14027.36,1.0,CUS-1462656821,2018-09-26,Isaiah,M,-33.76,151.27,,253fa40e-505f-4e87-b982-5b82e8233784,-33.93,151.16,NSW,Tempe,debit,authorized,522583ff42fc4ab990d1564558162f72,SALES-POS,20-30,2018,9,26,1,24,Wednesday,14 days,101781.554
ACC-588564840,23,25.0,14002.36,,CUS-1462656821,2018-09-26,Isaiah,M,-33.76,151.27,,,,,,,debit,posted,6a51fc03ac2f466580941dfbb9d252d1,INTER BANK,20-30,2018,9,26,7,0,Wednesday,14 days,101781.554
ACC-588564840,23,12.23,17894.08,1.0,CUS-1462656821,2018-09-26,Isaiah,M,-33.76,151.27,,796b871d-4e2b-4153-83ed-85d841c20a01,-33.92,150.92,NSW,Liverpool,debit,authorized,6f0a2bdeb4b34828a51ed7196bc3c1c7,SALES-POS,20-30,2018,9,26,13,27,Wednesday,14 days,101781.554
ACC-588564840,23,41.0,17853.08,,CUS-1462656821,2018-09-27,Isaiah,M,-33.76,151.27,,,,,,,debit,posted,e2f89b9f87ea4ebeab506a88b1648128,PAYMENT,20-30,2018,9,27,18,0,Thursday,14 days,101781.554
ACC-588564840,23,27.58,17825.5,1.0,CUS-1462656821,2018-09-28,Isaiah,M,-33.76,151.27,,220fdde7-4fd3-4283-b607-d656dc178ee8,-33.91,151.16,NSW,Marrickville,debit,authorized,b03c11c369c340379fcfc47886091021,POS,20-30,2018,9,28,14,52,Friday,14 days,101781.554
ACC-588564840,23,2.94,17822.56,1.0,CUS-1462656821,2018-09-29,Isaiah,M,-33.76,151.27,,a4162475-f5dc-4715-ae7d-ee83f3d027f3,-33.96,151.14,NSW,Rockdale,debit,authorized,96aeb18f6673465b9f7e97545cf0d52b,POS,20-30,2018,9,29,11,4,Saturday,14 days,101781.554
ACC-588564840,23,117.0,17705.56,,CUS-1462656821,2018-10-02,Isaiah,M,-33.76,151.27,,,,,,,debit,posted,5217d953f6204672b0976181f6a7e2a9,INTER BANK,20-30,2018,10,2,13,0,Tuesday,14 days,101781.554
ACC-588564840,23,181.0,17524.56,,CUS-1462656821,2018-10-02,Isaiah,M,-33.76,151.27,,,,,,,debit,posted,3816e9c10a054d8295b3b64537f29f34,PAYMENT,20-30,2018,10,2,17,0,Tuesday,14 days,101781.554
ACC-588564840,23,25.0,17499.56,,CUS-1462656821,2018-10-03,Isaiah,M,-33.76,151.27,,,,,,,debit,posted,d5251ee398ef4637980474842c76b16d,INTER BANK,20-30,2018,10,3,7,0,Wednesday,14 days,101781.554
ACC-588564840,23,41.0,17458.56,,CUS-1462656821,2018-10-04,Isaiah,M,-33.76,151.27,,,,,,,debit,posted,9582c48f32d14f6c8a89954df38e99ba,PAYMENT,20-30,2018,10,4,18,0,Thursday,14 days,101781.554
ACC-588564840,23,101.0,17357.56,,CUS-1462656821,2018-10-06,Isaiah,M,-33.76,151.27,,,,,,,debit,posted,8b36b9080af94ffa8ee7a540189fa8c7,PAYMENT,20-30,2018,10,6,12,0,Saturday,14 days,101781.554
ACC-588564840,23,25.0,17332.56,,CUS-1462656821,2018-10-10,Isaiah,M,-33.76,151.27,,,,,,,debit,posted,059d3271adf14cdc897554fe149ad2b0,INTER BANK,20-30,2018,10,10,7,0,Wednesday,14 days,101781.554
ACC-588564840,23,41.0,21195.51,,CUS-1462656821,2018-10-11,Isaiah,M,-33.76,151.27,,,,,,,debit,posted,f16538b32bf644f98671218ef0607a5e,PAYMENT,20-30,2018,10,11,18,0,Thursday,14 days,101781.554
ACC-588564840,23,177.0,21018.51,,CUS-1462656821,2018-10-12,Isaiah,M,-33.76,151.27,,,,,,,debit,posted,bb43910dda994066b75422181350a4ad,PAYMENT,20-30,2018,10,12,6,0,Friday,14 days,101781.554
ACC-588564840,23,25.0,20993.51,,CUS-1462656821,2018-10-17,Isaiah,M,-33.76,151.27,,,,,,,debit,posted,a5e9f2b1310e4db78f410c7df954040e,INTER BANK,20-30,2018,10,17,7,0,Wednesday,14 days,101781.554
ACC-588564840,23,97.0,20896.51,,CUS-1462656821,2018-10-17,Isaiah,M,-33.76,151.27,,,,,,,debit,posted,733274a2795046cebd72762a515c85aa,PAYMENT,20-30,2018,10,17,7,0,Wednesday,14 days,101781.554
ACC-588564840,23,23.47,20873.04,1.0,CUS-1462656821,2018-10-18,Isaiah,M,-33.76,151.27,,b8fa60ab-e122-4f63-b92f-83526fb63090,-31.89,115.76,WA,Scarborough,debit,authorized,ca17e7d4b7a14f3aba3ee22beb30ffd6,POS,20-30,2018,10,18,11,50,Thursday,14 days,101781.554
ACC-588564840,23,41.0,20832.04,,CUS-1462656821,2018-10-18,Isaiah,M,-33.76,151.27,,,,,,,debit,posted,0085aef4953c4db480251a8462d206bf,PAYMENT,20-30,2018,10,18,18,0,Thursday,14 days,101781.554
ACC-588564840,23,44.4,20787.64,1.0,CUS-1462656821,2018-10-19,Isaiah,M,-33.76,151.27,,66729dac-f504-4c14-8aee-445cc8a28c2c,-33.77,150.83,NSW,Mount Druitt,debit,authorized,b64ed207fe9c4902b4b3086fb94bcc57,POS,20-30,2018,10,19,21,9,Friday,14 days,101781.554
ACC-588564840,23,18.46,20769.18,1.0,CUS-1462656821,2018-10-20,Isaiah,M,-33.76,151.27,,f230b989-cbdc-45b3-9303-f8c3f53cd562,-33.9,151.18,NSW,Newtown,debit,authorized,54756498ae364a0396f63174333ccc73,SALES-POS,20-30,2018,10,20,4,8,Saturday,14 days,101781.554
ACC-588564840,23,12.99,20756.19,1.0,CUS-1462656821,2018-10-20,Isaiah,M,-33.76,151.27,,bf0044b7-e0dd-45c5-a9e9-627da9a4bfca,-33.91,151.22,NSW,Kensington,debit,authorized,b57a0e99dd4745e3a5d574a1c0f5d47f,SALES-POS,20-30,2018,10,20,4,39,Saturday,14 days,101781.554
ACC-588564840,23,38.5,20717.69,1.0,CUS-1462656821,2018-10-20,Isaiah,M,-33.76,151.27,,b46defe4-52f3-40da-817e-ed4d2891aced,-33.92,151.24,NSW,Randwick,debit,authorized,f12b4c9eb683445c94c5f684e58122a4,SALES-POS,20-30,2018,10,20,9,42,Saturday,14 days,101781.554
ACC-588564840,23,15.87,20701.82,1.0,CUS-1462656821,2018-10-20,Isaiah,M,-33.76,151.27,,b7771d5f-e430-48ee-8671-9db06345ec35,-33.8,150.99,NSW,Westmead,debit,authorized,6d0741e8b551448fa257311ea3e9cc0c,SALES-POS,20-30,2018,10,20,12,29,Saturday,14 days,101781.554
ACC-588564840,23,27.62,20674.2,1.0,CUS-1462656821,2018-10-21,Isaiah,M,-33.76,151.27,,11f3f86e-b56b-40e8-b331-3f016359865c,-33.8,151.18,NSW,Chatswood,debit,authorized,88a4750d2baa433f9f6d85e6da4658f5,SALES-POS,20-30,2018,10,21,11,15,Sunday,14 days,101781.554
ACC-588564840,23,18.91,20655.29,0.0,CUS-1462656821,2018-10-21,Isaiah,M,-33.76,151.27,,32100f2e-5efd-4abc-bedf-71003ce39e63,-33.83,150.97,NSW,Merrylands West,debit,authorized,38b9f9a9f41b44caad12e3dc345bff1e,SALES-POS,20-30,2018,10,21,11,24,Sunday,14 days,101781.554
ACC-588564840,23,17.03,20638.26,1.0,CUS-1462656821,2018-10-22,Isaiah,M,-33.76,151.27,,e9c95a83-b406-414e-b447-0ec282d38faf,-33.95,115.07,WA,Margaret River,debit,authorized,101a40b544de4fd4aebd97de8d1dfa43,POS,20-30,2018,10,22,14,35,Monday,14 days,101781.554
ACC-588564840,23,66.05,20572.21,1.0,CUS-1462656821,2018-10-23,Isaiah,M,-33.76,151.27,,b18df733-2a92-4973-938b-ae213db39546,-33.83,151.05,NSW,Silverwater,debit,authorized,aee261ce5792424bb2e76b7deab88fa6,POS,20-30,2018,10,23,8,26,Tuesday,14 days,101781.554
ACC-588564840,23,25.0,20547.21,,CUS-1462656821,2018-10-24,Isaiah,M,-33.76,151.27,,,,,,,debit,posted,7764dee5231b4fa492b85aa2b8fd4850,INTER BANK,20-30,2018,10,24,7,0,Wednesday,14 days,101781.554
ACC-588564840,23,77.0,24374.16,,CUS-1462656821,2018-10-25,Isaiah,M,-33.76,151.27,,,,,,,debit,posted,9515f90bdad94fa899d9c842d414eae7,PAYMENT,20-30,2018,10,25,6,0,Thursday,14 days,101781.554
ACC-588564840,23,41.0,24333.16,,CUS-1462656821,2018-10-25,Isaiah,M,-33.76,151.27,,,,,,,debit,posted,524d00cf8d2d49e982b02f73f26cfc44,PAYMENT,20-30,2018,10,25,18,0,Thursday,14 days,101781.554
ACC-588564840,23,25.0,24308.16,,CUS-1462656821,2018-10-31,Isaiah,M,-33.76,151.27,,,,,,,debit,posted,05010a8fbb9b4be7a53f232b0ba378fe,INTER BANK,20-30,2018,10,31,7,0,Wednesday,14 days,101781.554
ACC-1496451953,43,39.0,173.66,,CUS-3142625864,2018-08-01,Ricky,M,-37.84,145.16,,,,,,,debit,posted,243dcea5fb1846ffb89671edf45f157d,INTER BANK,40-50,2018,8,1,7,0,Wednesday,7 days,134946.236
ACC-1496451953,43,10.07,163.59,1.0,CUS-3142625864,2018-08-02,Ricky,M,-37.84,145.16,,c18dbd6b-599d-40fe-870d-a0bf6b4d64f6,-37.7,144.78,VIC,Taylors Lakes,debit,authorized,48d4e7bbc8ce4c998fb93bbffda6c852,POS,40-50,2018,8,2,1,15,Thursday,7 days,134946.236
ACC-1496451953,43,16.0,147.59,,CUS-3142625864,2018-08-02,Ricky,M,-37.84,145.16,,,,,,,debit,posted,24aaa29ad4f042f8bd10eceac58fc6d8,INTER BANK,40-50,2018,8,2,2,0,Thursday,7 days,134946.236
ACC-1496451953,43,23.0,124.59,,CUS-3142625864,2018-08-03,Ricky,M,-37.84,145.16,,,,,,,debit,posted,54041b8fb5ec42ff97fa55bc63a90ab3,PAYMENT,40-50,2018,8,3,4,0,Friday,7 days,134946.236
ACC-1496451953,43,17.0,107.59,,CUS-3142625864,2018-08-03,Ricky,M,-37.84,145.16,,,,,,,debit,posted,e5c139708a6d4cc989f244fb6f2a8769,PAYMENT,40-50,2018,8,3,7,0,Friday,7 days,134946.236
ACC-1496451953,43,31.0,76.59,,CUS-3142625864,2018-08-05,Ricky,M,-37.84,145.16,,,,,,,debit,posted,f1476c30534f46c692a5474522de2858,INTER BANK,40-50,2018,8,5,11,0,Sunday,7 days,134946.236
ACC-1496451953,43,39.0,2625.6,,CUS-3142625864,2018-08-08,Ricky,M,-37.84,145.16,,,,,,,debit,posted,ab364abb437345b091ce4acea375793a,INTER BANK,40-50,2018,8,8,7,0,Wednesday,7 days,134946.236
ACC-1496451953,43,16.0,2609.6,,CUS-3142625864,2018-08-09,Ricky,M,-37.84,145.16,,,,,,,debit,posted,d6ef071399c0428b8ed3fb3c54cd9c49,INTER BANK,40-50,2018,8,9,2,0,Thursday,7 days,134946.236
ACC-1496451953,43,23.0,2586.6,,CUS-3142625864,2018-08-10,Ricky,M,-37.84,145.16,,,,,,,debit,posted,8dc0c774299c453ebec172ed3839c64c,PAYMENT,40-50,2018,8,10,4,0,Friday,7 days,134946.236
ACC-1496451953,43,17.0,2569.6,,CUS-3142625864,2018-08-10,Ricky,M,-37.84,145.16,,,,,,,debit,posted,4732f508d2c04e2f86af2dc9a5402f49,PAYMENT,40-50,2018,8,10,7,0,Friday,7 days,134946.236
ACC-1496451953,43,146.0,2423.6,,CUS-3142625864,2018-08-12,Ricky,M,-37.84,145.16,,,,,,,debit,posted,1b953106b79446ad9430c1125e526632,INTER BANK,40-50,2018,8,12,6,0,Sunday,7 days,134946.236
ACC-1496451953,43,31.0,2392.6,,CUS-3142625864,2018-08-12,Ricky,M,-37.84,145.16,,,,,,,debit,posted,31280fd330534afcaa72466c7a4895b4,INTER BANK,40-50,2018,8,12,11,0,Sunday,7 days,134946.236
ACC-1496451953,43,71.0,4909.61,,CUS-3142625864,2018-08-14,Ricky,M,-37.84,145.16,,,,,,,debit,posted,a4b9ec6da3ae445b8035de2bb1cbdd81,PAYMENT,40-50,2018,8,14,4,0,Tuesday,7 days,134946.236
ACC-1496451953,43,39.0,4870.61,,CUS-3142625864,2018-08-15,Ricky,M,-37.84,145.16,,,,,,,debit,posted,15092acb97e24cc1802b1c743972b903,INTER BANK,40-50,2018,8,15,7,0,Wednesday,7 days,134946.236
ACC-1496451953,43,150.0,4720.61,,CUS-3142625864,2018-08-15,Ricky,M,-37.84,145.16,,,,,,,debit,posted,f7f1bb65461d43ad887d0689a48b3f1a,PAYMENT,40-50,2018,8,15,10,0,Wednesday,7 days,134946.236
ACC-1496451953,43,77.84,4642.77,1.0,CUS-3142625864,2018-08-15,Ricky,M,-37.84,145.16,,98b850d7-13b8-4a3b-9369-b4c10322002b,-37.83,140.77,SA,Mount Gambier,debit,authorized,1f7acc90090f4d80a4d56172cc5f0ac0,SALES-POS,40-50,2018,8,15,15,39,Wednesday,7 days,134946.236
ACC-1496451953,43,23.0,4586.26,,CUS-3142625864,2018-08-17,Ricky,M,-37.84,145.16,,,,,,,debit,posted,7fc00b16baa34ab99fb14e4a5b09120a,PAYMENT,40-50,2018,8,17,4,0,Friday,7 days,134946.236
ACC-1496451953,43,17.0,4525.86,,CUS-3142625864,2018-08-17,Ricky,M,-37.84,145.16,,,,,,,debit,posted,bc35f07c2c064e61bddaa523e32554a3,PAYMENT,40-50,2018,8,17,7,0,Friday,7 days,134946.236
ACC-1496451953,43,43.4,4542.86,1.0,CUS-3142625864,2018-08-17,Ricky,M,-37.84,145.16,,9eee8fac-e82d-4df1-b380-066ed55f7782,-37.88,145.28,VIC,Ferntree Gully,debit,authorized,4d55e8bca5c14afc8ab94a207c2c38ef,SALES-POS,40-50,2018,8,17,7,29,Friday,7 days,134946.236
ACC-1496451953,43,42.78,4483.08,1.0,CUS-3142625864,2018-08-17,Ricky,M,-37.84,145.16,,c023a991-ed3c-42d9-8064-7a5c9d9fdc26,-37.62,144.34,VIC,Myrniong,debit,authorized,56efd343fa7549e29043d225e3589b75,SALES-POS,40-50,2018,8,17,8,57,Friday,7 days,134946.236
ACC-1496451953,43,69.24,4413.84,1.0,CUS-3142625864,2018-08-17,Ricky,M,-37.84,145.16,,944d7ebc-3594-4022-a560-a7436d4f4d15,-37.77,144.96,VIC,Brunswick,debit,authorized,e75bfbac76204122ab5ea3c519460474,POS,40-50,2018,8,17,9,42,Friday,7 days,134946.236
ACC-1496451953,43,31.0,4382.84,,CUS-3142625864,2018-08-19,Ricky,M,-37.84,145.16,,,,,,,debit,posted,bc6a48aa65a846e593119bfa074054c3,INTER BANK,40-50,2018,8,19,11,0,Sunday,7 days,134946.236
ACC-1496451953,43,20.71,4362.13,1.0,CUS-3142625864,2018-08-19,Ricky,M,-37.84,145.16,,5a9c52f5-3be9-411b-9735-a79a7588b85f,-37.82,144.96,VIC,Melbourne,debit,authorized,567382138310416890cefa18ee876646,SALES-POS,40-50,2018,8,19,21,13,Sunday,7 days,134946.236
ACC-1496451953,43,39.51,4322.62,1.0,CUS-3142625864,2018-08-20,Ricky,M,-37.84,145.16,,a3224a1c-36f1-4640-9b17-3a566c71f5f5,-37.78,144.83,VIC,Sunshine,debit,authorized,1989a0c289fd48a3953d7b485c81482b,SALES-POS,40-50,2018,8,20,8,18,Monday,7 days,134946.236
ACC-1496451953,43,39.0,6871.63,,CUS-3142625864,2018-08-22,Ricky,M,-37.84,145.16,,,,,,,debit,posted,e7420e779a11491f885db0598808356b,INTER BANK,40-50,2018,8,22,7,0,Wednesday,7 days,134946.236
ACC-1496451953,43,24.79,6846.84,0.0,CUS-3142625864,2018-08-22,Ricky,M,-37.84,145.16,,bfa799bc-44b3-4c12-9029-e6f1cb34786e,-37.77,145.09,VIC,Bulleen,debit,authorized,ea5e45476f5945139165c3d97f37f77f,SALES-POS,40-50,2018,8,22,9,32,Wednesday,7 days,134946.236
ACC-1496451953,43,46.28,6800.56,1.0,CUS-3142625864,2018-08-22,Ricky,M,-37.84,145.16,,40138f41-6964-4c8e-9756-c4bb1afa1c01,-37.77,144.89,VIC,Maribyrnong,debit,authorized,6d6bad50950e4b47ac3784c908ade235,POS,40-50,2018,8,22,9,49,Wednesday,7 days,134946.236
ACC-1496451953,43,12.68,6787.88,1.0,CUS-3142625864,2018-08-22,Ricky,M,-37.84,145.16,,86e10e23-b99e-47a1-83b3-6a8a8488a4aa,-37.85,144.96,VIC,Middle Park,debit,authorized,cae1dc4f04cd4c33bf1925f822d5b379,SALES-POS,40-50,2018,8,22,12,9,Wednesday,7 days,134946.236
ACC-1496451953,43,26.94,6760.94,1.0,CUS-3142625864,2018-08-22,Ricky,M,-37.84,145.16,,25c895f5-a4c8-4654-a2f7-56567f6a3a27,-37.82,145.01,VIC,Richmond,debit,authorized,e978e2cf057440eaa710a15dbb1099e9,SALES-POS,40-50,2018,8,22,16,22,Wednesday,7 days,134946.236
ACC-1496451953,43,38.01,6722.93,0.0,CUS-3142625864,2018-08-22,Ricky,M,-37.84,145.16,,b5629e6f-ddc0-4c61-b437-12a8c8bf66dd,-37.83,144.96,VIC,South Melbourne,debit,authorized,2355cf0ddbc34028a10b96399209137f,POS,40-50,2018,8,22,17,8,Wednesday,7 days,134946.236
ACC-1496451953,43,16.0,6706.93,,CUS-3142625864,2018-08-23,Ricky,M,-37.84,145.16,,,,,,,debit,posted,666dea608a4a454396ac9b4a8902bd00,INTER BANK,40-50,2018,8,23,2,0,Thursday,7 days,134946.236
ACC-1496451953,43,41.97,6664.96,1.0,CUS-3142625864,2018-08-23,Ricky,M,-37.84,145.16,,1e7648f6-51ee-451b-9408-7761e7a5df8a,-37.86,144.99,VIC,Windsor,debit,authorized,dbaf622c264649619a98801975e643c2,SALES-POS,40-50,2018,8,23,17,3,Thursday,7 days,134946.236
ACC-1496451953,43,16.71,6648.25,1.0,CUS-3142625864,2018-08-23,Ricky,M,-37.84,145.16,,012fee56-7727-4955-921a-f0369663dc65,-12.46,130.84,NT,Darwin City,debit,authorized,b1f79103279f4f47b336a50810d6f0d0,SALES-POS,40-50,2018,8,23,22,40,Thursday,7 days,134946.236
ACC-1496451953,43,23.0,6625.25,,CUS-3142625864,2018-08-24,Ricky,M,-37.84,145.16,,,,,,,debit,posted,5a75104e12804a0a8828146bccc23e76,PAYMENT,40-50,2018,8,24,4,0,Friday,7 days,134946.236
ACC-1496451953,43,17.0,6608.25,,CUS-3142625864,2018-08-24,Ricky,M,-37.84,145.16,,,,,,,debit,posted,a3e8fcb6015040578993fc9b3384eed5,PAYMENT,40-50,2018,8,24,7,0,Friday,7 days,134946.236
ACC-1496451953,43,311.91,6296.34,1.0,CUS-3142625864,2018-08-24,Ricky,M,-37.84,145.16,,74df394f-b073-43a8-9156-92c99cfd5f8c,-37.76,145.31,VIC,Chirnside Park,debit,authorized,e2169c918ada4be28766b060537e99bb,POS,40-50,2018,8,24,15,19,Friday,7 days,134946.236
ACC-1496451953,43,20.76,6275.58,1.0,CUS-3142625864,2018-08-24,Ricky,M,-37.84,145.16,,66a0231a-2397-4bf1-ba73-5b8ec0b069b4,-37.86,145.03,VIC,Malvern,debit,authorized,b36d0f20ff0843d79479c1f2efd4f37e,POS,40-50,2018,8,24,15,46,Friday,7 days,134946.236
ACC-1496451953,43,38.53,6237.05,1.0,CUS-3142625864,2018-08-25,Ricky,M,-37.84,145.16,,b393ecf9-84c5-43ae-831d-198bab3f05b4,-37.66,145.37,VIC,Yarra Glen,debit,authorized,3b2a410847fd4fa787a80138b0c6744d,POS,40-50,2018,8,25,2,54,Saturday,7 days,134946.236
ACC-1496451953,43,68.63,6168.42,1.0,CUS-3142625864,2018-08-25,Ricky,M,-37.84,145.16,,beab21f3-b006-4e80-8034-808c45f1d957,-37.83,140.79,SA,Mount Gambier,debit,authorized,53658139bf794269a04de3c7a91f3657,POS,40-50,2018,8,25,8,14,Saturday,7 days,134946.236
ACC-1496451953,43,14.01,6154.41,1.0,CUS-3142625864,2018-08-25,Ricky,M,-37.84,145.16,,5602cc9d-b9eb-4ccd-99d6-837649f6d209,-37.88,145.04,VIC,Caulfield East,debit,authorized,037d3f2e1ae44b29b5a8a785d4bb46a5,POS,40-50,2018,8,25,10,45,Saturday,7 days,134946.236
ACC-1496451953,43,42.1,6112.31,0.0,CUS-3142625864,2018-08-25,Ricky,M,-37.84,145.16,,e288a819-9b84-424f-b17c-e4e4869472b4,-37.83,140.78,SA,Mount Gambier,debit,authorized,cfcfec29d59d4bae8cf6d1485d558d39,POS,40-50,2018,8,25,22,6,Saturday,7 days,134946.236
ACC-1496451953,43,13.78,6098.53,1.0,CUS-3142625864,2018-08-25,Ricky,M,-37.84,145.16,,6ef2c3ff-dd5e-47a9-a2d4-be8ec90fab1f,-37.81,144.96,VIC,Melbourne,debit,authorized,9da6bca24cb042abb70dfba9e79d8ecc,POS,40-50,2018,8,25,22,39,Saturday,7 days,134946.236
ACC-1496451953,43,20.52,6078.01,1.0,CUS-3142625864,2018-08-26,Ricky,M,-37.84,145.16,,615e2e91-00d1-4b4d-ab10-3b0255636fdc,-37.87,144.78,VIC,Altona Meadows,debit,authorized,00067fbc5d0648a58846078a251bf681,SALES-POS,40-50,2018,8,26,1,56,Sunday,7 days,134946.236
ACC-1496451953,43,9.45,6068.56,1.0,CUS-3142625864,2018-08-26,Ricky,M,-37.84,145.16,,2bb3f330-4c11-4e29-b7c5-e82157b5fbca,-37.69,145.14,VIC,Eltham North,debit,authorized,e8c2d22a405045bca5cb5b1b2a1cdd91,SALES-POS,40-50,2018,8,26,8,42,Sunday,7 days,134946.236
ACC-1496451953,43,18.32,6050.24,1.0,CUS-3142625864,2018-08-26,Ricky,M,-37.84,145.16,,b2a84303-95fe-4683-8136-d43d23ee6868,-37.83,144.96,VIC,South Melbourne,debit,authorized,2270574dab8f4ad39b86bbc4d12a74b2,SALES-POS,40-50,2018,8,26,9,18,Sunday,7 days,134946.236
ACC-1496451953,43,31.0,6019.24,,CUS-3142625864,2018-08-26,Ricky,M,-37.84,145.16,,,,,,,debit,posted,97216da5ea6649f29f71ea155674be01,INTER BANK,40-50,2018,8,26,11,0,Sunday,7 days,134946.236
ACC-1496451953,43,9.81,8597.44,1.0,CUS-3142625864,2018-08-27,Ricky,M,-37.84,145.16,,cfa55f6c-bcbd-41c6-ad2f-a311bba78f74,-37.81,144.96,VIC,Melbourne,debit,authorized,33f462d74f194b2ca4a3d24199a0c73b,POS,40-50,2018,8,27,20,16,Monday,7 days,134946.236
ACC-1496451953,43,39.0,8558.44,,CUS-3142625864,2018-08-29,Ricky,M,-37.84,145.16,,,,,,,debit,posted,1c30722d053f4096bd57011b09872c73,INTER BANK,40-50,2018,8,29,7,0,Wednesday,7 days,134946.236
ACC-1496451953,43,16.0,8542.44,,CUS-3142625864,2018-08-30,Ricky,M,-37.84,145.16,,,,,,,debit,posted,febe4716802840b8b3fb1ed761d9c2c1,INTER BANK,40-50,2018,8,30,2,0,Thursday,7 days,134946.236
ACC-1496451953,43,23.0,8519.44,,CUS-3142625864,2018-08-31,Ricky,M,-37.84,145.16,,,,,,,debit,posted,99bafd4a9eac4efd9bb3cca24132c102,PAYMENT,40-50,2018,8,31,4,0,Friday,7 days,134946.236
ACC-1496451953,43,17.0,8502.44,,CUS-3142625864,2018-08-31,Ricky,M,-37.84,145.16,,,,,,,debit,posted,86a995bc50ed4ce3af11dd2e7cf60466,PAYMENT,40-50,2018,8,31,7,0,Friday,7 days,134946.236
ACC-1496451953,43,28.06,8474.38,1.0,CUS-3142625864,2018-08-31,Ricky,M,-37.84,145.16,,b2064789-cb26-4828-8874-20cf146cba01,-37.85,145,VIC,Prahran,debit,authorized,e1265226b51e49fd87d93bb3ddc4706d,SALES-POS,40-50,2018,8,31,9,22,Friday,7 days,134946.236
ACC-1496451953,43,26.54,8447.84,1.0,CUS-3142625864,2018-08-31,Ricky,M,-37.84,145.16,,5c7ccfe3-1e4d-4a0c-bc0b-684e878a6992,-37.87,144.74,VIC,Williams Landing,debit,authorized,59372e57e6c34f419a1cb370fd771d35,POS,40-50,2018,8,31,13,42,Friday,7 days,134946.236
ACC-1496451953,43,62.52,8385.32,1.0,CUS-3142625864,2018-08-31,Ricky,M,-37.84,145.16,,4fec12c6-b31f-41aa-a1b1-9fa793452fa5,-26.65,153.09,QLD,Maroochydore,debit,authorized,ac0ca41f0f56485a99c3cd061e9d71a0,SALES-POS,40-50,2018,8,31,20,41,Friday,7 days,134946.236
ACC-1496451953,43,31.0,8354.32,,CUS-3142625864,2018-09-02,Ricky,M,-37.84,145.16,,,,,,,debit,posted,3bd44bb7a7c949deaf7cf3a633bf0b17,INTER BANK,40-50,2018,9,2,11,0,Sunday,7 days,134946.236
ACC-1496451953,43,216.58,10725.75,1.0,CUS-3142625864,2018-09-04,Ricky,M,-37.84,145.16,,ae795fdc-a1a3-4dce-8869-2a39ea3231cf,-37.83,145.06,VIC,Hawthorn East,debit,authorized,0d97e45179ed4629a4513d31fa7519b4,POS,40-50,2018,9,4,4,29,Tuesday,7 days,134946.236
ACC-1496451953,43,13.71,10712.04,1.0,CUS-3142625864,2018-09-04,Ricky,M,-37.84,145.16,,5ea2ea42-b0b9-4ae7-8151-ec4a45d92171,-37.8,144.96,VIC,Parkville,debit,authorized,3596113f07754bd1b2dbc4712c6be4e6,SALES-POS,40-50,2018,9,4,8,19,Tuesday,7 days,134946.236
ACC-1496451953,43,39.0,10673.04,,CUS-3142625864,2018-09-05,Ricky,M,-37.84,145.16,,,,,,,debit,posted,5318f7e5d2464b4a80ed87b1b93d690d,INTER BANK,40-50,2018,9,5,7,0,Wednesday,7 days,134946.236
ACC-1496451953,43,31.02,10642.02,0.0,CUS-3142625864,2018-09-05,Ricky,M,-37.84,145.16,,d49c7364-41a4-4a48-be59-a2034aa21419,-37.88,144.68,VIC,Hoppers Crossing,debit,authorized,e9b9d5f8a5f24bad80e5562bdfdb1170,SALES-POS,40-50,2018,9,5,8,1,Wednesday,7 days,134946.236
ACC-1496451953,43,36.1,10605.92,1.0,CUS-3142625864,2018-09-05,Ricky,M,-37.84,145.16,,99a705e7-d828-428a-89ce-3e24979369c5,-37.83,144.96,VIC,South Melbourne,debit,authorized,fd1e362f12a84c2e9bb807cfcd275217,SALES-POS,40-50,2018,9,5,8,45,Wednesday,7 days,134946.236
ACC-1496451953,43,15.78,10590.14,1.0,CUS-3142625864,2018-09-05,Ricky,M,-37.84,145.16,,9c44d27e-8c57-4251-90cb-5bf682678c7d,-37.84,144.95,VIC,Albert Park,debit,authorized,bfa1c48d786743dfa4fcf5ee5ee7549e,SALES-POS,40-50,2018,9,5,9,35,Wednesday,7 days,134946.236
ACC-1496451953,43,16.0,10574.14,,CUS-3142625864,2018-09-06,Ricky,M,-37.84,145.16,,,,,,,debit,posted,b0d6571270424b2498b83800ca4c6dc5,INTER BANK,40-50,2018,9,6,2,0,Thursday,7 days,134946.236
ACC-1496451953,43,27.85,10546.29,1.0,CUS-3142625864,2018-09-06,Ricky,M,-37.84,145.16,,943ebc8a-ae0b-41bc-bd9f-12ff1ed089a0,-37.87,144.99,VIC,Balaclava,debit,authorized,06456694a005427a84c1a9d6004587f6,POS,40-50,2018,9,6,9,52,Thursday,7 days,134946.236
ACC-1496451953,43,23.2,10523.09,1.0,CUS-3142625864,2018-09-06,Ricky,M,-37.84,145.16,,3922c9d5-5370-4eb4-a707-cfa94cf0d44a,-37.82,144.99,VIC,Richmond,debit,authorized,5754b4a4db9d40ffbf99f7714cf824d6,POS,40-50,2018,9,6,11,32,Thursday,7 days,134946.236
ACC-1496451953,43,23.0,10500.09,,CUS-3142625864,2018-09-07,Ricky,M,-37.84,145.16,,,,,,,debit,posted,ec8a75ab9c57425cb40f60719832cdc3,PAYMENT,40-50,2018,9,7,4,0,Friday,7 days,134946.236
ACC-1496451953,43,17.0,10483.09,,CUS-3142625864,2018-09-07,Ricky,M,-37.84,145.16,,,,,,,debit,posted,9cd09cf3917a4e0ebcc5c5b18ecb3c9b,PAYMENT,40-50,2018,9,7,7,0,Friday,7 days,134946.236
ACC-1496451953,43,31.0,10452.09,,CUS-3142625864,2018-09-09,Ricky,M,-37.84,145.16,,,,,,,debit,posted,38878dae30114737bdf9bdbd8d90b68b,INTER BANK,40-50,2018,9,9,11,0,Sunday,7 days,134946.236
ACC-1496451953,43,60.97,12979.13,1.0,CUS-3142625864,2018-09-11,Ricky,M,-37.84,145.16,,b88cd541-59bf-4bb6-be5a-8a7e000dd472,-27.4,153.01,QLD,Stafford Heights,debit,authorized,0c1aa38a17d7492dadbee62c94807b79,SALES-POS,40-50,2018,9,11,15,36,Tuesday,7 days,134946.236
ACC-1496451953,43,146.0,12833.13,,CUS-3142625864,2018-09-12,Ricky,M,-37.84,145.16,,,,,,,debit,posted,6fdc76a285fe421b9e924d8972451e07,INTER BANK,40-50,2018,9,12,6,0,Wednesday,7 days,134946.236
ACC-1496451953,43,39.0,12794.13,,CUS-3142625864,2018-09-12,Ricky,M,-37.84,145.16,,,,,,,debit,posted,3186135baf904b2d81ca02b210eb6c36,INTER BANK,40-50,2018,9,12,7,0,Wednesday,7 days,134946.236
ACC-1496451953,43,16.0,12778.13,,CUS-3142625864,2018-09-13,Ricky,M,-37.84,145.16,,,,,,,debit,posted,083435ba4c8c4395a5139266cb603901,INTER BANK,40-50,2018,9,13,2,0,Thursday,7 days,134946.236
ACC-1496451953,43,23.0,12755.13,,CUS-3142625864,2018-09-14,Ricky,M,-37.84,145.16,,,,,,,debit,posted,c2e076bb29ed478bb2b927d89cbb371b,PAYMENT,40-50,2018,9,14,4,0,Friday,7 days,134946.236
ACC-1496451953,43,71.0,12684.13,,CUS-3142625864,2018-09-14,Ricky,M,-37.84,145.16,,,,,,,debit,posted,a280266f92724587889e8324fc7235cb,PAYMENT,40-50,2018,9,14,4,0,Friday,7 days,134946.236
ACC-1496451953,43,17.0,12667.13,,CUS-3142625864,2018-09-14,Ricky,M,-37.84,145.16,,,,,,,debit,posted,75385724e73c4be899398bfdf87af153,PAYMENT,40-50,2018,9,14,7,0,Friday,7 days,134946.236
ACC-1496451953,43,150.0,12517.13,,CUS-3142625864,2018-09-15,Ricky,M,-37.84,145.16,,,,,,,debit,posted,4e12f75ec49a4402a0a0cdd3f75536d2,PAYMENT,40-50,2018,9,15,10,0,Saturday,7 days,134946.236
ACC-1496451953,43,31.0,12486.13,,CUS-3142625864,2018-09-16,Ricky,M,-37.84,145.16,,,,,,,debit,posted,f1662569b97049cdac941d4caabbba5c,INTER BANK,40-50,2018,9,16,11,0,Sunday,7 days,134946.236
ACC-1496451953,43,19.82,12466.31,1.0,CUS-3142625864,2018-09-16,Ricky,M,-37.84,145.16,,8d8ff73c-5cb3-489c-87ac-73613853ba42,-37.84,144.99,VIC,South Yarra,debit,authorized,6fa4a043bd8b41f4b7b55453a0011afb,POS,40-50,2018,9,16,20,25,Sunday,7 days,134946.236
ACC-1496451953,43,16.26,12450.05,1.0,CUS-3142625864,2018-09-16,Ricky,M,-37.84,145.16,,dfb85e0b-ee84-4436-9a99-7ff6ef9a2e14,-37.82,144.96,VIC,Melbourne,debit,authorized,a91b9b3c1a0e479cbfa41b50a4f1473d,SALES-POS,40-50,2018,9,16,23,29,Sunday,7 days,134946.236
ACC-1496451953,43,1254.0,11196.05,,CUS-3142625864,2018-09-17,Ricky,M,-37.84,145.16,,,,,,,debit,posted,a9b04e105f684ecba76c193374bb0b5e,INTER BANK,40-50,2018,9,17,11,0,Monday,7 days,134946.236
ACC-1496451953,43,69.36,13714.7,1.0,CUS-3142625864,2018-09-17,Ricky,M,-37.84,145.16,,9ebfddf3-d523-430c-9645-5ea69cc104eb,-37.84,144.95,VIC,Albert Park,debit,authorized,7f8b2d9968044e208c499342051b4349,POS,40-50,2018,9,17,16,31,Monday,7 days,134946.236
ACC-1496451953,43,34.77,13679.93,1.0,CUS-3142625864,2018-09-17,Ricky,M,-37.84,145.16,,87898f6b-97a4-4a26-80a8-c15f0322af30,-27.49,153.03,QLD,Woolloongabba,debit,authorized,e8ff0307e3234448b6f410a3a8680224,SALES-POS,40-50,2018,9,17,20,16,Monday,7 days,134946.236
ACC-1496451953,43,508.36,13171.57,0.0,CUS-3142625864,2018-09-18,Ricky,M,-37.84,145.16,,51131543-f0e0-45e6-9a5c-172979091a9b,-37.83,144.97,VIC,South Melbourne,debit,authorized,640ff22db79043668ea4fb77fb19fa66,POS,40-50,2018,9,18,9,3,Tuesday,7 days,134946.236
ACC-1496451953,43,39.0,13132.57,,CUS-3142625864,2018-09-19,Ricky,M,-37.84,145.16,,,,,,,debit,posted,e5d1270441284ab5aec074291a7e42b2,INTER BANK,40-50,2018,9,19,7,0,Wednesday,7 days,134946.236
ACC-1496451953,43,16.0,13116.57,,CUS-3142625864,2018-09-20,Ricky,M,-37.84,145.16,,,,,,,debit,posted,e03aa1fe0c224193a46eac9a4072a208,INTER BANK,40-50,2018,9,20,2,0,Thursday,7 days,134946.236
ACC-1496451953,43,29.1,13087.47,1.0,CUS-3142625864,2018-09-20,Ricky,M,-37.84,145.16,,ed5bf651-1c4f-4e04-a68b-9513e3c3dd8f,-37.88,147.99,VIC,Lakes Entrance,debit,authorized,0029f553381243e3b72ad58e8e819dc3,POS,40-50,2018,9,20,8,1,Thursday,7 days,134946.236
ACC-1496451953,43,23.0,13064.47,,CUS-3142625864,2018-09-21,Ricky,M,-37.84,145.16,,,,,,,debit,posted,277abaadb7d04893b005617517c9f73c,PAYMENT,40-50,2018,9,21,4,0,Friday,7 days,134946.236
ACC-1496451953,43,17.0,13047.47,,CUS-3142625864,2018-09-21,Ricky,M,-37.84,145.16,,,,,,,debit,posted,7d28f76bd4ec4dad80ff595d46cc4cd9,PAYMENT,40-50,2018,9,21,7,0,Friday,7 days,134946.236
ACC-1496451953,43,56.64,12990.83,1.0,CUS-3142625864,2018-09-21,Ricky,M,-37.84,145.16,,4d13e895-2453-4bbd-bbf1-99cb6dc83c41,-37.77,145.11,VIC,Templestowe Lower,debit,authorized,1abe58540458438ca2d4ef562ea40d45,SALES-POS,40-50,2018,9,21,21,19,Friday,7 days,134946.236
ACC-1496451953,43,35.59,12955.24,0.0,CUS-3142625864,2018-09-21,Ricky,M,-37.84,145.16,,3b4cef6e-7b92-41cb-92cb-2602d25486b6,-37.82,145.03,VIC,Hawthorn,debit,authorized,a2265810048f4b9b9c2575cce027db86,SALES-POS,40-50,2018,9,21,22,9,Friday,7 days,134946.236
ACC-1496451953,43,16.79,12938.45,1.0,CUS-3142625864,2018-09-22,Ricky,M,-37.84,145.16,,da9a82a8-4e5c-4c7a-8032-dd3e08c37c58,-37.83,145,VIC,Richmond,debit,authorized,75f5902af52e4bc1ae8d8e8836cc6c8d,SALES-POS,40-50,2018,9,22,9,29,Saturday,7 days,134946.236
ACC-1496451953,43,14.74,12923.71,1.0,CUS-3142625864,2018-09-22,Ricky,M,-37.84,145.16,,7714a613-3013-46d8-8b95-a11e2e79801b,-37.78,144.96,VIC,Parkville,debit,authorized,e7c5e038b9e542bf8460c425b128b191,POS,40-50,2018,9,22,12,19,Saturday,7 days,134946.236
ACC-1496451953,43,31.0,12892.71,,CUS-3142625864,2018-09-23,Ricky,M,-37.84,145.16,,,,,,,debit,posted,38f7e8c2875f489e8cd5619b3b001763,INTER BANK,40-50,2018,9,23,11,0,Sunday,7 days,134946.236
ACC-1496451953,43,55.26,12837.45,1.0,CUS-3142625864,2018-09-24,Ricky,M,-37.84,145.16,,53a01835-ca2e-4893-9417-fc0f1e4b43a5,-33.86,151.21,NSW,Sydney,debit,authorized,3a9fb4395d2546d2ab1bbcf221659369,POS,40-50,2018,9,24,9,39,Monday,7 days,134946.236
ACC-1496451953,43,24.03,12813.42,1.0,CUS-3142625864,2018-09-24,Ricky,M,-37.84,145.16,,e32de69d-4c7f-4f4d-8147-26c60bb2248d,-37.83,145.03,VIC,Hawthorn,debit,authorized,eb2f8f7ce7514256b5f8121b7c35906e,SALES-POS,40-50,2018,9,24,10,15,Monday,7 days,134946.236
ACC-1496451953,43,9.7,12803.72,1.0,CUS-3142625864,2018-09-24,Ricky,M,-37.84,145.16,,b1de710b-95a2-471b-bfdd-d0d25a7da038,-37.99,145.17,VIC,Keysborough,debit,authorized,c0237d68f09b49f6b80c7e34190f13a3,SALES-POS,40-50,2018,9,24,10,53,Monday,7 days,134946.236
ACC-1496451953,43,15.34,15376.39,1.0,CUS-3142625864,2018-09-24,Ricky,M,-37.84,145.16,,11c306b7-2934-4494-a30a-bbcf3422a164,-37.81,144.96,VIC,Melbourne,debit,authorized,b98d3f827a4d4147afa4ff73300646a6,SALES-POS,40-50,2018,9,24,16,18,Monday,7 days,134946.236
ACC-1496451953,43,17.88,15358.51,1.0,CUS-3142625864,2018-09-24,Ricky,M,-37.84,145.16,,d725167e-2d74-47e5-a608-eab00c80c36a,-37.8,144.96,VIC,Melbourne,debit,authorized,eaeff6e7dfcf4662acace63e1c222aea,SALES-POS,40-50,2018,9,24,16,48,Monday,7 days,134946.236
ACC-1496451953,43,15.88,15342.63,1.0,CUS-3142625864,2018-09-24,Ricky,M,-37.84,145.16,,727f70ec-7434-44fd-8cd7-0583a1b07097,-37.83,147.63,VIC,Bairnsdale,debit,authorized,c842712f6ab94aeabf04ca267cbc3fdd,SALES-POS,40-50,2018,9,24,21,31,Monday,7 days,134946.236
ACC-1496451953,43,39.0,15303.63,,CUS-3142625864,2018-09-26,Ricky,M,-37.84,145.16,,,,,,,debit,posted,74e295252054415c827cd1e98ad2da38,INTER BANK,40-50,2018,9,26,7,0,Wednesday,7 days,134946.236
ACC-1496451953,43,55.71,15247.92,0.0,CUS-3142625864,2018-09-26,Ricky,M,-37.84,145.16,,fa2bf76e-c908-4516-9763-a8539c144f95,-37.97,145.09,VIC,Moorabbin Airport,debit,authorized,cc74bcc96c5a489886b433873c2702f2,POS,40-50,2018,9,26,8,47,Wednesday,7 days,134946.236
ACC-1496451953,43,13.4,15234.52,1.0,CUS-3142625864,2018-09-26,Ricky,M,-37.84,145.16,,0c5c8a41-16d3-40a7-a858-355845ec4eed,-37.81,144.97,VIC,Melbourne,debit,authorized,385bbf90a9de4822807d58007c366579,POS,40-50,2018,9,26,9,15,Wednesday,7 days,134946.236
ACC-1496451953,43,16.0,15218.52,,CUS-3142625864,2018-09-27,Ricky,M,-37.84,145.16,,,,,,,debit,posted,0a698ccbc771425cb4558e1593309272,INTER BANK,40-50,2018,9,27,2,0,Thursday,7 days,134946.236
ACC-1496451953,43,23.0,15195.52,,CUS-3142625864,2018-09-28,Ricky,M,-37.84,145.16,,,,,,,debit,posted,e267db76341444dc85e7a1feae613741,PAYMENT,40-50,2018,9,28,4,0,Friday,7 days,134946.236
ACC-1496451953,43,17.0,15178.52,,CUS-3142625864,2018-09-28,Ricky,M,-37.84,145.16,,,,,,,debit,posted,e7ecf0ac69e7440db065a47de571dd53,PAYMENT,40-50,2018,9,28,7,0,Friday,7 days,134946.236
ACC-1496451953,43,34.37,15144.15,1.0,CUS-3142625864,2018-09-28,Ricky,M,-37.84,145.16,,5c2e34a0-39b2-437c-8d12-5efa90528e16,-37.9,144.66,VIC,Werribee,debit,authorized,e74f253b6fb24895a3d6b812c1d1550c,POS,40-50,2018,9,28,9,47,Friday,7 days,134946.236
ACC-1496451953,43,31.0,15070.91,,CUS-3142625864,2018-09-30,Ricky,M,-37.84,145.16,,,,,,,debit,posted,fcb41c822b8546b9a903fe1acefb7c0a,INTER BANK,40-50,2018,9,30,11,0,Sunday,7 days,134946.236
ACC-1496451953,43,42.24,15101.91,1.0,CUS-3142625864,2018-09-30,Ricky,M,-37.84,145.16,,8ec2d803-6e04-45e1-9d3b-fe04be0b7c30,-37.85,144.98,VIC,Melbourne,debit,authorized,cae8272e8d4845d284e7a2cd5590dfb8,SALES-POS,40-50,2018,9,30,11,35,Sunday,7 days,134946.236
ACC-1496451953,43,115.87,14955.04,1.0,CUS-3142625864,2018-09-30,Ricky,M,-37.84,145.16,,d48a7d74-63bc-4e31-9495-47b1a8f6244a,-37.82,144.99,VIC,East Melbourne,debit,authorized,cd28b8108cb349c1a487f6f6daf8cf69,SALES-POS,40-50,2018,9,30,21,4,Sunday,7 days,134946.236
ACC-1496451953,43,39.0,17504.05,,CUS-3142625864,2018-10-03,Ricky,M,-37.84,145.16,,,,,,,debit,posted,de51519fad5846a4ba8b38d1137dd155,INTER BANK,40-50,2018,10,3,7,0,Wednesday,7 days,134946.236
ACC-1496451953,43,16.0,17488.05,,CUS-3142625864,2018-10-04,Ricky,M,-37.84,145.16,,,,,,,debit,posted,d8d5de0866244bc184931933052b4aac,INTER BANK,40-50,2018,10,4,2,0,Thursday,7 days,134946.236
ACC-1496451953,43,23.0,17465.05,,CUS-3142625864,2018-10-05,Ricky,M,-37.84,145.16,,,,,,,debit,posted,c30878e516b8423e922b56370a026f74,PAYMENT,40-50,2018,10,5,4,0,Friday,7 days,134946.236
ACC-1496451953,43,17.0,17448.05,,CUS-3142625864,2018-10-05,Ricky,M,-37.84,145.16,,,,,,,debit,posted,bff9b21428f343cea3eb8791c0a5377f,PAYMENT,40-50,2018,10,5,7,0,Friday,7 days,134946.236
ACC-1496451953,43,31.0,17417.05,,CUS-3142625864,2018-10-07,Ricky,M,-37.84,145.16,,,,,,,debit,posted,b5c09e388b2e4a3eb3198fac471cf4ba,INTER BANK,40-50,2018,10,7,11,0,Sunday,7 days,134946.236
ACC-1496451953,43,39.0,19966.06,,CUS-3142625864,2018-10-10,Ricky,M,-37.84,145.16,,,,,,,debit,posted,27d10745fcb345309c3c8224639c27eb,INTER BANK,40-50,2018,10,10,7,0,Wednesday,7 days,134946.236
ACC-1496451953,43,16.0,19950.06,,CUS-3142625864,2018-10-11,Ricky,M,-37.84,145.16,,,,,,,debit,posted,5635cb0f1cc645d3b52aeb701554d787,INTER BANK,40-50,2018,10,11,2,0,Thursday,7 days,134946.236
ACC-1496451953,43,28.26,19921.8,1.0,CUS-3142625864,2018-10-11,Ricky,M,-37.84,145.16,,dfb5abd7-1ca2-476f-9aa5-52c8ed8a3628,-37.78,144.96,VIC,Brunswick,debit,authorized,5ff566fb6b4b4cf79a1e521c24f53b78,POS,40-50,2018,10,11,23,6,Thursday,7 days,134946.236
ACC-1496451953,43,12.63,19909.17,1.0,CUS-3142625864,2018-10-12,Ricky,M,-37.84,145.16,,bc251b19-9cbe-4def-bbf6-f88abf060678,-37.82,144.97,VIC,Melbourne,debit,authorized,933f15117a264eddb4e80c192c6687ed,POS,40-50,2018,10,12,2,7,Friday,7 days,134946.236
ACC-1496451953,43,23.0,19886.17,,CUS-3142625864,2018-10-12,Ricky,M,-37.84,145.16,,,,,,,debit,posted,43d22dec842a42bf91695789e539d78e,PAYMENT,40-50,2018,10,12,4,0,Friday,7 days,134946.236
ACC-1496451953,43,146.0,19740.17,,CUS-3142625864,2018-10-12,Ricky,M,-37.84,145.16,,,,,,,debit,posted,43733fd43b864d42bf610f9426e6da62,INTER BANK,40-50,2018,10,12,6,0,Friday,7 days,134946.236
ACC-1496451953,43,17.0,19723.17,,CUS-3142625864,2018-10-12,Ricky,M,-37.84,145.16,,,,,,,debit,posted,dc2723317dc64d1796efaa22f37a94c5,PAYMENT,40-50,2018,10,12,7,0,Friday,7 days,134946.236
ACC-1496451953,43,10.77,19712.4,0.0,CUS-3142625864,2018-10-12,Ricky,M,-37.84,145.16,,f08035f1-2ce9-44a7-ad29-06a2abd24599,-37.82,144.95,VIC,Docklands,debit,authorized,3e8480cf665c4f978e847c6655a0641a,SALES-POS,40-50,2018,10,12,8,11,Friday,7 days,134946.236
ACC-1496451953,43,71.0,19641.4,,CUS-3142625864,2018-10-14,Ricky,M,-37.84,145.16,,,,,,,debit,posted,9f633bbe5ec34cfead8d7ca72a4051a0,PAYMENT,40-50,2018,10,14,4,0,Sunday,7 days,134946.236
ACC-1496451953,43,31.0,19610.4,,CUS-3142625864,2018-10-14,Ricky,M,-37.84,145.16,,,,,,,debit,posted,f896cc4171f64d6895d5d8c7273470b4,INTER BANK,40-50,2018,10,14,11,0,Sunday,7 days,134946.236
ACC-1496451953,43,11.52,19598.88,1.0,CUS-3142625864,2018-10-15,Ricky,M,-37.84,145.16,,94926e2a-8ab7-4a9a-9121-5faa65015c0f,-37.8,144.96,VIC,North Melbourne,debit,authorized,0b4d1477fdae46dd8072f8f520d897bf,POS,40-50,2018,10,15,9,11,Monday,7 days,134946.236
ACC-1496451953,43,150.0,19448.88,,CUS-3142625864,2018-10-15,Ricky,M,-37.84,145.16,,,,,,,debit,posted,1a71d3115c7548e3abe2fce247d68966,PAYMENT,40-50,2018,10,15,10,0,Monday,7 days,134946.236
ACC-1496451953,43,39.0,21997.89,,CUS-3142625864,2018-10-17,Ricky,M,-37.84,145.16,,,,,,,debit,posted,98f01606607e43109be759f782f90634,INTER BANK,40-50,2018,10,17,7,0,Wednesday,7 days,134946.236
ACC-1496451953,43,41.09,21956.8,1.0,CUS-3142625864,2018-10-17,Ricky,M,-37.84,145.16,,ff184ad8-a641-40ef-80c2-1e914ecc0e55,-37.78,144.84,VIC,Sunshine North,debit,authorized,6555fa1b5f1e4e24af1406a3d6e89296,SALES-POS,40-50,2018,10,17,18,8,Wednesday,7 days,134946.236
ACC-1496451953,43,16.0,21940.8,,CUS-3142625864,2018-10-18,Ricky,M,-37.84,145.16,,,,,,,debit,posted,5a976a7c2e7d4c84a1659d755264119a,INTER BANK,40-50,2018,10,18,2,0,Thursday,7 days,134946.236
ACC-1496451953,43,27.06,21913.74,0.0,CUS-3142625864,2018-10-18,Ricky,M,-37.84,145.16,,6f662a1b-28cf-45cb-9bf0-8511db407ab2,-37.82,144.95,VIC,Docklands,debit,authorized,390af10a01d746c2988450e9d7188b36,POS,40-50,2018,10,18,8,10,Thursday,7 days,134946.236
ACC-1496451953,43,26.12,21887.62,1.0,CUS-3142625864,2018-10-18,Ricky,M,-37.84,145.16,,2cb96e87-9e03-4aa2-8ea0-f20f9d54b070,-37.82,144.96,VIC,Melbourne,debit,authorized,c3bf4b5455914b37ba1390e3b81267b4,POS,40-50,2018,10,18,12,39,Thursday,7 days,134946.236
ACC-1496451953,43,157.31,21730.31,1.0,CUS-3142625864,2018-10-18,Ricky,M,-37.84,145.16,,e67cbcbd-e44b-4cf0-b318-30827a7425af,-37.82,144.95,VIC,Docklands,debit,authorized,2d09c2ed9e0b46b7ba66e38b9fc621db,POS,40-50,2018,10,18,15,3,Thursday,7 days,134946.236
ACC-1496451953,43,23.0,21707.31,,CUS-3142625864,2018-10-19,Ricky,M,-37.84,145.16,,,,,,,debit,posted,c0bfd071a8ea4c4eb0da4c271774a96f,PAYMENT,40-50,2018,10,19,4,0,Friday,7 days,134946.236
ACC-1496451953,43,17.0,21690.31,,CUS-3142625864,2018-10-19,Ricky,M,-37.84,145.16,,,,,,,debit,posted,bc7dc5b8888c48788257aaf7e3cac3ed,PAYMENT,40-50,2018,10,19,7,0,Friday,7 days,134946.236
ACC-1496451953,43,13.2,21677.11,1.0,CUS-3142625864,2018-10-19,Ricky,M,-37.84,145.16,,8ab80360-2816-4edd-bf54-44ae1c61be26,-37.74,144.97,VIC,Coburg,debit,authorized,58e72f0192fd40c1ac6d281b40c3eee8,SALES-POS,40-50,2018,10,19,17,54,Friday,7 days,134946.236
ACC-1496451953,43,31.0,21646.11,,CUS-3142625864,2018-10-21,Ricky,M,-37.84,145.16,,,,,,,debit,posted,4c33f264877c472391b3df625dbd65a7,INTER BANK,40-50,2018,10,21,11,0,Sunday,7 days,134946.236
ACC-1496451953,43,1128.0,20518.11,,CUS-3142625864,2018-10-21,Ricky,M,-37.84,145.16,,,,,,,debit,posted,afc9470e8efa4eec8c09e559488627a0,PAYMENT,40-50,2018,10,21,18,0,Sunday,7 days,134946.236
ACC-1496451953,43,543.0,19975.11,,CUS-3142625864,2018-10-22,Ricky,M,-37.84,145.16,,,,,,,debit,posted,bb694c37c1aa4cad9ff0acf94f5c7f27,PAYMENT,40-50,2018,10,22,2,0,Monday,7 days,134946.236
ACC-1496451953,43,7.55,22555.57,1.0,CUS-3142625864,2018-10-23,Ricky,M,-37.84,145.16,,289957e7-8cf1-4f81-8d81-37a65a3273ad,-37.81,144.97,VIC,Melbourne,debit,authorized,1e19c609fc0c41c2a13a39b081a02b19,SALES-POS,40-50,2018,10,23,17,22,Tuesday,7 days,134946.236
ACC-1496451953,43,22.45,22533.12,1.0,CUS-3142625864,2018-10-23,Ricky,M,-37.84,145.16,,662a443c-8a1d-46e6-9904-e23f8fc53c50,-27.49,153.03,QLD,Woolloongabba,debit,authorized,3429a615c12a4ebebc0f1eb7eb09d55d,SALES-POS,40-50,2018,10,23,20,25,Tuesday,7 days,134946.236
ACC-1496451953,43,39.0,22494.12,,CUS-3142625864,2018-10-24,Ricky,M,-37.84,145.16,,,,,,,debit,posted,f619fefcee314e5a97509ea90b02209f,INTER BANK,40-50,2018,10,24,7,0,Wednesday,7 days,134946.236
ACC-1496451953,43,35.54,22458.58,1.0,CUS-3142625864,2018-10-24,Ricky,M,-37.84,145.16,,000ac2ae-b188-4c3c-b035-aa5f5ffac2ba,-37.69,144.58,VIC,Melton,debit,authorized,53a0f7c042b8485b97108213b91d9179,POS,40-50,2018,10,24,9,21,Wednesday,7 days,134946.236
ACC-1496451953,43,89.32,22369.26,1.0,CUS-3142625864,2018-10-24,Ricky,M,-37.84,145.16,,5a4388e1-76b4-4c52-87b6-f0a3e791fb8d,-37.95,145.18,VIC,Noble Park North,debit,authorized,25741fe785c24af58b4f4f9b0a67ef95,SALES-POS,40-50,2018,10,24,21,22,Wednesday,7 days,134946.236
ACC-1496451953,43,16.0,22353.26,,CUS-3142625864,2018-10-25,Ricky,M,-37.84,145.16,,,,,,,debit,posted,8f6881c1c0b247e2aede0c835a8ebb01,INTER BANK,40-50,2018,10,25,2,0,Thursday,7 days,134946.236
ACC-1496451953,43,23.0,22330.26,,CUS-3142625864,2018-10-26,Ricky,M,-37.84,145.16,,,,,,,debit,posted,5f419425cbd849ccaf8af5e1d0dd13f7,PAYMENT,40-50,2018,10,26,4,0,Friday,7 days,134946.236
ACC-1496451953,43,17.0,22313.26,,CUS-3142625864,2018-10-26,Ricky,M,-37.84,145.16,,,,,,,debit,posted,5c3c1b02543a44c284bc151985e54895,PAYMENT,40-50,2018,10,26,7,0,Friday,7 days,134946.236
ACC-1496451953,43,11.5,22301.76,0.0,CUS-3142625864,2018-10-26,Ricky,M,-37.84,145.16,,a071fbe0-788d-46dc-a3a2-71ee19e8670a,-37.77,144.92,VIC,Ascot Vale,debit,authorized,c0ef1019c64c45598a53082eb0edff98,SALES-POS,40-50,2018,10,26,9,26,Friday,7 days,134946.236
ACC-1496451953,43,22.19,22279.57,1.0,CUS-3142625864,2018-10-26,Ricky,M,-37.84,145.16,,5b985e93-7f6f-4c12-ab44-312a711d20dd,-37.77,144.95,VIC,Brunswick West,debit,authorized,add3d701623746a49a10b632bbae02bb,SALES-POS,40-50,2018,10,26,21,2,Friday,7 days,134946.236
ACC-1496451953,43,18.47,22261.1,1.0,CUS-3142625864,2018-10-27,Ricky,M,-37.84,145.16,,863b3f54-f26c-4dac-8100-749d335e3b57,-37.77,144.92,VIC,Moonee Ponds,debit,authorized,8f501324545d4a8588640dfde3ee0764,POS,40-50,2018,10,27,1,14,Saturday,7 days,134946.236
ACC-1496451953,43,31.0,22230.1,,CUS-3142625864,2018-10-28,Ricky,M,-37.84,145.16,,,,,,,debit,posted,483434cd4c824cb5a2a1db856536afaa,INTER BANK,40-50,2018,10,28,11,0,Sunday,7 days,134946.236
ACC-1496451953,43,39.0,24779.11,,CUS-3142625864,2018-10-31,Ricky,M,-37.84,145.16,,,,,,,debit,posted,94ab18ff63404e748df5e29789a5a57f,INTER BANK,40-50,2018,10,31,7,0,Wednesday,7 days,134946.236
ACC-1903037542,30,10.79,2.85,1.0,CUS-860700529,2018-08-01,Jeffrey,M,-27.61,153.05,,d920de7f-959c-4d9a-aee5-930689a2f8cd,-27.55,152.94,QLD,Mount Ommaney,debit,authorized,28347ba260d84f8d81ab70d9e901ea8e,POS,20-30,2018,8,1,7,20,Wednesday,14 days,48057.61714285714
ACC-1903037542,30,22.16,1789.31,0.0,CUS-860700529,2018-08-02,Jeffrey,M,-27.61,153.05,,86dde4fe-7852-4ea4-856e-46959a0d3796,-27.57,151.97,QLD,Toowoomba,debit,authorized,0b2c2a6432594d18aa906ead06b1c760,SALES-POS,20-30,2018,8,2,15,23,Thursday,14 days,48057.61714285714
ACC-1903037542,30,20.63,1768.68,1.0,CUS-860700529,2018-08-02,Jeffrey,M,-27.61,153.05,,ccb23d24-bdeb-4e7f-a4f3-5d12f36b8168,-26.78,153.12,QLD,Battery Hill,debit,authorized,b4ab1f7cda2c4c72b295c2a8c82cb568,SALES-POS,20-30,2018,8,2,23,42,Thursday,14 days,48057.61714285714
ACC-1903037542,30,291.31,1477.37,1.0,CUS-860700529,2018-08-03,Jeffrey,M,-27.61,153.05,,d00d2c9a-883a-4564-806f-54b6533d5472,-33.87,151.21,NSW,Sydney,debit,authorized,eb4797bf91974bdbad20bd9ee99a87bc,SALES-POS,20-30,2018,8,3,8,0,Friday,14 days,48057.61714285714
ACC-1903037542,30,12.8,1464.57,1.0,CUS-860700529,2018-08-03,Jeffrey,M,-27.61,153.05,,5cd080b9-b0e7-4763-9d3e-319b7502930a,-27.53,153.07,QLD,Mount Gravatt,debit,authorized,51226caa68714eb18cc9c173c4ea6048,SALES-POS,20-30,2018,8,3,9,9,Friday,14 days,48057.61714285714
ACC-1903037542,30,22.31,1442.26,1.0,CUS-860700529,2018-08-03,Jeffrey,M,-27.61,153.05,,388848fa-5b48-40ef-9fa0-f1d271a93bf2,-37.79,144.85,VIC,Sunshine,debit,authorized,fd19f211be464ed790dd8f5148881051,POS,20-30,2018,8,3,9,34,Friday,14 days,48057.61714285714
ACC-1903037542,30,28.78,1413.48,1.0,CUS-860700529,2018-08-03,Jeffrey,M,-27.61,153.05,,58308f9a-7d32-40d1-b52d-774c6d7b44f7,-26.76,152.85,QLD,Maleny,debit,authorized,03d6e2638e2f4b35b60abbf7c1056e91,SALES-POS,20-30,2018,8,3,9,46,Friday,14 days,48057.61714285714
ACC-1903037542,30,23.0,1390.48,,CUS-860700529,2018-08-03,Jeffrey,M,-27.61,153.05,,,,,,,debit,posted,c8177c21b605493b8b25e075b0db7113,PAYMENT,20-30,2018,8,3,21,0,Friday,14 days,48057.61714285714
ACC-1903037542,30,35.7,1354.78,1.0,CUS-860700529,2018-08-03,Jeffrey,M,-27.61,153.05,,5b645982-1673-4af2-a53f-af46c7fd6601,-27.5,153.08,QLD,Camp Hill,debit,authorized,960c1229cdeb432a8e6fca16424e767d,SALES-POS,20-30,2018,8,3,22,46,Friday,14 days,48057.61714285714
ACC-1903037542,30,15.36,1339.42,1.0,CUS-860700529,2018-08-04,Jeffrey,M,-27.61,153.05,,fa6b4381-10b8-4216-b091-82709cc037fc,-29.62,153.07,NSW,Calliope,debit,authorized,ff89d14965544db19737983881080a25,SALES-POS,20-30,2018,8,4,20,0,Saturday,14 days,48057.61714285714
ACC-1903037542,30,134.0,1205.42,,CUS-860700529,2018-08-07,Jeffrey,M,-27.61,153.05,,,,,,,debit,posted,e009b67935cd4ee9968f27b7c0d7f815,PHONE BANK,20-30,2018,8,7,2,0,Tuesday,14 days,48057.61714285714
ACC-1903037542,30,39.54,1165.88,1.0,CUS-860700529,2018-08-09,Jeffrey,M,-27.61,153.05,,e505c28a-ce1d-4342-8877-04bce1f7faaf,-27.09,152.95,QLD,Caboolture South,debit,authorized,ca7943e5a5a34102b84cc1cdba445f63,SALES-POS,20-30,2018,8,9,9,37,Thursday,14 days,48057.61714285714
ACC-1903037542,30,23.0,1125.55,,CUS-860700529,2018-08-10,Jeffrey,M,-27.61,153.05,,,,,,,debit,posted,1b15dbc5e0fd4d8b85345bbf0a63c0d5,PAYMENT,20-30,2018,8,10,21,0,Friday,14 days,48057.61714285714
ACC-1903037542,30,17.33,1148.55,1.0,CUS-860700529,2018-08-10,Jeffrey,M,-27.61,153.05,,dc8ec94b-c95b-4c04-8fe3-073c8893c04f,-27.57,153.06,QLD,Sunnybank,debit,authorized,38118234ede048e7839e3012c6fe5c75,SALES-POS,20-30,2018,8,10,21,5,Friday,14 days,48057.61714285714
ACC-1903037542,30,21.93,1103.62,1.0,CUS-860700529,2018-08-11,Jeffrey,M,-27.61,153.05,,5bc46134-38d5-48fe-9eef-ace058313ca8,-27.52,153.22,QLD,Alexandra Hills,debit,authorized,22eca262055742b1a44bb8c871d3535a,SALES-POS,20-30,2018,8,11,0,37,Saturday,14 days,48057.61714285714
ACC-1903037542,30,5.14,1098.48,1.0,CUS-860700529,2018-08-11,Jeffrey,M,-27.61,153.05,,a70b53f8-09ff-48e0-83af-560d1af7635c,-27.47,153.03,QLD,Brisbane City,debit,authorized,f9919f64b9ff42d89c9b58068f178054,POS,20-30,2018,8,11,2,3,Saturday,14 days,48057.61714285714
ACC-1903037542,30,15.79,1082.69,1.0,CUS-860700529,2018-08-11,Jeffrey,M,-27.61,153.05,,b1d45593-2661-43bb-847a-7bd8f51e95d4,-26.83,153.11,QLD,Golden Beach,debit,authorized,efd30784a8934bc2b82b7413aca30379,SALES-POS,20-30,2018,8,11,4,13,Saturday,14 days,48057.61714285714
ACC-1903037542,30,19.73,1062.96,1.0,CUS-860700529,2018-08-11,Jeffrey,M,-27.61,153.05,,e1c910dc-258d-4953-b785-442403046677,-27.51,152.94,QLD,Kenmore,debit,authorized,adde1813ee484621860c8b9d1e0c5b34,POS,20-30,2018,8,11,9,27,Saturday,14 days,48057.61714285714
ACC-1903037542,30,13.11,1049.85,1.0,CUS-860700529,2018-08-11,Jeffrey,M,-27.61,153.05,,6f5a7067-d4f4-4a97-b253-5b50879fcbf2,-27.6,153.11,QLD,Underwood,debit,authorized,9bb0cfba4b6540618fdad5ddea433bc9,SALES-POS,20-30,2018,8,11,16,22,Saturday,14 days,48057.61714285714
ACC-1903037542,30,13.6,1036.25,1.0,CUS-860700529,2018-08-11,Jeffrey,M,-27.61,153.05,,5f3c6e39-87e3-4eae-aa20-6b178ed9329e,-26.53,153.09,QLD,Coolum Beach,debit,authorized,064b5ba9088d44a49e1e7d435e7b8609,SALES-POS,20-30,2018,8,11,20,48,Saturday,14 days,48057.61714285714
ACC-1903037542,30,15.25,1021.0,1.0,CUS-860700529,2018-08-11,Jeffrey,M,-27.61,153.05,,970c51b0-5709-4c2f-9643-7de2c6488f1a,-27.62,152.76,QLD,Ipswich,debit,authorized,358f41f70aeb42969a9e638dcb443609,SALES-POS,20-30,2018,8,11,22,5,Saturday,14 days,48057.61714285714
ACC-1903037542,30,24.2,996.8,0.0,CUS-860700529,2018-08-12,Jeffrey,M,-27.61,153.05,,bd73a145-2b2f-4e3c-921e-3439f305ca4a,-27.67,153.03,QLD,Hillcrest,debit,authorized,677ba609064e45ccb373e30968b4d471,POS,20-30,2018,8,12,1,23,Sunday,14 days,48057.61714285714
ACC-1903037542,30,23.4,973.4,0.0,CUS-860700529,2018-08-12,Jeffrey,M,-27.61,153.05,,1dbb9ca9-427e-4269-b6a3-570a6a67a33f,-27.41,152.99,QLD,Everton Park,debit,authorized,81e042f598f543099771df23c28bd2f4,POS,20-30,2018,8,12,6,2,Sunday,14 days,48057.61714285714
ACC-1903037542,30,15.24,958.16,0.0,CUS-860700529,2018-08-12,Jeffrey,M,-27.61,153.05,,eb2a1b6f-d154-4294-9c08-2e06303e7b23,-27.59,153.08,QLD,Runcorn,debit,authorized,f33667714b47454fa854e044178df861,POS,20-30,2018,8,12,9,59,Sunday,14 days,48057.61714285714
ACC-1903037542,30,8.57,949.59,0.0,CUS-860700529,2018-08-12,Jeffrey,M,-27.61,153.05,,6e7dd7ca-4409-4d43-9a0c-6f20f9c4b6f2,-31.43,152.91,NSW,Port Macquarie,debit,authorized,e097d3af8d474c8091e33c937048d5e4,POS,20-30,2018,8,12,10,30,Sunday,14 days,48057.61714285714
ACC-1903037542,30,6.73,942.86,0.0,CUS-860700529,2018-08-12,Jeffrey,M,-27.61,153.05,,7a82bfa2-2088-4c68-acde-dababd8044b2,-27.79,153.25,QLD,Ormeau,debit,authorized,475d1e159c964861a0e017924077bfd5,POS,20-30,2018,8,12,14,3,Sunday,14 days,48057.61714285714
ACC-1903037542,30,13.7,929.16,1.0,CUS-860700529,2018-08-12,Jeffrey,M,-27.61,153.05,,b7eaf093-d90a-41b2-bf03-a02990b56275,-27.47,153.02,QLD,Brisbane City,debit,authorized,1fed877738d74fdeb6e9c3dd89584a86,SALES-POS,20-30,2018,8,12,14,16,Sunday,14 days,48057.61714285714
ACC-1903037542,30,31.31,897.85,1.0,CUS-860700529,2018-08-12,Jeffrey,M,-27.61,153.05,,c2eb9048-90af-4a10-b65e-14a2e5e1a401,-27.45,153.19,QLD,Manly,debit,authorized,1842722aebb547c4be4257872066a1bc,SALES-POS,20-30,2018,8,12,14,40,Sunday,14 days,48057.61714285714
ACC-1903037542,30,92.22,805.63,0.0,CUS-860700529,2018-08-13,Jeffrey,M,-27.61,153.05,,9d51aada-0f7e-4664-aa5d-6119a888f759,-33.87,151.21,NSW,Sydney,debit,authorized,6b9ac52f32fe496e9fcfde4279b4baf6,SALES-POS,20-30,2018,8,13,14,37,Monday,14 days,48057.61714285714
ACC-1903037542,30,276.25,529.38,0.0,CUS-860700529,2018-08-13,Jeffrey,M,-27.61,153.05,,e9195c52-7050-454d-aa27-bad1ad4b4ee0,-33.88,151.21,NSW,Sydney,debit,authorized,1c9827d6913a4338b70ff1e7e654df32,SALES-POS,20-30,2018,8,13,16,5,Monday,14 days,48057.61714285714
ACC-1903037542,30,40.06,489.32,1.0,CUS-860700529,2018-08-13,Jeffrey,M,-27.61,153.05,,ab60c859-f944-407c-b7ff-fd3a91c77ad2,-27.23,153.02,QLD,North Lakes,debit,authorized,4a9fa2c528eb4126a9e64ca3ae958e31,SALES-POS,20-30,2018,8,13,20,1,Monday,14 days,48057.61714285714
ACC-1903037542,30,78.0,411.32,,CUS-860700529,2018-08-14,Jeffrey,M,-27.61,153.05,,,,,,,debit,posted,77d8d6dbe4c743749fa8c2f3e58ce8de,INTER BANK,20-30,2018,8,14,20,0,Tuesday,14 days,48057.61714285714
ACC-1903037542,30,8.92,402.4,1.0,CUS-860700529,2018-08-15,Jeffrey,M,-27.61,153.05,,1126bc54-6a39-446f-8d97-4c5f711ab224,-27.47,153.03,QLD,Brisbane City,debit,authorized,51ccea98ace14cc68adfb9f30662b313,SALES-POS,20-30,2018,8,15,14,54,Wednesday,14 days,48057.61714285714
ACC-1903037542,30,25.49,376.91,1.0,CUS-860700529,2018-08-15,Jeffrey,M,-27.61,153.05,,1dfcf039-ccaa-4974-bdd0-ca6e348eb2eb,-27.78,153.25,QLD,Ormeau,debit,authorized,7ed8638eaeaa4ea9b52b93d525ab2365,POS,20-30,2018,8,15,19,19,Wednesday,14 days,48057.61714285714
ACC-1903037542,30,30.33,346.58,1.0,CUS-860700529,2018-08-15,Jeffrey,M,-27.61,153.05,,5831d0ea-140f-49e1-afce-f64cf7dde078,-25.28,152.84,QLD,Pialba,debit,authorized,69fb36a36ddd403695d5da90e8d2513a,SALES-POS,20-30,2018,8,15,20,53,Wednesday,14 days,48057.61714285714
ACC-1903037542,30,8.06,1965.13,1.0,CUS-860700529,2018-08-17,Jeffrey,M,-27.61,153.05,,6a75ccfd-d953-4f7a-b8a2-73cbb358e86d,-27.46,153.01,QLD,Paddington,debit,authorized,a740943cccf74ff38c0c3cce5b38c009,SALES-POS,20-30,2018,8,17,18,43,Friday,14 days,48057.61714285714
ACC-1903037542,30,12.43,1952.7,1.0,CUS-860700529,2018-08-17,Jeffrey,M,-27.61,153.05,,0b92c9b2-0029-4ceb-b77f-25444aa10c5a,-27.49,152.99,QLD,Toowong,debit,authorized,a5c36a6b9aa44e6ebdd92201d44e8cdb,POS,20-30,2018,8,17,19,20,Friday,14 days,48057.61714285714
ACC-1903037542,30,10.47,1942.23,1.0,CUS-860700529,2018-08-17,Jeffrey,M,-27.61,153.05,,452fea06-c6b6-43ac-953e-b90c93a4d3b6,-27.5,152.97,QLD,Indooroopilly,debit,authorized,885fd809d7f74d26b3c0b31dff3d1021,SALES-POS,20-30,2018,8,17,20,46,Friday,14 days,48057.61714285714
ACC-1903037542,30,30.87,1911.36,1.0,CUS-860700529,2018-08-17,Jeffrey,M,-27.61,153.05,,9e4162e0-3e99-4a94-a80e-0b1e1b842f08,-25.29,152.84,QLD,Pialba,debit,authorized,78a9b2762a2040dfb97e6b2eeeb44464,SALES-POS,20-30,2018,8,17,20,55,Friday,14 days,48057.61714285714
ACC-1903037542,30,23.0,1878.85,,CUS-860700529,2018-08-17,Jeffrey,M,-27.61,153.05,,,,,,,debit,posted,b8fae6058e7c4075a1fb53ec07dea051,PAYMENT,20-30,2018,8,17,21,0,Friday,14 days,48057.61714285714
ACC-1903037542,30,9.51,1901.85,0.0,CUS-860700529,2018-08-17,Jeffrey,M,-27.61,153.05,,33811363-abb7-4590-87ac-5ce712c58608,-27.66,152.74,QLD,Yamanto,debit,authorized,2f2df3051fb4497ebb681c364c580210,SALES-POS,20-30,2018,8,17,21,46,Friday,14 days,48057.61714285714
ACC-1903037542,30,9.61,1869.24,1.0,CUS-860700529,2018-08-18,Jeffrey,M,-27.61,153.05,,d6951a26-bf13-4d8c-aba7-627777f614bb,-31.08,152.85,NSW,East Kempsey,debit,authorized,dc71b22d42ee4c5f935ab198c0a51e8b,SALES-POS,20-30,2018,8,18,2,13,Saturday,14 days,48057.61714285714
ACC-1903037542,30,6.86,1862.38,0.0,CUS-860700529,2018-08-18,Jeffrey,M,-27.61,153.05,,289ac334-a1d3-4639-9401-a48392a8ade8,-27.36,153.06,QLD,Boondall,debit,authorized,ee38d1c38ae94978bdb75ce6bb3adab3,POS,20-30,2018,8,18,11,6,Saturday,14 days,48057.61714285714
ACC-1903037542,30,11.34,1851.04,1.0,CUS-860700529,2018-08-18,Jeffrey,M,-27.61,153.05,,960dca6f-a94c-4215-9d2b-d3f3e91e5447,-26.41,153.1,QLD,Sunshine Beach,debit,authorized,e90bb31d22bc4e65a6aff9b10097a876,SALES-POS,20-30,2018,8,18,16,57,Saturday,14 days,48057.61714285714
ACC-1903037542,30,274.64,1576.4,1.0,CUS-860700529,2018-08-18,Jeffrey,M,-27.61,153.05,,a2494963-ddfe-40d7-885f-a4a7e7cee711,-27.37,153.06,QLD,Virginia,debit,authorized,66cf0d563d16450199f5f254f18673d3,SALES-POS,20-30,2018,8,18,22,14,Saturday,14 days,48057.61714285714
ACC-1903037542,30,23.0,1553.4,,CUS-860700529,2018-08-24,Jeffrey,M,-27.61,153.05,,,,,,,debit,posted,59789096e634439488bfaf418b7a1398,PAYMENT,20-30,2018,8,24,21,0,Friday,14 days,48057.61714285714
ACC-1903037542,30,23.0,3311.65,,CUS-860700529,2018-08-31,Jeffrey,M,-27.61,153.05,,,,,,,debit,posted,4c924d211a6f4ae18a2f842df0d5bd69,PAYMENT,20-30,2018,8,31,21,0,Friday,14 days,48057.61714285714
ACC-1903037542,30,20.5,3341.52,1.0,CUS-860700529,2018-08-31,Jeffrey,M,-27.61,153.05,,b871810d-2737-45c0-8c1a-34dee0368cd3,-28.07,153.45,QLD,Miami,debit,authorized,d1ebd664ca5141de86b56ae0ac07c324,SALES-POS,20-30,2018,8,31,21,34,Friday,14 days,48057.61714285714
ACC-1903037542,30,6.87,3334.65,1.0,CUS-860700529,2018-08-31,Jeffrey,M,-27.61,153.05,,db9c1b81-1ae7-4032-8623-06e46ea919c3,-27.23,153.11,QLD,Redcliffe,debit,authorized,32de04450bd64d9e80459541995fd010,SALES-POS,20-30,2018,8,31,21,44,Friday,14 days,48057.61714285714
ACC-1903037542,30,8.93,3302.72,0.0,CUS-860700529,2018-08-31,Jeffrey,M,-27.61,153.05,,5139f9a3-9391-4462-933f-a9a9400c4d62,-27.45,153.01,QLD,Red Hill,debit,authorized,6bbe708bfea845819d964aff825765a7,SALES-POS,20-30,2018,8,31,22,50,Friday,14 days,48057.61714285714
ACC-1903037542,30,14.46,3288.26,1.0,CUS-860700529,2018-08-31,Jeffrey,M,-27.61,153.05,,9f3694c1-cdf2-4a95-9908-1e590194a552,-27.39,153.03,QLD,Chermside,debit,authorized,42f4afcfcf0d475aacb31c845ce67ad4,SALES-POS,20-30,2018,8,31,23,29,Friday,14 days,48057.61714285714
ACC-1903037542,30,9.15,3279.11,1.0,CUS-860700529,2018-09-01,Jeffrey,M,-27.61,153.05,,35703b7a-216b-4a01-9056-0bfd36d2ec03,-27.61,152.87,QLD,Redbank,debit,authorized,900330f3b6e64a4aa547e90ff93b8326,POS,20-30,2018,9,1,0,35,Saturday,14 days,48057.61714285714
ACC-1903037542,30,20.17,3258.94,1.0,CUS-860700529,2018-09-01,Jeffrey,M,-27.61,153.05,,6703c648-7b87-4417-b2c4-43ae4a2d5579,-26.63,152.96,QLD,Nambour,debit,authorized,89cc6687099d4f83af0d88f3f2d90b7b,SALES-POS,20-30,2018,9,1,21,31,Saturday,14 days,48057.61714285714
ACC-1903037542,30,21.09,3237.85,1.0,CUS-860700529,2018-09-01,Jeffrey,M,-27.61,153.05,,a01f26fd-0a90-4522-9206-687a8091125c,-27.94,153.4,QLD,Labrador,debit,authorized,bd87dbabe27d4ef4b1f8d5cf34df0452,POS,20-30,2018,9,1,23,1,Saturday,14 days,48057.61714285714
ACC-1903037542,30,20.17,3217.68,1.0,CUS-860700529,2018-09-01,Jeffrey,M,-27.61,153.05,,3fbd914e-7602-46b5-9dca-a5ad2ffb27a3,-27.39,153.02,QLD,Chermside,debit,authorized,c2308ed03d5c45959cc30cbca477d43d,SALES-POS,20-30,2018,9,1,23,54,Saturday,14 days,48057.61714285714
ACC-1903037542,30,25.6,3192.08,1.0,CUS-860700529,2018-09-02,Jeffrey,M,-27.61,153.05,,9bd98735-8b39-4eb1-9226-4624430f74a1,-27.59,151.98,QLD,Rangeville,debit,authorized,9e5e8a77dd1b48748b8a84efdd69d28c,POS,20-30,2018,9,2,1,36,Sunday,14 days,48057.61714285714
ACC-1903037542,30,4.78,3187.3,1.0,CUS-860700529,2018-09-03,Jeffrey,M,-27.61,153.05,,ba23d4fd-81e8-4850-8e24-412e2e985541,-35.32,149.18,ACT,Fyshwick,debit,authorized,40f225a874e244be96ab341caee3201e,POS,20-30,2018,9,3,9,41,Monday,14 days,48057.61714285714
ACC-1903037542,30,11.04,3176.26,1.0,CUS-860700529,2018-09-03,Jeffrey,M,-27.61,153.05,,dd4b2615-de83-4f80-ae6f-62681f218108,-26.73,153.12,QLD,Birtinya,debit,authorized,70bb0e8111974e70914da9e09698d0d9,SALES-POS,20-30,2018,9,3,10,7,Monday,14 days,48057.61714285714
ACC-1903037542,30,24.43,3151.83,1.0,CUS-860700529,2018-09-03,Jeffrey,M,-27.61,153.05,,8cd6e1d8-7197-416b-bfbc-b621fb041d71,-30.66,152.99,NSW,Nambucca Heads,debit,authorized,3c9844bab6d9497ab67ae39bc614141d,POS,20-30,2018,9,3,17,4,Monday,14 days,48057.61714285714
ACC-1903037542,30,14.48,3137.35,1.0,CUS-860700529,2018-09-04,Jeffrey,M,-27.61,153.05,,187e0000-4520-465c-9469-842217001e32,-27.46,153.03,QLD,Fortitude Valley,debit,authorized,2e3d1f3b548f49c2ad3802d8fc3c3ecf,SALES-POS,20-30,2018,9,4,0,14,Tuesday,14 days,48057.61714285714
ACC-1903037542,30,6.69,3130.66,1.0,CUS-860700529,2018-09-05,Jeffrey,M,-27.61,153.05,,3bdc2db8-cc83-42a7-a69f-1220270a6a58,-27.61,153.3,QLD,Redland Bay,debit,authorized,7524d057f7ac4c54b1153ccb45bd1b88,SALES-POS,20-30,2018,9,5,11,10,Wednesday,14 days,48057.61714285714
ACC-1903037542,30,17.18,3113.48,1.0,CUS-860700529,2018-09-05,Jeffrey,M,-27.61,153.05,,618e495b-47b7-4bd3-a2b9-882e0fc879ca,-30.3,153.12,NSW,Coffs Harbour,debit,authorized,69dcab659b6a47fda31ebab758c15569,SALES-POS,20-30,2018,9,5,12,29,Wednesday,14 days,48057.61714285714
ACC-1903037542,30,21.42,3092.06,1.0,CUS-860700529,2018-09-06,Jeffrey,M,-27.61,153.05,,a549719b-438c-4664-bbfd-d849bbfd1484,-30.46,152.92,NSW,Bellingen,debit,authorized,b8b0a8c9d38547348ad7ff34bac454b9,SALES-POS,20-30,2018,9,6,4,56,Thursday,14 days,48057.61714285714
ACC-1903037542,30,86.49,3005.57,0.0,CUS-860700529,2018-09-06,Jeffrey,M,-27.61,153.05,,8fa7c1a9-28e3-4b02-92ef-58510a010425,-27.46,153.04,QLD,Fortitude Valley,debit,authorized,1a690ec3fee74f3dafefb4c426e6f5ad,SALES-POS,20-30,2018,9,6,11,49,Thursday,14 days,48057.61714285714
ACC-1903037542,30,7.84,2997.73,1.0,CUS-860700529,2018-09-06,Jeffrey,M,-27.61,153.05,,9f9cc91e-cd1e-449f-b683-01e96508743f,-27.72,153.21,QLD,Beenleigh,debit,authorized,63345068580d427ba1d77f087fea284f,POS,20-30,2018,9,6,11,58,Thursday,14 days,48057.61714285714
ACC-1903037542,30,8.61,2989.12,1.0,CUS-860700529,2018-09-06,Jeffrey,M,-27.61,153.05,,6dfc96a4-59da-4046-a47c-1bd063058106,-31.02,152.95,NSW,Gladstone,debit,authorized,8b7bca191c95461ba6e4a56bdd90dad5,POS,20-30,2018,9,6,16,14,Thursday,14 days,48057.61714285714
ACC-1903037542,30,4.29,2984.83,1.0,CUS-860700529,2018-09-07,Jeffrey,M,-27.61,153.05,,8d80e8bb-ebf8-4d4f-b55d-9dbbaada1b21,-27.55,152.94,QLD,Mount Ommaney,debit,authorized,b01f41da770742c89ee21013385cbf1e,POS,20-30,2018,9,7,1,49,Friday,14 days,48057.61714285714
ACC-1903037542,30,134.0,2850.83,,CUS-860700529,2018-09-07,Jeffrey,M,-27.61,153.05,,,,,,,debit,posted,deb358bfc3c743dbafca5a11aad96f15,PHONE BANK,20-30,2018,9,7,2,0,Friday,14 days,48057.61714285714
ACC-1903037542,30,23.0,2827.83,,CUS-860700529,2018-09-07,Jeffrey,M,-27.61,153.05,,,,,,,debit,posted,1e72eeb5594147ddb0aa934f2b267cc9,PAYMENT,20-30,2018,9,7,21,0,Friday,14 days,48057.61714285714
ACC-1903037542,30,5.46,2822.37,1.0,CUS-860700529,2018-09-10,Jeffrey,M,-27.61,153.05,,1f10692f-b889-42d7-ac95-09d28d9e2126,-27.56,153.27,QLD,Thornlands,debit,authorized,7d49838ebea442bd9c07770d20c3a976,POS,20-30,2018,9,10,9,23,Monday,14 days,48057.61714285714
ACC-1903037542,30,20.95,2801.42,1.0,CUS-860700529,2018-09-10,Jeffrey,M,-27.61,153.05,,57e1ee3c-4118-4218-92be-48a1dcd01a7c,-27.48,153.01,QLD,West End,debit,authorized,2fd263ba6ba348349ba6446a12283bdf,SALES-POS,20-30,2018,9,10,17,6,Monday,14 days,48057.61714285714
ACC-1903037542,30,14.62,2786.8,1.0,CUS-860700529,2018-09-11,Jeffrey,M,-27.61,153.05,,6cceaaa5-2cb2-4f71-95af-9aea4fbce0b5,-27.48,152.99,QLD,Toowong,debit,authorized,10c234c847b04b11a406a33a0a32b7d6,SALES-POS,20-30,2018,9,11,11,13,Tuesday,14 days,48057.61714285714
ACC-1903037542,30,17.84,2768.96,1.0,CUS-860700529,2018-09-11,Jeffrey,M,-27.61,153.05,,080f11a9-7d38-40d1-84dc-b32f05742c52,-27.59,153.08,QLD,Runcorn,debit,authorized,d7a6afd3e58b4172bebc4a49c53a1784,POS,20-30,2018,9,11,16,7,Tuesday,14 days,48057.61714285714
ACC-1903037542,30,277.54,2491.42,1.0,CUS-860700529,2018-09-11,Jeffrey,M,-27.61,153.05,,8e1ff0f5-a647-4238-9e8e-b7d5c6430290,-27.54,153.08,QLD,Mount Gravatt East,debit,authorized,6f15ce8907fb48ecb6aff942aada6f65,POS,20-30,2018,9,11,19,54,Tuesday,14 days,48057.61714285714
ACC-1903037542,30,5.66,2485.76,1.0,CUS-860700529,2018-09-12,Jeffrey,M,-27.61,153.05,,2f11bd7f-d87d-4f06-adf9-0ae61fdca774,-27.47,153.02,QLD,Brisbane City,debit,authorized,29a1b6dd3a6a4bf7826047390107c897,POS,20-30,2018,9,12,9,32,Wednesday,14 days,48057.61714285714
ACC-1903037542,30,23.86,2461.9,1.0,CUS-860700529,2018-09-12,Jeffrey,M,-27.61,153.05,,8875d96e-09c6-4eeb-a080-e185fbcfc278,-27.49,153.22,QLD,Birkdale,debit,authorized,78af26aa4b6e4af99a3cf91b42757077,SALES-POS,20-30,2018,9,12,14,32,Wednesday,14 days,48057.61714285714
ACC-1903037542,30,11.11,2450.79,0.0,CUS-860700529,2018-09-12,Jeffrey,M,-27.61,153.05,,34ebf462-ae7d-4974-850e-a9fafdad65e4,-27.59,153.28,QLD,Victoria Point,debit,authorized,18b3b53b172844f9b1ccbfbeebc58f2a,SALES-POS,20-30,2018,9,12,21,24,Wednesday,14 days,48057.61714285714
ACC-1903037542,30,6.95,2443.84,0.0,CUS-860700529,2018-09-13,Jeffrey,M,-27.61,153.05,,eb6dedcd-cf23-4229-a5f7-e557a935a3e5,-27.56,151.95,QLD,Toowoomba City,debit,authorized,1adbd0ad5dfb4cf4bdd09ba27a8b142e,SALES-POS,20-30,2018,9,13,9,51,Thursday,14 days,48057.61714285714
ACC-1903037542,30,41.3,2402.54,1.0,CUS-860700529,2018-09-13,Jeffrey,M,-27.61,153.05,,1f67fe13-88de-4730-a94c-3ccd989930a2,-37.81,144.97,VIC,Melbourne,debit,authorized,9335083f8d73405e9215521f02da91d9,SALES-POS,20-30,2018,9,13,9,59,Thursday,14 days,48057.61714285714
ACC-1903037542,30,7.13,2395.41,1.0,CUS-860700529,2018-09-13,Jeffrey,M,-27.61,153.05,,f1830a21-3ed4-4659-9396-1ea7683f207a,-27.55,151.97,QLD,Mount Lofty,debit,authorized,1704712ff4d3439fb442e14e559eb3d2,POS,20-30,2018,9,13,10,18,Thursday,14 days,48057.61714285714
ACC-1903037542,30,6.77,2388.64,1.0,CUS-860700529,2018-09-13,Jeffrey,M,-27.61,153.05,,e8aa4daa-cfe2-4a2c-a0df-aaa9e6a629d2,-27.61,153.11,QLD,Underwood,debit,authorized,5b4ce73169c844e898bd5db38f4bb1a9,POS,20-30,2018,9,13,13,20,Thursday,14 days,48057.61714285714
ACC-1903037542,30,11.92,4185.34,1.0,CUS-860700529,2018-09-13,Jeffrey,M,-27.61,153.05,,a29bb976-b297-4ddd-9f2c-2283fa4a4e3c,-27.56,152.28,QLD,Gatton,debit,authorized,9fa66168581e484e822f0f264af09c41,POS,20-30,2018,9,13,15,22,Thursday,14 days,48057.61714285714
ACC-1903037542,30,15.52,4169.82,0.0,CUS-860700529,2018-09-13,Jeffrey,M,-27.61,153.05,,2ca9bb2e-01e3-48d2-a6df-3c45194dfd21,-27.62,152.79,QLD,Silkstone,debit,authorized,81a2af18c93d4990bdcc0a55c4b0efd4,SALES-POS,20-30,2018,9,13,15,45,Thursday,14 days,48057.61714285714
ACC-1903037542,30,18.1,4151.72,1.0,CUS-860700529,2018-09-13,Jeffrey,M,-27.61,153.05,,63ed3d01-4b95-49a5-a1d4-c95d4e49d9e3,-27.58,153.28,QLD,Victoria Point,debit,authorized,c0202dbaaa644c5495072ec319d9337f,POS,20-30,2018,9,13,17,41,Thursday,14 days,48057.61714285714
ACC-1903037542,30,14.47,4137.25,1.0,CUS-860700529,2018-09-13,Jeffrey,M,-27.61,153.05,,8d7c3b90-f653-45da-8afd-a53c94fb05dd,-33.87,151.21,NSW,Sydney,debit,authorized,39b53f652f4c4c2690bb7ee0b8140826,SALES-POS,20-30,2018,9,13,22,58,Thursday,14 days,48057.61714285714
ACC-1903037542,30,16.73,4120.52,1.0,CUS-860700529,2018-09-14,Jeffrey,M,-27.61,153.05,,dbe576eb-3ac2-423b-9c43-89141991c500,-27.59,153.28,QLD,Victoria Point,debit,authorized,3d3d3cc4c9374f9991d8ec201750745e,POS,20-30,2018,9,14,1,11,Friday,14 days,48057.61714285714
ACC-1903037542,30,15.95,4104.57,0.0,CUS-860700529,2018-09-14,Jeffrey,M,-27.61,153.05,,6f4caf36-f377-4894-8287-428874771395,-27.32,152.99,QLD,Brendale,debit,authorized,3d3e677f792d4391bf1cb1e91e8bfb64,POS,20-30,2018,9,14,4,11,Friday,14 days,48057.61714285714
ACC-1903037542,30,10.68,4093.89,0.0,CUS-860700529,2018-09-14,Jeffrey,M,-27.61,153.05,,5ac58602-21fe-456d-a258-4b5b49d89de0,-27.44,153.07,QLD,Hamilton,debit,authorized,a4ef7a47e50a47d1bb16fec204a29896,POS,20-30,2018,9,14,8,10,Friday,14 days,48057.61714285714
ACC-1903037542,30,5.95,4087.94,1.0,CUS-860700529,2018-09-14,Jeffrey,M,-27.61,153.05,,6572f528-736a-4223-a5e6-88124c6213d4,-27.48,153.02,QLD,South Brisbane,debit,authorized,7f2af8ff64bd46ccb0abaeea7e71d516,SALES-POS,20-30,2018,9,14,8,29,Friday,14 days,48057.61714285714
ACC-1903037542,30,30.42,4057.52,1.0,CUS-860700529,2018-09-14,Jeffrey,M,-27.61,153.05,,e12478ed-63bc-4625-96f9-ae5f94d84bb6,-27.51,152.94,QLD,Kenmore,debit,authorized,fc80edbb0e8e4d61a48a2b7c18041a97,SALES-POS,20-30,2018,9,14,9,18,Friday,14 days,48057.61714285714
ACC-1903037542,30,10.87,4046.65,1.0,CUS-860700529,2018-09-14,Jeffrey,M,-27.61,153.05,,1c39f7ff-3f06-4c06-9d8a-7a695117bf16,-27.47,153.02,QLD,Brisbane City,debit,authorized,2099162d9b05434d975f35af6688de9a,SALES-POS,20-30,2018,9,14,9,43,Friday,14 days,48057.61714285714
ACC-1903037542,30,3.48,4043.17,1.0,CUS-860700529,2018-09-14,Jeffrey,M,-27.61,153.05,,0a1d930e-fed4-4d23-adee-6f46a9ac8bdb,-27.42,153.05,QLD,Clayfield,debit,authorized,3e12a5258207450f8dd13b1a9fb5fdb6,SALES-POS,20-30,2018,9,14,10,6,Friday,14 days,48057.61714285714
ACC-1903037542,30,7.3,4035.87,1.0,CUS-860700529,2018-09-14,Jeffrey,M,-27.61,153.05,,ae3070be-618f-4bb4-96b1-e28a9696508f,-27.5,153.1,QLD,Carindale,debit,authorized,86f8e9777d3342e4885fb65ad58ef1d6,POS,20-30,2018,9,14,12,18,Friday,14 days,48057.61714285714
ACC-1903037542,30,25.85,4010.02,1.0,CUS-860700529,2018-09-14,Jeffrey,M,-27.61,153.05,,c7439064-0230-4908-8901-12c88d14e73d,-27.59,152.75,QLD,Brassall,debit,authorized,5b5eae1d76f442c99e262e3807fbeeec,POS,20-30,2018,9,14,13,31,Friday,14 days,48057.61714285714
ACC-1903037542,30,25.73,3984.29,0.0,CUS-860700529,2018-09-14,Jeffrey,M,-27.61,153.05,,c7439064-0230-4908-8901-12c88d14e73d,-27.59,152.75,QLD,Brassall,debit,authorized,1267433ddb5d4554b792d24c32358ed7,SALES-POS,20-30,2018,9,14,13,50,Friday,14 days,48057.61714285714
ACC-1903037542,30,20.17,3964.12,0.0,CUS-860700529,2018-09-14,Jeffrey,M,-27.61,153.05,,6cbf99f6-5365-40b7-9b16-29e51e772471,-27.5,153.01,QLD,Saint Lucia,debit,authorized,041cb7cdd6814a6bbf88f1c7529fc8b3,POS,20-30,2018,9,14,14,56,Friday,14 days,48057.61714285714
ACC-1903037542,30,67.37,3896.75,1.0,CUS-860700529,2018-09-14,Jeffrey,M,-27.61,153.05,,42ade571-5972-4160-9ecb-e0162a305fee,-33.7,151.21,NSW,Belrose,debit,authorized,363414cffcb44472a868e317f7dd63da,SALES-POS,20-30,2018,9,14,15,18,Friday,14 days,48057.61714285714
ACC-1903037542,30,23.82,3872.93,1.0,CUS-860700529,2018-09-14,Jeffrey,M,-27.61,153.05,,caf30f6a-3825-450b-ad8a-83a3355e048e,-27.53,153.06,QLD,Holland Park,debit,authorized,6e2b3579f3fe409f823ad997cad1faae,POS,20-30,2018,9,14,17,6,Friday,14 days,48057.61714285714
ACC-1903037542,30,9.82,3863.11,1.0,CUS-860700529,2018-09-14,Jeffrey,M,-27.61,153.05,,fdd2acf2-db2d-4934-84c5-d4ecb7deb645,-27.56,151.95,QLD,Toowoomba City,debit,authorized,8b82367e1f554a5484a410610dabffa5,POS,20-30,2018,9,14,17,48,Friday,14 days,48057.61714285714
ACC-1903037542,30,9.36,3853.75,1.0,CUS-860700529,2018-09-14,Jeffrey,M,-27.61,153.05,,f68431f6-1159-40bf-ba6a-c7d3b205d000,-27.57,153.06,QLD,Sunnybank,debit,authorized,10e50018f5494fe6910a81c95d260d26,SALES-POS,20-30,2018,9,14,18,42,Friday,14 days,48057.61714285714
ACC-1903037542,30,78.0,3767.11,,CUS-860700529,2018-09-14,Jeffrey,M,-27.61,153.05,,,,,,,debit,posted,364fc8017a50429cbfa098531e1c44c9,INTER BANK,20-30,2018,9,14,20,0,Friday,14 days,48057.61714285714
ACC-1903037542,30,8.64,3845.11,1.0,CUS-860700529,2018-09-14,Jeffrey,M,-27.61,153.05,,905df638-9513-4d5d-b5c2-65da440c19d0,-27.47,153.03,QLD,Brisbane City,debit,authorized,8bfcaa7c4c3545c596bada604045599e,POS,20-30,2018,9,14,20,38,Friday,14 days,48057.61714285714
ACC-1903037542,30,23.0,3744.11,,CUS-860700529,2018-09-14,Jeffrey,M,-27.61,153.05,,,,,,,debit,posted,61e48753c27b461596359e833d7a07ee,PAYMENT,20-30,2018,9,14,21,0,Friday,14 days,48057.61714285714
ACC-1903037542,30,17.01,3727.1,0.0,CUS-860700529,2018-09-14,Jeffrey,M,-27.61,153.05,,91f83684-2258-410c-9638-06d5c97fa60f,-27.5,152.98,QLD,Indooroopilly,debit,authorized,123829ea11d84506a3ade82c6d5eddae,SALES-POS,20-30,2018,9,14,22,59,Friday,14 days,48057.61714285714
ACC-1903037542,30,29.17,3697.93,0.0,CUS-860700529,2018-09-14,Jeffrey,M,-27.61,153.05,,8a2c577e-6d84-41ee-ba72-5148ad656792,-27.47,153.02,QLD,Brisbane City,debit,authorized,3b790288465247ea88abc8104d4ca30d,POS,20-30,2018,9,14,23,57,Friday,14 days,48057.61714285714
ACC-1903037542,30,165.0,3532.93,,CUS-860700529,2018-09-16,Jeffrey,M,-27.61,153.05,,,,,,,debit,posted,593736c84bc644089a8c84f312b8c5f5,PAYMENT,20-30,2018,9,16,14,0,Sunday,14 days,48057.61714285714
ACC-1903037542,30,296.51,3236.42,0.0,CUS-860700529,2018-09-18,Jeffrey,M,-27.61,153.05,,d00d2c9a-883a-4564-806f-54b6533d5472,-33.87,151.21,NSW,Sydney,debit,authorized,e736649244e2483ebd6c49f5fb0322cd,SALES-POS,20-30,2018,9,18,11,57,Tuesday,14 days,48057.61714285714
ACC-1903037542,30,31.35,3205.07,1.0,CUS-860700529,2018-09-19,Jeffrey,M,-27.61,153.05,,176a01ec-0cd5-4763-88e5-563d120ed7ad,-27.47,153.02,QLD,Brisbane City,debit,authorized,e6ac133b59f641bdab7f4a6360878cbb,POS,20-30,2018,9,19,15,24,Wednesday,14 days,48057.61714285714
ACC-1903037542,30,18.67,3186.4,1.0,CUS-860700529,2018-09-19,Jeffrey,M,-27.61,153.05,,f0b50df1-e111-4d7d-819a-e0454bc8513c,-31.55,152.85,NSW,Lake Cathie,debit,authorized,e20b8811b5e940cd836688327e8ad002,POS,20-30,2018,9,19,15,30,Wednesday,14 days,48057.61714285714
ACC-1903037542,30,45.38,3141.02,1.0,CUS-860700529,2018-09-19,Jeffrey,M,-27.61,153.05,,e6389142-a34c-4515-b2bf-1adb67d12aee,-37.89,145,VIC,Elsternwick,debit,authorized,1d525e5b639f49c1a2ff93498f397600,POS,20-30,2018,9,19,18,50,Wednesday,14 days,48057.61714285714
ACC-1903037542,30,5.32,3135.7,0.0,CUS-860700529,2018-09-19,Jeffrey,M,-27.61,153.05,,306fcc0c-c74a-48f6-b024-136cc07384c2,-27.41,153.07,QLD,Nundah,debit,authorized,7f26365a0da246eaae2aa84ec16881c5,POS,20-30,2018,9,19,20,20,Wednesday,14 days,48057.61714285714
ACC-1903037542,30,11.7,3124.0,1.0,CUS-860700529,2018-09-19,Jeffrey,M,-27.61,153.05,,d86f2741-9291-407e-af23-a1a672eec818,-27.48,153.02,QLD,Brisbane City,debit,authorized,e764a5e8903b4529901738ae089a8e6e,SALES-POS,20-30,2018,9,19,22,58,Wednesday,14 days,48057.61714285714
ACC-1903037542,30,10.54,3113.46,0.0,CUS-860700529,2018-09-21,Jeffrey,M,-27.61,153.05,,a06fdf17-f061-41ba-80b3-45506a8eac12,-27.61,153.12,QLD,Springwood,debit,authorized,de0bde6af6cc4bed8bdf2bc9f763ca8f,POS,20-30,2018,9,21,4,50,Friday,14 days,48057.61714285714
ACC-1903037542,30,36.04,3077.42,1.0,CUS-860700529,2018-09-21,Jeffrey,M,-27.61,153.05,,257daa01-b458-46f0-905c-221bf98a5669,-27.51,153.03,QLD,Annerley,debit,authorized,6205317af8754b49aad9060a24b7910f,POS,20-30,2018,9,21,19,23,Friday,14 days,48057.61714285714
ACC-1903037542,30,23.0,3054.42,,CUS-860700529,2018-09-21,Jeffrey,M,-27.61,153.05,,,,,,,debit,posted,e9a638e2506e4796b3a506d28baf7b16,PAYMENT,20-30,2018,9,21,21,0,Friday,14 days,48057.61714285714
ACC-1903037542,30,16.42,3038.0,1.0,CUS-860700529,2018-09-22,Jeffrey,M,-27.61,153.05,,3e22ce7f-00af-4c37-a778-515ab2186f93,-27.47,153.09,QLD,Cannon Hill,debit,authorized,b1556427db324fe797038b46ddd6326d,POS,20-30,2018,9,22,13,9,Saturday,14 days,48057.61714285714
ACC-1903037542,30,15.1,3022.9,0.0,CUS-860700529,2018-09-22,Jeffrey,M,-27.61,153.05,,080f11a9-7d38-40d1-84dc-b32f05742c52,-27.59,153.08,QLD,Runcorn,debit,authorized,2394bb341b01475882c7b5faf7a32e9f,POS,20-30,2018,9,22,13,27,Saturday,14 days,48057.61714285714
ACC-1903037542,30,27.72,2995.18,1.0,CUS-860700529,2018-09-22,Jeffrey,M,-27.61,153.05,,cd2b4b28-c008-435a-afdf-4dd03747f6e7,-27.46,153.02,QLD,Brisbane City,debit,authorized,a4ec78a87a6c4f9b8bc3bd741273037b,POS,20-30,2018,9,22,14,26,Saturday,14 days,48057.61714285714
ACC-1903037542,30,5.24,2989.94,1.0,CUS-860700529,2018-09-22,Jeffrey,M,-27.61,153.05,,5a99b1bd-249f-4841-a402-57bb79e5d2c1,-27.56,152.42,QLD,Plainland,debit,authorized,f2a5dc5838f3483e896e686cc211840d,SALES-POS,20-30,2018,9,22,18,42,Saturday,14 days,48057.61714285714
ACC-1903037542,30,16.43,2973.51,1.0,CUS-860700529,2018-09-23,Jeffrey,M,-27.61,153.05,,3aa28707-b482-4699-97f2-2e6270f4413b,-27.48,153.02,QLD,South Brisbane,debit,authorized,dd7b89590d29479f9af2392c2937c61d,POS,20-30,2018,9,23,0,18,Sunday,14 days,48057.61714285714
ACC-1903037542,30,18.41,2955.1,1.0,CUS-860700529,2018-09-23,Jeffrey,M,-27.61,153.05,,e1318054-6edd-4607-b008-22200e86a315,-33.87,151.21,NSW,Sydney,debit,authorized,4798dd73b879497e9e33fde47bb7508e,SALES-POS,20-30,2018,9,23,20,56,Sunday,14 days,48057.61714285714
ACC-1903037542,30,18.35,2936.75,1.0,CUS-860700529,2018-09-23,Jeffrey,M,-27.61,153.05,,b3451d96-ba32-44c5-a34f-a8e5730d25e0,-27.41,152.98,QLD,Mitchelton,debit,authorized,32223d8a3ab54096bcf39880a76b6765,POS,20-30,2018,9,23,21,13,Sunday,14 days,48057.61714285714
ACC-1903037542,30,12.19,2924.56,1.0,CUS-860700529,2018-09-24,Jeffrey,M,-27.61,153.05,,020e82c2-0869-43a3-84ad-8b7a2318faf8,-27.51,153.1,QLD,Carindale,debit,authorized,2a425a743339499dab3c2a393baf606b,SALES-POS,20-30,2018,9,24,22,24,Monday,14 days,48057.61714285714
ACC-1903037542,30,9.92,2914.64,1.0,CUS-860700529,2018-09-24,Jeffrey,M,-27.61,153.05,,36d1dbed-35a1-4655-afe7-926d5a8722a2,-27.42,153.06,QLD,Clayfield,debit,authorized,4c212facac35409ebb51bd386b243f20,SALES-POS,20-30,2018,9,24,22,36,Monday,14 days,48057.61714285714
ACC-1903037542,30,22.7,2891.94,1.0,CUS-860700529,2018-09-25,Jeffrey,M,-27.61,153.05,,388848fa-5b48-40ef-9fa0-f1d271a93bf2,-37.79,144.85,VIC,Sunshine,debit,authorized,80e803d37e2c4cfd89937bdb806b9d0d,POS,20-30,2018,9,25,7,47,Tuesday,14 days,48057.61714285714
ACC-1903037542,30,73.49,2818.45,0.0,CUS-860700529,2018-09-25,Jeffrey,M,-27.61,153.05,,9148f42a-c5b8-487d-8f5a-a38264d30552,-37.82,144.97,VIC,Melbourne,debit,authorized,c197ed21676b400795fb5ae0b4bd0425,POS,20-30,2018,9,25,10,21,Tuesday,14 days,48057.61714285714
ACC-1903037542,30,10.05,2808.4,0.0,CUS-860700529,2018-09-27,Jeffrey,M,-27.61,153.05,,32a4151d-1ae3-4037-a011-9711e3214134,-27.57,151.95,QLD,South Toowoomba,debit,authorized,9e844d91f4674e0b81847d9a8b09b4ed,POS,20-30,2018,9,27,4,44,Thursday,14 days,48057.61714285714
ACC-1903037542,30,15.23,2793.17,1.0,CUS-860700529,2018-09-27,Jeffrey,M,-27.61,153.05,,ca39f74c-0ca5-4c53-95fe-5059aba85479,-27.45,153.04,QLD,Newstead,debit,authorized,370ecf0263fb4a31be2446945885db33,POS,20-30,2018,9,27,14,21,Thursday,14 days,48057.61714285714
ACC-1903037542,30,12.44,2780.73,1.0,CUS-860700529,2018-09-27,Jeffrey,M,-27.61,153.05,,bfb6a27c-139c-4728-9be7-d1b68e430cb2,-27.47,153.03,QLD,Brisbane City,debit,authorized,a12f320ceb264497a0fcba99b0290d01,POS,20-30,2018,9,27,14,59,Thursday,14 days,48057.61714285714
ACC-1903037542,30,20.86,4568.49,1.0,CUS-860700529,2018-09-27,Jeffrey,M,-27.61,153.05,,7dce2f07-e937-432e-9c55-a83ba0a88bce,-28.09,153.39,QLD,Robina,debit,authorized,3279779cf37a47df9a8e8b0ece36cad9,SALES-POS,20-30,2018,9,27,15,34,Thursday,14 days,48057.61714285714
ACC-1903037542,30,15.48,4553.01,0.0,CUS-860700529,2018-09-27,Jeffrey,M,-27.61,153.05,,f2585ba4-8cb2-48af-a6fa-e0eba690d891,-31.95,115.89,WA,Burswood,debit,authorized,13e459c1fe8b424b830b745235e751dd,SALES-POS,20-30,2018,9,27,17,8,Thursday,14 days,48057.61714285714
ACC-1903037542,30,23.0,4530.01,,CUS-860700529,2018-09-28,Jeffrey,M,-27.61,153.05,,,,,,,debit,posted,5317f3d650734e24adb4718cbf0a9724,PAYMENT,20-30,2018,9,28,21,0,Friday,14 days,48057.61714285714
ACC-1903037542,30,3.77,4526.24,1.0,CUS-860700529,2018-09-29,Jeffrey,M,-27.61,153.05,,c6e24dac-a68f-4db8-9c3c-33d2ebd86f22,-27.42,153.04,QLD,Kedron,debit,authorized,0ad4f9474031496ba5ebc7633015fc59,SALES-POS,20-30,2018,9,29,7,31,Saturday,14 days,48057.61714285714
ACC-1903037542,30,6.37,4519.87,1.0,CUS-860700529,2018-09-29,Jeffrey,M,-27.61,153.05,,d4d98037-7715-4179-9e4a-3b1b0b0b7e11,-27.61,152.87,QLD,Redbank,debit,authorized,f99df92fa8f748908deb8e85ca58de58,SALES-POS,20-30,2018,9,29,8,2,Saturday,14 days,48057.61714285714
ACC-1903037542,30,17.32,4502.55,1.0,CUS-860700529,2018-09-29,Jeffrey,M,-27.61,153.05,,618e495b-47b7-4bd3-a2b9-882e0fc879ca,-30.3,153.12,NSW,Coffs Harbour,debit,authorized,716ffc16073f4063a1e635186af03b4b,POS,20-30,2018,9,29,11,48,Saturday,14 days,48057.61714285714
ACC-1903037542,30,8.68,4493.87,1.0,CUS-860700529,2018-09-29,Jeffrey,M,-27.61,153.05,,11c310e0-eaa4-495b-90c0-f34d99fa508c,-27.71,151.86,QLD,Cambooya,debit,authorized,445552835b2a45faa1a96f9e6a335368,SALES-POS,20-30,2018,9,29,14,35,Saturday,14 days,48057.61714285714
ACC-1903037542,30,10.34,4483.53,0.0,CUS-860700529,2018-09-29,Jeffrey,M,-27.61,153.05,,91e58a3d-7617-4000-b244-debe167206f0,-27.47,153.02,QLD,Brisbane City,debit,authorized,a8702cf135b2488b8a0453b6d7e4caa9,POS,20-30,2018,9,29,14,57,Saturday,14 days,48057.61714285714
ACC-1903037542,30,21.0,4462.53,0.0,CUS-860700529,2018-09-29,Jeffrey,M,-27.61,153.05,,a1427ac2-3ca9-4a6b-9b28-2da614698dec,-27.72,153.2,QLD,Mount Warren Park,debit,authorized,6b2ca664c5334c1da548012a92100e18,POS,20-30,2018,9,29,23,17,Saturday,14 days,48057.61714285714
ACC-1903037542,30,13.55,4448.98,1.0,CUS-860700529,2018-10-01,Jeffrey,M,-27.61,153.05,,e27a3a9f-223b-4c98-ac9c-4e9add0926e8,-27.45,153.04,QLD,Fortitude Valley,debit,authorized,897ab5cfb0b740a0801a84c5a2fa8ddc,POS,20-30,2018,10,1,14,15,Monday,14 days,48057.61714285714
ACC-1903037542,30,10.11,4438.87,1.0,CUS-860700529,2018-10-01,Jeffrey,M,-27.61,153.05,,b4b672c9-9ffa-470d-b3ba-cf52dd6819aa,-27.5,153.06,QLD,Coorparoo,debit,authorized,9f030193557445509543ec1d09a5c9cd,POS,20-30,2018,10,1,15,32,Monday,14 days,48057.61714285714
ACC-1903037542,30,14.96,4423.91,0.0,CUS-860700529,2018-10-02,Jeffrey,M,-27.61,153.05,,d879e353-647c-4c79-91c5-d5ec7bc13e7a,-27.57,153.06,QLD,Sunnybank,debit,authorized,7b48ae7d962a429bad2ac8dbfd5a99df,SALES-POS,20-30,2018,10,2,16,31,Tuesday,14 days,48057.61714285714
ACC-1903037542,30,40.59,4383.32,1.0,CUS-860700529,2018-10-02,Jeffrey,M,-27.61,153.05,,f18c699a-6fa4-4cf2-9098-07fd19ddb31e,-27.53,152.95,QLD,Jindalee,debit,authorized,0bbfff7c80d14c2a8cf2f4958d5e1b9b,POS,20-30,2018,10,2,17,39,Tuesday,14 days,48057.61714285714
ACC-1903037542,30,30.52,4352.8,0.0,CUS-860700529,2018-10-02,Jeffrey,M,-27.61,153.05,,e7aa23e1-a830-4d84-86ff-ab42036edece,-27.74,153.2,QLD,Windaroo,debit,authorized,5576029e556940daa1b95d17a6333f61,POS,20-30,2018,10,2,19,55,Tuesday,14 days,48057.61714285714
ACC-1903037542,30,8.01,4344.79,1.0,CUS-860700529,2018-10-02,Jeffrey,M,-27.61,153.05,,47a1a9ca-d993-4df2-95f1-081d889f49b3,-27.56,151.93,QLD,Toowoomba City,debit,authorized,df376ac4af53428fa0d68b54d878b67a,SALES-POS,20-30,2018,10,2,21,9,Tuesday,14 days,48057.61714285714
ACC-1903037542,30,19.29,4325.5,1.0,CUS-860700529,2018-10-03,Jeffrey,M,-27.61,153.05,,a9b8d6fe-61bc-4d10-82c4-c2865ba6686f,-27.56,152.95,QLD,Darra,debit,authorized,6773bfdbe8094a54b3956b734a8ef6b7,POS,20-30,2018,10,3,15,5,Wednesday,14 days,48057.61714285714
ACC-1903037542,30,38.8,4286.7,1.0,CUS-860700529,2018-10-03,Jeffrey,M,-27.61,153.05,,88596a59-6e90-4f5c-81f0-1032a90cfbf8,-27.56,153.09,QLD,Upper Mount Gravatt,debit,authorized,5f4eca2a1ce34de095dc173013c70b03,POS,20-30,2018,10,3,15,11,Wednesday,14 days,48057.61714285714
ACC-1903037542,30,6.14,4280.56,1.0,CUS-860700529,2018-10-04,Jeffrey,M,-27.61,153.05,,b0a6a7f9-b9c9-45b3-ac1b-eaf2e65a141c,-27.71,114.17,WA,Kalbarri,debit,authorized,8fff2c65ecea47ea8c68b6da1dd3b2d6,POS,20-30,2018,10,4,4,15,Thursday,14 days,48057.61714285714
ACC-1903037542,30,30.0,4250.56,1.0,CUS-860700529,2018-10-04,Jeffrey,M,-27.61,153.05,,589f7c5f-1522-4628-9385-61d8605d360d,-27.42,153,QLD,Alderley,debit,authorized,cdde66f1ccff43c0b72124e22a0f86cd,POS,20-30,2018,10,4,9,1,Thursday,14 days,48057.61714285714
ACC-1903037542,30,8.54,4242.02,1.0,CUS-860700529,2018-10-04,Jeffrey,M,-27.61,153.05,,5431e41f-1644-4e51-8abc-26239cb0b7c7,-16.92,145.77,QLD,Cairns City,debit,authorized,ab6d21a62e774ebe8397fdc4df887538,POS,20-30,2018,10,4,14,3,Thursday,14 days,48057.61714285714
ACC-1903037542,30,14.23,4227.79,1.0,CUS-860700529,2018-10-04,Jeffrey,M,-27.61,153.05,,dcfb6b32-dee7-4972-92ef-abc237562781,-27.52,153.25,QLD,Cleveland,debit,authorized,ce3196dbe44146bdb5212abd0e414240,SALES-POS,20-30,2018,10,4,14,21,Thursday,14 days,48057.61714285714
ACC-1903037542,30,5.61,4222.18,1.0,CUS-860700529,2018-10-04,Jeffrey,M,-27.61,153.05,,5a99b1bd-249f-4841-a402-57bb79e5d2c1,-27.56,152.42,QLD,Plainland,debit,authorized,09f25746fdab4ab99887d272b0708ca2,POS,20-30,2018,10,4,15,3,Thursday,14 days,48057.61714285714
ACC-1903037542,30,18.2,4203.98,1.0,CUS-860700529,2018-10-04,Jeffrey,M,-27.61,153.05,,e29d3f0f-c26f-4c94-8646-12e43b8b6542,-33.73,150.96,NSW,Baulkham Hills,debit,authorized,f3167f9c85ac4f0eac8e1592d8cc2715,POS,20-30,2018,10,4,15,49,Thursday,14 days,48057.61714285714
ACC-1903037542,30,20.13,4183.85,0.0,CUS-860700529,2018-10-04,Jeffrey,M,-27.61,153.05,,dbd510a6-f5b9-4302-b7bb-4772565381be,-27.67,153.14,QLD,Meadowbrook,debit,authorized,421c1874ee5a48f6b09d5def6e920619,POS,20-30,2018,10,4,20,40,Thursday,14 days,48057.61714285714
ACC-1903037542,30,12.8,4171.05,0.0,CUS-860700529,2018-10-04,Jeffrey,M,-27.61,153.05,,6b9bea63-44b3-4cb3-893b-704116ebce00,-27.49,152.99,QLD,Toowong,debit,authorized,a589940a3338435b84d4395ab304d67f,SALES-POS,20-30,2018,10,4,21,20,Thursday,14 days,48057.61714285714
ACC-1903037542,30,15.48,4155.57,1.0,CUS-860700529,2018-10-04,Jeffrey,M,-27.61,153.05,,2bcf4f78-081b-4758-8c38-23c162ee36cd,-27.52,153.22,QLD,Alexandra Hills,debit,authorized,581ac29cc9ba4a6189f8ccc896307c16,SALES-POS,20-30,2018,10,4,22,24,Thursday,14 days,48057.61714285714
ACC-1903037542,30,18.76,4136.81,1.0,CUS-860700529,2018-10-05,Jeffrey,M,-27.61,153.05,,e4bc12e1-0e87-439e-bc3b-961a06af1371,-37.84,145,VIC,South Yarra,debit,authorized,a1a29cbff52340b8bf54d7c372b383ba,SALES-POS,20-30,2018,10,5,14,10,Friday,14 days,48057.61714285714
ACC-1903037542,30,23.0,4099.11,,CUS-860700529,2018-10-05,Jeffrey,M,-27.61,153.05,,,,,,,debit,posted,1a7521dd1bad472fb2b215f73b70af9d,PAYMENT,20-30,2018,10,5,21,0,Friday,14 days,48057.61714285714
ACC-1903037542,30,14.7,4122.11,1.0,CUS-860700529,2018-10-05,Jeffrey,M,-27.61,153.05,,33c7954d-0719-426a-8321-ca6dc2512629,-27.55,152.94,QLD,Mount Ommaney,debit,authorized,89872dd7c0fa475f8e83e554b3b2fc9d,SALES-POS,20-30,2018,10,5,21,51,Friday,14 days,48057.61714285714
ACC-1903037542,30,134.0,3965.11,,CUS-860700529,2018-10-07,Jeffrey,M,-27.61,153.05,,,,,,,debit,posted,f95d91a539864400b9db4f923b2ca445,PHONE BANK,20-30,2018,10,7,2,0,Sunday,14 days,48057.61714285714
ACC-1903037542,30,50.56,3914.55,1.0,CUS-860700529,2018-10-10,Jeffrey,M,-27.61,153.05,,b755a38f-b8d8-48a4-800a-63db88276e34,-27.55,135.45,SA,Oodnadatta,debit,authorized,5f849ec26ee4456d8aa89c5326e1e4ac,POS,20-30,2018,10,10,4,58,Wednesday,14 days,48057.61714285714
ACC-1903037542,30,23.84,3890.71,1.0,CUS-860700529,2018-10-11,Jeffrey,M,-27.61,153.05,,84d91937-8b3e-4a73-8294-6a0a8198b4c5,-27.53,152.97,QLD,Fig Tree Pocket,debit,authorized,b0b90ce755bc4f3da69e21d7324547a0,POS,20-30,2018,10,11,9,55,Thursday,14 days,48057.61714285714
ACC-1903037542,30,5.2,3885.51,1.0,CUS-860700529,2018-10-11,Jeffrey,M,-27.61,153.05,,c9461443-0ddb-4ba3-868f-d780db2c8f88,-27.73,153.21,QLD,Mount Warren Park,debit,authorized,0ee17ae0e42647b987f2ec04cb5b02e9,SALES-POS,20-30,2018,10,11,11,44,Thursday,14 days,48057.61714285714
ACC-1903037542,30,23.0,5671.13,,CUS-860700529,2018-10-12,Jeffrey,M,-27.61,153.05,,,,,,,debit,posted,4d177efefe2d4168a29fd5b8041b9da8,PAYMENT,20-30,2018,10,12,21,0,Friday,14 days,48057.61714285714
ACC-1903037542,30,11.21,5659.92,1.0,CUS-860700529,2018-10-13,Jeffrey,M,-27.61,153.05,,8b9cc894-d0b1-4ea8-b71f-2d3f2763cc31,-27.48,152.99,QLD,Toowong,debit,authorized,413f70cd6da74072b45d26f567d65026,SALES-POS,20-30,2018,10,13,11,46,Saturday,14 days,48057.61714285714
ACC-1903037542,30,11.57,5648.35,1.0,CUS-860700529,2018-10-13,Jeffrey,M,-27.61,153.05,,3ab50da1-b4b6-418c-a5f2-bf841f68f183,-27.46,153.03,QLD,Spring Hill,debit,authorized,358d798e718f47678d1ba4aa7c17d8cd,SALES-POS,20-30,2018,10,13,15,11,Saturday,14 days,48057.61714285714
ACC-1903037542,30,378.76,5269.59,1.0,CUS-860700529,2018-10-13,Jeffrey,M,-27.61,153.05,,be1e094b-a748-494b-a2c3-32b3e7c39b92,-27.42,152.95,QLD,Keperra,debit,authorized,60cd5db52ca14684b2da0268da73faf1,POS,20-30,2018,10,13,15,30,Saturday,14 days,48057.61714285714
ACC-1903037542,30,20.7,5248.89,1.0,CUS-860700529,2018-10-13,Jeffrey,M,-27.61,153.05,,4952a8a3-2d57-4286-b32c-381a3e8c0f59,-27.67,153.19,QLD,Loganholme,debit,authorized,cbcb098ead5d4bcb9559980c10f2ac50,SALES-POS,20-30,2018,10,13,23,46,Saturday,14 days,48057.61714285714
ACC-1903037542,30,17.54,5231.35,1.0,CUS-860700529,2018-10-14,Jeffrey,M,-27.61,153.05,,789529cd-d84d-4dcd-b900-d0179cd7f092,-27.47,153.01,QLD,Milton,debit,authorized,30798f563297427e99885f9c9ea28c02,SALES-POS,20-30,2018,10,14,0,17,Sunday,14 days,48057.61714285714
ACC-1903037542,30,13.55,5217.8,0.0,CUS-860700529,2018-10-14,Jeffrey,M,-27.61,153.05,,4362e2ee-6761-413a-b056-2070f9a2d964,-27.5,153.1,QLD,Carina,debit,authorized,7f632439c0fe4209ad1aafc259cce96d,POS,20-30,2018,10,14,8,54,Sunday,14 days,48057.61714285714
ACC-1903037542,30,9.66,5208.14,1.0,CUS-860700529,2018-10-14,Jeffrey,M,-27.61,153.05,,0c9a9567-20b6-4917-8e4e-df4b42940e3f,-27.55,151.93,QLD,Wilsonton,debit,authorized,ea2b671bf7b74aa49e9c17a891866d6e,SALES-POS,20-30,2018,10,14,11,41,Sunday,14 days,48057.61714285714
ACC-1903037542,30,13.97,5194.17,1.0,CUS-860700529,2018-10-14,Jeffrey,M,-27.61,153.05,,09d50500-6b6b-40d6-8477-d6781af393ca,-27.5,153.04,QLD,Greenslopes,debit,authorized,db58439df74a4c278535784b1cc54c80,SALES-POS,20-30,2018,10,14,14,31,Sunday,14 days,48057.61714285714
ACC-1903037542,30,8.51,5185.66,1.0,CUS-860700529,2018-10-14,Jeffrey,M,-27.61,153.05,,d306d1c0-8bf6-4fd6-b16e-8a07b1d4d557,-27.53,153.27,QLD,Cleveland,debit,authorized,49a858c98d4f4da9b0de97670dac9501,SALES-POS,20-30,2018,10,14,19,53,Sunday,14 days,48057.61714285714
ACC-1903037542,30,78.0,5093.99,,CUS-860700529,2018-10-14,Jeffrey,M,-27.61,153.05,,,,,,,debit,posted,36f8251ce18d4b52a771b9115f40c531,INTER BANK,20-30,2018,10,14,20,0,Sunday,14 days,48057.61714285714
ACC-1903037542,30,5.77,5179.89,1.0,CUS-860700529,2018-10-14,Jeffrey,M,-27.61,153.05,,7d8decaf-9b13-4339-b93b-6c24e33a75dd,-27.47,153.03,QLD,Brisbane City,debit,authorized,2e09a7ece21949ff8db7a1971b3f3f54,SALES-POS,20-30,2018,10,14,20,30,Sunday,14 days,48057.61714285714
ACC-1903037542,30,7.9,5171.99,0.0,CUS-860700529,2018-10-14,Jeffrey,M,-27.61,153.05,,90b719ad-1dad-4d77-8f06-11507532fc78,-27.47,153.03,QLD,Brisbane City,debit,authorized,8f0225c5ddf646e0ad54b87dfad4ea46,SALES-POS,20-30,2018,10,14,20,37,Sunday,14 days,48057.61714285714
ACC-1903037542,30,73.12,5020.87,0.0,CUS-860700529,2018-10-14,Jeffrey,M,-27.61,153.05,,ca9fa256-5d60-4cfa-929f-829c89239474,-27.67,153.18,QLD,Loganholme,debit,authorized,05f0c934271344ceb80e81321fbce4cf,SALES-POS,20-30,2018,10,14,21,16,Sunday,14 days,48057.61714285714
ACC-1903037542,30,29.97,4990.9,1.0,CUS-860700529,2018-10-14,Jeffrey,M,-27.61,153.05,,aafc0b02-95e0-4061-92d3-34ea0eccf42f,-27.56,153.27,QLD,Thornlands,debit,authorized,5659756a630649efa906a7d55eec84ab,SALES-POS,20-30,2018,10,14,22,47,Sunday,14 days,48057.61714285714
ACC-1903037542,30,24.91,4965.99,0.0,CUS-860700529,2018-10-14,Jeffrey,M,-27.61,153.05,,c0a97399-2d3d-47bc-a2f0-f9d1bbc942f0,-27.53,153.2,QLD,Capalaba,debit,authorized,f8d9e19369594197b6f53ae8978b6882,SALES-POS,20-30,2018,10,14,23,59,Sunday,14 days,48057.61714285714
ACC-1903037542,30,165.0,4659.84,,CUS-860700529,2018-10-16,Jeffrey,M,-27.61,153.05,,,,,,,debit,posted,54e7b00b7b0b4bc5919f2b2c8b165d83,PAYMENT,20-30,2018,10,16,14,0,Tuesday,14 days,48057.61714285714
ACC-1903037542,30,141.15,4824.84,1.0,CUS-860700529,2018-10-16,Jeffrey,M,-27.61,153.05,,af8c71f9-7ff7-42f6-8a8e-11cf83ac7c56,-27.5,153.04,QLD,Woolloongabba,debit,authorized,dc9b1530d6204c379685ffaf9cebee13,SALES-POS,20-30,2018,10,16,14,49,Tuesday,14 days,48057.61714285714
ACC-1903037542,30,23.06,4636.78,0.0,CUS-860700529,2018-10-17,Jeffrey,M,-27.61,153.05,,eacf62b4-9734-46ef-9786-745c8e7d3b17,-26.66,153.08,QLD,Maroochydore,debit,authorized,d35553c1ca9a4dacba6cc88198b56f5f,SALES-POS,20-30,2018,10,17,1,38,Wednesday,14 days,48057.61714285714
ACC-1903037542,30,22.0,4614.78,1.0,CUS-860700529,2018-10-17,Jeffrey,M,-27.61,153.05,,d8bb12ed-2bac-4433-b623-3f1b83d85195,-27.45,151.94,QLD,Highfields,debit,authorized,e2c5395dbce345119bd76d64a86ebbfd,SALES-POS,20-30,2018,10,17,9,27,Wednesday,14 days,48057.61714285714
ACC-1903037542,30,13.85,4600.93,1.0,CUS-860700529,2018-10-17,Jeffrey,M,-27.61,153.05,,09f296a0-890e-41a3-9060-7c31399a94c9,-27.96,153.38,QLD,Southport,debit,authorized,584bf78e6dba4a37928dd0980b8aa2ed,SALES-POS,20-30,2018,10,17,9,32,Wednesday,14 days,48057.61714285714
ACC-1903037542,30,6.73,4594.2,1.0,CUS-860700529,2018-10-17,Jeffrey,M,-27.61,153.05,,f4daf865-ec0a-4d8f-8126-3cb2c1df1367,-27.5,153.1,QLD,Carindale,debit,authorized,500ffab7eedf4426950218c5808ab2b2,POS,20-30,2018,10,17,10,50,Wednesday,14 days,48057.61714285714
ACC-1903037542,30,11.11,4583.09,1.0,CUS-860700529,2018-10-17,Jeffrey,M,-27.61,153.05,,aa7448ff-6e32-4fd3-a7bd-06e854a7da2b,-27.59,153.28,QLD,Victoria Point,debit,authorized,3d8a23a139254cdab5022a502e8214d6,POS,20-30,2018,10,17,15,3,Wednesday,14 days,48057.61714285714
ACC-1903037542,30,42.15,4540.94,1.0,CUS-860700529,2018-10-17,Jeffrey,M,-27.61,153.05,,848f6f12-a594-461b-aaf5-72b7712ded60,-38.15,144.36,VIC,Geelong,debit,authorized,ff853aa337a24b63b3d469fa26430223,POS,20-30,2018,10,17,15,21,Wednesday,14 days,48057.61714285714
ACC-1903037542,30,18.57,4522.37,1.0,CUS-860700529,2018-10-17,Jeffrey,M,-27.61,153.05,,e3ec4729-aac7-4b6e-b92a-f3df8379111b,-27.32,153.06,QLD,Deagon,debit,authorized,8639163f768746af8841d1266e6602c6,SALES-POS,20-30,2018,10,17,15,27,Wednesday,14 days,48057.61714285714
ACC-1903037542,30,48.7,4473.67,0.0,CUS-860700529,2018-10-17,Jeffrey,M,-27.61,153.05,,57c9e10d-7a7b-4120-ad24-23843d682625,-27.52,152.98,QLD,Graceville,debit,authorized,c1e8ba1383374ca2aff479b4af7c2d12,POS,20-30,2018,10,17,21,48,Wednesday,14 days,48057.61714285714
ACC-1903037542,30,9.85,4463.82,1.0,CUS-860700529,2018-10-18,Jeffrey,M,-27.61,153.05,,68247442-f679-4eb8-84ff-31a852e84538,-27.49,153.09,QLD,Carina,debit,authorized,bb4e984055f64385a00af73e3c1ea1e6,POS,20-30,2018,10,18,9,32,Thursday,14 days,48057.61714285714
ACC-1903037542,30,14.94,4448.88,1.0,CUS-860700529,2018-10-18,Jeffrey,M,-27.61,153.05,,6c2fd1bf-8162-4721-a4ae-ab87a4d00c77,-27.56,153.08,QLD,Upper Mount Gravatt,debit,authorized,5dbc5186df2b430581948a2fe898f951,POS,20-30,2018,10,18,10,35,Thursday,14 days,48057.61714285714
ACC-1903037542,30,227.65,4221.23,1.0,CUS-860700529,2018-10-18,Jeffrey,M,-27.61,153.05,,9cd4ce71-52da-4385-841e-cae85382b931,-31.95,115.84,WA,West Perth,debit,authorized,cced6c4651054d66b23f06829a762e3c,POS,20-30,2018,10,18,15,17,Thursday,14 days,48057.61714285714
ACC-1903037542,30,11.26,4209.97,1.0,CUS-860700529,2018-10-19,Jeffrey,M,-27.61,153.05,,7f5d4734-3e9c-4a82-8ec5-ecab1682f244,-25.29,152.84,QLD,Hervey Bay,debit,authorized,a3b2b06eb01a40c18b3ebeccfff578e0,POS,20-30,2018,10,19,9,27,Friday,14 days,48057.61714285714
ACC-1903037542,30,15.93,4194.04,1.0,CUS-860700529,2018-10-19,Jeffrey,M,-27.61,153.05,,69efe0c2-5a9d-447b-87eb-30e60852534b,-27.44,153.04,QLD,Newstead,debit,authorized,891dc0c6e4674e25a65235c0ee85a7f4,POS,20-30,2018,10,19,12,51,Friday,14 days,48057.61714285714
ACC-1903037542,30,9.49,4184.55,1.0,CUS-860700529,2018-10-19,Jeffrey,M,-27.61,153.05,,7dbeae3d-bd81-4f52-bfd7-72c57ec57f1a,-27.58,153.1,QLD,Eight Mile Plains,debit,authorized,194e06615db34dabb11beee0e155d709,SALES-POS,20-30,2018,10,19,17,43,Friday,14 days,48057.61714285714
ACC-1903037542,30,4.99,4179.56,1.0,CUS-860700529,2018-10-19,Jeffrey,M,-27.61,153.05,,994f51ea-1a1f-49a7-b117-6651005b4bec,-27.47,153.03,QLD,Brisbane City,debit,authorized,0eda01de8e00468ebeec3047ea15edc2,SALES-POS,20-30,2018,10,19,19,39,Friday,14 days,48057.61714285714
ACC-1903037542,30,23.0,4122.34,,CUS-860700529,2018-10-19,Jeffrey,M,-27.61,153.05,,,,,,,debit,posted,d043b3958a474ad2bafcefb5aa77885f,PAYMENT,20-30,2018,10,19,21,0,Friday,14 days,48057.61714285714
ACC-1903037542,30,10.99,4168.57,1.0,CUS-860700529,2018-10-19,Jeffrey,M,-27.61,153.05,,00c512dd-562d-4159-ae33-248dfcf6d9cd,-27.66,153.04,QLD,Browns Plains,debit,authorized,065e2e44875645ceb157f9dd20c7159d,POS,20-30,2018,10,19,21,1,Friday,14 days,48057.61714285714
ACC-1903037542,30,23.23,4145.34,1.0,CUS-860700529,2018-10-19,Jeffrey,M,-27.61,153.05,,f58a09ad-ae82-442e-b66e-de1aa42d14df,-27.53,153.07,QLD,Mount Gravatt,debit,authorized,7a883c4989414c6882854e48b40afea1,POS,20-30,2018,10,19,21,26,Friday,14 days,48057.61714285714
ACC-1903037542,30,53.71,4068.63,1.0,CUS-860700529,2018-10-20,Jeffrey,M,-27.61,153.05,,95ce5769-e4a1-4560-86dd-dc4dfc4a2345,-27.47,153.05,QLD,New Farm,debit,authorized,27d6d6d6e9904cf48ee8bdb089b192de,SALES-POS,20-30,2018,10,20,21,23,Saturday,14 days,48057.61714285714
ACC-1903037542,30,8.69,4059.94,1.0,CUS-860700529,2018-10-20,Jeffrey,M,-27.61,153.05,,4e77a162-b3b9-411e-b3c9-955b93fb9fda,-27.59,153.28,QLD,Victoria Point,debit,authorized,80ed96393fe44c499b4b7f25f4b6f608,POS,20-30,2018,10,20,21,27,Saturday,14 days,48057.61714285714
ACC-1903037542,30,10.53,4049.41,0.0,CUS-860700529,2018-10-20,Jeffrey,M,-27.61,153.05,,11e234ec-e1d6-4db1-8a7f-11fbccc23802,-27.59,153.28,QLD,Victoria Point,debit,authorized,a013612e27b0476dbc776fa5bfd6679d,SALES-POS,20-30,2018,10,20,23,0,Saturday,14 days,48057.61714285714
ACC-1903037542,30,10.3,4039.11,1.0,CUS-860700529,2018-10-21,Jeffrey,M,-27.61,153.05,,51a0e373-c056-47b5-b397-40888ccc5b24,-27.59,153.03,QLD,Acacia Ridge,debit,authorized,7e8131c35a1a4a599b9554621905cb74,SALES-POS,20-30,2018,10,21,1,16,Sunday,14 days,48057.61714285714
ACC-1903037542,30,24.62,4014.49,1.0,CUS-860700529,2018-10-21,Jeffrey,M,-27.61,153.05,,0073ac09-8f1f-4de8-b83b-3dbe45bf504d,-27.53,153.02,QLD,Moorooka,debit,authorized,5dd36df5576b48a094378efbf3fea030,SALES-POS,20-30,2018,10,21,19,20,Sunday,14 days,48057.61714285714
ACC-1903037542,30,8.22,4006.27,1.0,CUS-860700529,2018-10-22,Jeffrey,M,-27.61,153.05,,f9d98b4b-8222-4769-a6f2-0aebfb134efe,-27.59,153.06,QLD,Sunnybank Hills,debit,authorized,408b87899cbc42368d6bd261105c0cf9,SALES-POS,20-30,2018,10,22,20,20,Monday,14 days,48057.61714285714
ACC-1903037542,30,10.11,3996.16,1.0,CUS-860700529,2018-10-23,Jeffrey,M,-27.61,153.05,,cc34d375-e0e1-4abb-b6af-4e0a7789e15b,-27.57,153.06,QLD,Sunnybank,debit,authorized,af2a67f0c2c54b2a9e14a434b6a4426f,POS,20-30,2018,10,23,9,54,Tuesday,14 days,48057.61714285714
ACC-1903037542,30,24.52,3971.64,1.0,CUS-860700529,2018-10-24,Jeffrey,M,-27.61,153.05,,e4f97038-2b5a-4530-81c5-1fe235bd5830,-27.97,153.41,QLD,Southport,debit,authorized,20112a29f9e94f9ab0d1bac96535fcb1,SALES-POS,20-30,2018,10,24,9,3,Wednesday,14 days,48057.61714285714
ACC-1903037542,30,15.73,3955.91,1.0,CUS-860700529,2018-10-24,Jeffrey,M,-27.61,153.05,,bcf746b5-7bf5-44fc-934b-9c44540ed213,-27.53,153.27,QLD,Cleveland,debit,authorized,490522847fe6404ea9b2d271c0f3fdf4,POS,20-30,2018,10,24,9,17,Wednesday,14 days,48057.61714285714
ACC-1903037542,30,20.9,3935.01,1.0,CUS-860700529,2018-10-24,Jeffrey,M,-27.61,153.05,,2c3eb181-cb33-418f-a96e-2f062dede376,-33.86,151.2,NSW,Sydney,debit,authorized,5e7f5a0ef6b74ffb8ee0b975b6116110,SALES-POS,20-30,2018,10,24,10,17,Wednesday,14 days,48057.61714285714
ACC-1903037542,30,35.92,3899.09,1.0,CUS-860700529,2018-10-24,Jeffrey,M,-27.61,153.05,,1246f7c0-606a-4ad2-9c6b-3a44edbdab64,-27.51,153.11,QLD,Carindale,debit,authorized,be9baabbe12749eba8cbb98a129cc1e4,POS,20-30,2018,10,24,13,23,Wednesday,14 days,48057.61714285714
ACC-1903037542,30,33.13,3865.96,1.0,CUS-860700529,2018-10-24,Jeffrey,M,-27.61,153.05,,8c1e002f-70cd-4fae-8ecd-7492afdddb76,-27.66,152.74,QLD,Yamanto,debit,authorized,dbd85b69d2574ea9acd0de45502fbeea,POS,20-30,2018,10,24,16,28,Wednesday,14 days,48057.61714285714
ACC-1903037542,30,21.18,5653.4,1.0,CUS-860700529,2018-10-25,Jeffrey,M,-27.61,153.05,,4fa1856a-561b-4a9e-8e9d-4bb9a6019939,-27.5,152.97,QLD,Indooroopilly,debit,authorized,10dfafb4ca6b4343b8adb6cc066a9f7b,POS,20-30,2018,10,25,18,44,Thursday,14 days,48057.61714285714
ACC-1903037542,30,10.08,5643.32,0.0,CUS-860700529,2018-10-26,Jeffrey,M,-27.61,153.05,,ace23a98-572b-490c-a151-2bd1105db8ef,-27.57,151.95,QLD,Toowoomba,debit,authorized,abc4e782207c4f1bbce420a156e203f4,SALES-POS,20-30,2018,10,26,0,57,Friday,14 days,48057.61714285714
ACC-1903037542,30,67.49,5575.83,1.0,CUS-860700529,2018-10-26,Jeffrey,M,-27.61,153.05,,29d41cac-3207-49c0-b33f-c7d55f912440,-27.48,153.14,QLD,Wakerley,debit,authorized,0ad62216594441a48a8669217778490e,POS,20-30,2018,10,26,17,46,Friday,14 days,48057.61714285714
ACC-1903037542,30,23.0,5552.83,,CUS-860700529,2018-10-26,Jeffrey,M,-27.61,153.05,,,,,,,debit,posted,f664a2050717466497083a68e7538856,PAYMENT,20-30,2018,10,26,21,0,Friday,14 days,48057.61714285714
ACC-1903037542,30,8.37,5544.46,1.0,CUS-860700529,2018-10-27,Jeffrey,M,-27.61,153.05,,d397880f-8fb7-4dea-ad87-acb67828c476,-27.48,153.02,QLD,South Brisbane,debit,authorized,577ce974151447b1b9c87698693c0573,POS,20-30,2018,10,27,8,37,Saturday,14 days,48057.61714285714
ACC-1903037542,30,12.39,5532.07,1.0,CUS-860700529,2018-10-27,Jeffrey,M,-27.61,153.05,,e96d88f5-a617-4dea-b42d-cf64afc26dd8,-27.45,153.04,QLD,Fortitude Valley,debit,authorized,3d9ec47e425a411f90a7469198b1e83f,SALES-POS,20-30,2018,10,27,15,6,Saturday,14 days,48057.61714285714
ACC-1903037542,30,4.23,5527.84,1.0,CUS-860700529,2018-10-27,Jeffrey,M,-27.61,153.05,,fecfbf4d-3784-4ecb-a059-9e7d8c8ed7d2,-27.53,153.09,QLD,Mount Gravatt East,debit,authorized,52050875766d48d1aa386f571d147f66,SALES-POS,20-30,2018,10,27,15,17,Saturday,14 days,48057.61714285714
ACC-1903037542,30,14.28,5513.56,1.0,CUS-860700529,2018-10-28,Jeffrey,M,-27.61,153.05,,a1bfab8f-6dd7-4111-8e7f-b32c841a2bc9,-27.46,153.06,QLD,Hawthorne,debit,authorized,9e7235e90827405ba08faa2daa41ab24,SALES-POS,20-30,2018,10,28,22,15,Sunday,14 days,48057.61714285714
ACC-1903037542,30,76.7,5436.86,1.0,CUS-860700529,2018-10-28,Jeffrey,M,-27.61,153.05,,d076eb9a-abe5-4936-8182-d626bf62d504,-33.87,151.21,NSW,Sydney,debit,authorized,639c1942dccb46138cdfa5bf39780a98,POS,20-30,2018,10,28,22,28,Sunday,14 days,48057.61714285714
ACC-1903037542,30,23.67,5413.19,1.0,CUS-860700529,2018-10-29,Jeffrey,M,-27.61,153.05,,c4d83067-ae21-4743-8c3f-2ae32f1c9225,-27.52,153.19,QLD,Capalaba,debit,authorized,b75f65aa62244c4696c567d8f5f8211c,SALES-POS,20-30,2018,10,29,8,2,Monday,14 days,48057.61714285714
ACC-1903037542,30,28.51,5384.68,1.0,CUS-860700529,2018-10-29,Jeffrey,M,-27.61,153.05,,ace64f01-3da7-4f7a-a5c1-cfc131156fa7,-31.43,152.91,NSW,Port Macquarie,debit,authorized,dd8fd044c3134256988d95ed53c09501,SALES-POS,20-30,2018,10,29,12,3,Monday,14 days,48057.61714285714
ACC-1903037542,30,13.31,5371.37,1.0,CUS-860700529,2018-10-29,Jeffrey,M,-27.61,153.05,,e82fd5f9-b431-474b-b799-30e17cc0dc5a,-27.49,153.2,QLD,Thorneside,debit,authorized,ac711a0a3e674b3cbcb35067e6e05429,POS,20-30,2018,10,29,22,27,Monday,14 days,48057.61714285714
ACC-1903037542,30,23.08,5348.29,1.0,CUS-860700529,2018-10-30,Jeffrey,M,-27.61,153.05,,395eb712-6667-47c1-9613-c7f6bca17a5b,-27.56,152.42,QLD,Plainland,debit,authorized,259d624065ff47d7963b3c0f4bb81658,SALES-POS,20-30,2018,10,30,9,19,Tuesday,14 days,48057.61714285714
ACC-1903037542,30,65.49,5282.8,1.0,CUS-860700529,2018-10-30,Jeffrey,M,-27.61,153.05,,f951df7c-92b7-444c-959b-e227f5bb6735,-33.85,151.05,NSW,Lidcombe,debit,authorized,eddb9b0510e142bcb2ed8c25c6899e9e,POS,20-30,2018,10,30,10,48,Tuesday,14 days,48057.61714285714
ACC-1903037542,30,22.97,5259.83,1.0,CUS-860700529,2018-10-30,Jeffrey,M,-27.61,153.05,,a086006a-264f-4045-9ddc-05bb70a1d6c0,-27.46,152.65,QLD,Fernvale,debit,authorized,bc4d6f0b2ec540aea70e14e82c41e038,SALES-POS,20-30,2018,10,30,11,32,Tuesday,14 days,48057.61714285714
ACC-1903037542,30,6.15,5253.68,0.0,CUS-860700529,2018-10-30,Jeffrey,M,-27.61,153.05,,e19ecaed-8cd6-4a56-b8f0-e871bc87febd,-27.56,153.08,QLD,Upper Mount Gravatt,debit,authorized,9afeb17234f445dcac9083195debb700,POS,20-30,2018,10,30,13,52,Tuesday,14 days,48057.61714285714
ACC-1903037542,30,9.87,5243.81,1.0,CUS-860700529,2018-10-31,Jeffrey,M,-27.61,153.05,,88fd592b-743c-4cd3-b5d4-d396f44eba3b,-27.51,152.94,QLD,Kenmore,debit,authorized,505f197798b144e6861a0cf6274eb4f5,POS,20-30,2018,10,31,9,53,Wednesday,14 days,48057.61714285714
ACC-2014856841,46,22.0,260514.83,,CUS-2370108457,2018-08-01,Patrick,M,-37.90,144.99,,,,,,,debit,posted,ae8124d2e33547bdb605d9a51581457f,INTER BANK,40-50,2018,8,1,8,0,Wednesday,14 days,56834.671
ACC-2014856841,46,50.0,260464.83,,CUS-2370108457,2018-08-02,Patrick,M,-37.90,144.99,,,,,,,debit,posted,6e94b79528074f5f9abf7868e64cf7e6,PAYMENT,40-50,2018,8,2,19,0,Thursday,14 days,56834.671
ACC-2014856841,46,122.81,260342.02,1.0,CUS-2370108457,2018-08-03,Patrick,M,-37.90,144.99,,59626c1c-832a-4779-bd27-616214df91be,-37.78,145.13,VIC,Doncaster,debit,authorized,a99e295f07254cabab3833d1bf239caa,POS,40-50,2018,8,3,22,59,Friday,14 days,56834.671
ACC-2014856841,46,43.0,260299.02,,CUS-2370108457,2018-08-04,Patrick,M,-37.90,144.99,,,,,,,debit,posted,1308fa8b48bd4594bb60d94a5d87070c,PAYMENT,40-50,2018,8,4,23,0,Saturday,14 days,56834.671
ACC-2014856841,46,2013.08,258285.94,1.0,CUS-2370108457,2018-08-07,Patrick,M,-37.90,144.99,,735cb78a-1f49-4e16-8eba-ed2ee2b58b0c,-37.81,144.98,VIC,East Melbourne,debit,authorized,1e98baadf0654ebcb8973876dec4e335,POS,40-50,2018,8,7,11,24,Tuesday,14 days,56834.671
ACC-2014856841,46,22.0,258263.94,,CUS-2370108457,2018-08-08,Patrick,M,-37.90,144.99,,,,,,,debit,posted,a0afa890ba7e4910a19ef47b63192d47,INTER BANK,40-50,2018,8,8,8,0,Wednesday,14 days,56834.671
ACC-2014856841,46,50.0,258213.94,,CUS-2370108457,2018-08-09,Patrick,M,-37.90,144.99,,,,,,,debit,posted,1fe7326fa8a3430c97d5c8cb3fb3d87f,PAYMENT,40-50,2018,8,9,19,0,Thursday,14 days,56834.671
ACC-2014856841,46,43.0,260350.9,,CUS-2370108457,2018-08-11,Patrick,M,-37.90,144.99,,,,,,,debit,posted,117561a20c55480e9ec8cb0af3a06613,PAYMENT,40-50,2018,8,11,23,0,Saturday,14 days,56834.671
ACC-2014856841,46,190.0,260160.9,,CUS-2370108457,2018-08-12,Patrick,M,-37.90,144.99,,,,,,,debit,posted,b3ee111d605043a0a3ca7cb7deba527b,PAYMENT,40-50,2018,8,12,16,0,Sunday,14 days,56834.671
ACC-2014856841,46,22.0,260138.9,,CUS-2370108457,2018-08-15,Patrick,M,-37.90,144.99,,,,,,,debit,posted,a38011973e054449b314e746fa6dcc3c,INTER BANK,40-50,2018,8,15,8,0,Wednesday,14 days,56834.671
ACC-2014856841,46,43.0,260045.9,,CUS-2370108457,2018-08-18,Patrick,M,-37.90,144.99,,,,,,,debit,posted,73d02de3d5f74abbaad660693ce74abc,PAYMENT,40-50,2018,8,18,23,0,Saturday,14 days,56834.671
ACC-2014856841,46,22.0,260023.9,,CUS-2370108457,2018-08-22,Patrick,M,-37.90,144.99,,,,,,,debit,posted,2fb3a0fffd044ce69e8bbb7db92f59b4,INTER BANK,40-50,2018,8,22,8,0,Wednesday,14 days,56834.671
ACC-2014856841,46,50.0,259973.9,,CUS-2370108457,2018-08-23,Patrick,M,-37.90,144.99,,,,,,,debit,posted,528448ee053741e19de769590978680b,PAYMENT,40-50,2018,8,23,19,0,Thursday,14 days,56834.671
ACC-2014856841,46,43.0,262110.86,,CUS-2370108457,2018-08-25,Patrick,M,-37.90,144.99,,,,,,,debit,posted,5cd9c8bf8a3043b69eb72c55bfe71437,PAYMENT,40-50,2018,8,25,23,0,Saturday,14 days,56834.671
ACC-2014856841,46,22.0,262088.86,,CUS-2370108457,2018-08-29,Patrick,M,-37.90,144.99,,,,,,,debit,posted,cd44d7ec97154ff392b70aac591ad595,INTER BANK,40-50,2018,8,29,8,0,Wednesday,14 days,56834.671
ACC-2014856841,46,50.0,262038.86,,CUS-2370108457,2018-08-30,Patrick,M,-37.90,144.99,,,,,,,debit,posted,11a39608f74144e18232809b4b4a1078,PAYMENT,40-50,2018,8,30,19,0,Thursday,14 days,56834.671
ACC-2014856841,46,43.0,261995.86,,CUS-2370108457,2018-09-01,Patrick,M,-37.90,144.99,,,,,,,debit,posted,880fe1bb3aae4b9fbd60421fb3b599be,PAYMENT,40-50,2018,9,1,23,0,Saturday,14 days,56834.671
ACC-2014856841,46,22.0,261973.86,,CUS-2370108457,2018-09-05,Patrick,M,-37.90,144.99,,,,,,,debit,posted,6e045d561ed54be088c76b0c838a0d40,INTER BANK,40-50,2018,9,5,8,0,Wednesday,14 days,56834.671
ACC-2014856841,46,50.0,261923.86,,CUS-2370108457,2018-09-06,Patrick,M,-37.90,144.99,,,,,,,debit,posted,dde1495db09e4d58b6de08b7b6a4fe18,PAYMENT,40-50,2018,9,6,19,0,Thursday,14 days,56834.671
ACC-2014856841,46,16.09,264087.73,1.0,CUS-2370108457,2018-09-08,Patrick,M,-37.90,144.99,,326ed6b6-9f78-4f91-9916-6c33767aa38f,-37.81,144.97,VIC,Melbourne,debit,authorized,ed6ebbe0a41d44058566a19f263965b8,SALES-POS,40-50,2018,9,8,9,35,Saturday,14 days,56834.671
ACC-2014856841,46,43.54,264044.19,1.0,CUS-2370108457,2018-09-08,Patrick,M,-37.90,144.99,,cbd3236c-cf61-4e9a-9480-01f5f0b5a9bf,-37.85,144.99,VIC,Prahran,debit,authorized,5629d429182a4e0784dbbbe92f241b8b,POS,40-50,2018,9,8,11,59,Saturday,14 days,56834.671
ACC-2014856841,46,59.01,263985.18,1.0,CUS-2370108457,2018-09-08,Patrick,M,-37.90,144.99,,f5b5f728-a918-425a-b25e-f14da8d6e6f2,-37.78,145.13,VIC,Doncaster,debit,authorized,bab45f957b3146be8541d65772ea0435,SALES-POS,40-50,2018,9,8,14,34,Saturday,14 days,56834.671
ACC-2014856841,46,43.0,263942.18,,CUS-2370108457,2018-09-08,Patrick,M,-37.90,144.99,,,,,,,debit,posted,3fc47aa8577743d184abbc900e59ad93,PAYMENT,40-50,2018,9,8,23,0,Saturday,14 days,56834.671
ACC-2014856841,46,58.03,263884.15,1.0,CUS-2370108457,2018-09-11,Patrick,M,-37.90,144.99,,cbd9a62a-8929-4748-87c6-b178ab329117,-37.8,144.9,VIC,Footscray,debit,authorized,bd41eb80529343cb95c4fc6864d38d85,POS,40-50,2018,9,11,10,4,Tuesday,14 days,56834.671
ACC-2014856841,46,22.0,263862.15,,CUS-2370108457,2018-09-12,Patrick,M,-37.90,144.99,,,,,,,debit,posted,63bf39bcde3d49bcbd5f22fe421d4cfe,INTER BANK,40-50,2018,9,12,8,0,Wednesday,14 days,56834.671
ACC-2014856841,46,190.0,263672.15,,CUS-2370108457,2018-09-12,Patrick,M,-37.90,144.99,,,,,,,debit,posted,14ffbb3559e448ada4bf3d94bfb76e44,PAYMENT,40-50,2018,9,12,16,0,Wednesday,14 days,56834.671
ACC-2014856841,46,1168.0,262504.15,,CUS-2370108457,2018-09-13,Patrick,M,-37.90,144.99,,,,,,,debit,posted,430b19685b98400cbe3d21cf5e4b7708,INTER BANK,40-50,2018,9,13,17,0,Thursday,14 days,56834.671
ACC-2014856841,46,50.0,262454.15,,CUS-2370108457,2018-09-13,Patrick,M,-37.90,144.99,,,,,,,debit,posted,fbef9340fcb94b1382cbece1163b1287,PAYMENT,40-50,2018,9,13,19,0,Thursday,14 days,56834.671
ACC-2014856841,46,43.0,262411.15,,CUS-2370108457,2018-09-15,Patrick,M,-37.90,144.99,,,,,,,debit,posted,d9b987cb071642fc95fed87f23d8a22a,PAYMENT,40-50,2018,9,15,23,0,Saturday,14 days,56834.671
ACC-2014856841,46,22.0,262389.15,,CUS-2370108457,2018-09-19,Patrick,M,-37.90,144.99,,,,,,,debit,posted,63c1b6a805bc41408f96ff08d792cbca,INTER BANK,40-50,2018,9,19,8,0,Wednesday,14 days,56834.671
ACC-2014856841,46,50.0,262339.15,,CUS-2370108457,2018-09-20,Patrick,M,-37.90,144.99,,,,,,,debit,posted,fd8d23bb32e2490896db8ee138689aaa,PAYMENT,40-50,2018,9,20,19,0,Thursday,14 days,56834.671
ACC-2014856841,46,43.0,264476.11,,CUS-2370108457,2018-09-22,Patrick,M,-37.90,144.99,,,,,,,debit,posted,dd81fe1d3ccd4afc8a3b69f99522a8f2,PAYMENT,40-50,2018,9,22,23,0,Saturday,14 days,56834.671
ACC-2014856841,46,22.0,264454.11,,CUS-2370108457,2018-09-26,Patrick,M,-37.90,144.99,,,,,,,debit,posted,e0934612d4684eb3bca5314032c69b72,INTER BANK,40-50,2018,9,26,8,0,Wednesday,14 days,56834.671
ACC-2014856841,46,50.0,264404.11,,CUS-2370108457,2018-09-27,Patrick,M,-37.90,144.99,,,,,,,debit,posted,d2d8ca4bb20146f08fa5d6da006d3166,PAYMENT,40-50,2018,9,27,19,0,Thursday,14 days,56834.671
ACC-2014856841,46,43.0,264361.11,,CUS-2370108457,2018-09-29,Patrick,M,-37.90,144.99,,,,,,,debit,posted,e7138e3e32594664979046a1c5a7aed7,PAYMENT,40-50,2018,9,29,23,0,Saturday,14 days,56834.671
ACC-2014856841,46,22.0,264339.11,,CUS-2370108457,2018-10-03,Patrick,M,-37.90,144.99,,,,,,,debit,posted,df19cdad16ec41268303ddb252bbe879,INTER BANK,40-50,2018,10,3,8,0,Wednesday,14 days,56834.671
ACC-2014856841,46,50.0,264289.11,,CUS-2370108457,2018-10-04,Patrick,M,-37.90,144.99,,,,,,,debit,posted,e31995bc5fc84833ba92b29f17ae699f,PAYMENT,40-50,2018,10,4,19,0,Thursday,14 days,56834.671
ACC-2014856841,46,43.0,266426.07,,CUS-2370108457,2018-10-06,Patrick,M,-37.90,144.99,,,,,,,debit,posted,ca66dd0491874fbcac7fb3f46cdcd7b1,PAYMENT,40-50,2018,10,6,23,0,Saturday,14 days,56834.671
ACC-2014856841,46,22.0,266404.07,,CUS-2370108457,2018-10-10,Patrick,M,-37.90,144.99,,,,,,,debit,posted,6c73733a41f64a6ea930990e165b249d,INTER BANK,40-50,2018,10,10,8,0,Wednesday,14 days,56834.671
ACC-2014856841,46,50.0,266354.07,,CUS-2370108457,2018-10-11,Patrick,M,-37.90,144.99,,,,,,,debit,posted,6e1cc2ce2fad4dc6ba70cb0921689b7f,PAYMENT,40-50,2018,10,11,19,0,Thursday,14 days,56834.671
ACC-2014856841,46,190.0,266164.07,,CUS-2370108457,2018-10-12,Patrick,M,-37.90,144.99,,,,,,,debit,posted,c3d2087d0eb244bca6ed3c873d2d8daf,PAYMENT,40-50,2018,10,12,16,0,Friday,14 days,56834.671
ACC-2014856841,46,134.61,266029.46,1.0,CUS-2370108457,2018-10-13,Patrick,M,-37.90,144.99,,20350a17-ead5-464b-bea9-5cbf33362de2,-37.9,145.09,VIC,Oakleigh,debit,authorized,2a418b4f470349dfa920747dd18555a8,POS,40-50,2018,10,13,21,14,Saturday,14 days,56834.671
ACC-2014856841,46,43.0,265986.46,,CUS-2370108457,2018-10-13,Patrick,M,-37.90,144.99,,,,,,,debit,posted,7751c77e762445d1a47cf24921e066ed,PAYMENT,40-50,2018,10,13,23,0,Saturday,14 days,56834.671
ACC-2014856841,46,14.84,265971.62,0.0,CUS-2370108457,2018-10-14,Patrick,M,-37.90,144.99,,2a979fe3-2afe-4ef3-9ec5-7bec899dd3d4,-37.81,147.63,VIC,Eastwood,debit,authorized,4c6a670793a64cf096b14df499c82db5,SALES-POS,40-50,2018,10,14,9,32,Sunday,14 days,56834.671
ACC-2014856841,46,67.93,265903.69,0.0,CUS-2370108457,2018-10-16,Patrick,M,-37.90,144.99,,1ea0300f-e1ee-45ce-804e-d17af5bfe792,-37.82,145.04,VIC,Hawthorn,debit,authorized,86a72510b30a45c687d97682a22c8024,POS,40-50,2018,10,16,16,11,Tuesday,14 days,56834.671
ACC-2014856841,46,22.0,265881.69,,CUS-2370108457,2018-10-17,Patrick,M,-37.90,144.99,,,,,,,debit,posted,6184d7711b7c4ba8882f4662f04e2888,INTER BANK,40-50,2018,10,17,8,0,Wednesday,14 days,56834.671
ACC-2014856841,46,63.94,265817.75,0.0,CUS-2370108457,2018-10-17,Patrick,M,-37.90,144.99,,826e9398-cdcf-46fe-98e7-248b23e3f67c,-37.89,145.26,VIC,Scoresby,debit,authorized,bf70d2a02bd2410d979d91594815fa5a,SALES-POS,40-50,2018,10,17,9,36,Wednesday,14 days,56834.671
ACC-2014856841,46,684.0,265133.75,,CUS-2370108457,2018-10-18,Patrick,M,-37.90,144.99,,,,,,,debit,posted,71e6bdde296344068ad727efbcde0083,INTER BANK,40-50,2018,10,18,4,0,Thursday,14 days,56834.671
ACC-2014856841,46,135.19,264998.56,1.0,CUS-2370108457,2018-10-18,Patrick,M,-37.90,144.99,,7e0fa6aa-b48a-4d55-afed-ff2034fda51c,-27.39,153.07,QLD,Northgate,debit,authorized,e34b4eb383ff4bfa92bc3c722f344b28,POS,40-50,2018,10,18,18,30,Thursday,14 days,56834.671
ACC-2014856841,46,50.0,264948.56,,CUS-2370108457,2018-10-18,Patrick,M,-37.90,144.99,,,,,,,debit,posted,7e427c854c8947609d0efd662b1c52dc,PAYMENT,40-50,2018,10,18,19,0,Thursday,14 days,56834.671
ACC-2014856841,46,34.86,267093.66,1.0,CUS-2370108457,2018-10-20,Patrick,M,-37.90,144.99,,d74f6467-029d-4ef5-9046-39db38104a5c,-37.79,145.09,VIC,Balwyn North,debit,authorized,ec6a8341a9464bffacad6c2cb7532023,POS,40-50,2018,10,20,21,5,Saturday,14 days,56834.671
ACC-2014856841,46,43.0,267050.66,,CUS-2370108457,2018-10-20,Patrick,M,-37.90,144.99,,,,,,,debit,posted,782a6d26da574671a5b09aefb38bc3c3,PAYMENT,40-50,2018,10,20,23,0,Saturday,14 days,56834.671
ACC-2014856841,46,21.69,267028.97,1.0,CUS-2370108457,2018-10-21,Patrick,M,-37.90,144.99,,8b13dcb3-04e0-43aa-b3f2-f8f452d06c2d,-37.78,144.83,VIC,Sunshine,debit,authorized,bf40d52ea2a940a1bc2c529bced62b71,SALES-POS,40-50,2018,10,21,14,33,Sunday,14 days,56834.671
ACC-2014856841,46,47.67,266981.3,1.0,CUS-2370108457,2018-10-21,Patrick,M,-37.90,144.99,,37ef33f1-3421-43ca-941f-38ddfbfe61d2,-37.82,144.96,VIC,Melbourne,debit,authorized,0ffb3be1e1c3479ea008836af0e0c64d,POS,40-50,2018,10,21,15,19,Sunday,14 days,56834.671
ACC-2014856841,46,64.98,266916.32,1.0,CUS-2370108457,2018-10-24,Patrick,M,-37.90,144.99,,6a044bfa-6fd1-460d-920a-db6ed0ea5227,-37.89,145.29,VIC,Ferntree Gully,debit,authorized,08e074cfdf8d4154bc20f66a5e30a4d0,POS,40-50,2018,10,24,1,45,Wednesday,14 days,56834.671
ACC-2014856841,46,22.0,266894.32,,CUS-2370108457,2018-10-24,Patrick,M,-37.90,144.99,,,,,,,debit,posted,49b707cec9454739a06dd80eb90da4a0,INTER BANK,40-50,2018,10,24,8,0,Wednesday,14 days,56834.671
ACC-2014856841,46,17.06,266877.26,1.0,CUS-2370108457,2018-10-24,Patrick,M,-37.90,144.99,,3a5bdc06-632f-4104-9194-1c5da4c1461b,-37.78,144.97,VIC,Brunswick,debit,authorized,39cf9edbf4e24e3aa61ef6420ff89ecd,SALES-POS,40-50,2018,10,24,9,8,Wednesday,14 days,56834.671
ACC-2014856841,46,122.38,266754.88,1.0,CUS-2370108457,2018-10-24,Patrick,M,-37.90,144.99,,c93d3a14-a29c-4fde-b1df-93b331a66ffc,-33.8,151.18,NSW,Chatswood,debit,authorized,fbd3a546ace84da780508aae0f9369be,POS,40-50,2018,10,24,21,55,Wednesday,14 days,56834.671
ACC-2014856841,46,50.0,266704.88,,CUS-2370108457,2018-10-25,Patrick,M,-37.90,144.99,,,,,,,debit,posted,c426496c514647bc8f9d73d471c0bc19,PAYMENT,40-50,2018,10,25,19,0,Thursday,14 days,56834.671
ACC-2014856841,46,43.0,266661.88,,CUS-2370108457,2018-10-27,Patrick,M,-37.90,144.99,,,,,,,debit,posted,f0b41da4158c4103b2880a744e06df78,PAYMENT,40-50,2018,10,27,23,0,Saturday,14 days,56834.671
ACC-2014856841,46,22.0,266639.88,,CUS-2370108457,2018-10-31,Patrick,M,-37.90,144.99,,,,,,,debit,posted,e80dfc6294684d13b9e6facdfe0c3741,INTER BANK,40-50,2018,10,31,8,0,Wednesday,14 days,56834.671
ACC-4163822186,26,55.0,3117.94,,CUS-2630892467,2018-08-01,Karen,F,-34.97,149.03,,,,,,,debit,posted,0b0bc166b6da49b1ac64d3bb9c4ef550,PAYMENT,20-30,2018,8,1,8,0,Wednesday,7 days,48008.45
ACC-4163822186,26,46.0,3071.94,,CUS-2630892467,2018-08-01,Karen,F,-34.97,149.03,,,,,,,debit,posted,f9517b2856424dee847566e333c1da49,PAYMENT,20-30,2018,8,1,12,0,Wednesday,7 days,48008.45
ACC-4163822186,26,50.0,3021.94,,CUS-2630892467,2018-08-01,Karen,F,-34.97,149.03,,,,,,,debit,posted,2aebc7593cb842b49df7313c3a650725,PAYMENT,20-30,2018,8,1,17,0,Wednesday,7 days,48008.45
ACC-4163822186,26,35.6,2986.34,1.0,CUS-2630892467,2018-08-02,Karen,F,-34.97,149.03,,7c8b371e-51b1-48a4-a112-de37dd8287ec,-34.91,138.53,SA,Kidman Park,debit,authorized,3569455b943e4a708e97675ba899bd7e,SALES-POS,20-30,2018,8,2,9,8,Thursday,7 days,48008.45
ACC-4163822186,26,55.0,3852.05,,CUS-2630892467,2018-08-08,Karen,F,-34.97,149.03,,,,,,,debit,posted,ee3948b898b14003bf4cb981bc98dcfe,PAYMENT,20-30,2018,8,8,8,0,Wednesday,7 days,48008.45
ACC-4163822186,26,46.0,3806.05,,CUS-2630892467,2018-08-08,Karen,F,-34.97,149.03,,,,,,,debit,posted,04f8fa7df0ce45cdb83776a71299ba27,PAYMENT,20-30,2018,8,8,12,0,Wednesday,7 days,48008.45
ACC-4163822186,26,50.0,3756.05,,CUS-2630892467,2018-08-08,Karen,F,-34.97,149.03,,,,,,,debit,posted,b9828bbdb4b84ec1a325ce22adbe8135,PAYMENT,20-30,2018,8,8,17,0,Wednesday,7 days,48008.45
ACC-4163822186,26,55.0,4621.76,,CUS-2630892467,2018-08-15,Karen,F,-34.97,149.03,,,,,,,debit,posted,8281c45fb71d48faa728cc053baa3e7c,PAYMENT,20-30,2018,8,15,8,0,Wednesday,7 days,48008.45
ACC-4163822186,26,46.0,4575.76,,CUS-2630892467,2018-08-15,Karen,F,-34.97,149.03,,,,,,,debit,posted,e338409e7c0f4ef7935d2c2d5cdd5954,PAYMENT,20-30,2018,8,15,12,0,Wednesday,7 days,48008.45
ACC-4163822186,26,50.0,4525.76,,CUS-2630892467,2018-08-15,Karen,F,-34.97,149.03,,,,,,,debit,posted,cd375df8e66c469095b3c3e8609bed8c,PAYMENT,20-30,2018,8,15,17,0,Wednesday,7 days,48008.45
ACC-4163822186,26,46.64,4492.74,1.0,CUS-2630892467,2018-08-19,Karen,F,-34.97,149.03,,d785f0e6-5068-4215-9e18-9615f5047cf2,-34.95,138.63,SA,Fullarton,debit,authorized,01aff6e9fc6d44e984dbfaa8277957f8,SALES-POS,20-30,2018,8,19,9,55,Sunday,7 days,48008.45
ACC-4163822186,26,19.76,4472.98,1.0,CUS-2630892467,2018-08-19,Karen,F,-34.97,149.03,,c3409220-6c99-409b-9730-667c2ff12c97,-34.98,138.61,SA,Torrens Park,debit,authorized,29da80f85145436f800a8d3cab107b3c,POS,20-30,2018,8,19,10,19,Sunday,7 days,48008.45
ACC-4163822186,26,55.0,4417.98,,CUS-2630892467,2018-08-22,Karen,F,-34.97,149.03,,,,,,,debit,posted,2bfec70d0eb74db4a5dfd110f6044440,PAYMENT,20-30,2018,8,22,8,0,Wednesday,7 days,48008.45
ACC-4163822186,26,46.0,4371.98,,CUS-2630892467,2018-08-22,Karen,F,-34.97,149.03,,,,,,,debit,posted,6e468df6299442a4bcfa335c812b5ab8,PAYMENT,20-30,2018,8,22,12,0,Wednesday,7 days,48008.45
ACC-4163822186,26,50.0,4321.98,,CUS-2630892467,2018-08-22,Karen,F,-34.97,149.03,,,,,,,debit,posted,23a2f9a90d844a529fd0878c28687674,PAYMENT,20-30,2018,8,22,17,0,Wednesday,7 days,48008.45
ACC-4163822186,26,22.31,5220.38,1.0,CUS-2630892467,2018-08-27,Karen,F,-34.97,149.03,,2660b4a7-c122-46e1-94ba-936d87a23e4e,-21.15,148.95,QLD,Marian,debit,authorized,82deabed637a431d8d5bcc9ffa48de98,SALES-POS,20-30,2018,8,27,9,23,Monday,7 days,48008.45
ACC-4163822186,26,55.0,5165.38,,CUS-2630892467,2018-08-29,Karen,F,-34.97,149.03,,,,,,,debit,posted,abf4abb32c824b9f889bdef50fdf09fe,PAYMENT,20-30,2018,8,29,8,0,Wednesday,7 days,48008.45
ACC-4163822186,26,46.0,5119.38,,CUS-2630892467,2018-08-29,Karen,F,-34.97,149.03,,,,,,,debit,posted,26b0fb637427408f9ddd66c3af5f0cab,PAYMENT,20-30,2018,8,29,12,0,Wednesday,7 days,48008.45
ACC-4163822186,26,50.0,5069.38,,CUS-2630892467,2018-08-29,Karen,F,-34.97,149.03,,,,,,,debit,posted,7c28a8f4421d4092ac4ddd04c539a7d5,PAYMENT,20-30,2018,8,29,17,0,Wednesday,7 days,48008.45
ACC-4163822186,26,55.0,5935.09,,CUS-2630892467,2018-09-05,Karen,F,-34.97,149.03,,,,,,,debit,posted,e0e91faf30694e888cc1edb8464bda94,PAYMENT,20-30,2018,9,5,8,0,Wednesday,7 days,48008.45
ACC-4163822186,26,46.0,5889.09,,CUS-2630892467,2018-09-05,Karen,F,-34.97,149.03,,,,,,,debit,posted,64e3e6b2c2b144b68295c7793f656534,PAYMENT,20-30,2018,9,5,12,0,Wednesday,7 days,48008.45
ACC-4163822186,26,50.0,5839.09,,CUS-2630892467,2018-09-05,Karen,F,-34.97,149.03,,,,,,,debit,posted,bedde88f1df94985930f688f3c43ec1a,PAYMENT,20-30,2018,9,5,17,0,Wednesday,7 days,48008.45
ACC-4163822186,26,55.0,6704.8,,CUS-2630892467,2018-09-12,Karen,F,-34.97,149.03,,,,,,,debit,posted,f61e571155924d259d0efa574f3f688b,PAYMENT,20-30,2018,9,12,8,0,Wednesday,7 days,48008.45
ACC-4163822186,26,46.0,6658.8,,CUS-2630892467,2018-09-12,Karen,F,-34.97,149.03,,,,,,,debit,posted,97e81152c3474675a6bc53de06cbfbea,PAYMENT,20-30,2018,9,12,12,0,Wednesday,7 days,48008.45
ACC-4163822186,26,50.0,6608.8,,CUS-2630892467,2018-09-12,Karen,F,-34.97,149.03,,,,,,,debit,posted,e8546f084a0e48339b52a41e09c66099,PAYMENT,20-30,2018,9,12,17,0,Wednesday,7 days,48008.45
ACC-4163822186,26,164.0,7365.51,,CUS-2630892467,2018-09-16,Karen,F,-34.97,149.03,,,,,,,debit,posted,6220e94c34fa490080d341cccd9787c0,PAYMENT,20-30,2018,9,16,17,0,Sunday,7 days,48008.45
ACC-4163822186,26,55.0,7310.51,,CUS-2630892467,2018-09-19,Karen,F,-34.97,149.03,,,,,,,debit,posted,9f1842542ea7441e9089bb201ed71d66,PAYMENT,20-30,2018,9,19,8,0,Wednesday,7 days,48008.45
ACC-4163822186,26,46.0,7264.51,,CUS-2630892467,2018-09-19,Karen,F,-34.97,149.03,,,,,,,debit,posted,48be7bdb14544d3a9ea5f1ac847895f4,PAYMENT,20-30,2018,9,19,12,0,Wednesday,7 days,48008.45
ACC-4163822186,26,50.0,7214.51,,CUS-2630892467,2018-09-19,Karen,F,-34.97,149.03,,,,,,,debit,posted,d54bdd2d49c04c6dab58637c68356b24,PAYMENT,20-30,2018,9,19,17,0,Wednesday,7 days,48008.45
ACC-4163822186,26,55.0,8080.22,,CUS-2630892467,2018-09-26,Karen,F,-34.97,149.03,,,,,,,debit,posted,617d186e033c43f29e1392371bc96722,PAYMENT,20-30,2018,9,26,8,0,Wednesday,7 days,48008.45
ACC-4163822186,26,46.0,8034.22,,CUS-2630892467,2018-09-26,Karen,F,-34.97,149.03,,,,,,,debit,posted,9ab3cda6c8ee448aa8804ea3fbbcffc3,PAYMENT,20-30,2018,9,26,12,0,Wednesday,7 days,48008.45
ACC-4163822186,26,50.0,7984.22,,CUS-2630892467,2018-09-26,Karen,F,-34.97,149.03,,,,,,,debit,posted,0d1b1e6c82d0434199e5ef0a105602e3,PAYMENT,20-30,2018,9,26,17,0,Wednesday,7 days,48008.45
ACC-4163822186,26,55.0,8849.93,,CUS-2630892467,2018-10-03,Karen,F,-34.97,149.03,,,,,,,debit,posted,014503527bff49d1a209c3417c201d6e,PAYMENT,20-30,2018,10,3,8,0,Wednesday,7 days,48008.45
ACC-4163822186,26,46.0,8803.93,,CUS-2630892467,2018-10-03,Karen,F,-34.97,149.03,,,,,,,debit,posted,736a785afec9479d8cbf71853ec5a03e,PAYMENT,20-30,2018,10,3,12,0,Wednesday,7 days,48008.45
ACC-4163822186,26,50.0,8753.93,,CUS-2630892467,2018-10-03,Karen,F,-34.97,149.03,,,,,,,debit,posted,9f78a500368b463db47a0984f0cca41f,PAYMENT,20-30,2018,10,3,17,0,Wednesday,7 days,48008.45
ACC-4163822186,26,55.0,9619.64,,CUS-2630892467,2018-10-10,Karen,F,-34.97,149.03,,,,,,,debit,posted,4ab953f8cc804e38957404714cb41c92,PAYMENT,20-30,2018,10,10,8,0,Wednesday,7 days,48008.45
ACC-4163822186,26,46.0,9573.64,,CUS-2630892467,2018-10-10,Karen,F,-34.97,149.03,,,,,,,debit,posted,f80c328d863d4c2d9122e8ae4fbf61ea,PAYMENT,20-30,2018,10,10,12,0,Wednesday,7 days,48008.45
ACC-4163822186,26,50.0,9523.64,,CUS-2630892467,2018-10-10,Karen,F,-34.97,149.03,,,,,,,debit,posted,ffe5494dac1f473d8d23c22b01d74914,PAYMENT,20-30,2018,10,10,17,0,Wednesday,7 days,48008.45
ACC-4163822186,26,164.0,10280.35,,CUS-2630892467,2018-10-16,Karen,F,-34.97,149.03,,,,,,,debit,posted,ce6a16a3109e47759a47f986ef83bee0,PAYMENT,20-30,2018,10,16,17,0,Tuesday,7 days,48008.45
ACC-4163822186,26,55.0,10225.35,,CUS-2630892467,2018-10-17,Karen,F,-34.97,149.03,,,,,,,debit,posted,a7c7170fd22b470086b9a79d325b49a1,PAYMENT,20-30,2018,10,17,8,0,Wednesday,7 days,48008.45
ACC-4163822186,26,46.0,10179.35,,CUS-2630892467,2018-10-17,Karen,F,-34.97,149.03,,,,,,,debit,posted,2a17ec8ad6f54f6faa1b9be752debeeb,PAYMENT,20-30,2018,10,17,12,0,Wednesday,7 days,48008.45
ACC-4163822186,26,50.0,10129.35,,CUS-2630892467,2018-10-17,Karen,F,-34.97,149.03,,,,,,,debit,posted,92ed024e66de4032a91146fd6d20dae6,PAYMENT,20-30,2018,10,17,17,0,Wednesday,7 days,48008.45
ACC-4163822186,26,55.0,10995.06,,CUS-2630892467,2018-10-24,Karen,F,-34.97,149.03,,,,,,,debit,posted,ba53f4d5e893492d8f819d994856b292,PAYMENT,20-30,2018,10,24,8,0,Wednesday,7 days,48008.45
ACC-4163822186,26,46.0,10949.06,,CUS-2630892467,2018-10-24,Karen,F,-34.97,149.03,,,,,,,debit,posted,1ccf548487cf4ec3aec6011b6b9062f8,PAYMENT,20-30,2018,10,24,12,0,Wednesday,7 days,48008.45
ACC-4163822186,26,50.0,10899.06,,CUS-2630892467,2018-10-24,Karen,F,-34.97,149.03,,,,,,,debit,posted,6e623d509f4b42e3a38de619059a6b2c,PAYMENT,20-30,2018,10,24,17,0,Wednesday,7 days,48008.45
ACC-4163822186,26,55.0,11764.77,,CUS-2630892467,2018-10-31,Karen,F,-34.97,149.03,,,,,,,debit,posted,d8610d4023774edbaf82364427bf5b15,PAYMENT,20-30,2018,10,31,8,0,Wednesday,7 days,48008.45
ACC-4163822186,26,46.0,11718.77,,CUS-2630892467,2018-10-31,Karen,F,-34.97,149.03,,,,,,,debit,posted,973f926c4f844a468df6a9239d0f726c,PAYMENT,20-30,2018,10,31,12,0,Wednesday,7 days,48008.45
ACC-4163822186,26,50.0,11668.77,,CUS-2630892467,2018-10-31,Karen,F,-34.97,149.03,,,,,,,debit,posted,fc980fbb588c4231aae09d6ad34cf31b,PAYMENT,20-30,2018,10,31,17,0,Wednesday,7 days,48008.45
ACC-3954677887,47,58.0,38.31,,CUS-3716701010,2018-08-01,Ruth,F,-32.28,115.72,,,,,,,debit,posted,c24ca89f7aba4ab4b8d3e9ac0c5f4fab,PAYMENT,40-50,2018,8,1,8,0,Wednesday,7 days,66350.221
ACC-3954677887,47,20.87,17.44,0.0,CUS-3716701010,2018-08-02,Ruth,F,-32.28,115.72,,15ceaf10-4350-41a8-b409-51e97e9bf4ab,-31.82,115.81,WA,Kingsley,debit,authorized,bdbd26386e8441ffaee17eeddf5ecea7,POS,40-50,2018,8,2,8,25,Thursday,7 days,66350.221
ACC-3954677887,47,58.0,1231.91,,CUS-3716701010,2018-08-08,Ruth,F,-32.28,115.72,,,,,,,debit,posted,6a66b1eacc3b459f9c4040daa6df2af8,PAYMENT,40-50,2018,8,8,8,0,Wednesday,7 days,66350.221
ACC-3954677887,47,46.0,1185.91,,CUS-3716701010,2018-08-09,Ruth,F,-32.28,115.72,,,,,,,debit,posted,c98f82dddd1b404f9507f44ab16c664c,PAYMENT,40-50,2018,8,9,11,0,Thursday,7 days,66350.221
ACC-3954677887,47,24.0,1161.91,,CUS-3716701010,2018-08-11,Ruth,F,-32.28,115.72,,,,,,,debit,posted,ec40f0d4f9be46f18d93bf86971f38dc,PAYMENT,40-50,2018,8,11,23,0,Saturday,7 days,66350.221
ACC-3954677887,47,58.0,2376.38,,CUS-3716701010,2018-08-15,Ruth,F,-32.28,115.72,,,,,,,debit,posted,a1f22eab4bf34e19ba98ef5010e5edab,PAYMENT,40-50,2018,8,15,8,0,Wednesday,7 days,66350.221
ACC-3954677887,47,24.0,2306.38,,CUS-3716701010,2018-08-18,Ruth,F,-32.28,115.72,,,,,,,debit,posted,19a99a927529464baaabdbe85cd69de5,PAYMENT,40-50,2018,8,18,23,0,Saturday,7 days,66350.221
ACC-3954677887,47,42.91,2263.47,1.0,CUS-3716701010,2018-08-20,Ruth,F,-32.28,115.72,,525cdd9d-873c-4395-a93d-aeb2dda14888,-32.45,124.01,WA,Balladonia,debit,authorized,7b6a2e97fdb542c3b53eea2e234856a3,POS,40-50,2018,8,20,9,6,Monday,7 days,66350.221
ACC-3954677887,47,23.02,2240.45,1.0,CUS-3716701010,2018-08-20,Ruth,F,-32.28,115.72,,a626b9a3-6b9f-4d6e-ae9f-9fba2dfe4c8e,-32.3,115.76,WA,Cooloongup,debit,authorized,d7cd3c775eb64774b418742bbdee50c4,SALES-POS,40-50,2018,8,20,9,15,Monday,7 days,66350.221
ACC-3954677887,47,5.22,2235.23,1.0,CUS-3716701010,2018-08-20,Ruth,F,-32.28,115.72,,606e59e2-285f-4955-83b1-de242970d5b5,-33.9,151.21,NSW,Waterloo,debit,authorized,1ef6955129c940988bff27a60122b7e9,SALES-POS,40-50,2018,8,20,9,45,Monday,7 days,66350.221
ACC-3954677887,47,58.0,3427.68,,CUS-3716701010,2018-08-22,Ruth,F,-32.28,115.72,,,,,,,debit,posted,f0a8e2e00ed0483784433d6ba7f08295,PAYMENT,40-50,2018,8,22,8,0,Wednesday,7 days,66350.221
ACC-3954677887,47,22.02,3485.68,1.0,CUS-3716701010,2018-08-22,Ruth,F,-32.28,115.72,,ec4c8abb-5081-4ebb-9d33-1150d045d213,-31.99,115.9,WA,East Victoria Park,debit,authorized,1f28f045a9ad486e9cab12ad593ccfde,SALES-POS,40-50,2018,8,22,8,7,Wednesday,7 days,66350.221
ACC-3954677887,47,22.63,3405.05,1.0,CUS-3716701010,2018-08-22,Ruth,F,-32.28,115.72,,dec98c7f-de17-4533-bd06-f6e5acd537b6,-31.96,141.45,NSW,Broken Hill,debit,authorized,84e7a05511eb40eaa83461fa1a71183f,SALES-POS,40-50,2018,8,22,9,10,Wednesday,7 days,66350.221
ACC-3954677887,47,60.21,3344.84,1.0,CUS-3716701010,2018-08-22,Ruth,F,-32.28,115.72,,78bbe3f3-3090-4c0a-a291-3163f403c9be,-31.92,115.84,WA,Mt Hawthorn,debit,authorized,49e52e02c60a41cd8af7522ad46e6738,SALES-POS,40-50,2018,8,22,9,15,Wednesday,7 days,66350.221
ACC-3954677887,47,121.0,3223.84,,CUS-3716701010,2018-08-22,Ruth,F,-32.28,115.72,,,,,,,debit,posted,73e032c464674a4d9708878f5e8267ac,INTER BANK,40-50,2018,8,22,20,0,Wednesday,7 days,66350.221
ACC-3954677887,47,5.66,3218.18,1.0,CUS-3716701010,2018-08-22,Ruth,F,-32.28,115.72,,63f2f012-d9e7-43bd-87e3-b1281edbc7dc,-32.51,115.96,WA,North Dandalup,debit,authorized,925f2e4864824cca995cf2d867814cc0,POS,40-50,2018,8,22,21,38,Wednesday,7 days,66350.221
ACC-3954677887,47,30.86,3187.32,1.0,CUS-3716701010,2018-08-23,Ruth,F,-32.28,115.72,,85001102-e9fe-4fe8-b52a-9e7c16a34e98,-32.13,133.67,SA,Ceduna,debit,authorized,b738c61022324870af73c78e131ce2eb,POS,40-50,2018,8,23,9,55,Thursday,7 days,66350.221
ACC-3954677887,47,46.0,3141.32,,CUS-3716701010,2018-08-23,Ruth,F,-32.28,115.72,,,,,,,debit,posted,9a83cb53b2d74fd5bdae43eaf5e84918,PAYMENT,40-50,2018,8,23,11,0,Thursday,7 days,66350.221
ACC-3954677887,47,53.64,3087.68,1.0,CUS-3716701010,2018-08-23,Ruth,F,-32.28,115.72,,bea1a64d-1a9b-4631-9a45-7ff74fd3ca16,-32.29,115.74,WA,Rockingham,debit,authorized,565ffc910f67404a80ad511bdd5147dc,SALES-POS,40-50,2018,8,23,17,14,Thursday,7 days,66350.221
ACC-3954677887,47,30.15,3057.53,1.0,CUS-3716701010,2018-08-24,Ruth,F,-32.28,115.72,,b1c36e87-8132-4601-975b-df9c7e3b01b5,-32.28,115.73,WA,Rockingham,debit,authorized,d70c55d68e6f49c6bf274a38f25c80e1,SALES-POS,40-50,2018,8,24,22,34,Friday,7 days,66350.221
ACC-3954677887,47,46.7,3010.83,1.0,CUS-3716701010,2018-08-24,Ruth,F,-32.28,115.72,,75f2869a-b905-41ea-9294-0b04d3bb340f,-32.16,152.49,NSW,Tuncurry,debit,authorized,f5362d82940c45029de8c34b81c50503,SALES-POS,40-50,2018,8,24,23,1,Friday,7 days,66350.221
ACC-3954677887,47,113.0,2897.83,,CUS-3716701010,2018-08-25,Ruth,F,-32.28,115.72,,,,,,,debit,posted,78972628162e4da994fd9152ac346a15,INTER BANK,40-50,2018,8,25,9,0,Saturday,7 days,66350.221
ACC-3954677887,47,18.97,2878.86,1.0,CUS-3716701010,2018-08-25,Ruth,F,-32.28,115.72,,8a01afe8-1468-4e9f-8152-ccb237b7c614,-32.29,115.74,WA,Rockingham,debit,authorized,14302201336343a3af5c9d198ba425df,SALES-POS,40-50,2018,8,25,21,48,Saturday,7 days,66350.221
ACC-3954677887,47,24.0,2854.86,,CUS-3716701010,2018-08-25,Ruth,F,-32.28,115.72,,,,,,,debit,posted,5bd9034a67ec4cc3b741c79eb8b80fa1,PAYMENT,40-50,2018,8,25,23,0,Saturday,7 days,66350.221
ACC-3954677887,47,33.97,2820.89,1.0,CUS-3716701010,2018-08-27,Ruth,F,-32.28,115.72,,c9744c93-e984-40f0-82b4-aa09b945fe50,-34.43,150.89,NSW,Wollongong,debit,authorized,2e94f5da91984566901d6f5121b95e76,SALES-POS,40-50,2018,8,27,17,59,Monday,7 days,66350.221
ACC-3954677887,47,21.21,2799.68,1.0,CUS-3716701010,2018-08-28,Ruth,F,-32.28,115.72,,ecc5b9df-b406-4131-827f-2414533885dc,-32.32,115.75,WA,Waikiki,debit,authorized,250ff617c1ad43b8b494205dc28e8ea3,POS,40-50,2018,8,28,6,43,Tuesday,7 days,66350.221
ACC-3954677887,47,21.39,4050.76,1.0,CUS-3716701010,2018-08-28,Ruth,F,-32.28,115.72,,552b4220-1a02-4608-9e48-4b81003fb6e8,-31.89,116.77,WA,York,debit,authorized,4922643e09b942c49b2117b7f3c4d493,SALES-POS,40-50,2018,8,28,22,34,Tuesday,7 days,66350.221
ACC-3954677887,47,58.0,3992.76,,CUS-3716701010,2018-08-29,Ruth,F,-32.28,115.72,,,,,,,debit,posted,01bb959ba9704d16b18153d007737c8d,PAYMENT,40-50,2018,8,29,8,0,Wednesday,7 days,66350.221
ACC-3954677887,47,37.59,3955.17,1.0,CUS-3716701010,2018-08-29,Ruth,F,-32.28,115.72,,b5386da3-dd49-489a-a0a5-799de5429ec7,-31.84,115.81,WA,Warwick,debit,authorized,6790e4700b4d454cbe72bd382d9d268c,SALES-POS,40-50,2018,8,29,15,26,Wednesday,7 days,66350.221
ACC-3954677887,47,20.8,3934.37,1.0,CUS-3716701010,2018-08-30,Ruth,F,-32.28,115.72,,b09d863f-4ca8-4053-b342-8b2571dc1714,-31.97,115.93,WA,Cloverdale,debit,authorized,fcf2985704644b8fb5852c8884054c73,POS,40-50,2018,8,30,8,5,Thursday,7 days,66350.221
ACC-3954677887,47,46.0,3888.37,,CUS-3716701010,2018-08-30,Ruth,F,-32.28,115.72,,,,,,,debit,posted,b4c66c06651b4bc995c732408f6ac21a,PAYMENT,40-50,2018,8,30,11,0,Thursday,7 days,66350.221
ACC-3954677887,47,36.46,3851.91,1.0,CUS-3716701010,2018-08-30,Ruth,F,-32.28,115.72,,da3deefd-e453-4ba6-9d32-54edf2dfd93d,-37.82,144.95,VIC,Docklands,debit,authorized,f23676c58b5d4a8fa6064657658f6a55,POS,40-50,2018,8,30,19,19,Thursday,7 days,66350.221
ACC-3954677887,47,58.54,3793.37,1.0,CUS-3716701010,2018-08-30,Ruth,F,-32.28,115.72,,a2074a5f-2cc1-4dae-af9a-4fd4b6151d24,-32.48,137.76,SA,Port Augusta West,debit,authorized,d37f1a5e7a8a427e8365f03f56a6106e,SALES-POS,40-50,2018,8,30,19,38,Thursday,7 days,66350.221
ACC-3954677887,47,13.41,3779.96,0.0,CUS-3716701010,2018-09-01,Ruth,F,-32.28,115.72,,fa3a6b8e-fe87-45e8-96c1-c6560e487575,-32.24,148.6,NSW,Dubbo,debit,authorized,d841660d4625413ba65a7483c5d66e1d,POS,40-50,2018,9,1,21,44,Saturday,7 days,66350.221
ACC-3954677887,47,24.0,3755.96,,CUS-3716701010,2018-09-01,Ruth,F,-32.28,115.72,,,,,,,debit,posted,99d4dffe1b7e485a9bd8e3592c4aac04,PAYMENT,40-50,2018,9,1,23,0,Saturday,7 days,66350.221
ACC-3954677887,47,58.0,4970.43,,CUS-3716701010,2018-09-05,Ruth,F,-32.28,115.72,,,,,,,debit,posted,1eac41193b17495581f02b10c7e409db,PAYMENT,40-50,2018,9,5,8,0,Wednesday,7 days,66350.221
ACC-3954677887,47,29.19,4941.24,1.0,CUS-3716701010,2018-09-06,Ruth,F,-32.28,115.72,,9d91fb2d-da37-46a6-a379-3fd219608187,-31.94,115.84,WA,Leederville,debit,authorized,081b9a988c1146f28753280607b489cc,POS,40-50,2018,9,6,9,44,Thursday,7 days,66350.221
ACC-3954677887,47,46.0,4895.24,,CUS-3716701010,2018-09-06,Ruth,F,-32.28,115.72,,,,,,,debit,posted,bae8e1474b5d480eb0191449c73276ab,PAYMENT,40-50,2018,9,6,11,0,Thursday,7 days,66350.221
ACC-3954677887,47,32.62,4862.62,0.0,CUS-3716701010,2018-09-06,Ruth,F,-32.28,115.72,,eb39df03-0b99-4c7f-b34a-8d65813a53d1,-31.92,115.89,WA,Inglewood,debit,authorized,1d7ae516248b4110bb85a3796be44226,POS,40-50,2018,9,6,12,15,Thursday,7 days,66350.221
ACC-3954677887,47,29.52,4833.1,1.0,CUS-3716701010,2018-09-06,Ruth,F,-32.28,115.72,,ab969dde-bf2b-4ad7-a34f-9b603ae5e039,-31.91,115.85,WA,Yokine,debit,authorized,2079925e877b4e6baee8ba854f3b510b,POS,40-50,2018,9,6,15,46,Thursday,7 days,66350.221
ACC-3954677887,47,34.4,4798.7,1.0,CUS-3716701010,2018-09-06,Ruth,F,-32.28,115.72,,f70d646b-d9a2-44a5-9ffa-becda2a18792,-33.88,151.19,NSW,Glebe,debit,authorized,1f5672d0d1a04ff0823b00348fe509b1,POS,40-50,2018,9,6,19,5,Thursday,7 days,66350.221
ACC-3954677887,47,17.47,4781.23,1.0,CUS-3716701010,2018-09-06,Ruth,F,-32.28,115.72,,63d4551d-08b2-469f-9e3a-2d7adf8ea517,-32.04,115.79,WA,Palmyra,debit,authorized,a38f5182214e4fed83abeb6954559665,POS,40-50,2018,9,6,20,45,Thursday,7 days,66350.221
ACC-3954677887,47,10.53,4770.7,1.0,CUS-3716701010,2018-09-07,Ruth,F,-32.28,115.72,,db242cd6-db1f-4950-8a6e-a85f66e2437a,-32.01,115.84,WA,Applecross,debit,authorized,b1361fd8047443c7af31c059c3b8c7bd,POS,40-50,2018,9,7,13,34,Friday,7 days,66350.221
ACC-3954677887,47,34.87,4735.83,0.0,CUS-3716701010,2018-09-07,Ruth,F,-32.28,115.72,,1854ef5e-5990-46d5-8552-11dbff1c4efa,-32.01,115.89,WA,Karawara,debit,authorized,64f8adb1efe7470c9d408bcb29bb1706,SALES-POS,40-50,2018,9,7,20,44,Friday,7 days,66350.221
ACC-3954677887,47,185.65,4550.18,1.0,CUS-3716701010,2018-09-08,Ruth,F,-32.28,115.72,,2013fab2-4c62-4f96-8199-22db61f0d0ed,-33.82,151.01,NSW,Parramatta,debit,authorized,223ebadc53e74afa95298a9ed08967ba,POS,40-50,2018,9,8,14,42,Saturday,7 days,66350.221
ACC-3954677887,47,13.76,4536.42,0.0,CUS-3716701010,2018-09-08,Ruth,F,-32.28,115.72,,c2b7018f-025c-4c19-bd80-3d84733d10c7,-32.16,115.85,WA,Hammond Park,debit,authorized,6dfb1110194c428dbb87e1f4b5c32c64,SALES-POS,40-50,2018,9,8,21,9,Saturday,7 days,66350.221
ACC-3954677887,47,24.0,4512.42,,CUS-3716701010,2018-09-08,Ruth,F,-32.28,115.72,,,,,,,debit,posted,57e6c036aee5461ab401301b360542d5,PAYMENT,40-50,2018,9,8,23,0,Saturday,7 days,66350.221
ACC-3954677887,47,19.9,4492.52,1.0,CUS-3716701010,2018-09-09,Ruth,F,-32.28,115.72,,ce912643-28ef-478f-aaa5-0f4100a5286a,-32.48,137.76,SA,Port Augusta West,debit,authorized,c6346d433cee40ce81c3d5146710c403,POS,40-50,2018,9,9,11,45,Sunday,7 days,66350.221
ACC-3954677887,47,58.0,5706.99,,CUS-3716701010,2018-09-12,Ruth,F,-32.28,115.72,,,,,,,debit,posted,a8f7686574a94993b1c5e62b27cc5a63,PAYMENT,40-50,2018,9,12,8,0,Wednesday,7 days,66350.221
ACC-3954677887,47,5.52,5701.47,1.0,CUS-3716701010,2018-09-13,Ruth,F,-32.28,115.72,,0573359a-48af-4d38-a1a0-00d115cb2654,-31.91,152.46,NSW,Taree,debit,authorized,1b093d0f8984475396c6b8ef0e8ed3dd,SALES-POS,40-50,2018,9,13,7,6,Thursday,7 days,66350.221
ACC-3954677887,47,27.07,5674.4,1.0,CUS-3716701010,2018-09-13,Ruth,F,-32.28,115.72,,209ea563-6f75-4605-b322-d9f5d24d7a45,-31.77,115.82,WA,Hocking,debit,authorized,6363ba1726944ee792b93d61775a60ee,POS,40-50,2018,9,13,9,34,Thursday,7 days,66350.221
ACC-3954677887,47,46.0,5628.4,,CUS-3716701010,2018-09-13,Ruth,F,-32.28,115.72,,,,,,,debit,posted,8c90d376f63b4df9aea63a6d1a37f603,PAYMENT,40-50,2018,9,13,11,0,Thursday,7 days,66350.221
ACC-3954677887,47,24.0,5604.4,,CUS-3716701010,2018-09-15,Ruth,F,-32.28,115.72,,,,,,,debit,posted,1e57552deb7e46b9833fe44c2eab1793,PAYMENT,40-50,2018,9,15,23,0,Saturday,7 days,66350.221
ACC-3954677887,47,10.7,5593.7,0.0,CUS-3716701010,2018-09-16,Ruth,F,-32.28,115.72,,5be1f568-5d69-421e-9a73-37cb0e37c893,-31.72,115.74,WA,Kinross,debit,authorized,90b448c7feab448f8e71c5ab9893676b,SALES-POS,40-50,2018,9,16,14,21,Sunday,7 days,66350.221
ACC-3954677887,47,45.04,5548.66,1.0,CUS-3716701010,2018-09-16,Ruth,F,-32.28,115.72,,b429e42e-e416-4d68-975f-e6a8f56638b7,-31.85,115.88,WA,Malaga,debit,authorized,d4003df99bf340b2b7507ed66a63b26f,POS,40-50,2018,9,16,20,7,Sunday,7 days,66350.221
ACC-3954677887,47,58.0,6763.13,,CUS-3716701010,2018-09-19,Ruth,F,-32.28,115.72,,,,,,,debit,posted,408b4c0642c649d899fa1cd46d6ca2bc,PAYMENT,40-50,2018,9,19,8,0,Wednesday,7 days,66350.221
ACC-3954677887,47,46.0,6717.13,,CUS-3716701010,2018-09-20,Ruth,F,-32.28,115.72,,,,,,,debit,posted,4cb6dd95083242ffb32896da5a4ddc9b,PAYMENT,40-50,2018,9,20,11,0,Thursday,7 days,66350.221
ACC-3954677887,47,1403.0,5314.13,,CUS-3716701010,2018-09-21,Ruth,F,-32.28,115.72,,,,,,,debit,posted,7c4b48f394244361b8381b3cb09088e6,PAYMENT,40-50,2018,9,21,13,0,Friday,7 days,66350.221
ACC-3954677887,47,121.0,5193.13,,CUS-3716701010,2018-09-22,Ruth,F,-32.28,115.72,,,,,,,debit,posted,f6f3871228294897b229fd00891b5dda,INTER BANK,40-50,2018,9,22,20,0,Saturday,7 days,66350.221
ACC-3954677887,47,24.0,5169.13,,CUS-3716701010,2018-09-22,Ruth,F,-32.28,115.72,,,,,,,debit,posted,af2de8810ee242a19c502b4d2cdea138,PAYMENT,40-50,2018,9,22,23,0,Saturday,7 days,66350.221
ACC-3954677887,47,1085.0,4084.13,,CUS-3716701010,2018-09-24,Ruth,F,-32.28,115.72,,,,,,,debit,posted,9dc33bbcd068468f825a1cf8dc95bfbb,PAYMENT,40-50,2018,9,24,12,0,Monday,7 days,66350.221
ACC-3954677887,47,113.0,3971.13,,CUS-3716701010,2018-09-25,Ruth,F,-32.28,115.72,,,,,,,debit,posted,d1d320a5df344b98b78e4f4735c8bcff,INTER BANK,40-50,2018,9,25,9,0,Tuesday,7 days,66350.221
ACC-3954677887,47,58.0,5185.6,,CUS-3716701010,2018-09-26,Ruth,F,-32.28,115.72,,,,,,,debit,posted,a19f09f554cf4bd8871532bec4d1f57d,PAYMENT,40-50,2018,9,26,8,0,Wednesday,7 days,66350.221
ACC-3954677887,47,46.0,5139.6,,CUS-3716701010,2018-09-27,Ruth,F,-32.28,115.72,,,,,,,debit,posted,f77eb90a71a743cf956f34e5ca8b8fec,PAYMENT,40-50,2018,9,27,11,0,Thursday,7 days,66350.221
ACC-3954677887,47,24.0,5115.6,,CUS-3716701010,2018-09-29,Ruth,F,-32.28,115.72,,,,,,,debit,posted,7c0a137aee194904810e1136bb2c8c72,PAYMENT,40-50,2018,9,29,23,0,Saturday,7 days,66350.221
ACC-3954677887,47,58.0,6330.07,,CUS-3716701010,2018-10-03,Ruth,F,-32.28,115.72,,,,,,,debit,posted,e6b43f4657c44073a83d3ea081671c05,PAYMENT,40-50,2018,10,3,8,0,Wednesday,7 days,66350.221
ACC-3954677887,47,46.0,6284.07,,CUS-3716701010,2018-10-04,Ruth,F,-32.28,115.72,,,,,,,debit,posted,746bcae9b3e6433496a72763d42bdb55,PAYMENT,40-50,2018,10,4,11,0,Thursday,7 days,66350.221
ACC-3954677887,47,24.0,6260.07,,CUS-3716701010,2018-10-06,Ruth,F,-32.28,115.72,,,,,,,debit,posted,f0776aca2ebc4b23be771df1525a34f1,PAYMENT,40-50,2018,10,6,23,0,Saturday,7 days,66350.221
ACC-3954677887,47,58.0,7474.54,,CUS-3716701010,2018-10-10,Ruth,F,-32.28,115.72,,,,,,,debit,posted,476835fe0c1f4aa29c3c19c5221a18f9,PAYMENT,40-50,2018,10,10,8,0,Wednesday,7 days,66350.221
ACC-3954677887,47,46.0,7428.54,,CUS-3716701010,2018-10-11,Ruth,F,-32.28,115.72,,,,,,,debit,posted,c0d539ba64154cd5bf9bd971a08891b7,PAYMENT,40-50,2018,10,11,11,0,Thursday,7 days,66350.221
ACC-3954677887,47,24.0,7404.54,,CUS-3716701010,2018-10-13,Ruth,F,-32.28,115.72,,,,,,,debit,posted,137cf6f7f8a043bc982e012f1ad9468d,PAYMENT,40-50,2018,10,13,23,0,Saturday,7 days,66350.221
ACC-3954677887,47,17.0,8660.01,1.0,CUS-3716701010,2018-10-16,Ruth,F,-32.28,115.72,,e62512ac-6ed5-474c-8745-4cc82b13ad94,-32.49,137.77,SA,Port Augusta,debit,authorized,6d50a533f9ea41d7807d75b8d0812c7c,POS,40-50,2018,10,16,19,50,Tuesday,7 days,66350.221
ACC-3954677887,47,58.0,8476.49,,CUS-3716701010,2018-10-17,Ruth,F,-32.28,115.72,,,,,,,debit,posted,dc88fc9012cf4a7b8fe33a768c190494,PAYMENT,40-50,2018,10,17,8,0,Wednesday,7 days,66350.221
ACC-3954677887,47,125.52,8534.49,1.0,CUS-3716701010,2018-10-17,Ruth,F,-32.28,115.72,,e410750c-3db2-4bcb-ac4f-28ff88ced0cc,-32.12,116.02,WA,Kelmscott,debit,authorized,54f15609599942cfbda691a74213b7e2,POS,40-50,2018,10,17,8,37,Wednesday,7 days,66350.221
ACC-3954677887,47,47.22,8429.27,1.0,CUS-3716701010,2018-10-17,Ruth,F,-32.28,115.72,,eeda9bcd-4ada-449a-8851-150fd704c328,-31.77,115.77,WA,Beldon,debit,authorized,24d510c4aed74b90b9a0d95e0b584acf,SALES-POS,40-50,2018,10,17,12,59,Wednesday,7 days,66350.221
ACC-3954677887,47,23.2,8406.07,1.0,CUS-3716701010,2018-10-17,Ruth,F,-32.28,115.72,,170f7d2c-9a6c-445e-ab8f-a4827256fd99,-32.29,115.75,WA,Rockingham,debit,authorized,5f9c4b7123944f45862d4a801bca8bcb,SALES-POS,40-50,2018,10,17,14,11,Wednesday,7 days,66350.221
ACC-3954677887,47,46.0,8360.07,,CUS-3716701010,2018-10-18,Ruth,F,-32.28,115.72,,,,,,,debit,posted,620e8c70efed42a784202e70251c67f2,PAYMENT,40-50,2018,10,18,11,0,Thursday,7 days,66350.221
ACC-3954677887,47,13.96,8346.11,1.0,CUS-3716701010,2018-10-19,Ruth,F,-32.28,115.72,,fa3a6b8e-fe87-45e8-96c1-c6560e487575,-32.24,148.6,NSW,Dubbo,debit,authorized,5ce0470731d240b48ec33c8bcaac5a7f,POS,40-50,2018,10,19,17,32,Friday,7 days,66350.221
ACC-3954677887,47,136.19,8209.92,1.0,CUS-3716701010,2018-10-19,Ruth,F,-32.28,115.72,,bcbd4135-4f71-489a-8267-93ceed452aba,-37.74,145.03,VIC,Preston,debit,authorized,d58952c9cd00476fbdaa3ded750cdab5,POS,40-50,2018,10,19,21,50,Friday,7 days,66350.221
ACC-3954677887,47,23.81,8186.11,1.0,CUS-3716701010,2018-10-20,Ruth,F,-32.28,115.72,,3f1aa031-c119-45af-b171-87a3d87c866e,-31.82,115.82,WA,Madeley,debit,authorized,7fe40b4659124727bd75ee93e353002f,SALES-POS,40-50,2018,10,20,4,54,Saturday,7 days,66350.221
ACC-3954677887,47,23.13,8162.98,1.0,CUS-3716701010,2018-10-20,Ruth,F,-32.28,115.72,,a6448b7f-1de5-47d5-bb6f-988fb1212955,-32.26,148.63,NSW,Dubbo,debit,authorized,af9b5acf2a2e4ff887c39fb4d82cc5af,SALES-POS,40-50,2018,10,20,19,24,Saturday,7 days,66350.221
ACC-3954677887,47,183.18,7979.8,1.0,CUS-3716701010,2018-10-20,Ruth,F,-32.28,115.72,,11fac570-b721-4c16-9dd9-9b85a2d87a35,-31.78,115.79,WA,Woodvale,debit,authorized,b8e05e34d1b04649b0dea7561e80eea0,SALES-POS,40-50,2018,10,20,21,14,Saturday,7 days,66350.221
ACC-3954677887,47,24.0,7955.8,,CUS-3716701010,2018-10-20,Ruth,F,-32.28,115.72,,,,,,,debit,posted,79b71ef16152488e85dfa03ca898f5e6,PAYMENT,40-50,2018,10,20,23,0,Saturday,7 days,66350.221
ACC-3954677887,47,121.0,7834.8,,CUS-3716701010,2018-10-22,Ruth,F,-32.28,115.72,,,,,,,debit,posted,07479c5b3c7d4f9fb612fc04027ad0d4,INTER BANK,40-50,2018,10,22,20,0,Monday,7 days,66350.221
ACC-3954677887,47,58.0,9049.27,,CUS-3716701010,2018-10-24,Ruth,F,-32.28,115.72,,,,,,,debit,posted,851dbd1fadfa4149b72461675a422e36,PAYMENT,40-50,2018,10,24,8,0,Wednesday,7 days,66350.221
ACC-3954677887,47,113.0,8936.27,,CUS-3716701010,2018-10-25,Ruth,F,-32.28,115.72,,,,,,,debit,posted,46930c1076f14c4bac6a3d4f1b45f3af,INTER BANK,40-50,2018,10,25,9,0,Thursday,7 days,66350.221
ACC-3954677887,47,46.0,8890.27,,CUS-3716701010,2018-10-25,Ruth,F,-32.28,115.72,,,,,,,debit,posted,9c9a8f85e6574449971a5c74eaf6a743,PAYMENT,40-50,2018,10,25,11,0,Thursday,7 days,66350.221
ACC-3954677887,47,27.0,8863.27,1.0,CUS-3716701010,2018-10-25,Ruth,F,-32.28,115.72,,fe41c89b-1d15-41a0-aa74-547a6c50d681,-31.69,115.72,WA,Clarkson,debit,authorized,a4b774269c2843c5aa3ff356e617e325,POS,40-50,2018,10,25,13,42,Thursday,7 days,66350.221
ACC-3954677887,47,46.09,8817.18,1.0,CUS-3716701010,2018-10-27,Ruth,F,-32.28,115.72,,75f2869a-b905-41ea-9294-0b04d3bb340f,-32.16,152.49,NSW,Tuncurry,debit,authorized,f0badc57dd2f48e2a7945052ff545cc2,POS,40-50,2018,10,27,11,44,Saturday,7 days,66350.221
ACC-3954677887,47,12.51,8804.67,1.0,CUS-3716701010,2018-10-27,Ruth,F,-32.28,115.72,,b058eafd-52f8-4de8-8caa-5cac0144173a,-31.94,115.88,WA,Perth,debit,authorized,9da57b59f9454a199ab24b493996bdc4,POS,40-50,2018,10,27,16,3,Saturday,7 days,66350.221
ACC-3954677887,47,24.0,8780.67,,CUS-3716701010,2018-10-27,Ruth,F,-32.28,115.72,,,,,,,debit,posted,f725b0ac6d5245d99cfdd0a269e7610e,PAYMENT,40-50,2018,10,27,23,0,Saturday,7 days,66350.221
ACC-3954677887,47,21.86,10031.28,0.0,CUS-3716701010,2018-10-31,Ruth,F,-32.28,115.72,,c4f05a97-bfa6-47a0-9d0f-a0cd7863d9e8,-31.9,115.94,WA,Bassendean,debit,authorized,02f4e836071049d4a09dfc5c7647046c,POS,40-50,2018,10,31,1,4,Wednesday,7 days,66350.221
ACC-3954677887,47,25.44,10005.84,1.0,CUS-3716701010,2018-10-31,Ruth,F,-32.28,115.72,,9f6a37bb-f618-4ffe-8ea9-5a883be3ad35,-32.07,116,WA,Gosnells,debit,authorized,6a516d587ef04645998af899c11f9977,SALES-POS,40-50,2018,10,31,7,5,Wednesday,7 days,66350.221
ACC-3954677887,47,58.0,9947.84,,CUS-3716701010,2018-10-31,Ruth,F,-32.28,115.72,,,,,,,debit,posted,d56be8ce10b843088874be73b2faa46d,PAYMENT,40-50,2018,10,31,8,0,Wednesday,7 days,66350.221
ACC-3954677887,47,21.34,9926.5,1.0,CUS-3716701010,2018-10-31,Ruth,F,-32.28,115.72,,f396e354-0172-4f22-b316-e62abe051504,-31.93,115.84,WA,Leederville,debit,authorized,7c5a7762136d4bb7b6c9e05ba85b1361,SALES-POS,40-50,2018,10,31,11,23,Wednesday,7 days,66350.221
ACC-3954677887,47,9.56,9916.94,1.0,CUS-3716701010,2018-10-31,Ruth,F,-32.28,115.72,,886c596d-4191-4628-8742-339f14c7b3d7,-32.04,115.91,WA,Riverton,debit,authorized,f0d147d30d334a378b56fbbeb1468c1c,SALES-POS,40-50,2018,10,31,17,31,Wednesday,7 days,66350.221
ACC-3954677887,47,15.91,9901.03,0.0,CUS-3716701010,2018-10-31,Ruth,F,-32.28,115.72,,4995bfd1-13d8-4c5f-a9f3-d5331da83f85,-31.74,115.77,WA,Joondalup,debit,authorized,063fb5b8132b4da5814aa98b0bf06e30,SALES-POS,40-50,2018,10,31,18,14,Wednesday,7 days,66350.221
ACC-4258502723,24,7.37,708.28,1.0,CUS-3378712515,2018-08-01,Kimberly,F,-37.74,145.45,,b5565fff-0333-4c74-a61a-56a074d0ec0f,-37.78,144.96,VIC,Brunswick,debit,authorized,2f77c3cbe847468bbf99f7f0cead69f9,POS,20-30,2018,8,1,8,0,Wednesday,7 days,55263.086
ACC-4258502723,24,9.67,698.61,1.0,CUS-3378712515,2018-08-01,Kimberly,F,-37.74,145.45,,66c00c79-11a0-4c11-af28-a31a40931a90,-37.78,145.13,VIC,Doncaster,debit,authorized,d79653456df54a20a564af7069156f60,SALES-POS,20-30,2018,8,1,9,23,Wednesday,7 days,55263.086
ACC-4258502723,24,109.51,589.1,0.0,CUS-3378712515,2018-08-01,Kimberly,F,-37.74,145.45,,e77e7118-9958-4ae0-8ecd-b705bde43c16,-33.87,151.21,NSW,Sydney,debit,authorized,fcb9829f70104a338b34cee4eb6cc9c8,POS,20-30,2018,8,1,11,45,Wednesday,7 days,55263.086
ACC-4258502723,24,50.25,538.85,0.0,CUS-3378712515,2018-08-01,Kimberly,F,-37.74,145.45,,17d20b9f-f49d-4164-9e7d-a1043052faae,-37.81,144.96,VIC,Melbourne,debit,authorized,ce39f465e532476da3322a54ed8b4c7c,SALES-POS,20-30,2018,8,1,14,10,Wednesday,7 days,55263.086
ACC-4258502723,24,17.12,521.73,1.0,CUS-3378712515,2018-08-02,Kimberly,F,-37.74,145.45,,d3e8e9ea-1e27-44bf-9574-7164c8e31fa7,-38.02,145.31,VIC,Narre Warren,debit,authorized,6dc295ac58bf4fd9997729e0ccfc7da8,SALES-POS,20-30,2018,8,2,10,46,Thursday,7 days,55263.086
ACC-4258502723,24,6.66,515.07,1.0,CUS-3378712515,2018-08-03,Kimberly,F,-37.74,145.45,,40a111ca-da92-4ab5-a75a-ba57b491dab8,-37.82,145.02,VIC,Hawthorn,debit,authorized,3cabc7cbac004bb3ae6b66b798f597f1,POS,20-30,2018,8,3,9,22,Friday,7 days,55263.086
ACC-4258502723,24,14.05,501.02,0.0,CUS-3378712515,2018-08-03,Kimberly,F,-37.74,145.45,,25b3b309-2175-4d24-b6c6-fa874374a1fa,-16.48,145.38,QLD,Mossman,debit,authorized,87ccfc872d97476fa8aa8627100df260,POS,20-30,2018,8,3,19,7,Friday,7 days,55263.086
ACC-4258502723,24,11.84,489.18,0.0,CUS-3378712515,2018-08-04,Kimberly,F,-37.74,145.45,,036455f7-7c1f-44df-8ae6-fe2948d97df6,-37.68,144.86,VIC,Melbourne Airport,debit,authorized,6149ffba1e5a45ee82d554ef7a9950d3,POS,20-30,2018,8,4,4,19,Saturday,7 days,55263.086
ACC-4258502723,24,28.0,461.18,,CUS-3378712515,2018-08-04,Kimberly,F,-37.74,145.45,,,,,,,debit,posted,e62d8a2a291448b7890f2b1c6401ff28,INTER BANK,20-30,2018,8,4,20,0,Saturday,7 days,55263.086
ACC-4258502723,24,38.0,423.18,,CUS-3378712515,2018-08-05,Kimberly,F,-37.74,145.45,,,,,,,debit,posted,e260d608f32841c29f3561611860adf5,PAYMENT,20-30,2018,8,5,4,0,Sunday,7 days,55263.086
ACC-4258502723,24,53.0,1430.02,,CUS-3378712515,2018-08-06,Kimberly,F,-37.74,145.45,,,,,,,debit,posted,4f03bb436d8a4fa2b854a6a92e750f66,PAYMENT,20-30,2018,8,6,17,0,Monday,7 days,55263.086
ACC-4258502723,24,75.0,1355.02,,CUS-3378712515,2018-08-08,Kimberly,F,-37.74,145.45,,,,,,,debit,posted,409cfce52bac4e08b96f652ad0a385e0,PAYMENT,20-30,2018,8,8,12,0,Wednesday,7 days,55263.086
ACC-4258502723,24,9.82,1345.2,1.0,CUS-3378712515,2018-08-09,Kimberly,F,-37.74,145.45,,ddae4c76-a956-4cc2-8c55-2a954d6d5e10,-37.78,144.96,VIC,Brunswick,debit,authorized,8bb2610dc61c4a178d5baa0453ec0193,SALES-POS,20-30,2018,8,9,15,43,Thursday,7 days,55263.086
ACC-4258502723,24,16.36,1328.84,1.0,CUS-3378712515,2018-08-09,Kimberly,F,-37.74,145.45,,c612fc22-c403-458a-be79-06259a01af00,-37.74,145.03,VIC,Preston,debit,authorized,d998407276534dedbdfb24cbbae7c8cb,POS,20-30,2018,8,9,16,39,Thursday,7 days,55263.086
ACC-4258502723,24,42.49,1286.35,1.0,CUS-3378712515,2018-08-10,Kimberly,F,-37.74,145.45,,71238aec-2d2e-41c4-924a-a3fb2a3aefef,-17.27,145.58,QLD,Yungaburra,debit,authorized,74c9e1e5e01644b49c8a286344e2d389,SALES-POS,20-30,2018,8,10,1,54,Friday,7 days,55263.086
ACC-4258502723,24,12.37,1273.98,1.0,CUS-3378712515,2018-08-10,Kimberly,F,-37.74,145.45,,404dcd84-8176-476a-bd48-afe561bc1ce8,-37.67,144.85,VIC,Melbourne Airport,debit,authorized,30459827f4c6477e8b760b7f69a6edee,SALES-POS,20-30,2018,8,10,8,19,Friday,7 days,55263.086
ACC-4258502723,24,20.8,1253.18,1.0,CUS-3378712515,2018-08-10,Kimberly,F,-37.74,145.45,,e33da709-904b-47bb-a8b2-54bdc73debb5,-37.82,144.91,VIC,Port Melbourne,debit,authorized,c4e1e4ea8ea3433bb5bf61d415dbb475,SALES-POS,20-30,2018,8,10,21,29,Friday,7 days,55263.086
ACC-4258502723,24,43.91,1209.27,1.0,CUS-3378712515,2018-08-11,Kimberly,F,-37.74,145.45,,71238aec-2d2e-41c4-924a-a3fb2a3aefef,-17.27,145.58,QLD,Yungaburra,debit,authorized,06104fed131b4d38a5fa9bbf7f7d2a88,SALES-POS,20-30,2018,8,11,13,2,Saturday,7 days,55263.086
ACC-4258502723,24,18.98,1190.29,0.0,CUS-3378712515,2018-08-11,Kimberly,F,-37.74,145.45,,76622c57-cef8-4670-a24f-34697adc465c,-17.27,145.58,QLD,Yungaburra,debit,authorized,1018e913fe3743f7884732f56c787c06,SALES-POS,20-30,2018,8,11,15,9,Saturday,7 days,55263.086
ACC-4258502723,24,28.0,1162.29,,CUS-3378712515,2018-08-11,Kimberly,F,-37.74,145.45,,,,,,,debit,posted,b096c856c4e648ec9b1b621ed06a5102,INTER BANK,20-30,2018,8,11,20,0,Saturday,7 days,55263.086
ACC-4258502723,24,4.22,1158.07,1.0,CUS-3378712515,2018-08-11,Kimberly,F,-37.74,145.45,,7441801c-f4c9-48cc-8a11-c3c4f8bab5a7,-37.87,144.98,VIC,Saint Kilda,debit,authorized,0f5fe09af0314e78b3aaa935199832d1,POS,20-30,2018,8,11,21,47,Saturday,7 days,55263.086
ACC-4258502723,24,38.0,1120.07,,CUS-3378712515,2018-08-12,Kimberly,F,-37.74,145.45,,,,,,,debit,posted,07d350583da044dcb8718fa00789087c,PAYMENT,20-30,2018,8,12,4,0,Sunday,7 days,55263.086
ACC-4258502723,24,53.0,2126.91,,CUS-3378712515,2018-08-13,Kimberly,F,-37.74,145.45,,,,,,,debit,posted,f753d58272ae4908850f080ad8d2c036,PAYMENT,20-30,2018,8,13,17,0,Monday,7 days,55263.086
ACC-4258502723,24,14.95,2111.96,1.0,CUS-3378712515,2018-08-14,Kimberly,F,-37.74,145.45,,24d7bc70-27a9-44a6-a5cf-e7c91412ee44,-37.81,144.98,VIC,Fitzroy,debit,authorized,b0d3c5dfc62f47bea9ef6bacf71ce4bb,POS,20-30,2018,8,14,9,13,Tuesday,7 days,55263.086
ACC-4258502723,24,19.11,2092.85,0.0,CUS-3378712515,2018-08-14,Kimberly,F,-37.74,145.45,,1f9e633b-7dd0-4101-ab75-39b94806fbc8,-17.26,145.48,QLD,Atherton,debit,authorized,6243880137014afc810f9412ade964a3,SALES-POS,20-30,2018,8,14,14,54,Tuesday,7 days,55263.086
ACC-4258502723,24,7.03,2085.82,1.0,CUS-3378712515,2018-08-14,Kimberly,F,-37.74,145.45,,adaa514b-cd95-498f-bfb1-cde0b49d96f5,-36.35,145.4,VIC,Shepparton,debit,authorized,956627b18aef4942be096f1384af08cd,POS,20-30,2018,8,14,17,8,Tuesday,7 days,55263.086
ACC-4258502723,24,9.16,2076.66,1.0,CUS-3378712515,2018-08-15,Kimberly,F,-37.74,145.45,,625ce358-1e06-419b-a6cf-b7a8a56ca554,-37.77,145.12,VIC,Doncaster,debit,authorized,c0985d24a5b14e7c9ed6bfc2a88940bc,POS,20-30,2018,8,15,10,19,Wednesday,7 days,55263.086
ACC-4258502723,24,87.27,1989.39,1.0,CUS-3378712515,2018-08-15,Kimberly,F,-37.74,145.45,,ee7ab545-152d-45fb-b117-e98a0a6f04d7,-35.28,149.13,ACT,Canberra,debit,authorized,c8f0871aa5e44144919767b05a0825de,POS,20-30,2018,8,15,14,17,Wednesday,7 days,55263.086
ACC-4258502723,24,9.38,1980.01,1.0,CUS-3378712515,2018-08-15,Kimberly,F,-37.74,145.45,,2b50255f-71be-4cb4-acd7-1bf1ad15391c,-37.67,144.85,VIC,Melbourne Airport,debit,authorized,6b73b530d57543e79e9b9ba014039120,SALES-POS,20-30,2018,8,15,23,14,Wednesday,7 days,55263.086
ACC-4258502723,24,102.0,1780.15,,CUS-3378712515,2018-08-17,Kimberly,F,-37.74,145.45,,,,,,,debit,posted,97d88b4b03f64ecea8fed4affa84d03a,INTER BANK,20-30,2018,8,17,2,0,Friday,7 days,55263.086
ACC-4258502723,24,17.09,1763.06,1.0,CUS-3378712515,2018-08-17,Kimberly,F,-37.74,145.45,,198c2a0c-3eb7-4e5c-9c0e-5e9b4ff99a90,-37.6,140.31,SA,Millicent,debit,authorized,e22ddadaf974433fb487cd257f6efd5d,SALES-POS,20-30,2018,8,17,8,29,Friday,7 days,55263.086
ACC-4258502723,24,29.34,1733.72,1.0,CUS-3378712515,2018-08-17,Kimberly,F,-37.74,145.45,,2bbe7254-003f-4845-8b74-2dcc6baa3fc0,-37.81,145.14,VIC,Box Hill North,debit,authorized,18439b1abc2e475ab07c1723790ef6bc,SALES-POS,20-30,2018,8,17,10,6,Friday,7 days,55263.086
ACC-4258502723,24,14.31,1719.41,1.0,CUS-3378712515,2018-08-17,Kimberly,F,-37.74,145.45,,f4ae589f-2e4c-4329-acec-19a947c4c73b,-37.68,144.44,VIC,Bacchus Marsh,debit,authorized,2f3e7e27e60a4506bf31f7cc8c3e391f,SALES-POS,20-30,2018,8,17,12,53,Friday,7 days,55263.086
ACC-4258502723,24,28.0,1691.41,,CUS-3378712515,2018-08-18,Kimberly,F,-37.74,145.45,,,,,,,debit,posted,c543a905feb34ed881c6c04d5a1e5a03,INTER BANK,20-30,2018,8,18,20,0,Saturday,7 days,55263.086
ACC-4258502723,24,38.0,1653.41,,CUS-3378712515,2018-08-19,Kimberly,F,-37.74,145.45,,,,,,,debit,posted,79b759b7081244cdb1c9052e2722f3b7,PAYMENT,20-30,2018,8,19,4,0,Sunday,7 days,55263.086
ACC-4258502723,24,315.39,1338.02,1.0,CUS-3378712515,2018-08-20,Kimberly,F,-37.74,145.45,,cb3fa428-3166-488a-a2bf-e25cd18df37a,-37.67,144.85,VIC,Melbourne Airport,debit,authorized,f27fca2c20a24f93ab46304a3e3018e9,POS,20-30,2018,8,20,10,41,Monday,7 days,55263.086
ACC-4258502723,24,303.1,1034.92,0.0,CUS-3378712515,2018-08-20,Kimberly,F,-37.74,145.45,,51131543-f0e0-45e6-9a5c-172979091a9b,-37.83,144.97,VIC,South Melbourne,debit,authorized,9f40b703ef8e46439224943fcfff643d,POS,20-30,2018,8,20,12,56,Monday,7 days,55263.086
ACC-4258502723,24,53.0,2030.91,,CUS-3378712515,2018-08-20,Kimberly,F,-37.74,145.45,,,,,,,debit,posted,e6d588035e87465b8e091fc2d9b77c6b,PAYMENT,20-30,2018,8,20,17,0,Monday,7 days,55263.086
ACC-4258502723,24,10.85,2083.91,1.0,CUS-3378712515,2018-08-20,Kimberly,F,-37.74,145.45,,1be5573c-02b3-41da-85f6-f4c9b6d4b363,-37.68,144.92,VIC,Broadmeadows,debit,authorized,cf8bee46a94e4b458567a0725621ff35,POS,20-30,2018,8,20,17,29,Monday,7 days,55263.086
ACC-4258502723,24,15.45,2015.46,1.0,CUS-3378712515,2018-08-21,Kimberly,F,-37.74,145.45,,b556617e-684b-4a75-bb40-6fbdc57e791a,-37.84,144.88,VIC,Newport,debit,authorized,7482656144b840d192a5896b35317f42,SALES-POS,20-30,2018,8,21,9,52,Tuesday,7 days,55263.086
ACC-4258502723,24,9.64,2005.82,1.0,CUS-3378712515,2018-08-21,Kimberly,F,-37.74,145.45,,fae3017e-09e9-4802-b0e3-c1b86ec9a5e4,-37.72,145.05,VIC,Bundoora,debit,authorized,613923da4a864b11b5edd033ed4e4672,SALES-POS,20-30,2018,8,21,15,37,Tuesday,7 days,55263.086
ACC-4258502723,24,9.09,1996.73,1.0,CUS-3378712515,2018-08-21,Kimberly,F,-37.74,145.45,,5fb40fad-b97e-4a8a-8620-721ac14bc217,-38.21,145.5,VIC,Koo Wee Rup,debit,authorized,bfd9045556b54bef8c261f338d52ed29,POS,20-30,2018,8,21,17,11,Tuesday,7 days,55263.086
ACC-4258502723,24,22.07,1974.66,0.0,CUS-3378712515,2018-08-22,Kimberly,F,-37.74,145.45,,0fad9ab3-9f39-461d-bc77-af7fb8bcd525,-37.82,145,VIC,Richmond,debit,authorized,6b2aa3456752428eb47e9f5f5d6388c1,POS,20-30,2018,8,22,19,1,Wednesday,7 days,55263.086
ACC-4258502723,24,196.45,1778.21,1.0,CUS-3378712515,2018-08-23,Kimberly,F,-37.74,145.45,,16b9f329-7a9d-415d-8a7e-98429a138219,-37.81,144.97,VIC,Melbourne,debit,authorized,6693778151e24a30afcf6f0a81df11ba,SALES-POS,20-30,2018,8,23,9,18,Thursday,7 days,55263.086
ACC-4258502723,24,3.95,1774.26,1.0,CUS-3378712515,2018-08-23,Kimberly,F,-37.74,145.45,,1bd06592-6004-49d7-bb94-09ce684f0598,-37.81,144.97,VIC,Melbourne,debit,authorized,d1085ec6b0544945bdfc0766e4621140,POS,20-30,2018,8,23,11,38,Thursday,7 days,55263.086
ACC-4258502723,24,4.57,1769.69,1.0,CUS-3378712515,2018-08-23,Kimberly,F,-37.74,145.45,,2868fa67-ae37-449a-8c3a-1ce9a259f383,-37.88,145.04,VIC,Caulfield East,debit,authorized,991eb9e769cf42788dfcfeb6503f4379,POS,20-30,2018,8,23,13,7,Thursday,7 days,55263.086
ACC-4258502723,24,2.85,1766.84,1.0,CUS-3378712515,2018-08-24,Kimberly,F,-37.74,145.45,,85e5a336-7b71-469d-828d-4152e38cbd39,-16.48,145.46,QLD,Port Douglas,debit,authorized,588f6895cb35417db4fa3106d5e18161,POS,20-30,2018,8,24,9,14,Friday,7 days,55263.086
ACC-4258502723,24,7.59,1759.25,1.0,CUS-3378712515,2018-08-25,Kimberly,F,-37.74,145.45,,02c27399-a966-4882-953d-5dedae0cfce0,-37.74,145,VIC,Preston,debit,authorized,bf79b41e895f4556a542350bd7718d07,POS,20-30,2018,8,25,11,13,Saturday,7 days,55263.086
ACC-4258502723,24,28.0,1731.25,,CUS-3378712515,2018-08-25,Kimberly,F,-37.74,145.45,,,,,,,debit,posted,530dcd96f661483b927c2b990065ed69,INTER BANK,20-30,2018,8,25,20,0,Saturday,7 days,55263.086
ACC-4258502723,24,8.81,1722.44,1.0,CUS-3378712515,2018-08-25,Kimberly,F,-37.74,145.45,,5d0f3f07-b027-44c1-a453-8e4b2e89cb7b,-37.78,145.16,VIC,Doncaster East,debit,authorized,0d2966c22f9c44699d555c8b951f1ee5,SALES-POS,20-30,2018,8,25,21,43,Saturday,7 days,55263.086
ACC-4258502723,24,4.51,1717.93,0.0,CUS-3378712515,2018-08-25,Kimberly,F,-37.74,145.45,,a86a0eb0-20a0-4f3c-b617-d5199f3c132e,-37.97,145.11,VIC,Moorabbin Airport,debit,authorized,3cc0d9b19d6c442d8bcf478c1b1c7f1e,POS,20-30,2018,8,25,22,23,Saturday,7 days,55263.086
ACC-4258502723,24,18.49,1699.44,1.0,CUS-3378712515,2018-08-25,Kimberly,F,-37.74,145.45,,8e16b640-cd02-4272-99e1-e9955dfed3dd,-38.03,145.28,VIC,Hampton Park,debit,authorized,b85b29310296461e801f34121d66b1bf,POS,20-30,2018,8,25,22,31,Saturday,7 days,55263.086
ACC-4258502723,24,48.92,1650.52,1.0,CUS-3378712515,2018-08-26,Kimberly,F,-37.74,145.45,,5013fc4b-fa35-4952-8500-5a22af779090,-37.78,144.86,VIC,Braybrook,debit,authorized,5318fa147415409892a837ceadab34b3,POS,20-30,2018,8,26,0,7,Sunday,7 days,55263.086
ACC-4258502723,24,19.0,1631.52,1.0,CUS-3378712515,2018-08-26,Kimberly,F,-37.74,145.45,,52caf85e-43d7-4bbe-a9b4-c4296ddfc28a,-37.83,140.77,SA,Mount Gambier,debit,authorized,24bac12444b644e88e9ceb237c6bbfee,SALES-POS,20-30,2018,8,26,2,48,Sunday,7 days,55263.086
ACC-4258502723,24,38.0,1593.52,,CUS-3378712515,2018-08-26,Kimberly,F,-37.74,145.45,,,,,,,debit,posted,1ff55f301b99454aa4806aa944fe75b3,PAYMENT,20-30,2018,8,26,4,0,Sunday,7 days,55263.086
ACC-4258502723,24,8.46,1585.06,1.0,CUS-3378712515,2018-08-26,Kimberly,F,-37.74,145.45,,958da525-af63-4261-b326-2284eae8bfd0,-37.84,145,VIC,South Yarra,debit,authorized,e3331b9a9eda4a9ba444c0088a04cd2d,SALES-POS,20-30,2018,8,26,9,58,Sunday,7 days,55263.086
ACC-4258502723,24,4.57,1580.49,1.0,CUS-3378712515,2018-08-26,Kimberly,F,-37.74,145.45,,34995bdf-ac65-4a31-874c-9321b5e184d1,-37.81,144.86,VIC,Tottenham,debit,authorized,0617af30c2bd4bbc8bb523cccd5c8956,SALES-POS,20-30,2018,8,26,19,0,Sunday,7 days,55263.086
ACC-4258502723,24,7.94,1572.55,1.0,CUS-3378712515,2018-08-27,Kimberly,F,-37.74,145.45,,14391467-3b68-4107-b6c9-023c6b0b348f,-37.67,144.85,VIC,Melbourne Airport,debit,authorized,034d94575b8f4879b125f804fc33b83b,SALES-POS,20-30,2018,8,27,1,44,Monday,7 days,55263.086
ACC-4258502723,24,8.27,1564.28,1.0,CUS-3378712515,2018-08-27,Kimberly,F,-37.74,145.45,,645b4142-5a9b-49b5-a2a3-d41957505a50,-37.81,145.03,VIC,Kew,debit,authorized,b553ad0fa49d4f43ad3978a1e92d0066,POS,20-30,2018,8,27,10,10,Monday,7 days,55263.086
ACC-4258502723,24,36.41,1527.87,1.0,CUS-3378712515,2018-08-27,Kimberly,F,-37.74,145.45,,535ea858-8516-4f9e-9467-498cee9d2dd3,-37.67,144.97,VIC,Campbellfield,debit,authorized,a0e55c8af8b24249ac5d6d666cab0b8f,SALES-POS,20-30,2018,8,27,11,16,Monday,7 days,55263.086
ACC-4258502723,24,7.87,2579.84,1.0,CUS-3378712515,2018-08-27,Kimberly,F,-37.74,145.45,,958da525-af63-4261-b326-2284eae8bfd0,-37.84,145,VIC,South Yarra,debit,authorized,49beb299f1af4d89af057e44a3606e74,POS,20-30,2018,8,27,16,25,Monday,7 days,55263.086
ACC-4258502723,24,53.0,2526.84,,CUS-3378712515,2018-08-27,Kimberly,F,-37.74,145.45,,,,,,,debit,posted,9d1be3f8afcb49a2b698fc5252b901d8,PAYMENT,20-30,2018,8,27,17,0,Monday,7 days,55263.086
ACC-4258502723,24,26.78,2500.06,0.0,CUS-3378712515,2018-08-28,Kimberly,F,-37.74,145.45,,ca8118bd-cc76-4c17-8b06-d59faafbe4ef,-37.79,145.31,VIC,Mooroolbark,debit,authorized,444d210b9300490db69507c870711f91,SALES-POS,20-30,2018,8,28,11,44,Tuesday,7 days,55263.086
ACC-4258502723,24,13.42,2486.64,1.0,CUS-3378712515,2018-08-28,Kimberly,F,-37.74,145.45,,7c8cee26-cfe7-4b60-be11-ec5a69a5aea3,-37.92,145.04,VIC,Bentleigh,debit,authorized,fe114a5b8a064914a47fab0ffd8eccbb,SALES-POS,20-30,2018,8,28,17,39,Tuesday,7 days,55263.086
ACC-4258502723,24,45.56,2441.08,0.0,CUS-3378712515,2018-08-29,Kimberly,F,-37.74,145.45,,b66afd3f-6bcb-4ac0-adfc-2689bc96bb4e,-37.79,144.89,VIC,Footscray,debit,authorized,a95010c7f13841c3bab7f024259b7067,SALES-POS,20-30,2018,8,29,7,57,Wednesday,7 days,55263.086
ACC-4258502723,24,17.86,2423.22,1.0,CUS-3378712515,2018-08-29,Kimberly,F,-37.74,145.45,,f39c3860-b72a-403e-a325-b0773954e1a4,-37.87,145,VIC,Saint Kilda East,debit,authorized,b6e9f222c96b46baa6a26343e2b07da6,SALES-POS,20-30,2018,8,29,14,3,Wednesday,7 days,55263.086
ACC-4258502723,24,85.78,2337.44,1.0,CUS-3378712515,2018-08-29,Kimberly,F,-37.74,145.45,,2f3bc0c3-93fd-41a4-a1cc-5ad551adbecc,-33.87,151.2,NSW,Sydney,debit,authorized,6624f0bad6a744e0bd3a71d119bef3ba,POS,20-30,2018,8,29,14,37,Wednesday,7 days,55263.086
ACC-4258502723,24,5.44,2332.0,1.0,CUS-3378712515,2018-08-29,Kimberly,F,-37.74,145.45,,6ef13e0c-7568-47c7-9dfe-80952f858fa8,-37.83,145.08,VIC,Canterbury,debit,authorized,c53a5f03d22847e2895038bfd7ef7f66,POS,20-30,2018,8,29,15,20,Wednesday,7 days,55263.086
ACC-4258502723,24,24.79,2307.21,1.0,CUS-3378712515,2018-08-29,Kimberly,F,-37.74,145.45,,1c629f4a-ab4c-432f-9fda-f6b9acb44c88,-37.81,144.97,VIC,Melbourne,debit,authorized,650970ec09d6451a91b9b457c3ae623e,POS,20-30,2018,8,29,15,43,Wednesday,7 days,55263.086
ACC-4258502723,24,13.62,2293.59,1.0,CUS-3378712515,2018-08-30,Kimberly,F,-37.74,145.45,,60fe8a98-3ef5-446f-9174-10d77c8e995d,-37.65,145.02,VIC,Epping,debit,authorized,ac978344251b43bfb2afd60dbbca674e,POS,20-30,2018,8,30,0,1,Thursday,7 days,55263.086
ACC-4258502723,24,7.68,2285.91,1.0,CUS-3378712515,2018-08-30,Kimberly,F,-37.74,145.45,,d9161ca9-1671-48ff-a78e-b3ed332d1950,-37.86,144.98,VIC,Saint Kilda,debit,authorized,bfeace97d616437cada5054a7891c3bf,SALES-POS,20-30,2018,8,30,9,5,Thursday,7 days,55263.086
ACC-4258502723,24,35.07,2250.84,1.0,CUS-3378712515,2018-08-30,Kimberly,F,-37.74,145.45,,6d447101-22cf-4181-894d-2dc37dccabf9,-37.67,144.84,VIC,Melbourne Airport,debit,authorized,071f6268f6144c80b69b815a636e72e6,SALES-POS,20-30,2018,8,30,15,8,Thursday,7 days,55263.086
ACC-4258502723,24,16.99,2233.85,1.0,CUS-3378712515,2018-08-30,Kimberly,F,-37.74,145.45,,014b2838-7331-4874-b792-9092327d96a2,-37.82,144.96,VIC,Melbourne,debit,authorized,6c3cdb520c9c4b9fbcaff932be0cf441,POS,20-30,2018,8,30,21,4,Thursday,7 days,55263.086
ACC-4258502723,24,17.58,2216.27,1.0,CUS-3378712515,2018-08-30,Kimberly,F,-37.74,145.45,,ea74dd90-6681-4d97-bb41-7bf308fa6388,-27.46,153.03,QLD,Brisbane City,debit,authorized,9117012730da4eaebf32b18731789c34,POS,20-30,2018,8,30,22,11,Thursday,7 days,55263.086
ACC-4258502723,24,30.37,2185.9,0.0,CUS-3378712515,2018-08-31,Kimberly,F,-37.74,145.45,,dd2f7c66-f3f9-4b71-bde3-3f86cbef3b12,-37.82,144.96,VIC,Melbourne,debit,authorized,2c2bc8ac45fd4cbaac31d226f314925f,POS,20-30,2018,8,31,1,40,Friday,7 days,55263.086
ACC-4258502723,24,24.43,2161.47,0.0,CUS-3378712515,2018-08-31,Kimberly,F,-37.74,145.45,,c77784c1-e6b8-4d16-b7f2-95811569db8e,-37.71,145.15,VIC,Eltham,debit,authorized,fe582f4991c64d07b09f9c82a6747c68,SALES-POS,20-30,2018,8,31,12,31,Friday,7 days,55263.086
ACC-4258502723,24,6.75,2154.72,1.0,CUS-3378712515,2018-08-31,Kimberly,F,-37.74,145.45,,df85de79-140f-4114-9e59-248008da934d,-37.85,145.12,VIC,Burwood,debit,authorized,073ea78fcabf4c5d9f616e9cf17cea29,POS,20-30,2018,8,31,14,41,Friday,7 days,55263.086
ACC-4258502723,24,7.88,2146.84,1.0,CUS-3378712515,2018-08-31,Kimberly,F,-37.74,145.45,,3c7da1c3-394a-472f-92b3-3ded0fabbf02,-37.82,145,VIC,Richmond,debit,authorized,562af1db2fd7409f97af58871cc6ddb1,SALES-POS,20-30,2018,8,31,16,11,Friday,7 days,55263.086
ACC-4258502723,24,18.24,2128.6,1.0,CUS-3378712515,2018-08-31,Kimberly,F,-37.74,145.45,,18276409-7398-4abf-94a8-a631dd3e4e32,-37.78,144.98,VIC,Fitzroy North,debit,authorized,71bb3dce0c114e4096381e3b5ec5658d,POS,20-30,2018,8,31,20,14,Friday,7 days,55263.086
ACC-4258502723,24,18.66,2109.94,0.0,CUS-3378712515,2018-09-01,Kimberly,F,-37.74,145.45,,fd80b331-9f35-4ea8-9cf1-8fbb1ee77c89,-37.81,144.97,VIC,Melbourne,debit,authorized,5062d45cf8084e85a5c1ba6da35678db,POS,20-30,2018,9,1,15,58,Saturday,7 days,55263.086
ACC-4258502723,24,28.0,2081.94,,CUS-3378712515,2018-09-01,Kimberly,F,-37.74,145.45,,,,,,,debit,posted,4ca73467d311406e9ad0a0ce8cf2fa66,INTER BANK,20-30,2018,9,1,20,0,Saturday,7 days,55263.086
ACC-4258502723,24,38.0,2043.94,,CUS-3378712515,2018-09-02,Kimberly,F,-37.74,145.45,,,,,,,debit,posted,de7c4bed4ff04054837c605b5ca04f5d,PAYMENT,20-30,2018,9,2,4,0,Sunday,7 days,55263.086
ACC-4258502723,24,27.67,2016.27,1.0,CUS-3378712515,2018-09-02,Kimberly,F,-37.74,145.45,,c8eceabd-a059-494b-ad51-2909222cf772,-37.75,145.01,VIC,Preston,debit,authorized,822a3b48adc84f66a5c88c05c947a943,SALES-POS,20-30,2018,9,2,23,39,Sunday,7 days,55263.086
ACC-4258502723,24,7.7,2008.57,1.0,CUS-3378712515,2018-09-03,Kimberly,F,-37.74,145.45,,76760ebf-de38-4ca6-a239-81751a689133,-37.94,145.49,VIC,Cockatoo,debit,authorized,8592356821c14561acc995ac60b4abed,POS,20-30,2018,9,3,12,1,Monday,7 days,55263.086
ACC-4258502723,24,53.0,3015.41,,CUS-3378712515,2018-09-03,Kimberly,F,-37.74,145.45,,,,,,,debit,posted,20fa8c479d714478b2618f42ef64b14f,PAYMENT,20-30,2018,9,3,17,0,Monday,7 days,55263.086
ACC-4258502723,24,18.12,2997.29,1.0,CUS-3378712515,2018-09-03,Kimberly,F,-37.74,145.45,,313c9457-6860-4958-b1b1-21251c59fbb3,-37.79,145.13,VIC,Doncaster,debit,authorized,623210908b5d4b7a903a802b70bf911c,POS,20-30,2018,9,3,19,18,Monday,7 days,55263.086
ACC-4258502723,24,22.24,2975.05,0.0,CUS-3378712515,2018-09-03,Kimberly,F,-37.74,145.45,,26a64103-e734-41d6-8858-3a0f020e74b3,-37.84,145.17,VIC,Forest Hill,debit,authorized,3e8ec5e4ebc1497d9ff770fe5e2b8633,SALES-POS,20-30,2018,9,3,19,59,Monday,7 days,55263.086
ACC-4258502723,24,25.92,2949.13,1.0,CUS-3378712515,2018-09-03,Kimberly,F,-37.74,145.45,,14ef90fd-0a6f-411d-b05e-cf03dd599464,-37.73,145.02,VIC,Reservoir,debit,authorized,00fc859e031d45fca49afdae47a50737,SALES-POS,20-30,2018,9,3,22,5,Monday,7 days,55263.086
ACC-4258502723,24,25.79,2923.34,0.0,CUS-3378712515,2018-09-05,Kimberly,F,-37.74,145.45,,692d143c-720b-4ea8-8378-1890b495eab9,-37.74,145.03,VIC,Preston,debit,authorized,0ec0a3178a5c49f390d8262cc23139dc,POS,20-30,2018,9,5,0,41,Wednesday,7 days,55263.086
ACC-4258502723,24,8.72,2914.62,1.0,CUS-3378712515,2018-09-05,Kimberly,F,-37.74,145.45,,7b7b6770-2460-489e-899a-39f96a866ded,-37.74,145,VIC,Preston,debit,authorized,29ad185f7a1544cb9c7d01cecde370e0,POS,20-30,2018,9,5,9,16,Wednesday,7 days,55263.086
ACC-4258502723,24,25.82,2888.8,1.0,CUS-3378712515,2018-09-05,Kimberly,F,-37.74,145.45,,b1a1fb0e-9093-4eb9-bbd7-a88a65407bb0,-37.68,144.44,VIC,Bacchus Marsh,debit,authorized,f74128942dd5418ea5d217869488f078,SALES-POS,20-30,2018,9,5,9,28,Wednesday,7 days,55263.086
ACC-4258502723,24,5.7,2883.1,1.0,CUS-3378712515,2018-09-05,Kimberly,F,-37.74,145.45,,632ad1d4-16ae-4d8c-aac8-dec4c3aed886,-37.65,145.02,VIC,Epping,debit,authorized,b6a9578b97764193b926739c700f656a,POS,20-30,2018,9,5,21,49,Wednesday,7 days,55263.086
ACC-4258502723,24,26.03,2857.07,1.0,CUS-3378712515,2018-09-06,Kimberly,F,-37.74,145.45,,6968d68f-8379-4eb7-9af6-0cc63d9e3931,-37.82,144.96,VIC,Southbank,debit,authorized,a3934272c4d646e3955c08c2dfc77746,SALES-POS,20-30,2018,9,6,1,42,Thursday,7 days,55263.086
ACC-4258502723,24,15.77,2841.3,1.0,CUS-3378712515,2018-09-06,Kimberly,F,-37.74,145.45,,fe21287e-b38e-407e-8dd2-7f2a7349248e,-37.8,144.98,VIC,Fitzroy,debit,authorized,fa79c711c74e426cb802e88552bc5ee7,SALES-POS,20-30,2018,9,6,8,45,Thursday,7 days,55263.086
ACC-4258502723,24,6.83,2834.47,1.0,CUS-3378712515,2018-09-07,Kimberly,F,-37.74,145.45,,7c3d05f7-f40d-4912-a39e-b8fa2fb1c23e,-37.84,144.94,VIC,Port Melbourne,debit,authorized,62473edda8514e5fbb1c09d0d8c140c1,POS,20-30,2018,9,7,8,1,Friday,7 days,55263.086
ACC-4258502723,24,13.57,2820.9,1.0,CUS-3378712515,2018-09-07,Kimberly,F,-37.74,145.45,,d2b99dd2-ee51-45a9-bdbe-f966d3336ff6,-37.85,144.96,VIC,Middle Park,debit,authorized,3dde54d9ed22414a8f74e371f27c4ebc,SALES-POS,20-30,2018,9,7,22,21,Friday,7 days,55263.086
ACC-4258502723,24,75.0,2745.9,,CUS-3378712515,2018-09-08,Kimberly,F,-37.74,145.45,,,,,,,debit,posted,5635da6b4fa34e34b50abf49f961172a,PAYMENT,20-30,2018,9,8,12,0,Saturday,7 days,55263.086
ACC-4258502723,24,28.0,2717.9,,CUS-3378712515,2018-09-08,Kimberly,F,-37.74,145.45,,,,,,,debit,posted,6d18ee3d78b54270a99cef4b5ae1cf99,INTER BANK,20-30,2018,9,8,20,0,Saturday,7 days,55263.086
ACC-4258502723,24,38.0,2679.9,,CUS-3378712515,2018-09-09,Kimberly,F,-37.74,145.45,,,,,,,debit,posted,d192cec1d9f44dd2b32d6397cabb1a18,PAYMENT,20-30,2018,9,9,4,0,Sunday,7 days,55263.086
ACC-4258502723,24,9.75,2670.15,1.0,CUS-3378712515,2018-09-09,Kimberly,F,-37.74,145.45,,62caefe4-7b4e-4ff4-8085-79a6bebb968c,-37.81,145.01,VIC,Richmond,debit,authorized,6033413d9a0442fbb36ca6c0eeed6e97,POS,20-30,2018,9,9,11,21,Sunday,7 days,55263.086
ACC-4258502723,24,12.41,2657.74,1.0,CUS-3378712515,2018-09-09,Kimberly,F,-37.74,145.45,,2571ed70-fa7e-4bb2-9b09-f083fc2f1ccd,-37.74,145.03,VIC,Preston,debit,authorized,106b6108b75e4637a595e1cf32bbaebd,POS,20-30,2018,9,9,13,13,Sunday,7 days,55263.086
ACC-4258502723,24,15.29,2642.45,0.0,CUS-3378712515,2018-09-09,Kimberly,F,-37.74,145.45,,fc25b568-cd4a-43cc-a9c8-aceff4141de8,-37.71,145.15,VIC,Eltham,debit,authorized,946029daeeb54e7eb313a42a69b639dc,POS,20-30,2018,9,9,14,20,Sunday,7 days,55263.086
ACC-4258502723,24,16.63,2625.82,1.0,CUS-3378712515,2018-09-09,Kimberly,F,-37.74,145.45,,4f5b62af-f80f-4b74-88d3-7e02361adc07,-37.65,145.08,VIC,South Morang,debit,authorized,d5ac97d30ad54ac697a4287e20caa752,POS,20-30,2018,9,9,16,4,Sunday,7 days,55263.086
ACC-4258502723,24,28.8,2597.02,1.0,CUS-3378712515,2018-09-09,Kimberly,F,-37.74,145.45,,02d8f097-abb7-4545-8ffd-a0090fece10c,-33.89,150.91,NSW,Cabramatta West,debit,authorized,238e80d42aed4990aa2a3f1dde6f26a5,POS,20-30,2018,9,9,17,6,Sunday,7 days,55263.086
ACC-4258502723,24,46.79,2550.23,1.0,CUS-3378712515,2018-09-10,Kimberly,F,-37.74,145.45,,9089ad5d-70a1-42d0-ac2f-a6e6debc4f3c,-37.83,144.97,VIC,Melbourne,debit,authorized,f7be5db2dafe452289eff40ca29ff195,SALES-POS,20-30,2018,9,10,9,27,Monday,7 days,55263.086
ACC-4258502723,24,15.9,2534.33,1.0,CUS-3378712515,2018-09-10,Kimberly,F,-37.74,145.45,,61072baf-cc28-4da8-a7e2-27022f9b9d92,-37.81,144.96,VIC,Melbourne,debit,authorized,25d818989a7544e4ab82c805ed68d31b,SALES-POS,20-30,2018,9,10,10,22,Monday,7 days,55263.086
ACC-4258502723,24,53.0,3541.17,,CUS-3378712515,2018-09-10,Kimberly,F,-37.74,145.45,,,,,,,debit,posted,1ce717be418e4352a8aaf80b05cfe52c,PAYMENT,20-30,2018,9,10,17,0,Monday,7 days,55263.086
ACC-4258502723,24,15.95,3525.22,0.0,CUS-3378712515,2018-09-10,Kimberly,F,-37.74,145.45,,5d3d6f33-1fa9-4e4f-abe6-502cacbf7743,-37.77,144.92,VIC,Moonee Ponds,debit,authorized,16b1a694eb91439fb802833ebcf43940,SALES-POS,20-30,2018,9,10,19,31,Monday,7 days,55263.086
ACC-4258502723,24,11.58,3513.64,1.0,CUS-3378712515,2018-09-11,Kimberly,F,-37.74,145.45,,b43f887e-c154-40b8-b4e0-96ca0321ca83,-37.82,145.12,VIC,Box Hill,debit,authorized,258871b5bdc647629ee1200f128409a2,SALES-POS,20-30,2018,9,11,8,59,Tuesday,7 days,55263.086
ACC-4258502723,24,6.87,3506.77,1.0,CUS-3378712515,2018-09-11,Kimberly,F,-37.74,145.45,,bdaa1e6c-2c0e-46f7-9c0f-9b3144ccc6ca,-37.81,144.96,VIC,Melbourne,debit,authorized,3803209a281147d7a221530326ee20a2,SALES-POS,20-30,2018,9,11,16,31,Tuesday,7 days,55263.086
ACC-4258502723,24,123.81,3382.96,1.0,CUS-3378712515,2018-09-11,Kimberly,F,-37.74,145.45,,e501d4a3-36da-4af4-9d66-38523457078b,-37.87,144.99,VIC,Saint Kilda,debit,authorized,63cf658522cc468182c4d814a8d87693,POS,20-30,2018,9,11,21,7,Tuesday,7 days,55263.086
ACC-4258502723,24,15.05,3367.91,0.0,CUS-3378712515,2018-09-11,Kimberly,F,-37.74,145.45,,f5f9329e-f039-4d5e-a24b-53dbbcc66b45,-36.39,145.36,VIC,Mooroopna,debit,authorized,998eed8541dd4bc3a4492d77e1035f99,POS,20-30,2018,9,11,23,29,Tuesday,7 days,55263.086
ACC-4258502723,24,5.07,3362.84,1.0,CUS-3378712515,2018-09-12,Kimberly,F,-37.74,145.45,,cb89466f-81a0-4ff5-af34-bf6b7310a82a,-37.84,144.99,VIC,South Yarra,debit,authorized,0686dca0d045406ca1f87be8cb60815e,POS,20-30,2018,9,12,9,17,Wednesday,7 days,55263.086
ACC-4258502723,24,12.66,3350.18,1.0,CUS-3378712515,2018-09-12,Kimberly,F,-37.74,145.45,,27e8bea5-a0b7-4a0a-a4fe-82e4e1693c74,-37.88,145.04,VIC,Caulfield East,debit,authorized,e7d13eda425b4e39b637efd832dd5866,POS,20-30,2018,9,12,9,51,Wednesday,7 days,55263.086
ACC-4258502723,24,53.54,3296.64,1.0,CUS-3378712515,2018-09-12,Kimberly,F,-37.74,145.45,,8f9ce8af-35cb-4c54-abb7-81ce189206a2,-37.8,144.97,VIC,Carlton,debit,authorized,003144b8e1c34dda9d34bfe630a55359,SALES-POS,20-30,2018,9,12,10,28,Wednesday,7 days,55263.086
ACC-4258502723,24,82.27,3214.37,0.0,CUS-3378712515,2018-09-12,Kimberly,F,-37.74,145.45,,33b9a101-8bd1-4014-80da-27d84e786424,-37.97,145.09,VIC,Moorabbin Airport,debit,authorized,9bd9d66cfe2949e2b2e8e96946fd1a42,SALES-POS,20-30,2018,9,12,13,27,Wednesday,7 days,55263.086
ACC-4258502723,24,8.58,3205.79,1.0,CUS-3378712515,2018-09-13,Kimberly,F,-37.74,145.45,,6a981542-751b-48d6-9060-63190edeacf4,-37.81,144.96,VIC,Melbourne,debit,authorized,398302dc364c40f0b9fcb4a5e625c8b1,POS,20-30,2018,9,13,8,38,Thursday,7 days,55263.086
ACC-4258502723,24,7.02,3198.77,1.0,CUS-3378712515,2018-09-13,Kimberly,F,-37.74,145.45,,6e268cb4-abc2-41b1-9f90-beac7955627f,-37.82,145.04,VIC,Hawthorn,debit,authorized,2c556891ad994e7ba5259eb35f2c27be,SALES-POS,20-30,2018,9,13,9,13,Thursday,7 days,55263.086
ACC-4258502723,24,18.89,3179.88,0.0,CUS-3378712515,2018-09-13,Kimberly,F,-37.74,145.45,,26b0b9bc-a8af-4484-b4d3-4cf0838ed5bf,-37.83,144.97,VIC,Southbank,debit,authorized,c3785d6070c749cfb9f1f79f8f623d0b,POS,20-30,2018,9,13,9,38,Thursday,7 days,55263.086
ACC-4258502723,24,22.46,3157.42,1.0,CUS-3378712515,2018-09-15,Kimberly,F,-37.74,145.45,,138d4caf-1025-4013-a659-628b4148eb08,-33.87,151.2,NSW,Sydney,debit,authorized,b301b1b5820640f88a331e8bfff4cb3f,SALES-POS,20-30,2018,9,15,11,39,Saturday,7 days,55263.086
ACC-4258502723,24,15.86,3141.56,1.0,CUS-3378712515,2018-09-15,Kimberly,F,-37.74,145.45,,86c35382-adfd-4d1b-9ffe-6b64c2672db2,-37.86,144.97,VIC,Saint Kilda,debit,authorized,d1276ef844fa4e32bebac067595ef8a5,SALES-POS,20-30,2018,9,15,14,48,Saturday,7 days,55263.086
ACC-4258502723,24,28.0,3113.56,,CUS-3378712515,2018-09-15,Kimberly,F,-37.74,145.45,,,,,,,debit,posted,9db6a385e0924da3ac1e3539332758a5,INTER BANK,20-30,2018,9,15,20,0,Saturday,7 days,55263.086
ACC-4258502723,24,13.22,3100.34,0.0,CUS-3378712515,2018-09-15,Kimberly,F,-37.74,145.45,,b89d48ff-342d-4d4b-80ed-eaa740240f1e,-37.8,145,VIC,Abbotsford,debit,authorized,45b8e6647ceb4a879e72f578dfbd253c,SALES-POS,20-30,2018,9,15,21,14,Saturday,7 days,55263.086
ACC-4258502723,24,27.79,3072.55,1.0,CUS-3378712515,2018-09-15,Kimberly,F,-37.74,145.45,,6323cdfc-09c7-4537-ae1b-1533672d469f,-37.75,144.86,VIC,Keilor East,debit,authorized,ecf809d6a5904d0d8d9d4c6d83a02d57,SALES-POS,20-30,2018,9,15,21,34,Saturday,7 days,55263.086
ACC-4258502723,24,4.69,3067.86,0.0,CUS-3378712515,2018-09-16,Kimberly,F,-37.74,145.45,,4637eca8-efb6-4b52-b8dc-08103abdef9c,-37.82,144.96,VIC,Melbourne,debit,authorized,c2808c1ace0e438e83a59b382c21171f,POS,20-30,2018,9,16,2,43,Sunday,7 days,55263.086
ACC-4258502723,24,38.0,3029.86,,CUS-3378712515,2018-09-16,Kimberly,F,-37.74,145.45,,,,,,,debit,posted,bd522a9b26854ec8b2ebac62047dc504,PAYMENT,20-30,2018,9,16,4,0,Sunday,7 days,55263.086
ACC-4258502723,24,11.94,3017.92,1.0,CUS-3378712515,2018-09-16,Kimberly,F,-37.74,145.45,,8af717e4-15d7-4a88-a321-5aa41602ec46,-38.01,145.32,VIC,Berwick,debit,authorized,28615f8d5fc74779a3e7577f6b56d021,POS,20-30,2018,9,16,10,1,Sunday,7 days,55263.086
ACC-4258502723,24,102.0,2915.92,,CUS-3378712515,2018-09-17,Kimberly,F,-37.74,145.45,,,,,,,debit,posted,3eb73ba23ab44aecb7f0411eba550588,INTER BANK,20-30,2018,9,17,2,0,Monday,7 days,55263.086
ACC-4258502723,24,53.0,3922.76,,CUS-3378712515,2018-09-17,Kimberly,F,-37.74,145.45,,,,,,,debit,posted,2ccf879f948147a28a2c292d24642848,PAYMENT,20-30,2018,9,17,17,0,Monday,7 days,55263.086
ACC-4258502723,24,21.27,3901.49,1.0,CUS-3378712515,2018-09-18,Kimberly,F,-37.74,145.45,,985c2daa-14e0-4698-936b-c4552273c0dc,-37.72,145.04,VIC,Kingsbury,debit,authorized,15f0765f79f64270b83231d8053ea59d,SALES-POS,20-30,2018,9,18,16,29,Tuesday,7 days,55263.086
ACC-4258502723,24,7.39,3894.1,1.0,CUS-3378712515,2018-09-18,Kimberly,F,-37.74,145.45,,f0d7db8f-2e69-486d-8a2f-6ec33bb68fb3,-37.71,144.89,VIC,Airport West,debit,authorized,61b6a2e144c54fac8e25dddecbee4b03,SALES-POS,20-30,2018,9,18,18,27,Tuesday,7 days,55263.086
ACC-4258502723,24,7.23,3886.87,1.0,CUS-3378712515,2018-09-19,Kimberly,F,-37.74,145.45,,550ac697-db6b-42fb-94f5-6728b52b2616,-37.67,144.85,VIC,Melbourne Airport,debit,authorized,ef3460d555dd421abfeb4d8d908b4a90,SALES-POS,20-30,2018,9,19,17,33,Wednesday,7 days,55263.086
ACC-4258502723,24,15.49,3871.38,1.0,CUS-3378712515,2018-09-20,Kimberly,F,-37.74,145.45,,03ae6833-0686-486b-ad5e-506357c9ad7b,-37.82,144.82,VIC,Laverton North,debit,authorized,401afa0be4364c26b1a13d1ddf5c410f,POS,20-30,2018,9,20,14,19,Thursday,7 days,55263.086
ACC-4258502723,24,21.53,3849.85,1.0,CUS-3378712515,2018-09-20,Kimberly,F,-37.74,145.45,,a03db1e2-6e3e-408b-a023-355149eaaf18,-37.79,145.28,VIC,Croydon,debit,authorized,1158077a5ebd402e8bc536736b1edd32,SALES-POS,20-30,2018,9,20,18,54,Thursday,7 days,55263.086
ACC-4258502723,24,15.32,3834.53,1.0,CUS-3378712515,2018-09-21,Kimberly,F,-37.74,145.45,,9d07fa84-55ae-4bdf-b38c-c74924dc5e2f,-37.87,145.24,VIC,Wantirna South,debit,authorized,3b909a59f4934ad798ae3aab926a5f2f,POS,20-30,2018,9,21,14,29,Friday,7 days,55263.086
ACC-4258502723,24,46.58,3787.95,0.0,CUS-3378712515,2018-09-21,Kimberly,F,-37.74,145.45,,2d3f9099-eb95-48d7-8e34-ef4c4f1e492b,-37.83,144.99,VIC,Cremorne,debit,authorized,9aa9b5c2a85b41efb5fcf541c26c5ddd,POS,20-30,2018,9,21,15,58,Friday,7 days,55263.086
ACC-4258502723,24,26.28,3761.67,1.0,CUS-3378712515,2018-09-21,Kimberly,F,-37.74,145.45,,b2bfeb0c-0b50-493e-a1e4-bd6c571b22a6,-37.81,144.97,VIC,Melbourne,debit,authorized,23fa2dbd309c4a9fa9320be86257a73f,POS,20-30,2018,9,21,17,36,Friday,7 days,55263.086
ACC-4258502723,24,16.82,3744.85,1.0,CUS-3378712515,2018-09-21,Kimberly,F,-37.74,145.45,,4a8af3dc-01df-4c80-ad93-997f7a63e238,-37.7,144.78,VIC,Taylors Lakes,debit,authorized,90703e895299462e8957945334bd3e15,POS,20-30,2018,9,21,18,48,Friday,7 days,55263.086
ACC-4258502723,24,55.92,3688.93,1.0,CUS-3378712515,2018-09-21,Kimberly,F,-37.74,145.45,,4c843dbc-0934-4af5-bacb-9a813503bb6d,-28.1,153.42,QLD,Burleigh Heads,debit,authorized,635ecc684c4643a5baee068c7221a3cd,SALES-POS,20-30,2018,9,21,21,6,Friday,7 days,55263.086
ACC-4258502723,24,28.0,3660.93,,CUS-3378712515,2018-09-22,Kimberly,F,-37.74,145.45,,,,,,,debit,posted,e52b2a2abfa745f1aeec02094f5f805e,INTER BANK,20-30,2018,9,22,20,0,Saturday,7 days,55263.086
ACC-4258502723,24,38.0,3622.93,,CUS-3378712515,2018-09-23,Kimberly,F,-37.74,145.45,,,,,,,debit,posted,20d735c8385a4d548f4bc3837e797f2c,PAYMENT,20-30,2018,9,23,4,0,Sunday,7 days,55263.086
ACC-4258502723,24,53.0,4629.77,,CUS-3378712515,2018-09-24,Kimberly,F,-37.74,145.45,,,,,,,debit,posted,34c52210925c4adbb5b5bab698967bca,PAYMENT,20-30,2018,9,24,17,0,Monday,7 days,55263.086
ACC-4258502723,24,576.0,4053.77,,CUS-3378712515,2018-09-26,Kimberly,F,-37.74,145.45,,,,,,,debit,posted,fdc15e073f014860bff5671359fbd6d9,PAYMENT,20-30,2018,9,26,15,0,Wednesday,7 days,55263.086
ACC-4258502723,24,20.54,4033.23,0.0,CUS-3378712515,2018-09-26,Kimberly,F,-37.74,145.45,,a038df8c-bade-40e9-b864-9371758a8745,-33.87,151.2,NSW,Pyrmont,debit,authorized,34c8121164e44d6e9b1c0d50273eae71,SALES-POS,20-30,2018,9,26,17,16,Wednesday,7 days,55263.086
ACC-4258502723,24,20.45,4012.78,1.0,CUS-3378712515,2018-09-27,Kimberly,F,-37.74,145.45,,cc231789-e16d-4d0c-8d3c-4406615004e5,-36.39,145.42,VIC,Shepparton,debit,authorized,f0746ecee3ad46eeb83340d9fe270ddb,SALES-POS,20-30,2018,9,27,2,48,Thursday,7 days,55263.086
ACC-4258502723,24,5.61,4007.17,1.0,CUS-3378712515,2018-09-27,Kimberly,F,-37.74,145.45,,313febcb-f3e7-457d-ad9e-fd70e82db047,-38.03,145.3,VIC,Narre Warren South,debit,authorized,5541942ac4914960b51c726523485235,POS,20-30,2018,9,27,21,32,Thursday,7 days,55263.086
ACC-4258502723,24,28.0,3979.17,,CUS-3378712515,2018-09-29,Kimberly,F,-37.74,145.45,,,,,,,debit,posted,abe408fcf6f742928ebe56e480eb3213,INTER BANK,20-30,2018,9,29,20,0,Saturday,7 days,55263.086
ACC-4258502723,24,9.95,3969.22,1.0,CUS-3378712515,2018-09-29,Kimberly,F,-37.74,145.45,,bc42627b-f309-4144-90c0-bc56b934280e,-37.77,144.95,VIC,Brunswick West,debit,authorized,1123eb1c7e384e09bbaf2f9611a16653,SALES-POS,20-30,2018,9,29,23,2,Saturday,7 days,55263.086
ACC-4258502723,24,38.0,3931.22,,CUS-3378712515,2018-09-30,Kimberly,F,-37.74,145.45,,,,,,,debit,posted,3665162a6f4a4faa920ad4341789f8a3,PAYMENT,20-30,2018,9,30,4,0,Sunday,7 days,55263.086
ACC-4258502723,24,32.61,3898.61,1.0,CUS-3378712515,2018-09-30,Kimberly,F,-37.74,145.45,,18c1a3d3-f398-443b-8889-c8cf34ff4ec2,-16.24,145.43,QLD,Cow Bay,debit,authorized,4e9f0b15198845a69e7337ddcf6212ed,SALES-POS,20-30,2018,9,30,8,53,Sunday,7 days,55263.086
ACC-4258502723,24,12.38,3886.23,1.0,CUS-3378712515,2018-09-30,Kimberly,F,-37.74,145.45,,d69814ea-d3aa-477e-8990-23d2c23059a8,-37.88,145.09,VIC,Chadstone,debit,authorized,3d87673e98f04b19801794951c99bbb8,POS,20-30,2018,9,30,20,9,Sunday,7 days,55263.086
ACC-4258502723,24,53.0,4893.07,,CUS-3378712515,2018-10-01,Kimberly,F,-37.74,145.45,,,,,,,debit,posted,03113a53f7cf4e009d544e471703b5d4,PAYMENT,20-30,2018,10,1,17,0,Monday,7 days,55263.086
ACC-4258502723,24,7.14,4885.93,1.0,CUS-3378712515,2018-10-01,Kimberly,F,-37.74,145.45,,eadb5e95-81b4-4752-98d5-9c74e53bc053,-37.83,145.05,VIC,Hawthorn East,debit,authorized,2bd6117bddc844f5ac8855d23129908f,SALES-POS,20-30,2018,10,1,21,59,Monday,7 days,55263.086
ACC-4258502723,24,8.02,4877.91,1.0,CUS-3378712515,2018-10-02,Kimberly,F,-37.74,145.45,,0f12e6a7-93c7-4196-bf95-d626b07e183e,-37.77,144.89,VIC,Maribyrnong,debit,authorized,b321d606c7844439ba47c4da9ac66450,SALES-POS,20-30,2018,10,2,9,22,Tuesday,7 days,55263.086
ACC-4258502723,24,63.74,4814.17,1.0,CUS-3378712515,2018-10-02,Kimberly,F,-37.74,145.45,,32ba71fa-6ec0-43d9-a56d-3549998af015,-37.88,145.06,VIC,Malvern East,debit,authorized,56fec422223041ceb6d16d384beb1576,SALES-POS,20-30,2018,10,2,9,26,Tuesday,7 days,55263.086
ACC-4258502723,24,29.56,4784.61,1.0,CUS-3378712515,2018-10-02,Kimberly,F,-37.74,145.45,,4c590057-7a07-4639-9f6d-57cfadeb7509,-37.71,144.89,VIC,Airport West,debit,authorized,b482848fd84048708139582d47c33fc4,POS,20-30,2018,10,2,14,31,Tuesday,7 days,55263.086
ACC-4258502723,24,19.81,4764.8,1.0,CUS-3378712515,2018-10-03,Kimberly,F,-37.74,145.45,,e5280991-1515-432c-9f07-a29e865a0718,-32.09,115.92,WA,Canning Vale,debit,authorized,184dfd3b9aa9454580171e328b4c9874,POS,20-30,2018,10,3,7,26,Wednesday,7 days,55263.086
ACC-4258502723,24,15.76,4749.04,1.0,CUS-3378712515,2018-10-03,Kimberly,F,-37.74,145.45,,37c4a599-30ce-495a-bb3b-886c6f19ee80,-37.92,145,VIC,Brighton,debit,authorized,e5787f25eadb46609f0e5fa220dba7e6,POS,20-30,2018,10,3,11,42,Wednesday,7 days,55263.086
ACC-4258502723,24,34.16,4714.88,0.0,CUS-3378712515,2018-10-03,Kimberly,F,-37.74,145.45,,4b37945f-b47d-48f1-804a-67d0abe424d1,-37.75,144.94,VIC,Pascoe Vale South,debit,authorized,a78636e1018643a1bf9fffd63813a76f,SALES-POS,20-30,2018,10,3,15,17,Wednesday,7 days,55263.086
ACC-4258502723,24,15.89,4698.99,1.0,CUS-3378712515,2018-10-04,Kimberly,F,-37.74,145.45,,4ae59658-8b43-48dc-9ee2-1d2154551bb1,-37.74,144.8,VIC,Saint Albans,debit,authorized,1b9b34086a79481ea25f562723e9cd49,POS,20-30,2018,10,4,16,55,Thursday,7 days,55263.086
ACC-4258502723,24,19.0,4679.99,1.0,CUS-3378712515,2018-10-04,Kimberly,F,-37.74,145.45,,812729f9-ab3a-4762-8d25-b9e678d96abc,-37.58,144.71,VIC,Sunbury,debit,authorized,1b6f4644820549ea8ebb1eb609a3b083,SALES-POS,20-30,2018,10,4,17,18,Thursday,7 days,55263.086
ACC-4258502723,24,19.99,4660.0,1.0,CUS-3378712515,2018-10-04,Kimberly,F,-37.74,145.45,,abb97822-079b-427e-b65e-80887119fb8d,-37.71,144.79,VIC,Taylors Lakes,debit,authorized,2aa694e7308946bbb0a646cab9fc6826,SALES-POS,20-30,2018,10,4,19,24,Thursday,7 days,55263.086
ACC-4258502723,24,52.85,4607.15,1.0,CUS-3378712515,2018-10-06,Kimberly,F,-37.74,145.45,,026ec7ae-946f-415e-9642-76d60d3d85d0,-17.27,145.47,QLD,Atherton,debit,authorized,68999826b1b44794a7c2fee6fd07369e,SALES-POS,20-30,2018,10,6,9,45,Saturday,7 days,55263.086
ACC-4258502723,24,9.71,4597.44,1.0,CUS-3378712515,2018-10-06,Kimberly,F,-37.74,145.45,,c853cedf-5ab2-4252-a20f-51b76de236e6,-37.69,144.6,VIC,Melton,debit,authorized,4f0094b2f1374a1f8dcf63de9057ef75,POS,20-30,2018,10,6,11,9,Saturday,7 days,55263.086
ACC-4258502723,24,17.28,4580.16,1.0,CUS-3378712515,2018-10-06,Kimberly,F,-37.74,145.45,,d7dd53db-f124-4583-84e7-6ed8d1193a10,-37.81,140.79,SA,Mount Gambier,debit,authorized,38b8f08186024251aaf35dae65d00a07,SALES-POS,20-30,2018,10,6,13,28,Saturday,7 days,55263.086
ACC-4258502723,24,13.01,4567.15,0.0,CUS-3378712515,2018-10-06,Kimberly,F,-37.74,145.45,,10def92b-faf5-4491-a6d6-bf291413107d,-37.85,145.04,VIC,Malvern,debit,authorized,1008acf46e754a37ad4a2f4e0cb7e33e,SALES-POS,20-30,2018,10,6,14,26,Saturday,7 days,55263.086
ACC-4258502723,24,28.0,4539.15,,CUS-3378712515,2018-10-06,Kimberly,F,-37.74,145.45,,,,,,,debit,posted,d04b9f0d2cb645179db2ae17e149dde9,INTER BANK,20-30,2018,10,6,20,0,Saturday,7 days,55263.086
ACC-4258502723,24,38.0,4501.15,,CUS-3378712515,2018-10-07,Kimberly,F,-37.74,145.45,,,,,,,debit,posted,f3d05b77ff0b4049bf5b9bcc851230e4,PAYMENT,20-30,2018,10,7,4,0,Sunday,7 days,55263.086
ACC-4258502723,24,28.67,4472.48,0.0,CUS-3378712515,2018-10-07,Kimberly,F,-37.74,145.45,,89e8dca7-8fee-4613-87a5-1f1d71432d75,-37.85,144.71,VIC,Hoppers Crossing,debit,authorized,54712d524c204ebcb29bcfd6e9ef8042,SALES-POS,20-30,2018,10,7,7,49,Sunday,7 days,55263.086
ACC-4258502723,24,14.75,4457.73,1.0,CUS-3378712515,2018-10-07,Kimberly,F,-37.74,145.45,,37d0b3ce-d6e4-4b10-9a06-045f795b1a6b,-37.81,145.03,VIC,Kew,debit,authorized,c43216c832d0415ab23adfd8c099d39d,SALES-POS,20-30,2018,10,7,16,7,Sunday,7 days,55263.086
ACC-4258502723,24,7.98,4449.75,0.0,CUS-3378712515,2018-10-08,Kimberly,F,-37.74,145.45,,2201f92d-9a1e-4efd-a3b9-3e6ed73d8629,-37.68,144.88,VIC,Melbourne,debit,authorized,2931defe49714605a7ee9ab9dbaacf49,SALES-POS,20-30,2018,10,8,9,12,Monday,7 days,55263.086
ACC-4258502723,24,4.48,4445.27,1.0,CUS-3378712515,2018-10-08,Kimberly,F,-37.74,145.45,,219c6173-ff08-468a-9403-4f1286b33145,-37.74,144.89,VIC,Niddrie,debit,authorized,d84b0dc26e534e278edf502a2f4d890e,POS,20-30,2018,10,8,9,29,Monday,7 days,55263.086
ACC-4258502723,24,12.25,4433.02,0.0,CUS-3378712515,2018-10-08,Kimberly,F,-37.74,145.45,,864d9103-1806-4a26-be3b-cf4c2c4d29ab,-37.81,144.97,VIC,Melbourne,debit,authorized,1410695f113f4227893eccc86421f2ec,POS,20-30,2018,10,8,9,55,Monday,7 days,55263.086
ACC-4258502723,24,75.0,4358.02,,CUS-3378712515,2018-10-08,Kimberly,F,-37.74,145.45,,,,,,,debit,posted,e425bc4cc36448bd930b0f89ce6e2319,PAYMENT,20-30,2018,10,8,12,0,Monday,7 days,55263.086
ACC-4258502723,24,116.26,4241.76,1.0,CUS-3378712515,2018-10-08,Kimberly,F,-37.74,145.45,,e7bf57d9-9eeb-41b4-886e-efb676a5bd80,-16.48,145.46,QLD,Port Douglas,debit,authorized,b1e504ecf44840abb3a48b4ab8510f00,SALES-POS,20-30,2018,10,8,13,33,Monday,7 days,55263.086
ACC-4258502723,24,53.0,5248.6,,CUS-3378712515,2018-10-08,Kimberly,F,-37.74,145.45,,,,,,,debit,posted,5fce306e44b845b9beeff5f96538e819,PAYMENT,20-30,2018,10,8,17,0,Monday,7 days,55263.086
ACC-4258502723,24,10.39,5238.21,1.0,CUS-3378712515,2018-10-08,Kimberly,F,-37.74,145.45,,eb8be374-b244-43da-a09d-00c8e59df64d,-37.83,145.15,VIC,Blackburn South,debit,authorized,62aa238eaa52480d9ed4c04c7bc511de,POS,20-30,2018,10,8,21,44,Monday,7 days,55263.086
ACC-4258502723,24,18.35,5219.86,0.0,CUS-3378712515,2018-10-09,Kimberly,F,-37.74,145.45,,0f9c8b05-4aaf-4114-bb61-9837dc31e971,-37.71,144.89,VIC,Airport West,debit,authorized,6fadb08f759f4fa09417c40c3c1ac3b8,POS,20-30,2018,10,9,9,36,Tuesday,7 days,55263.086
ACC-4258502723,24,15.22,5204.64,1.0,CUS-3378712515,2018-10-09,Kimberly,F,-37.74,145.45,,74abca52-02e5-4f70-ab6a-205cf19e5003,-37.71,144.92,VIC,Glenroy,debit,authorized,172f5a5b32ce45cdbe8dc472fc400ae3,SALES-POS,20-30,2018,10,9,12,58,Tuesday,7 days,55263.086
ACC-4258502723,24,54.51,5150.13,1.0,CUS-3378712515,2018-10-10,Kimberly,F,-37.74,145.45,,f3b432d7-4224-4216-9f69-972559838cba,-33.87,151.21,NSW,Sydney,debit,authorized,303c3177783e474cbd591a69f8540d0e,POS,20-30,2018,10,10,13,29,Wednesday,7 days,55263.086
ACC-4258502723,24,13.46,5136.67,0.0,CUS-3378712515,2018-10-11,Kimberly,F,-37.74,145.45,,d8111957-c4a7-4485-b966-1d343291d1d4,-37.63,144.92,VIC,Roxburgh Park,debit,authorized,a51b8a992b6a4a97af40819017aaa90d,POS,20-30,2018,10,11,9,45,Thursday,7 days,55263.086
ACC-4258502723,24,14.18,5122.49,1.0,CUS-3378712515,2018-10-11,Kimberly,F,-37.74,145.45,,7770e116-8b4a-4d48-b0f5-7a6399958848,-37.68,144.58,VIC,Melton,debit,authorized,dfa272cc57334c7ca87f61a258cb5b90,SALES-POS,20-30,2018,10,11,12,7,Thursday,7 days,55263.086
ACC-4258502723,24,18.75,5103.74,0.0,CUS-3378712515,2018-10-12,Kimberly,F,-37.74,145.45,,f66d88b2-a9de-4413-85d2-57b960504668,-37.75,144.94,VIC,Pascoe Vale South,debit,authorized,ced1ba5b22f942b0af53da2200b14c16,SALES-POS,20-30,2018,10,12,21,22,Friday,7 days,55263.086
ACC-4258502723,24,23.94,5079.8,1.0,CUS-3378712515,2018-10-12,Kimberly,F,-37.74,145.45,,64d7ed6b-30c0-4da8-befb-c4e26aaa29a0,-27.4,153.01,QLD,Stafford Heights,debit,authorized,3fa8821edc974a379a658aa47c5975cc,SALES-POS,20-30,2018,10,12,22,55,Friday,7 days,55263.086
ACC-4258502723,24,13.22,5066.58,1.0,CUS-3378712515,2018-10-13,Kimberly,F,-37.74,145.45,,31a30bb3-a932-4136-8299-09974f55b62e,-37.77,144.91,VIC,Moonee Ponds,debit,authorized,a7bf24da0ff147b894d2712f9596fd59,SALES-POS,20-30,2018,10,13,3,38,Saturday,7 days,55263.086
ACC-4258502723,24,18.19,5048.39,0.0,CUS-3378712515,2018-10-13,Kimberly,F,-37.74,145.45,,5295910b-9e69-4b4a-b2dd-3061a6b9d75d,-37.88,145.15,VIC,Mount Waverley,debit,authorized,91bd6f68c8b448f196cb681d7a578699,SALES-POS,20-30,2018,10,13,10,10,Saturday,7 days,55263.086
ACC-4258502723,24,16.47,5031.92,1.0,CUS-3378712515,2018-10-13,Kimberly,F,-37.74,145.45,,30e848ee-308c-48df-a898-12619658e06c,-37.82,144.96,VIC,Southbank,debit,authorized,793d7a03132146b19627c4f692fd719e,SALES-POS,20-30,2018,10,13,11,30,Saturday,7 days,55263.086
ACC-4258502723,24,28.0,5003.92,,CUS-3378712515,2018-10-13,Kimberly,F,-37.74,145.45,,,,,,,debit,posted,319492e629a048a582966b028c0ae951,INTER BANK,20-30,2018,10,13,20,0,Saturday,7 days,55263.086
ACC-4258502723,24,38.0,4965.92,,CUS-3378712515,2018-10-14,Kimberly,F,-37.74,145.45,,,,,,,debit,posted,fd7b6a03a67f42d7a40310a9211511e5,PAYMENT,20-30,2018,10,14,4,0,Sunday,7 days,55263.086
ACC-4258502723,24,24.9,4941.02,1.0,CUS-3378712515,2018-10-14,Kimberly,F,-37.74,145.45,,9028e0e7-d52a-4e74-9aa2-015aca34887c,-37.67,144.75,VIC,Calder Park,debit,authorized,8dc93d38f48c435aa78b8420dc990ce7,SALES-POS,20-30,2018,10,14,21,21,Sunday,7 days,55263.086
ACC-4258502723,24,10.78,4930.24,1.0,CUS-3378712515,2018-10-14,Kimberly,F,-37.74,145.45,,463172d5-f0ac-4f2c-a7c9-6cdec83b3c97,-37.7,148.46,VIC,Orbost,debit,authorized,f7bce3b1ed2246f28823319830ec4768,POS,20-30,2018,10,14,23,3,Sunday,7 days,55263.086
ACC-4258502723,24,53.0,5937.08,,CUS-3378712515,2018-10-15,Kimberly,F,-37.74,145.45,,,,,,,debit,posted,64e0dcf7ead442a0b515c8aed1dfc753,PAYMENT,20-30,2018,10,15,17,0,Monday,7 days,55263.086
ACC-4258502723,24,8.28,5928.8,0.0,CUS-3378712515,2018-10-15,Kimberly,F,-37.74,145.45,,86e10e23-b99e-47a1-83b3-6a8a8488a4aa,-37.85,144.96,VIC,Middle Park,debit,authorized,e6c698830a4b498f933882045ad6f209,SALES-POS,20-30,2018,10,15,20,59,Monday,7 days,55263.086
ACC-4258502723,24,45.75,5883.05,0.0,CUS-3378712515,2018-10-15,Kimberly,F,-37.74,145.45,,62ed38ee-64c0-475d-83a5-5781451f87a3,-38.61,145.59,VIC,Wonthaggi,debit,authorized,34117dd2cd344c7eb5e479ad3b5e1fec,POS,20-30,2018,10,15,22,21,Monday,7 days,55263.086
ACC-4258502723,24,7.72,5875.33,1.0,CUS-3378712515,2018-10-16,Kimberly,F,-37.74,145.45,,614cb678-f761-4d73-b72c-9c16c71d00d3,-37.82,145.12,VIC,Box Hill,debit,authorized,5596bf03eab34a5f894fd84ff42b5366,POS,20-30,2018,10,16,8,56,Tuesday,7 days,55263.086
ACC-4258502723,24,7.82,5867.51,1.0,CUS-3378712515,2018-10-16,Kimberly,F,-37.74,145.45,,bea37606-1f00-4ba7-8d06-a8f9b30902e7,-37.82,144.95,VIC,Melbourne,debit,authorized,2c57948658f0495ea295247ed2ea349d,SALES-POS,20-30,2018,10,16,20,18,Tuesday,7 days,55263.086
ACC-4258502723,24,102.0,5765.51,,CUS-3378712515,2018-10-17,Kimberly,F,-37.74,145.45,,,,,,,debit,posted,124d5335d5d341a38b241f921fbae94e,INTER BANK,20-30,2018,10,17,2,0,Wednesday,7 days,55263.086
ACC-4258502723,24,22.51,5743.0,1.0,CUS-3378712515,2018-10-19,Kimberly,F,-37.74,145.45,,a7638d42-ff4e-43a8-9119-bdcfdb81d85b,-37.88,145,VIC,Elsternwick,debit,authorized,b24087e4e0f84f80a13d26bdf9182250,POS,20-30,2018,10,19,10,34,Friday,7 days,55263.086
ACC-4258502723,24,22.16,5720.84,1.0,CUS-3378712515,2018-10-19,Kimberly,F,-37.74,145.45,,e38e1715-8f87-41d5-9b2c-e1a2c88444d0,-37.76,145.07,VIC,Heidelberg,debit,authorized,0b9dd936dba7409bb83f3909036066d2,POS,20-30,2018,10,19,11,32,Friday,7 days,55263.086
ACC-4258502723,24,13.57,5707.27,1.0,CUS-3378712515,2018-10-19,Kimberly,F,-37.74,145.45,,01b9e70a-8f39-486d-9eae-b91cab542d80,-37.82,144.95,VIC,Docklands,debit,authorized,ad1ddef9055947ba8c03e711eba0d0bf,SALES-POS,20-30,2018,10,19,12,33,Friday,7 days,55263.086
ACC-4258502723,24,20.71,5686.56,1.0,CUS-3378712515,2018-10-19,Kimberly,F,-37.74,145.45,,e24aeb44-5755-4e13-9d70-319cc9062bc0,-37.76,145,VIC,Thornbury,debit,authorized,b1c566ece5a34298b8de83c3ab178b64,SALES-POS,20-30,2018,10,19,19,19,Friday,7 days,55263.086
ACC-4258502723,24,9.02,5677.54,1.0,CUS-3378712515,2018-10-19,Kimberly,F,-37.74,145.45,,0a142703-a518-46ac-b854-a98a334f9b27,-37.88,147.99,VIC,Lakes Entrance,debit,authorized,e5943290cc6e47c7a5318df8f8818303,POS,20-30,2018,10,19,20,37,Friday,7 days,55263.086
ACC-4258502723,24,8.3,5669.24,1.0,CUS-3378712515,2018-10-19,Kimberly,F,-37.74,145.45,,d632171a-e91e-44b2-b83f-7266ec58c733,-37.65,145.07,VIC,Mill Park,debit,authorized,29cb7cb0ec774f48ac9ff2021ae9f442,POS,20-30,2018,10,19,22,56,Friday,7 days,55263.086
ACC-4258502723,24,13.84,5655.4,0.0,CUS-3378712515,2018-10-19,Kimberly,F,-37.74,145.45,,d8111957-c4a7-4485-b966-1d343291d1d4,-37.63,144.92,VIC,Roxburgh Park,debit,authorized,f28a1a6d666d4cd18217df6a853309bd,SALES-POS,20-30,2018,10,19,23,39,Friday,7 days,55263.086
ACC-4258502723,24,12.84,5642.56,1.0,CUS-3378712515,2018-10-20,Kimberly,F,-37.74,145.45,,5211e4a0-2dd8-4e78-9801-1e7c1ba2b4c4,-37.82,144.97,VIC,Melbourne,debit,authorized,3f1a6100951549db8a12ff4a202dfb25,POS,20-30,2018,10,20,0,46,Saturday,7 days,55263.086
ACC-4258502723,24,10.86,5631.7,0.0,CUS-3378712515,2018-10-20,Kimberly,F,-37.74,145.45,,8b84934b-890b-4fcb-8102-b6b58156d048,-37.84,144.98,VIC,South Yarra,debit,authorized,68c8d13fbc334449b5b4f5b6e0580b66,SALES-POS,20-30,2018,10,20,8,58,Saturday,7 days,55263.086
ACC-4258502723,24,12.08,5619.62,1.0,CUS-3378712515,2018-10-20,Kimberly,F,-37.74,145.45,,8270b732-efc4-4639-8d91-111b39a30123,-37.82,144.95,VIC,Docklands,debit,authorized,a93a128f6d5d410f8d2b38cb8cdbd668,SALES-POS,20-30,2018,10,20,11,0,Saturday,7 days,55263.086
ACC-4258502723,24,11.61,5608.01,1.0,CUS-3378712515,2018-10-20,Kimberly,F,-37.74,145.45,,f9ead686-3a62-4217-8031-0a9a5c892fb1,-37.78,144.83,VIC,Sunshine,debit,authorized,d1e7968b7b354621b1d4b75a3dd4aeb9,POS,20-30,2018,10,20,11,49,Saturday,7 days,55263.086
ACC-4258502723,24,13.24,5594.77,1.0,CUS-3378712515,2018-10-20,Kimberly,F,-37.74,145.45,,3b19cf83-a361-4891-b084-feac44b4b5a3,-37.84,144.68,VIC,Tarneit,debit,authorized,25dc25a93a9f4b8585c1a27a4b762611,POS,20-30,2018,10,20,14,40,Saturday,7 days,55263.086
ACC-4258502723,24,87.91,5506.86,1.0,CUS-3378712515,2018-10-20,Kimberly,F,-37.74,145.45,,202453f5-0691-418b-9164-0ccab8209fe3,-27.31,152.99,QLD,Strathpine,debit,authorized,f795c6f8858148ba8c9e60876c950a3f,POS,20-30,2018,10,20,15,5,Saturday,7 days,55263.086
ACC-4258502723,24,28.0,5438.16,,CUS-3378712515,2018-10-20,Kimberly,F,-37.74,145.45,,,,,,,debit,posted,9b80f04da2ad4f448c05313657535de1,INTER BANK,20-30,2018,10,20,20,0,Saturday,7 days,55263.086
ACC-4258502723,24,40.7,5466.16,1.0,CUS-3378712515,2018-10-20,Kimberly,F,-37.74,145.45,,2cfe8040-ae8e-4735-94f0-352bea48bc86,-37.67,144.85,VIC,Melbourne Airport,debit,authorized,106d3808747c4de9a8f8d916fb14b0c3,SALES-POS,20-30,2018,10,20,20,56,Saturday,7 days,55263.086
ACC-4258502723,24,38.0,5400.16,,CUS-3378712515,2018-10-21,Kimberly,F,-37.74,145.45,,,,,,,debit,posted,17b653787c9d4dc5b2aa3dbf5235f715,PAYMENT,20-30,2018,10,21,4,0,Sunday,7 days,55263.086
ACC-4258502723,24,22.58,5377.58,1.0,CUS-3378712515,2018-10-21,Kimberly,F,-37.74,145.45,,42ad63fa-ddda-481b-95dd-80bdc3e3851a,-37.74,144.97,VIC,Coburg,debit,authorized,0fd4905a5ed6424ebf8c36852cd62927,POS,20-30,2018,10,21,9,41,Sunday,7 days,55263.086
ACC-4258502723,24,170.69,5206.89,1.0,CUS-3378712515,2018-10-21,Kimberly,F,-37.74,145.45,,187bc0a4-053a-414d-9ff3-af7d49ef536d,-33.87,151.21,NSW,Sydney,debit,authorized,5e07b452aed44b81bad162a879c05531,SALES-POS,20-30,2018,10,21,10,5,Sunday,7 days,55263.086
ACC-4258502723,24,10.08,5196.81,1.0,CUS-3378712515,2018-10-21,Kimberly,F,-37.74,145.45,,7556256f-5f93-487d-be6d-e2f262447bf5,-37.87,144.74,VIC,Williams Landing,debit,authorized,b54cd188510d4df3b6c1f7a23d4764f9,SALES-POS,20-30,2018,10,21,20,1,Sunday,7 days,55263.086
ACC-4258502723,24,15.19,5181.62,1.0,CUS-3378712515,2018-10-21,Kimberly,F,-37.74,145.45,,59dbd618-ed1a-4931-adc6-62cae6a53768,-37.81,144.97,VIC,Melbourne,debit,authorized,47af7c742cdf48bf9064a8e3b240071f,POS,20-30,2018,10,21,21,4,Sunday,7 days,55263.086
ACC-4258502723,24,14.69,5166.93,1.0,CUS-3378712515,2018-10-21,Kimberly,F,-37.74,145.45,,c0fab9eb-a843-4853-a6f7-5ccdc0010fe2,-37.71,144.89,VIC,Airport West,debit,authorized,f39d56bffb384457938385a0f5072bea,SALES-POS,20-30,2018,10,21,21,27,Sunday,7 days,55263.086
ACC-4258502723,24,5.02,5161.91,1.0,CUS-3378712515,2018-10-21,Kimberly,F,-37.74,145.45,,35b4eb35-f89c-4691-8d78-719ed4f4b397,-37.89,145.06,VIC,Carnegie,debit,authorized,61ad3802aefc45e9984b0c4cc7c9281e,POS,20-30,2018,10,21,21,41,Sunday,7 days,55263.086
ACC-4258502723,24,6.35,5155.56,1.0,CUS-3378712515,2018-10-21,Kimberly,F,-37.74,145.45,,bf93e7e4-948f-4d9d-b86d-a9c736e1b87f,-37.84,145.11,VIC,Surrey Hills,debit,authorized,4d8148c557cf4813aeda5a4bc14c95be,SALES-POS,20-30,2018,10,21,21,55,Sunday,7 days,55263.086
ACC-4258502723,24,11.76,5143.8,0.0,CUS-3378712515,2018-10-21,Kimberly,F,-37.74,145.45,,12516b1d-40f0-4f78-ae05-c501dc709386,-37.74,142.02,VIC,Hamilton,debit,authorized,11a6eb0036434ddca436d20deacb6362,SALES-POS,20-30,2018,10,21,23,16,Sunday,7 days,55263.086
ACC-4258502723,24,53.0,6150.64,,CUS-3378712515,2018-10-22,Kimberly,F,-37.74,145.45,,,,,,,debit,posted,93f317d4d9ee42cdb95f1218f4f249c1,PAYMENT,20-30,2018,10,22,17,0,Monday,7 days,55263.086
ACC-4258502723,24,26.79,6123.85,1.0,CUS-3378712515,2018-10-22,Kimberly,F,-37.74,145.45,,6eec64c9-d8e9-4d2f-a4bb-f9f503757727,-37.82,145.22,VIC,Ringwood,debit,authorized,1c0321d8040e417e9d226049ab0e8574,SALES-POS,20-30,2018,10,22,21,39,Monday,7 days,55263.086
ACC-4258502723,24,28.8,6095.05,1.0,CUS-3378712515,2018-10-23,Kimberly,F,-37.74,145.45,,ec7db81a-e46d-457b-be49-aea6d57f508b,-37.83,144.85,VIC,Altona North,debit,authorized,634c28a22a164ae194d93a091bda763a,SALES-POS,20-30,2018,10,23,10,35,Tuesday,7 days,55263.086
ACC-4258502723,24,70.3,6024.75,0.0,CUS-3378712515,2018-10-23,Kimberly,F,-37.74,145.45,,fb69e1a8-26b5-4280-ba02-5a52d287426f,-37.86,145.29,VIC,Boronia,debit,authorized,8b502206120e4f4aa073462948eb32a5,SALES-POS,20-30,2018,10,23,16,48,Tuesday,7 days,55263.086
ACC-4258502723,24,20.86,6003.89,1.0,CUS-3378712515,2018-10-23,Kimberly,F,-37.74,145.45,,4b2fbc4b-533f-4084-8cd8-02132e2acea0,-37.62,145.03,VIC,Wollert,debit,authorized,c4bca638ea6944599f98f782da8864ce,POS,20-30,2018,10,23,21,29,Tuesday,7 days,55263.086
ACC-4258502723,24,22.59,5981.3,1.0,CUS-3378712515,2018-10-24,Kimberly,F,-37.74,145.45,,dd1ae7a0-7fff-494b-9943-241e82a59683,-37.8,145.13,VIC,Box Hill North,debit,authorized,0488ee38a7b6473585a810a32a0e5d86,SALES-POS,20-30,2018,10,24,9,44,Wednesday,7 days,55263.086
ACC-4258502723,24,1248.09,4733.21,1.0,CUS-3378712515,2018-10-25,Kimberly,F,-37.74,145.45,,1029c910-b7e8-41b5-a081-17c4fbad1cd3,-37.77,144.89,VIC,Maribyrnong,debit,authorized,35740efb6eb9482abb7565fc5017da66,POS,20-30,2018,10,25,17,5,Thursday,7 days,55263.086
ACC-4258502723,24,6.4,4726.81,1.0,CUS-3378712515,2018-10-26,Kimberly,F,-37.74,145.45,,336d86a3-de1e-4675-b98d-7c4f68a767ae,-37.88,145,VIC,Elsternwick,debit,authorized,dde7a24a93e84d4bb4ff7220a2100664,SALES-POS,20-30,2018,10,26,5,13,Friday,7 days,55263.086
ACC-4258502723,24,13.55,4713.26,0.0,CUS-3378712515,2018-10-26,Kimberly,F,-37.74,145.45,,b0944786-a71a-4e5a-9379-a5dab8097205,-37.65,145.02,VIC,Epping,debit,authorized,8fbd767969d1439db42045f42bde055f,POS,20-30,2018,10,26,9,46,Friday,7 days,55263.086
ACC-4258502723,24,18.21,4695.05,0.0,CUS-3378712515,2018-10-26,Kimberly,F,-37.74,145.45,,b7c9f1cd-dfc8-4831-ad48-03bdeb2cac6a,-37.7,145.1,VIC,Greensborough,debit,authorized,94fd5d676ea447fd94764e03c84de5a6,POS,20-30,2018,10,26,9,56,Friday,7 days,55263.086
ACC-4258502723,24,27.63,4667.42,1.0,CUS-3378712515,2018-10-26,Kimberly,F,-37.74,145.45,,cc36a928-e2b3-4809-a463-1f51a9fac356,-33.73,150.98,NSW,Castle Hill,debit,authorized,3a323fb839ef4a7697336d4ab0929fab,SALES-POS,20-30,2018,10,26,17,56,Friday,7 days,55263.086
ACC-4258502723,24,14.16,4653.26,1.0,CUS-3378712515,2018-10-27,Kimberly,F,-37.74,145.45,,c2ae1e53-cba2-4e6d-b539-2394cd86662d,-37.85,144.99,VIC,South Yarra,debit,authorized,7a118021ff5541b6bc5452db13d7b767,POS,20-30,2018,10,27,9,9,Saturday,7 days,55263.086
ACC-4258502723,24,15.49,4637.77,1.0,CUS-3378712515,2018-10-27,Kimberly,F,-37.74,145.45,,646a8ca1-83af-4a9c-9afa-49d50cd515d6,-37.79,144.93,VIC,Kensington,debit,authorized,135db3ab07ee4b99a2e3396b96d75f50,SALES-POS,20-30,2018,10,27,18,31,Saturday,7 days,55263.086
ACC-4258502723,24,3.76,4634.01,1.0,CUS-3378712515,2018-10-27,Kimberly,F,-37.74,145.45,,72cde54c-aa30-42de-bc67-54369a9cf904,-37.74,140.78,SA,Mount Gambier Airport,debit,authorized,af3509ce79524c88b29cf90fb68594b7,SALES-POS,20-30,2018,10,27,19,29,Saturday,7 days,55263.086
ACC-4258502723,24,28.0,4599.41,,CUS-3378712515,2018-10-27,Kimberly,F,-37.74,145.45,,,,,,,debit,posted,7fd54cad971248daa27d638c4ead6570,INTER BANK,20-30,2018,10,27,20,0,Saturday,7 days,55263.086
ACC-4258502723,24,6.6,4627.41,0.0,CUS-3378712515,2018-10-27,Kimberly,F,-37.74,145.45,,a1009772-a12f-4312-90af-25062f35b0a1,-37.79,144.95,VIC,Parkville,debit,authorized,3123eb1326f249cfbf02090ac7bc455a,SALES-POS,20-30,2018,10,27,20,28,Saturday,7 days,55263.086
ACC-4258502723,24,28.73,4570.68,1.0,CUS-3378712515,2018-10-27,Kimberly,F,-37.74,145.45,,27b825d9-1f8b-4488-ad57-d344607b1c9b,-37.81,144.72,VIC,Truganina,debit,authorized,ecd12decdb1c48b39709e121b969b355,SALES-POS,20-30,2018,10,27,23,17,Saturday,7 days,55263.086
ACC-4258502723,24,34.59,4536.09,1.0,CUS-3378712515,2018-10-28,Kimberly,F,-37.74,145.45,,f134556f-f21d-4dc2-a80c-c34249b6b654,-16.93,145.77,QLD,Cairns City,debit,authorized,6316cd73305c4467853deb0f42040355,SALES-POS,20-30,2018,10,28,1,15,Sunday,7 days,55263.086
ACC-4258502723,24,38.0,4498.09,,CUS-3378712515,2018-10-28,Kimberly,F,-37.74,145.45,,,,,,,debit,posted,81dd190e959f4473870df64b25f7b75b,PAYMENT,20-30,2018,10,28,4,0,Sunday,7 days,55263.086
ACC-4258502723,24,24.44,4473.65,1.0,CUS-3378712515,2018-10-29,Kimberly,F,-37.74,145.45,,e788c93a-12cd-4cbc-a1c1-2baba59ab032,-37.82,144.96,VIC,Melbourne,debit,authorized,b634a903fc3f466aa34c67bc21119080,POS,20-30,2018,10,29,8,45,Monday,7 days,55263.086
ACC-4258502723,24,16.44,4457.21,1.0,CUS-3378712515,2018-10-29,Kimberly,F,-37.74,145.45,,79065b3f-a95c-407c-b2ad-26496e8efc62,-37.77,145,VIC,Northcote,debit,authorized,45dac80918334b5b82cb2eccb7d9f59a,POS,20-30,2018,10,29,10,37,Monday,7 days,55263.086
ACC-4258502723,24,53.0,5464.05,,CUS-3378712515,2018-10-29,Kimberly,F,-37.74,145.45,,,,,,,debit,posted,ea694513e7ed4437909ffa4425952ae7,PAYMENT,20-30,2018,10,29,17,0,Monday,7 days,55263.086
ACC-4258502723,24,16.91,5447.14,1.0,CUS-3378712515,2018-10-29,Kimberly,F,-37.74,145.45,,1ac9bf19-2ef1-483c-aad6-f3318830519d,-37.88,145.22,VIC,Wantirna South,debit,authorized,a556152fe378405d8ab9bccfdebdf750,POS,20-30,2018,10,29,20,47,Monday,7 days,55263.086
ACC-4258502723,24,16.55,5430.59,1.0,CUS-3378712515,2018-10-30,Kimberly,F,-37.74,145.45,,b1f41d62-13e9-4ffc-8e4e-e581edab341e,-37.68,145.01,VIC,Thomastown,debit,authorized,e324297682854b08b98c2b700a83aca8,SALES-POS,20-30,2018,10,30,10,16,Tuesday,7 days,55263.086
ACC-4258502723,24,7.29,5423.3,1.0,CUS-3378712515,2018-10-30,Kimberly,F,-37.74,145.45,,a4f857ff-bb40-40c6-8bdb-b1af3d6464c1,-37.81,144.97,VIC,Melbourne,debit,authorized,ff7345e3f69c43229caa4f99eea0bbb2,POS,20-30,2018,10,30,21,7,Tuesday,7 days,55263.086
ACC-4258502723,24,11.63,5411.67,1.0,CUS-3378712515,2018-10-30,Kimberly,F,-37.74,145.45,,9b63be51-6f08-4f3d-81a3-064465141e7d,-37.77,144.99,VIC,Northcote,debit,authorized,3c197446f65c48d7ab53b854df04c038,SALES-POS,20-30,2018,10,30,22,9,Tuesday,7 days,55263.086
ACC-2890243754,37,24.77,275.93,0.0,CUS-2695611575,2018-08-01,Joseph,M,-27.93,153.32,,7e8bf667-e724-4359-a406-3538a3e27b4e,-28.81,153.28,NSW,Lismore,debit,authorized,1f12467d33ce4609890fb64978ebbcbb,POS,30-40,2018,8,1,8,19,Wednesday,7 days,47838.464
ACC-2890243754,37,52.0,223.93,,CUS-2695611575,2018-08-02,Joseph,M,-27.93,153.32,,,,,,,debit,posted,c4c8649383e84c5ba4274e9226d42efa,PAYMENT,30-40,2018,8,2,3,0,Thursday,7 days,47838.464
ACC-2890243754,37,18.0,205.93,,CUS-2695611575,2018-08-02,Joseph,M,-27.93,153.32,,,,,,,debit,posted,d58732b5d0e64c098b4f317ebf496ce1,PAYMENT,30-40,2018,8,2,5,0,Thursday,7 days,47838.464
ACC-2890243754,37,4.99,200.94,1.0,CUS-2695611575,2018-08-02,Joseph,M,-27.93,153.32,,026c8f57-2c11-4651-81fd-75fdd4305c00,-29.44,153.36,NSW,Yamba,debit,authorized,9a0fc559aa47424f87ca47b3d2e3d3eb,SALES-POS,30-40,2018,8,2,17,17,Thursday,7 days,47838.464
ACC-2890243754,37,15.61,185.33,0.0,CUS-2695611575,2018-08-03,Joseph,M,-27.93,153.32,,7bb1d766-64e1-49f8-92ef-28cae0beef1d,-27.95,153.4,QLD,Labrador,debit,authorized,00f70e758124442aac20bf5e10364930,POS,30-40,2018,8,3,1,20,Friday,7 days,47838.464
ACC-2890243754,37,21.25,164.08,1.0,CUS-2695611575,2018-08-03,Joseph,M,-27.93,153.32,,ecada98d-c7e0-46e5-855a-d704ad5917d6,-28.81,153.28,NSW,Lismore,debit,authorized,31aff0b099004cdeaa3ba777815865f7,SALES-POS,30-40,2018,8,3,7,23,Friday,7 days,47838.464
ACC-2890243754,37,9.49,154.59,1.0,CUS-2695611575,2018-08-03,Joseph,M,-27.93,153.32,,be8aa135-b3b8-4694-9024-c7cd4da1bdc2,-28.81,153.29,NSW,Lismore,debit,authorized,e3923a0a2cb64f879f40128673309ce6,POS,30-40,2018,8,3,10,25,Friday,7 days,47838.464
ACC-2890243754,37,12.38,1059.66,0.0,CUS-2695611575,2018-08-03,Joseph,M,-27.93,153.32,,2e4529be-02ba-44b9-b740-b3914eb04c0a,-28.82,153.33,NSW,Goonellabah,debit,authorized,ebe965ed2e754e58a44c14c338a0a2ac,SALES-POS,30-40,2018,8,3,20,54,Friday,7 days,47838.464
ACC-2890243754,37,10.38,1049.28,0.0,CUS-2695611575,2018-08-04,Joseph,M,-27.93,153.32,,93a49bbd-78ee-4227-b5ed-13e6dc8dd1c4,-27.91,153.39,QLD,Runaway Bay,debit,authorized,5e76841b07824983966b66f8e3d112c0,POS,30-40,2018,8,4,19,16,Saturday,7 days,47838.464
ACC-2890243754,37,6.11,1043.17,1.0,CUS-2695611575,2018-08-05,Joseph,M,-27.93,153.32,,023f7601-2795-4081-9ffe-3199ee4b49c2,-27.91,153.4,QLD,Runaway Bay,debit,authorized,ac72e63d4e2440a88c9b0b4c98e35142,SALES-POS,30-40,2018,8,5,18,23,Sunday,7 days,47838.464
ACC-2890243754,37,6.83,1036.34,1.0,CUS-2695611575,2018-08-05,Joseph,M,-27.93,153.32,,023f7601-2795-4081-9ffe-3199ee4b49c2,-27.91,153.4,QLD,Runaway Bay,debit,authorized,65d6d6fd77894414bf67fd5bcaf9026a,POS,30-40,2018,8,5,20,37,Sunday,7 days,47838.464
ACC-2890243754,37,78.97,957.37,0.0,CUS-2695611575,2018-08-07,Joseph,M,-27.93,153.32,,1755f299-52e5-4489-a5ce-d86c236a351c,-33.82,151.19,NSW,St Leonards,debit,authorized,5809bd636c2f42448ab020db99628b20,SALES-POS,30-40,2018,8,7,11,6,Tuesday,7 days,47838.464
ACC-2890243754,37,7.35,950.02,1.0,CUS-2695611575,2018-08-07,Joseph,M,-27.93,153.32,,3a12af3d-a155-4e6f-aaf0-24d4ad71a57d,-28.82,153.3,NSW,East Lismore,debit,authorized,ef1ee1b3547c43639451dbff289ab3fb,SALES-POS,30-40,2018,8,7,14,5,Tuesday,7 days,47838.464
ACC-2890243754,37,28.97,921.05,1.0,CUS-2695611575,2018-08-08,Joseph,M,-27.93,153.32,,86f6f266-ca2e-4a5e-b563-2a40bda8d2e0,-37.82,144.96,VIC,Melbourne,debit,authorized,2d76faa8e0014ecfaf3589af3c4f4f17,SALES-POS,30-40,2018,8,8,0,33,Wednesday,7 days,47838.464
ACC-2890243754,37,52.0,869.05,,CUS-2695611575,2018-08-09,Joseph,M,-27.93,153.32,,,,,,,debit,posted,cb3147c647f044738943e6cb98e14d22,PAYMENT,30-40,2018,8,9,3,0,Thursday,7 days,47838.464
ACC-2890243754,37,18.0,851.05,,CUS-2695611575,2018-08-09,Joseph,M,-27.93,153.32,,,,,,,debit,posted,082904810b004ca19917caa02add99de,PAYMENT,30-40,2018,8,9,5,0,Thursday,7 days,47838.464
ACC-2890243754,37,10.19,840.86,1.0,CUS-2695611575,2018-08-09,Joseph,M,-27.93,153.32,,c9aac2c8-cce7-42c4-b27b-292ff1c527de,-28.07,153.35,QLD,Tallai,debit,authorized,3af4d14a0b9c4dbf83d9e9f807a53a04,SALES-POS,30-40,2018,8,9,10,49,Thursday,7 days,47838.464
ACC-2890243754,37,6.39,834.47,1.0,CUS-2695611575,2018-08-10,Joseph,M,-27.93,153.32,,b9c7b802-1f1d-480c-9d0f-51f1a2b37af4,-29.43,153.33,NSW,Yamba,debit,authorized,9337909b572e429282f71ee6263bbae5,POS,30-40,2018,8,10,8,27,Friday,7 days,47838.464
ACC-2890243754,37,9.48,1742.44,1.0,CUS-2695611575,2018-08-10,Joseph,M,-27.93,153.32,,8fb514c9-4014-4875-876a-1028d2fb3890,-28.05,153.35,QLD,Worongary,debit,authorized,2a61165d225e43dfa69d51f56233cad0,SALES-POS,30-40,2018,8,10,14,4,Friday,7 days,47838.464
ACC-2890243754,37,41.48,1700.96,1.0,CUS-2695611575,2018-08-10,Joseph,M,-27.93,153.32,,7e0fa6aa-b48a-4d55-afed-ff2034fda51c,-27.39,153.07,QLD,Northgate,debit,authorized,1d3f15ccbd8048a59455836b27f49243,SALES-POS,30-40,2018,8,10,15,11,Friday,7 days,47838.464
ACC-2890243754,37,15.86,1685.1,0.0,CUS-2695611575,2018-08-11,Joseph,M,-27.93,153.32,,563c469e-e997-4b33-be52-8e44c9bd8292,-27.86,153.35,QLD,Hope Island,debit,authorized,5c55676a05b94d3dabe4e73bba57b013,POS,30-40,2018,8,11,4,49,Saturday,7 days,47838.464
ACC-2890243754,37,25.48,1659.62,1.0,CUS-2695611575,2018-08-11,Joseph,M,-27.93,153.32,,afd4176c-7426-4efe-947e-7e9f49af21c6,-28.08,153.36,QLD,Mudgeeraba,debit,authorized,870412b380aa44a58886f603ef651283,SALES-POS,30-40,2018,8,11,8,34,Saturday,7 days,47838.464
ACC-2890243754,37,42.77,1616.85,1.0,CUS-2695611575,2018-08-11,Joseph,M,-27.93,153.32,,040172a4-15b7-406c-80e6-cd502f0852c4,-31.96,115.88,WA,East Perth,debit,authorized,decf307cd802473c891683c48fc65454,POS,30-40,2018,8,11,13,20,Saturday,7 days,47838.464
ACC-2890243754,37,9.66,1607.19,0.0,CUS-2695611575,2018-08-11,Joseph,M,-27.93,153.32,,c8c21dd8-ec60-40b2-bded-8d7be0022c95,-27.97,153.41,QLD,Southport,debit,authorized,b0d4a9b6457f4d57993c0e8b63324e23,SALES-POS,30-40,2018,8,11,23,1,Saturday,7 days,47838.464
ACC-2890243754,37,8.79,1598.4,1.0,CUS-2695611575,2018-08-12,Joseph,M,-27.93,153.32,,159ac681-903d-4c31-aa81-7ab4febe4375,-28.08,153.38,QLD,Robina,debit,authorized,3958507f0a1c485980eec69f2ee03195,SALES-POS,30-40,2018,8,12,9,23,Sunday,7 days,47838.464
ACC-2890243754,37,105.47,1492.93,0.0,CUS-2695611575,2018-08-12,Joseph,M,-27.93,153.32,,6bbcd84f-2bd6-466b-9084-d0998fe887b2,-37.8,144.99,VIC,Collingwood,debit,authorized,824909582eec47c4bfd4fd059c4d85ea,SALES-POS,30-40,2018,8,12,11,16,Sunday,7 days,47838.464
ACC-2890243754,37,13.42,1479.51,1.0,CUS-2695611575,2018-08-12,Joseph,M,-27.93,153.32,,aef30de1-c67e-4ab7-8577-2931a4bf3c7e,-27.97,144.64,QLD,Yowah,debit,authorized,9c0d6147e64a491abb554f8196300567,POS,30-40,2018,8,12,11,53,Sunday,7 days,47838.464
ACC-2890243754,37,15.08,1464.43,0.0,CUS-2695611575,2018-08-13,Joseph,M,-27.93,153.32,,c597a99d-4f04-4f19-ac71-84a31d77cbba,-28.81,153.34,NSW,Goonellabah,debit,authorized,1f18f23f98e045a1a0eb917a289f927d,POS,30-40,2018,8,13,17,36,Monday,7 days,47838.464
ACC-2890243754,37,5.71,2168.17,0.0,CUS-2695611575,2018-08-18,Joseph,M,-27.93,153.32,,597a741f-68c7-4c24-baa5-c4ce755170b1,-27.49,153.03,QLD,Dutton Park,debit,authorized,23c347703a1f426abc7aaae63d461a35,SALES-POS,30-40,2018,8,18,18,23,Saturday,7 days,47838.464
ACC-2890243754,37,12.39,2155.78,1.0,CUS-2695611575,2018-08-18,Joseph,M,-27.93,153.32,,713f9e48-f582-4670-a6b1-ac3bed1d4d77,-27.49,153.07,QLD,Camp Hill,debit,authorized,4c9a97555a0445e5bec66389632756f9,SALES-POS,30-40,2018,8,18,19,14,Saturday,7 days,47838.464
ACC-2890243754,37,36.93,2118.85,1.0,CUS-2695611575,2018-08-18,Joseph,M,-27.93,153.32,,9f3481c2-1127-4297-8265-77286b963fc1,-28.08,153.41,QLD,Varsity Lakes,debit,authorized,ec4b9554be104f3ba168a9a49399d58e,SALES-POS,30-40,2018,8,18,21,29,Saturday,7 days,47838.464
ACC-2890243754,37,13.23,2105.62,1.0,CUS-2695611575,2018-08-18,Joseph,M,-27.93,153.32,,7230b09a-e32b-4e1d-af1c-c8b4a587064f,-28.01,153.43,QLD,Surfers Paradise,debit,authorized,aad1ce1c9b0547bc9b07145f45de2725,SALES-POS,30-40,2018,8,18,22,28,Saturday,7 days,47838.464
ACC-2890243754,37,10.73,2094.89,0.0,CUS-2695611575,2018-08-20,Joseph,M,-27.93,153.32,,6b6f922a-8f7b-4708-a8b8-4054423556da,-27.98,152.99,QLD,Beaudesert,debit,authorized,00be0bfc84c4472b9ec51cbb34793276,POS,30-40,2018,8,20,8,47,Monday,7 days,47838.464
ACC-2890243754,37,14.67,2080.22,1.0,CUS-2695611575,2018-08-20,Joseph,M,-27.93,153.32,,3aad442d-bce0-402c-b615-3c39af67a7a5,-27.95,153.39,QLD,Labrador,debit,authorized,dfa6454a2ad74b849fb106d8510f1b2d,POS,30-40,2018,8,20,11,50,Monday,7 days,47838.464
ACC-2890243754,37,9.36,2070.86,1.0,CUS-2695611575,2018-08-20,Joseph,M,-27.93,153.32,,d1f0a4db-a3f6-4b8a-8fa4-71c7bd6ca70c,-27.98,153.38,QLD,Ashmore,debit,authorized,215ebbb383684ad1b68db456ec802cac,POS,30-40,2018,8,20,13,20,Monday,7 days,47838.464
ACC-2890243754,37,9.44,2061.42,1.0,CUS-2695611575,2018-08-21,Joseph,M,-27.93,153.32,,6b6f922a-8f7b-4708-a8b8-4054423556da,-27.98,152.99,QLD,Beaudesert,debit,authorized,5f7f6f82d824480889b7e68c437c37ca,POS,30-40,2018,8,21,1,26,Tuesday,7 days,47838.464
ACC-2890243754,37,11.38,2050.04,1.0,CUS-2695611575,2018-08-21,Joseph,M,-27.93,153.32,,00097987-7795-4c01-92c7-66bf486bacca,-27.92,120.7,WA,Leinster,debit,authorized,7909f6374d5f409ab046b9e14eb8a23b,SALES-POS,30-40,2018,8,21,4,12,Tuesday,7 days,47838.464
ACC-2890243754,37,8.36,2041.68,1.0,CUS-2695611575,2018-08-21,Joseph,M,-27.93,153.32,,7a0f6cda-7672-4a2e-8ddc-8c88024575c5,-27.9,153.39,QLD,Coombabah,debit,authorized,ba520f716967407fa32bee4c4a294466,SALES-POS,30-40,2018,8,21,13,59,Tuesday,7 days,47838.464
ACC-2890243754,37,12.63,2029.05,1.0,CUS-2695611575,2018-08-21,Joseph,M,-27.93,153.32,,e73e8a23-5199-4197-b2de-2e67c6b196cd,-27.64,153.11,QLD,Logan Central,debit,authorized,f6fe653ec54245a4918fec45c68f6b86,SALES-POS,30-40,2018,8,21,18,13,Tuesday,7 days,47838.464
ACC-2890243754,37,7.37,2021.68,1.0,CUS-2695611575,2018-08-21,Joseph,M,-27.93,153.32,,92fe417d-f3c4-4f78-a0d8-31e1b51878c0,-28.11,153.36,QLD,Mudgeeraba,debit,authorized,00759f430c2842909f717f2688ec0e68,POS,30-40,2018,8,21,23,20,Tuesday,7 days,47838.464
ACC-2890243754,37,13.22,2008.46,1.0,CUS-2695611575,2018-08-22,Joseph,M,-27.93,153.32,,aef30de1-c67e-4ab7-8577-2931a4bf3c7e,-27.97,144.64,QLD,Yowah,debit,authorized,bdf1fc9d28764858afb7b98fd301ed6c,SALES-POS,30-40,2018,8,22,1,59,Wednesday,7 days,47838.464
ACC-2890243754,37,17.67,1990.79,1.0,CUS-2695611575,2018-08-22,Joseph,M,-27.93,153.32,,dd2927c4-ccc2-4aa7-be03-ca93ae8f77ad,-27.98,152.55,QLD,Aratula,debit,authorized,2b4c8f5895324a668df9ff02c9368205,SALES-POS,30-40,2018,8,22,8,15,Wednesday,7 days,47838.464
ACC-2890243754,37,8.71,1982.08,1.0,CUS-2695611575,2018-08-22,Joseph,M,-27.93,153.32,,0e15eea9-4cb7-4488-9770-07418b52745c,-28.04,153.43,QLD,Broadbeach,debit,authorized,505a0ad97ec94904a95bee5a24093c97,SALES-POS,30-40,2018,8,22,15,5,Wednesday,7 days,47838.464
ACC-2890243754,37,6.23,1975.85,0.0,CUS-2695611575,2018-08-22,Joseph,M,-27.93,153.32,,5a3d5cd5-8727-46ce-a599-5d51f1a10c41,-27.92,153.32,QLD,Oxenford,debit,authorized,fa42b80d50564b67bd21f41e9d0ddfcb,POS,30-40,2018,8,22,19,47,Wednesday,7 days,47838.464
ACC-2890243754,37,7.77,1968.08,1.0,CUS-2695611575,2018-08-22,Joseph,M,-27.93,153.32,,e7a45030-2dbf-44c5-bcb3-d0970bece74b,-27.98,152.55,QLD,Aratula,debit,authorized,fbb11f9b6a30428aa5ede2eee2411f5b,SALES-POS,30-40,2018,8,22,22,28,Wednesday,7 days,47838.464
ACC-2890243754,37,52.0,1916.08,,CUS-2695611575,2018-08-23,Joseph,M,-27.93,153.32,,,,,,,debit,posted,70267e2760d14be2b29106dba28cac0e,PAYMENT,30-40,2018,8,23,3,0,Thursday,7 days,47838.464
ACC-2890243754,37,18.0,1898.08,,CUS-2695611575,2018-08-23,Joseph,M,-27.93,153.32,,,,,,,debit,posted,f126ffd818d2423da712870f49ec1634,PAYMENT,30-40,2018,8,23,5,0,Thursday,7 days,47838.464
ACC-2890243754,37,16.96,1881.12,1.0,CUS-2695611575,2018-08-23,Joseph,M,-27.93,153.32,,23a87695-d818-44ad-a105-76d9e446a565,-27.59,153.28,QLD,Victoria Point,debit,authorized,54d8f95ad04f42739bffd7bbd3088a26,SALES-POS,30-40,2018,8,23,14,22,Thursday,7 days,47838.464
ACC-2890243754,37,166.0,1715.12,,CUS-2695611575,2018-08-24,Joseph,M,-27.93,153.32,,,,,,,debit,posted,eca626a191844cb58ceb4e73c95d1401,PAYMENT,30-40,2018,8,24,6,0,Friday,7 days,47838.464
ACC-2890243754,37,44.37,2588.2,0.0,CUS-2695611575,2018-08-25,Joseph,M,-27.93,153.32,,4c843dbc-0934-4af5-bacb-9a813503bb6d,-28.1,153.42,QLD,Burleigh Heads,debit,authorized,ed8b1f1457dd48ed933ab2fd474add92,SALES-POS,30-40,2018,8,25,2,19,Saturday,7 days,47838.464
ACC-2890243754,37,4.47,2583.73,0.0,CUS-2695611575,2018-08-25,Joseph,M,-27.93,153.32,,664250bc-4ca4-4fa3-9a6a-d55e1609e2e7,-27.96,153.38,QLD,Southport,debit,authorized,29838976aed14927aa4a204c85487899,POS,30-40,2018,8,25,4,3,Saturday,7 days,47838.464
ACC-2890243754,37,8.17,2575.56,1.0,CUS-2695611575,2018-08-25,Joseph,M,-27.93,153.32,,1c4d189b-15f8-4e6a-bf26-8c6e59804408,-27.88,151.27,QLD,Millmerran,debit,authorized,210577663f184f73a4bc2ae73cb6176c,POS,30-40,2018,8,25,8,29,Saturday,7 days,47838.464
ACC-2890243754,37,36.35,2539.21,1.0,CUS-2695611575,2018-08-25,Joseph,M,-27.93,153.32,,8d80c6be-943c-4061-841e-e3586f4e75c2,-28.03,153.43,QLD,Broadbeach,debit,authorized,f382dd7dbee9492199cf20fa5f3231a5,SALES-POS,30-40,2018,8,25,11,36,Saturday,7 days,47838.464
ACC-2890243754,37,127.0,2412.21,,CUS-2695611575,2018-08-26,Joseph,M,-27.93,153.32,,,,,,,debit,posted,b54d174934e5441198cbe05c05eac518,INTER BANK,30-40,2018,8,26,4,0,Sunday,7 days,47838.464
ACC-2890243754,37,5.76,2406.45,1.0,CUS-2695611575,2018-08-26,Joseph,M,-27.93,153.32,,c2fc1f3d-78c5-429b-97f3-78ac35f14b16,-27.61,153.3,QLD,Redland Bay,debit,authorized,22cb03e70d6d4166ad480c29e60085d6,SALES-POS,30-40,2018,8,26,10,47,Sunday,7 days,47838.464
ACC-2890243754,37,72.21,2334.24,0.0,CUS-2695611575,2018-08-26,Joseph,M,-27.93,153.32,,5488a5bd-eea0-4742-a97b-d4d0058253f6,-27.96,153.38,QLD,Southport,debit,authorized,cf9cf28e852b4ad793ea9a17f82e12e3,POS,30-40,2018,8,26,15,2,Sunday,7 days,47838.464
ACC-2890243754,37,18.27,2315.97,1.0,CUS-2695611575,2018-08-29,Joseph,M,-27.93,153.32,,6ad817d9-62c1-4ae0-b58e-250def5ff24f,-27.51,152.95,QLD,Kenmore,debit,authorized,30579056722640ca8f5aa6c2d5fc1932,POS,30-40,2018,8,29,14,29,Wednesday,7 days,47838.464
ACC-2890243754,37,47.08,2268.89,0.0,CUS-2695611575,2018-08-29,Joseph,M,-27.93,153.32,,b9970d9c-2621-4b85-b4eb-026aa612e696,-27.49,152.98,QLD,Taringa,debit,authorized,b626d24307f545a58d69274631daf1a2,SALES-POS,30-40,2018,8,29,15,2,Wednesday,7 days,47838.464
ACC-2890243754,37,7.74,2261.15,1.0,CUS-2695611575,2018-08-30,Joseph,M,-27.93,153.32,,de87aafc-b17e-4d34-ac3f-4eeb8053a6fe,-27.97,153.41,QLD,Southport,debit,authorized,c657c78bad6740f1bdeaca02011cf674,POS,30-40,2018,8,30,0,34,Thursday,7 days,47838.464
ACC-2890243754,37,52.0,2209.15,,CUS-2695611575,2018-08-30,Joseph,M,-27.93,153.32,,,,,,,debit,posted,bbbe28de413d4215b47453e6574cd74f,PAYMENT,30-40,2018,8,30,3,0,Thursday,7 days,47838.464
ACC-2890243754,37,5.93,2203.22,1.0,CUS-2695611575,2018-08-30,Joseph,M,-27.93,153.32,,58599f43-0a48-4767-be62-36ff44cee853,-28.08,153.39,QLD,Robina,debit,authorized,4d05e8f8c4ac4d0fb8f371106d3e0c4f,POS,30-40,2018,8,30,4,1,Thursday,7 days,47838.464
ACC-2890243754,37,18.0,2185.22,,CUS-2695611575,2018-08-30,Joseph,M,-27.93,153.32,,,,,,,debit,posted,843c371ea0da4c1486fa82de925279cd,PAYMENT,30-40,2018,8,30,5,0,Thursday,7 days,47838.464
ACC-2890243754,37,16.01,2169.21,0.0,CUS-2695611575,2018-08-30,Joseph,M,-27.93,153.32,,7fd1b176-d418-4ba9-959f-320e20a3ae05,-37.95,145.04,VIC,Highett,debit,authorized,473e41a5158c4694a36fc27173ebe277,SALES-POS,30-40,2018,8,30,6,55,Thursday,7 days,47838.464
ACC-2890243754,37,8.66,2160.55,1.0,CUS-2695611575,2018-08-30,Joseph,M,-27.93,153.32,,0a8608b7-efba-401b-b675-e17c4a802ba4,-28.03,153.43,QLD,Broadbeach,debit,authorized,c4f9a5088d9e4bd7b7bae28f7d3d5ea6,SALES-POS,30-40,2018,8,30,11,35,Thursday,7 days,47838.464
ACC-2890243754,37,31.37,2129.18,1.0,CUS-2695611575,2018-08-31,Joseph,M,-27.93,153.32,,fa9e019d-037f-4d0e-8c55-29383b059b1f,-27.98,153.38,QLD,Ashmore,debit,authorized,40f0f471a73c4136a11038edc05ce742,POS,30-40,2018,8,31,4,5,Friday,7 days,47838.464
ACC-2890243754,37,20.85,3025.78,0.0,CUS-2695611575,2018-09-02,Joseph,M,-27.93,153.32,,981c64c8-5e95-451b-9d4c-8a19e8b4f999,-28.12,153.47,QLD,Palm Beach,debit,authorized,866d5e4cb76346859c7238702652e370,POS,30-40,2018,9,2,10,56,Sunday,7 days,47838.464
ACC-2890243754,37,7.73,3018.05,1.0,CUS-2695611575,2018-09-02,Joseph,M,-27.93,153.32,,dee29734-d544-4e69-a6ef-4e923632c8a4,-27.49,153,QLD,Saint Lucia,debit,authorized,0e16023e6d9c457889c749986020791e,POS,30-40,2018,9,2,11,12,Sunday,7 days,47838.464
ACC-2890243754,37,8.25,3009.8,1.0,CUS-2695611575,2018-09-02,Joseph,M,-27.93,153.32,,8a0e9a21-4360-4421-8aac-9af5114c9cda,-28.08,153.39,QLD,Robina,debit,authorized,cd7abb7bba0c4a5a971ea30dd717e056,POS,30-40,2018,9,2,21,47,Sunday,7 days,47838.464
ACC-2890243754,37,19.89,2989.91,1.0,CUS-2695611575,2018-09-03,Joseph,M,-27.93,153.32,,663064e6-36b7-4a9e-803c-4bb8339491d6,-28.04,153.43,QLD,Broadbeach,debit,authorized,2bf9786b891142acb5e3e413a00a837e,POS,30-40,2018,9,3,1,25,Monday,7 days,47838.464
ACC-2890243754,37,7.75,2982.16,1.0,CUS-2695611575,2018-09-04,Joseph,M,-27.93,153.32,,06ff0a88-3635-4f3a-9427-57c0b973449c,-28.06,153.39,QLD,Robina,debit,authorized,8a0a062221ca44e7a2d944585e730cb3,SALES-POS,30-40,2018,9,4,11,20,Tuesday,7 days,47838.464
ACC-2890243754,37,7.78,2974.38,1.0,CUS-2695611575,2018-09-04,Joseph,M,-27.93,153.32,,24499ec9-83d4-48f9-8944-976018db1212,-27.97,153.4,QLD,Labrador,debit,authorized,8fcbec6a9a344cb4ab3de94cb27b1391,POS,30-40,2018,9,4,15,0,Tuesday,7 days,47838.464
ACC-2890243754,37,16.0,2958.38,1.0,CUS-2695611575,2018-09-04,Joseph,M,-27.93,153.32,,8d7196ad-1377-4169-b035-42cbf36a7907,-27.93,153.34,QLD,Helensvale,debit,authorized,c354ee18c3b241a1a1dad7a705ab13cc,SALES-POS,30-40,2018,9,4,15,23,Tuesday,7 days,47838.464
ACC-2890243754,37,9.58,2948.8,1.0,CUS-2695611575,2018-09-05,Joseph,M,-27.93,153.32,,bb8d08e9-10fc-4701-950e-5ef734b10e22,-29.44,153.34,NSW,Yamba,debit,authorized,7bb4998079d44e4e801c7a64256d47e1,POS,30-40,2018,9,5,9,20,Wednesday,7 days,47838.464
ACC-2890243754,37,16.27,2932.53,0.0,CUS-2695611575,2018-09-05,Joseph,M,-27.93,153.32,,830a451c-316e-4a6a-bf25-e37caedca49e,-33.87,151.21,NSW,Sydney,debit,authorized,bece5b5853944702a6894dda7210b730,POS,30-40,2018,9,5,11,57,Wednesday,7 days,47838.464
ACC-2890243754,37,52.0,2880.53,,CUS-2695611575,2018-09-06,Joseph,M,-27.93,153.32,,,,,,,debit,posted,5ea91f237d794d8e8cfab9528072bd0f,PAYMENT,30-40,2018,9,6,3,0,Thursday,7 days,47838.464
ACC-2890243754,37,51.37,2829.16,1.0,CUS-2695611575,2018-09-06,Joseph,M,-27.93,153.32,,c50f2e29-5fb5-4ac5-a2ea-1ae575443069,-33.88,151.21,NSW,Haymarket,debit,authorized,e0dfdc8b50a142999538f3cb66eb384e,SALES-POS,30-40,2018,9,6,4,6,Thursday,7 days,47838.464
ACC-2890243754,37,18.0,2811.16,,CUS-2695611575,2018-09-06,Joseph,M,-27.93,153.32,,,,,,,debit,posted,e12de1a44d6e404e8432ff94f57e3387,PAYMENT,30-40,2018,9,6,5,0,Thursday,7 days,47838.464
ACC-2890243754,37,9.93,2801.23,1.0,CUS-2695611575,2018-09-06,Joseph,M,-27.93,153.32,,8963ac9d-dbeb-46fc-997a-3a03d3925ba1,-27.99,153.34,QLD,Nerang,debit,authorized,d9803321b06940a4ba5ff65a19620fdb,POS,30-40,2018,9,6,9,22,Thursday,7 days,47838.464
ACC-2890243754,37,12.12,2789.11,1.0,CUS-2695611575,2018-09-06,Joseph,M,-27.93,153.32,,46f68654-3694-4f07-8b74-3cd1b74d7e4d,-28.04,153.43,QLD,Broadbeach,debit,authorized,31bc577eb6a14be2a80c02e149ae6d7f,POS,30-40,2018,9,6,13,47,Thursday,7 days,47838.464
ACC-2890243754,37,8.39,2780.72,0.0,CUS-2695611575,2018-09-06,Joseph,M,-27.93,153.32,,1c4d189b-15f8-4e6a-bf26-8c6e59804408,-27.88,151.27,QLD,Millmerran,debit,authorized,28c3516c59b547ed98a30278f659a9d2,POS,30-40,2018,9,6,17,26,Thursday,7 days,47838.464
ACC-2890243754,37,10.38,2770.34,1.0,CUS-2695611575,2018-09-06,Joseph,M,-27.93,153.32,,638ec592-e6a7-48b7-b7ca-5ae099d60f4f,-28.08,153.39,QLD,Robina,debit,authorized,cf30a490fd644a70b947c3759757a30e,SALES-POS,30-40,2018,9,6,19,25,Thursday,7 days,47838.464
ACC-2890243754,37,5.82,2764.52,1.0,CUS-2695611575,2018-09-07,Joseph,M,-27.93,153.32,,2d97d1a1-92ea-4475-b8aa-c3261eb1fcc4,-27.49,152.98,QLD,Taringa,debit,authorized,5d137701e0ce44a4aa99eb5f76811201,SALES-POS,30-40,2018,9,7,9,26,Friday,7 days,47838.464
ACC-2890243754,37,27.09,2737.43,1.0,CUS-2695611575,2018-09-07,Joseph,M,-27.93,153.32,,bbc37d9f-7125-44f4-bce3-bed20778d75a,-27.91,153.4,QLD,Runaway Bay,debit,authorized,01fe04501a66420aa7f2fe3e5e76d132,SALES-POS,30-40,2018,9,7,11,55,Friday,7 days,47838.464
ACC-2890243754,37,3.75,3651.13,1.0,CUS-2695611575,2018-09-07,Joseph,M,-27.93,153.32,,d9642f09-08df-4ac6-bc92-3ba4d45784e1,-27.97,153.42,QLD,Southport,debit,authorized,9f144d879be14c85858655be146a4dd4,POS,30-40,2018,9,7,14,39,Friday,7 days,47838.464
ACC-2890243754,37,121.58,3529.55,1.0,CUS-2695611575,2018-09-08,Joseph,M,-27.93,153.32,,976e9595-fdf4-4662-aaf2-476681a0291f,-33.87,151.2,NSW,Sydney,debit,authorized,ae9aab2393cb41ec82537dc66b3c871a,POS,30-40,2018,9,8,19,19,Saturday,7 days,47838.464
ACC-2890243754,37,48.11,3481.44,1.0,CUS-2695611575,2018-09-08,Joseph,M,-27.93,153.32,,6c8d61b1-eb6a-42d3-9a02-dd87e6deb70b,-27.97,153.4,QLD,Southport,debit,authorized,7e74decf04664d1abcfb67b896388c64,SALES-POS,30-40,2018,9,8,21,33,Saturday,7 days,47838.464
ACC-2890243754,37,6.7,3474.74,1.0,CUS-2695611575,2018-09-08,Joseph,M,-27.93,153.32,,be172563-5944-47ae-ad39-c01576a33450,-37.82,144.97,VIC,Melbourne,debit,authorized,aa8bf9490346478d921086d4c6f9c7bc,SALES-POS,30-40,2018,9,8,21,43,Saturday,7 days,47838.464
ACC-2890243754,37,16.34,3458.4,1.0,CUS-2695611575,2018-09-08,Joseph,M,-27.93,153.32,,bde60467-effb-4a93-bdf3-6e84ef38156b,-28.82,153.33,NSW,Goonellabah,debit,authorized,1f6fc0ad59514bf2b13edd85136068e2,SALES-POS,30-40,2018,9,8,22,32,Saturday,7 days,47838.464
ACC-2890243754,37,9.21,3449.19,0.0,CUS-2695611575,2018-09-08,Joseph,M,-27.93,153.32,,85ce7f6f-63f0-4a59-8e8b-b0353ee225a7,-27.93,153.39,QLD,Biggera Waters,debit,authorized,644f41df623e480f8acc2ed2a95d37f9,SALES-POS,30-40,2018,9,8,22,46,Saturday,7 days,47838.464
ACC-2890243754,37,7.34,3441.85,1.0,CUS-2695611575,2018-09-09,Joseph,M,-27.93,153.32,,3ae539ca-2824-413c-b978-e87360b047ea,-27.91,153.4,QLD,Runaway Bay,debit,authorized,7ac8327ec5e04005bd57c49b5264ac5f,SALES-POS,30-40,2018,9,9,1,19,Sunday,7 days,47838.464
ACC-2890243754,37,17.89,3423.96,1.0,CUS-2695611575,2018-09-09,Joseph,M,-27.93,153.32,,dd2927c4-ccc2-4aa7-be03-ca93ae8f77ad,-27.98,152.55,QLD,Aratula,debit,authorized,5c089d83c72e4dc9b01dec3dafdb0588,POS,30-40,2018,9,9,1,52,Sunday,7 days,47838.464
ACC-2890243754,37,46.27,3377.69,0.0,CUS-2695611575,2018-09-09,Joseph,M,-27.93,153.32,,46b3cce9-e6d0-4d6e-9313-c37b632d9227,-28.08,153.38,QLD,Robina,debit,authorized,8e6edd74502948a086c3e8102b7f698b,POS,30-40,2018,9,9,8,25,Sunday,7 days,47838.464
ACC-2890243754,37,18.44,3359.25,1.0,CUS-2695611575,2018-09-09,Joseph,M,-27.93,153.32,,663064e6-36b7-4a9e-803c-4bb8339491d6,-28.04,153.43,QLD,Broadbeach,debit,authorized,6f28269363344a1495920894a62acd7e,POS,30-40,2018,9,9,9,57,Sunday,7 days,47838.464
ACC-2890243754,37,76.96,3282.29,1.0,CUS-2695611575,2018-09-09,Joseph,M,-27.93,153.32,,e67cbcbd-e44b-4cf0-b318-30827a7425af,-37.82,144.95,VIC,Docklands,debit,authorized,ed69e206a8e74fb1a650cee666fdb90d,SALES-POS,30-40,2018,9,9,10,50,Sunday,7 days,47838.464
ACC-2890243754,37,15.82,3266.47,1.0,CUS-2695611575,2018-09-09,Joseph,M,-27.93,153.32,,fec186f5-66e5-4c1c-ab30-8433fd33ab70,-33.89,151.2,NSW,Chippendale,debit,authorized,fcd3cde093a442cb89fe88243db624cf,SALES-POS,30-40,2018,9,9,21,30,Sunday,7 days,47838.464
ACC-2890243754,37,11.86,3254.61,1.0,CUS-2695611575,2018-09-09,Joseph,M,-27.93,153.32,,70dfd5b8-2c05-4c08-8e9d-aac53cfa74fb,-27.49,153.04,QLD,Woolloongabba,debit,authorized,63b0763e111c403ba7b23c1fc6555ca5,SALES-POS,30-40,2018,9,9,22,44,Sunday,7 days,47838.464
ACC-2890243754,37,9.33,3245.28,0.0,CUS-2695611575,2018-09-09,Joseph,M,-27.93,153.32,,aae937a5-5887-4245-8042-0d5662aa2a38,-28.04,153.44,QLD,Mermaid Beach,debit,authorized,7d7e9802f657474284c49737e54667f7,SALES-POS,30-40,2018,9,9,23,5,Sunday,7 days,47838.464
ACC-2890243754,37,17.33,3227.95,1.0,CUS-2695611575,2018-09-10,Joseph,M,-27.93,153.32,,c4ab07ea-6c0a-40e4-a23c-aee19b347d6c,-28.08,153.37,QLD,Mudgeeraba,debit,authorized,0d6134b4470f48bd9bb6a4ac1e51494a,SALES-POS,30-40,2018,9,10,9,1,Monday,7 days,47838.464
ACC-2890243754,37,19.27,3208.68,0.0,CUS-2695611575,2018-09-10,Joseph,M,-27.93,153.32,,a7385530-4f23-4213-a86f-b46203b65374,-28.04,153.43,QLD,Broadbeach Waters,debit,authorized,1549503d28d04b57a71ad13c2a5f6ef8,POS,30-40,2018,9,10,18,49,Monday,7 days,47838.464
ACC-2890243754,37,21.58,3187.1,1.0,CUS-2695611575,2018-09-10,Joseph,M,-27.93,153.32,,1b8eb87e-5b88-4628-a7fa-1a414a0a5888,-28.1,153.44,QLD,Burleigh Heads,debit,authorized,907f009d7188453a8ea8407d93120e0b,POS,30-40,2018,9,10,21,43,Monday,7 days,47838.464
ACC-2890243754,37,6.09,3181.01,1.0,CUS-2695611575,2018-09-10,Joseph,M,-27.93,153.32,,c9c60926-5ca5-4e56-9085-c4b4ac429141,-29.07,153.34,NSW,Woodburn,debit,authorized,a066a61a1c28477fbc6cef7f0f62fcf4,SALES-POS,30-40,2018,9,10,21,56,Monday,7 days,47838.464
ACC-2890243754,37,52.0,3129.01,,CUS-2695611575,2018-09-13,Joseph,M,-27.93,153.32,,,,,,,debit,posted,e22667c353aa4a8a9039b35960ad0409,PAYMENT,30-40,2018,9,13,3,0,Thursday,7 days,47838.464
ACC-2890243754,37,18.0,3111.01,,CUS-2695611575,2018-09-13,Joseph,M,-27.93,153.32,,,,,,,debit,posted,75b0e29e6e864103b7fc804a263a81b6,PAYMENT,30-40,2018,9,13,5,0,Thursday,7 days,47838.464
ACC-2890243754,37,5.51,3105.5,1.0,CUS-2695611575,2018-09-13,Joseph,M,-27.93,153.32,,05a0ae1a-11ae-4407-8759-dcf2eaa2fe0d,-27.96,153.41,QLD,Southport,debit,authorized,d935fee0da664cfabef9b7c5a94a6d1c,SALES-POS,30-40,2018,9,13,11,44,Thursday,7 days,47838.464
ACC-2890243754,37,11.59,3093.91,1.0,CUS-2695611575,2018-09-13,Joseph,M,-27.93,153.32,,58ca4138-eccc-44ed-b9f4-89f52f586b07,-27.94,153.4,QLD,Biggera Waters,debit,authorized,345b0d694f4745efbd39946c522712b1,POS,30-40,2018,9,13,11,53,Thursday,7 days,47838.464
ACC-2890243754,37,3.7,4007.66,0.0,CUS-2695611575,2018-09-16,Joseph,M,-27.93,153.32,,ccd5a4a3-4226-4a54-a21d-4855be23e33a,-27.95,153.2,QLD,Tamborine Mountain,debit,authorized,998bb443b67444948d17ab69cdbd7d41,SALES-POS,30-40,2018,9,16,14,11,Sunday,7 days,47838.464
ACC-2890243754,37,3.9,4003.76,1.0,CUS-2695611575,2018-09-16,Joseph,M,-27.93,153.32,,d304c1c8-d745-4ec3-916c-b550f337da0e,-27.96,153.41,QLD,Southport,debit,authorized,e551af6f70c64c4d9443e1d6a6e619a9,POS,30-40,2018,9,16,15,51,Sunday,7 days,47838.464
ACC-2890243754,37,32.3,3971.46,1.0,CUS-2695611575,2018-09-16,Joseph,M,-27.93,153.32,,51c48fe8-7f8d-4b1d-9c51-a76202af058f,-27.56,151.95,QLD,Toowoomba City,debit,authorized,01b75203b68a4403a411b16238d369ec,SALES-POS,30-40,2018,9,16,20,44,Sunday,7 days,47838.464
ACC-2890243754,37,138.0,3833.46,,CUS-2695611575,2018-09-16,Joseph,M,-27.93,153.32,,,,,,,debit,posted,4b4418d1d1894261bc8ff0d892b27a31,PAYMENT,30-40,2018,9,16,21,0,Sunday,7 days,47838.464
ACC-2890243754,37,11.63,3821.83,1.0,CUS-2695611575,2018-09-17,Joseph,M,-27.93,153.32,,a7df322f-dfe8-48cc-855b-c0659f039b92,-27.97,153.41,QLD,Southport,debit,authorized,fad49555c3d14302ad82c1eb5824d1cf,SALES-POS,30-40,2018,9,17,10,13,Monday,7 days,47838.464
ACC-2890243754,37,14.91,3806.92,1.0,CUS-2695611575,2018-09-17,Joseph,M,-27.93,153.32,,3a34050c-5a24-497c-a27f-1b2924c898bd,-27.96,153.38,QLD,Parkwood,debit,authorized,c06abedf67fa4b93b98f7fc84fc7bf96,SALES-POS,30-40,2018,9,17,14,35,Monday,7 days,47838.464
ACC-2890243754,37,23.84,3783.08,1.0,CUS-2695611575,2018-09-18,Joseph,M,-27.93,153.32,,78efdc7f-9740-4b1f-a08f-d9961b2608a7,-27.89,153.31,QLD,Oxenford,debit,authorized,1832e2e5aab0457cbccdbdd573d0fe6e,POS,30-40,2018,9,18,11,13,Tuesday,7 days,47838.464
ACC-2890243754,37,52.0,3731.08,,CUS-2695611575,2018-09-20,Joseph,M,-27.93,153.32,,,,,,,debit,posted,ab5e56ef24a1493fb9582578ff7d994f,PAYMENT,30-40,2018,9,20,3,0,Thursday,7 days,47838.464
ACC-2890243754,37,18.0,3713.08,,CUS-2695611575,2018-09-20,Joseph,M,-27.93,153.32,,,,,,,debit,posted,7082d3a8837d493dacfab7a9d231da31,PAYMENT,30-40,2018,9,20,5,0,Thursday,7 days,47838.464
ACC-2890243754,37,18.03,4612.5,1.0,CUS-2695611575,2018-09-22,Joseph,M,-27.93,153.32,,dd2927c4-ccc2-4aa7-be03-ca93ae8f77ad,-27.98,152.55,QLD,Aratula,debit,authorized,07d06d785ace477faed0b6e34ea81874,SALES-POS,30-40,2018,9,22,5,4,Saturday,7 days,47838.464
ACC-2890243754,37,8.76,4603.74,1.0,CUS-2695611575,2018-09-22,Joseph,M,-27.93,153.32,,0680bf59-f888-4497-abb0-51caf22f7aa9,-28.04,153.43,QLD,Broadbeach,debit,authorized,cce1372e7b5842e5b5328405731ac538,POS,30-40,2018,9,22,9,15,Saturday,7 days,47838.464
ACC-2890243754,37,22.15,4581.59,1.0,CUS-2695611575,2018-09-22,Joseph,M,-27.93,153.32,,4fed93ab-f622-4e44-b7ca-8dcdd6b43e35,-28.04,153.43,QLD,Broadbeach,debit,authorized,279e2806911c422e9c5e6176edd8ab14,SALES-POS,30-40,2018,9,22,11,0,Saturday,7 days,47838.464
ACC-2890243754,37,13.8,4567.79,1.0,CUS-2695611575,2018-09-22,Joseph,M,-27.93,153.32,,6d2d226a-71f5-4f0d-8d84-1f1cc999470a,-27.93,153.39,QLD,Biggera Waters,debit,authorized,ae59326ef4d74f5ba32c7790529eb354,POS,30-40,2018,9,22,11,8,Saturday,7 days,47838.464
ACC-2890243754,37,8.62,4559.17,1.0,CUS-2695611575,2018-09-22,Joseph,M,-27.93,153.32,,24499ec9-83d4-48f9-8944-976018db1212,-27.97,153.4,QLD,Labrador,debit,authorized,fe089104f0ac43a88097abdc57b8aaa3,POS,30-40,2018,9,22,11,46,Saturday,7 days,47838.464
ACC-2890243754,37,14.75,4544.42,1.0,CUS-2695611575,2018-09-22,Joseph,M,-27.93,153.32,,b16fad42-e29d-461c-9b88-207d0cbee2d8,-27.51,153.03,QLD,Annerley,debit,authorized,84ff342abd16406d99f04f5eb7fbdc70,SALES-POS,30-40,2018,9,22,12,3,Saturday,7 days,47838.464
ACC-2890243754,37,9.75,4534.67,0.0,CUS-2695611575,2018-09-22,Joseph,M,-27.93,153.32,,98be2e04-ead8-4457-9f0a-18a63ec28153,-27.49,153.02,QLD,Highgate Hill,debit,authorized,0c6549ed5e14416ba28671004a5bad19,POS,30-40,2018,9,22,21,13,Saturday,7 days,47838.464
ACC-2890243754,37,13.85,4520.82,0.0,CUS-2695611575,2018-09-23,Joseph,M,-27.93,153.32,,07f96769-de90-4ca7-b636-db4df8bd9587,-28.03,153.43,QLD,Broadbeach,debit,authorized,b68d246878db4ec8b3b748acf0e24cec,POS,30-40,2018,9,23,2,50,Sunday,7 days,47838.464
ACC-2890243754,37,166.0,4354.82,,CUS-2695611575,2018-09-24,Joseph,M,-27.93,153.32,,,,,,,debit,posted,e358621781bc4e4eb57600a551bf00b1,PAYMENT,30-40,2018,9,24,6,0,Monday,7 days,47838.464
ACC-2890243754,37,74.76,4280.06,1.0,CUS-2695611575,2018-09-24,Joseph,M,-27.93,153.32,,5488a5bd-eea0-4742-a97b-d4d0058253f6,-27.96,153.38,QLD,Southport,debit,authorized,0dc9d0fa618a4fb7bbf73e42d7afffdd,SALES-POS,30-40,2018,9,24,9,56,Monday,7 days,47838.464
ACC-2890243754,37,14.6,4265.46,1.0,CUS-2695611575,2018-09-24,Joseph,M,-27.93,153.32,,7ce1c5c7-35c2-4a82-8002-e1d8040cba33,-28.1,153.43,QLD,Burleigh Waters,debit,authorized,e9e8863bb71e4217ac7156e598d6159e,POS,30-40,2018,9,24,10,0,Monday,7 days,47838.464
ACC-2890243754,37,6.95,4258.51,1.0,CUS-2695611575,2018-09-24,Joseph,M,-27.93,153.32,,c81f9513-0787-45b5-a956-ae58d2c1f89b,-28.01,153.43,QLD,Surfers Paradise,debit,authorized,370c1a7cc2474c8dae8d02f316a3d8b4,SALES-POS,30-40,2018,9,24,14,46,Monday,7 days,47838.464
ACC-2890243754,37,11.52,4246.99,1.0,CUS-2695611575,2018-09-24,Joseph,M,-27.93,153.32,,00097987-7795-4c01-92c7-66bf486bacca,-27.92,120.7,WA,Leinster,debit,authorized,718e3f9351fd48ba96073d834859ad07,POS,30-40,2018,9,24,21,2,Monday,7 days,47838.464
ACC-2890243754,37,40.98,4206.01,1.0,CUS-2695611575,2018-09-24,Joseph,M,-27.93,153.32,,e2275783-0f73-40fa-a54f-e589b176e0ae,-28.11,153.42,QLD,Burleigh Heads,debit,authorized,51010db6d96e4edcb8a6915389ae9522,SALES-POS,30-40,2018,9,24,22,0,Monday,7 days,47838.464
ACC-2890243754,37,14.18,4191.83,0.0,CUS-2695611575,2018-09-25,Joseph,M,-27.93,153.32,,aef30de1-c67e-4ab7-8577-2931a4bf3c7e,-27.97,144.64,QLD,Yowah,debit,authorized,b329ae7d06d24a1bbd7740cd2d3fead9,POS,30-40,2018,9,25,9,36,Tuesday,7 days,47838.464
ACC-2890243754,37,8.99,4182.84,0.0,CUS-2695611575,2018-09-25,Joseph,M,-27.93,153.32,,c8a9f03d-ea29-4aca-ac45-d595d830dbd8,-27.97,153.4,QLD,Southport,debit,authorized,d49e37b4d72046e0b4f9f33804d2c005,POS,30-40,2018,9,25,10,40,Tuesday,7 days,47838.464
ACC-2890243754,37,18.11,4164.73,1.0,CUS-2695611575,2018-09-25,Joseph,M,-27.93,153.32,,7deda505-d941-43ac-9d5e-f866d57dcc4e,-27.93,153.34,QLD,Helensvale,debit,authorized,6ede07811d31414490d7884c2d3277e2,SALES-POS,30-40,2018,9,25,11,7,Tuesday,7 days,47838.464
ACC-2890243754,37,12.48,4152.25,1.0,CUS-2695611575,2018-09-25,Joseph,M,-27.93,153.32,,d4eb82d5-9f02-4a97-8d9a-381a8bbd748f,-28.1,153.46,QLD,Palm Beach,debit,authorized,519477b733b3420cbb08c55a6c0f3fa4,SALES-POS,30-40,2018,9,25,11,51,Tuesday,7 days,47838.464
ACC-2890243754,37,3.21,4149.04,1.0,CUS-2695611575,2018-09-25,Joseph,M,-27.93,153.32,,1c507e4f-e0cb-424a-9ee4-ac3a102707cc,-27.48,152.99,QLD,Toowong,debit,authorized,d784f329ead546cfa82082269a7dc63d,POS,30-40,2018,9,25,14,51,Tuesday,7 days,47838.464
ACC-2890243754,37,7.41,4141.63,1.0,CUS-2695611575,2018-09-25,Joseph,M,-27.93,153.32,,5596adaf-2458-429c-8f3f-97413462dcde,-28.03,153.43,QLD,Broadbeach,debit,authorized,f0f127dd8a1049f9bb65dd458d365dc9,POS,30-40,2018,9,25,15,40,Tuesday,7 days,47838.464
ACC-2890243754,37,6.67,4134.96,1.0,CUS-2695611575,2018-09-25,Joseph,M,-27.93,153.32,,c81f9513-0787-45b5-a956-ae58d2c1f89b,-28.01,153.43,QLD,Surfers Paradise,debit,authorized,0e102ff746c748baac4ea20a995598d1,POS,30-40,2018,9,25,20,21,Tuesday,7 days,47838.464
ACC-2890243754,37,127.0,4007.96,,CUS-2695611575,2018-09-26,Joseph,M,-27.93,153.32,,,,,,,debit,posted,7826892bcdea47dbaf5787bb8066b42b,INTER BANK,30-40,2018,9,26,4,0,Wednesday,7 days,47838.464
ACC-2890243754,37,13.73,3994.23,1.0,CUS-2695611575,2018-09-26,Joseph,M,-27.93,153.32,,85f7ae83-20e3-44c8-88c0-bb1dc2de0061,-28.12,153.47,QLD,Palm Beach,debit,authorized,8ea10acf3f8046d09febbe8d96b580c2,POS,30-40,2018,9,26,12,11,Wednesday,7 days,47838.464
ACC-2890243754,37,11.24,3982.99,1.0,CUS-2695611575,2018-09-26,Joseph,M,-27.93,153.32,,4c43a2a9-8d6a-4827-9bfa-d9209b571785,-27.96,153.38,QLD,Parkwood,debit,authorized,e29b8c3fd024499f800d6ea3b35a98be,POS,30-40,2018,9,26,19,49,Wednesday,7 days,47838.464
ACC-2890243754,37,57.85,3925.14,1.0,CUS-2695611575,2018-09-26,Joseph,M,-27.93,153.32,,d076eb9a-abe5-4936-8182-d626bf62d504,-33.87,151.21,NSW,Sydney,debit,authorized,a59dd39ad00a4bc0b6d45ee06291319c,SALES-POS,30-40,2018,9,26,22,44,Wednesday,7 days,47838.464
ACC-2890243754,37,52.0,3873.14,,CUS-2695611575,2018-09-27,Joseph,M,-27.93,153.32,,,,,,,debit,posted,b991894a9dc5446e881540dd59d901fe,PAYMENT,30-40,2018,9,27,3,0,Thursday,7 days,47838.464
ACC-2890243754,37,18.0,3855.14,,CUS-2695611575,2018-09-27,Joseph,M,-27.93,153.32,,,,,,,debit,posted,5dbb464cf2674867b701d85633b7868e,PAYMENT,30-40,2018,9,27,5,0,Thursday,7 days,47838.464
ACC-2890243754,37,16.8,3838.34,1.0,CUS-2695611575,2018-09-27,Joseph,M,-27.93,153.32,,ee789377-3783-4757-968a-2e3726fc057e,-27.98,152.55,QLD,Aratula,debit,authorized,f5737d78503e47bea226f0e3dff4411d,SALES-POS,30-40,2018,9,27,9,6,Thursday,7 days,47838.464
ACC-2890243754,37,14.17,3824.17,1.0,CUS-2695611575,2018-09-28,Joseph,M,-27.93,153.32,,134b5145-433e-4237-be72-7d8f950c8fe6,-27.48,153.02,QLD,South Brisbane,debit,authorized,9cc9ba08e57842fd92308b4f7f1e9cb3,POS,30-40,2018,9,28,11,10,Friday,7 days,47838.464
ACC-2890243754,37,7.58,3816.59,1.0,CUS-2695611575,2018-09-28,Joseph,M,-27.93,153.32,,e7a45030-2dbf-44c5-bcb3-d0970bece74b,-27.98,152.55,QLD,Aratula,debit,authorized,7071ed64eb764b078ea9437f2d787dca,SALES-POS,30-40,2018,9,28,11,53,Friday,7 days,47838.464
ACC-2890243754,37,61.82,4672.22,1.0,CUS-2695611575,2018-09-28,Joseph,M,-27.93,153.32,,2524fe8b-0b41-460d-b7d6-77fdba54657d,-33.81,151.26,NSW,Clontarf,debit,authorized,0066f275a5d34b28b1cd2d2801ffa67a,POS,30-40,2018,9,28,13,38,Friday,7 days,47838.464
ACC-2890243754,37,6.79,4665.43,1.0,CUS-2695611575,2018-09-28,Joseph,M,-27.93,153.32,,05f5aac2-cb47-4f77-9db1-70621dd98caa,-27.96,153.38,QLD,Southport,debit,authorized,e52c192bcb6e42a68a28883855a37c92,SALES-POS,30-40,2018,9,28,19,47,Friday,7 days,47838.464
ACC-2890243754,37,27.24,4638.19,1.0,CUS-2695611575,2018-09-28,Joseph,M,-27.93,153.32,,165ae310-aa9e-43b6-b875-f996db6586bd,-27.47,153.03,QLD,Brisbane City,debit,authorized,b53c9c71298147008da1104e6039e5a5,POS,30-40,2018,9,28,21,15,Friday,7 days,47838.464
ACC-2890243754,37,6.14,4632.05,1.0,CUS-2695611575,2018-09-29,Joseph,M,-27.93,153.32,,d7c86774-b185-4a86-a713-4ef414c32101,-28.01,153.41,QLD,Bundall,debit,authorized,a43f0b4780af4685b55e3853bfc3baf2,SALES-POS,30-40,2018,9,29,13,58,Saturday,7 days,47838.464
ACC-2890243754,37,12.4,4619.65,1.0,CUS-2695611575,2018-09-29,Joseph,M,-27.93,153.32,,d49ce849-be19-4fe4-84df-299da4dc1fb3,-28.08,153.42,QLD,Burleigh Waters,debit,authorized,7fd084677de1421d868114559a3b4220,SALES-POS,30-40,2018,9,29,22,8,Saturday,7 days,47838.464
ACC-2890243754,37,11.16,4608.49,0.0,CUS-2695611575,2018-09-30,Joseph,M,-27.93,153.32,,dfa4627c-d38a-4f00-9e99-b9f5e77a35e3,-28.08,153.44,QLD,Miami,debit,authorized,61a89547d6c04774a2ad696f9ab87a1f,SALES-POS,30-40,2018,9,30,9,50,Sunday,7 days,47838.464
ACC-2890243754,37,8.33,4600.16,1.0,CUS-2695611575,2018-09-30,Joseph,M,-27.93,153.32,,cf2ac034-f61a-4c17-9312-09d5c68fecb3,-27.97,153.42,QLD,Southport,debit,authorized,6e61abc2c40c4726832dfbc6a71f806b,SALES-POS,30-40,2018,9,30,23,12,Sunday,7 days,47838.464
ACC-2890243754,37,14.25,4585.91,1.0,CUS-2695611575,2018-10-01,Joseph,M,-27.93,153.32,,aef30de1-c67e-4ab7-8577-2931a4bf3c7e,-27.97,144.64,QLD,Yowah,debit,authorized,1470a7d22ada4a41acbe14ad2c05d00b,POS,30-40,2018,10,1,9,41,Monday,7 days,47838.464
ACC-2890243754,37,17.33,4568.58,1.0,CUS-2695611575,2018-10-01,Joseph,M,-27.93,153.32,,7bb1d766-64e1-49f8-92ef-28cae0beef1d,-27.95,153.4,QLD,Labrador,debit,authorized,f94ce68170c94d86876b9fa4e8317c8e,POS,30-40,2018,10,1,20,7,Monday,7 days,47838.464
ACC-2890243754,37,16.91,4551.67,1.0,CUS-2695611575,2018-10-01,Joseph,M,-27.93,153.32,,4e074599-4aba-43e9-a16d-315313a92f8e,-28.1,153.42,QLD,Varsity Lakes,debit,authorized,23fdfecbb9104de38fcfdbc19cb3bd18,POS,30-40,2018,10,1,22,26,Monday,7 days,47838.464
ACC-2890243754,37,8.54,4543.13,1.0,CUS-2695611575,2018-10-02,Joseph,M,-27.93,153.32,,6399ce2b-7e1b-40c2-b5a0-5b56b98c89a5,-28.08,153.39,QLD,Robina,debit,authorized,4ef029996db04fc4b597392015b71f89,POS,30-40,2018,10,2,8,4,Tuesday,7 days,47838.464
ACC-2890243754,37,12.06,4531.07,1.0,CUS-2695611575,2018-10-02,Joseph,M,-27.93,153.32,,0abb2f4b-6297-4d55-9cec-147efad78b7f,-28.07,153.44,QLD,Miami,debit,authorized,95aad1065cfb4805bc1acf5b2cd08c03,POS,30-40,2018,10,2,9,13,Tuesday,7 days,47838.464
ACC-2890243754,37,5.58,4525.49,0.0,CUS-2695611575,2018-10-02,Joseph,M,-27.93,153.32,,c3895ade-aef8-46f2-a13c-3f22213c14da,-28.08,153.45,QLD,Burleigh Heads,debit,authorized,2fc0390398c94c7ea6d50d8acaa25d75,SALES-POS,30-40,2018,10,2,15,5,Tuesday,7 days,47838.464
ACC-2890243754,37,10.7,4514.79,1.0,CUS-2695611575,2018-10-02,Joseph,M,-27.93,153.32,,63e4c8c2-32cc-4e83-bf09-00516d71bbdf,-27.56,152.28,QLD,Gatton,debit,authorized,9c5465b1908541e99d376b9fc04b5b1b,SALES-POS,30-40,2018,10,2,20,34,Tuesday,7 days,47838.464
ACC-2890243754,37,18.59,4496.2,1.0,CUS-2695611575,2018-10-03,Joseph,M,-27.93,153.32,,4e891f2d-6f85-4283-9f43-263f05f8b65d,-28.09,153.45,QLD,Burleigh Heads,debit,authorized,255170c87d7e472296d46661f1ef1873,POS,30-40,2018,10,3,17,42,Wednesday,7 days,47838.464
ACC-2890243754,37,11.16,4485.04,1.0,CUS-2695611575,2018-10-03,Joseph,M,-27.93,153.32,,7b208d57-5c7e-48a0-9181-07350b8d304b,-27.97,153.42,QLD,Southport,debit,authorized,2c096f15843f498fbc05f011b9cbac8b,SALES-POS,30-40,2018,10,3,22,39,Wednesday,7 days,47838.464
ACC-2890243754,37,7.98,4477.06,1.0,CUS-2695611575,2018-10-03,Joseph,M,-27.93,153.32,,75f5ae12-3528-4b38-b9a9-589eae01cc57,-27.48,153.02,QLD,South Brisbane,debit,authorized,d69179a0f1ee434f9c7f8e102d2ddaa1,POS,30-40,2018,10,3,23,28,Wednesday,7 days,47838.464
ACC-2890243754,37,52.0,4425.06,,CUS-2695611575,2018-10-04,Joseph,M,-27.93,153.32,,,,,,,debit,posted,319b489794ed4876b48cac9ae4ce7e77,PAYMENT,30-40,2018,10,4,3,0,Thursday,7 days,47838.464
ACC-2890243754,37,18.0,4407.06,,CUS-2695611575,2018-10-04,Joseph,M,-27.93,153.32,,,,,,,debit,posted,2459ebaa03bd4cd9a548bdb4218f3526,PAYMENT,30-40,2018,10,4,5,0,Thursday,7 days,47838.464
ACC-2890243754,37,22.4,4384.66,0.0,CUS-2695611575,2018-10-04,Joseph,M,-27.93,153.32,,bb114176-22b5-4fc2-b6cb-3878142c3e20,-27.76,150.25,QLD,Moonie,debit,authorized,2a60f61144394a9cb446d6803d114ce9,POS,30-40,2018,10,4,18,4,Thursday,7 days,47838.464
ACC-2890243754,37,6.05,4378.61,1.0,CUS-2695611575,2018-10-04,Joseph,M,-27.93,153.32,,601bc008-50c1-4dad-9ea0-5f52273a2480,-27.93,153.4,QLD,Runaway Bay,debit,authorized,7512970f6228446eb9fc7183c873abb7,POS,30-40,2018,10,4,18,27,Thursday,7 days,47838.464
ACC-2890243754,37,9.78,4368.83,0.0,CUS-2695611575,2018-10-04,Joseph,M,-27.93,153.32,,455658c2-aeb2-4a6d-9f7e-7b2d829a8060,-27.91,153.4,QLD,Runaway Bay,debit,authorized,ca7763af113f4cbfa589bc7d48b4f6c4,SALES-POS,30-40,2018,10,4,20,58,Thursday,7 days,47838.464
ACC-2890243754,37,4.69,4364.14,1.0,CUS-2695611575,2018-10-05,Joseph,M,-27.93,153.32,,ed391d50-62cf-430b-aed5-b988f610ce4b,-27.98,153.41,QLD,Southport,debit,authorized,8a9f1b5371284111a3855c1dc1efee92,POS,30-40,2018,10,5,0,27,Friday,7 days,47838.464
ACC-2890243754,37,27.96,5253.63,0.0,CUS-2695611575,2018-10-05,Joseph,M,-27.93,153.32,,a58f7cad-e91b-4f3f-8709-79b3e1237698,-27.48,152.99,QLD,Toowong,debit,authorized,290b8964c88c46328020e864b5d84aac,SALES-POS,30-40,2018,10,5,15,10,Friday,7 days,47838.464
ACC-2890243754,37,12.45,5241.18,1.0,CUS-2695611575,2018-10-05,Joseph,M,-27.93,153.32,,aef30de1-c67e-4ab7-8577-2931a4bf3c7e,-27.97,144.64,QLD,Yowah,debit,authorized,77901c3afc534dc388dce7aa70da6efc,POS,30-40,2018,10,5,16,33,Friday,7 days,47838.464
ACC-2890243754,37,18.26,5222.92,1.0,CUS-2695611575,2018-10-09,Joseph,M,-27.93,153.32,,f66c8a8b-04da-4908-afbf-6a5fe6c5c6d2,-27.89,153.39,QLD,Paradise Point,debit,authorized,4647f62a3fd648b78b67a9af83ea1ae4,POS,30-40,2018,10,9,9,28,Tuesday,7 days,47838.464
ACC-2890243754,37,7.55,5215.37,1.0,CUS-2695611575,2018-10-09,Joseph,M,-27.93,153.32,,85ce7f6f-63f0-4a59-8e8b-b0353ee225a7,-27.93,153.39,QLD,Biggera Waters,debit,authorized,2b0cadc8060e41e5b35d65a1a5a71757,SALES-POS,30-40,2018,10,9,23,3,Tuesday,7 days,47838.464
ACC-2890243754,37,13.22,5202.15,1.0,CUS-2695611575,2018-10-10,Joseph,M,-27.93,153.32,,a1a75f24-d1a2-49dd-b984-6a743ea8cafe,-27.51,152.94,QLD,Kenmore,debit,authorized,e8fade9f5d2a4f0a8b5c47e6ad757476,SALES-POS,30-40,2018,10,10,18,51,Wednesday,7 days,47838.464
ACC-2890243754,37,52.0,5150.15,,CUS-2695611575,2018-10-11,Joseph,M,-27.93,153.32,,,,,,,debit,posted,5b8d866b68f94e46ab59cc1edff8248f,PAYMENT,30-40,2018,10,11,3,0,Thursday,7 days,47838.464
ACC-2890243754,37,18.0,5132.15,,CUS-2695611575,2018-10-11,Joseph,M,-27.93,153.32,,,,,,,debit,posted,0497e04ccf0b4ce5a2946fadc3640793,PAYMENT,30-40,2018,10,11,5,0,Thursday,7 days,47838.464
ACC-2890243754,37,11.1,5121.05,0.0,CUS-2695611575,2018-10-11,Joseph,M,-27.93,153.32,,c89acc7e-694c-4a77-8483-6f84b17988ca,-27.97,153.41,QLD,Southport,debit,authorized,9ea6a55e26274a4a88908f50b7207c1f,SALES-POS,30-40,2018,10,11,7,5,Thursday,7 days,47838.464
ACC-2890243754,37,7.84,5113.21,1.0,CUS-2695611575,2018-10-11,Joseph,M,-27.93,153.32,,273866a4-7edc-4109-b713-5ce0db2c0bd7,-27.79,153.26,QLD,Ormeau,debit,authorized,6b14c6a43e7442e9b137b8694cacddad,SALES-POS,30-40,2018,10,11,8,46,Thursday,7 days,47838.464
ACC-2890243754,37,6.44,5106.77,1.0,CUS-2695611575,2018-10-11,Joseph,M,-27.93,153.32,,968510cf-be75-4610-92d4-413496947bda,-27.93,153.34,QLD,Helensvale,debit,authorized,01756b3e5eb24e2ab321585d7bf9d430,POS,30-40,2018,10,11,9,27,Thursday,7 days,47838.464
ACC-2890243754,37,4094.33,1012.44,1.0,CUS-2695611575,2018-10-12,Joseph,M,-27.93,153.32,,af835ef4-60b7-4283-9d9a-5d0a8ab9cd6f,-27.48,153.02,QLD,South Brisbane,debit,authorized,c721e231d6224aaca8924b0448786104,POS,30-40,2018,10,12,7,7,Friday,7 days,47838.464
ACC-2890243754,37,18.86,993.58,1.0,CUS-2695611575,2018-10-12,Joseph,M,-27.93,153.32,,dd2927c4-ccc2-4aa7-be03-ca93ae8f77ad,-27.98,152.55,QLD,Aratula,debit,authorized,084483486e9c47c98ec44ee8f0e548a8,SALES-POS,30-40,2018,10,12,8,32,Friday,7 days,47838.464
ACC-2890243754,37,29.07,1881.96,1.0,CUS-2695611575,2018-10-12,Joseph,M,-27.93,153.32,,65e6ea12-42c5-45e0-bf37-3d1448bea1a4,-28.09,153.45,QLD,Burleigh Heads,debit,authorized,57e060a5885a45ea96dd3c1522036b10,POS,30-40,2018,10,12,14,35,Friday,7 days,47838.464
ACC-2890243754,37,6.21,1875.75,1.0,CUS-2695611575,2018-10-12,Joseph,M,-27.93,153.32,,4ebc232a-cd11-42f7-88c5-3ac36610bcdc,-28.04,148.59,QLD,Saint George,debit,authorized,c307d5b95c024aa4ac33e4658f18fa12,POS,30-40,2018,10,12,14,55,Friday,7 days,47838.464
ACC-2890243754,37,13.41,1862.34,1.0,CUS-2695611575,2018-10-12,Joseph,M,-27.93,153.32,,e66d5666-5938-4a6e-a0f4-1e86409c47a4,-28.09,153.45,QLD,Burleigh Heads,debit,authorized,0eae0ae97e79413b86abe1b39dce7783,SALES-POS,30-40,2018,10,12,19,10,Friday,7 days,47838.464
ACC-2890243754,37,13.98,1848.36,1.0,CUS-2695611575,2018-10-12,Joseph,M,-27.93,153.32,,41179464-a548-45e4-b684-71de31becfd6,-28.1,153.44,QLD,Burleigh Heads,debit,authorized,d7a337cf41b841b1b2267945f74692d2,POS,30-40,2018,10,12,21,7,Friday,7 days,47838.464
ACC-2890243754,37,9.05,1839.31,1.0,CUS-2695611575,2018-10-13,Joseph,M,-27.93,153.32,,e50eccbe-413c-4568-8cc9-fad43171dfb4,-27.97,153.42,QLD,Southport,debit,authorized,55df2f8efabd4c9381a975f171f8ed05,SALES-POS,30-40,2018,10,13,8,16,Saturday,7 days,47838.464
ACC-2890243754,37,18.73,1820.58,1.0,CUS-2695611575,2018-10-13,Joseph,M,-27.93,153.32,,dd2927c4-ccc2-4aa7-be03-ca93ae8f77ad,-27.98,152.55,QLD,Aratula,debit,authorized,6da0e003626e4b4aabc59c9fbf242c4d,SALES-POS,30-40,2018,10,13,14,53,Saturday,7 days,47838.464
ACC-2890243754,37,4.78,1815.8,1.0,CUS-2695611575,2018-10-13,Joseph,M,-27.93,153.32,,a5406597-256d-4bf1-8e72-fbda5b43f872,-27.98,153.38,QLD,Ashmore,debit,authorized,22e4a10f0867414d843f3f782b7010c5,POS,30-40,2018,10,13,17,56,Saturday,7 days,47838.464
ACC-2890243754,37,20.06,1795.74,1.0,CUS-2695611575,2018-10-13,Joseph,M,-27.93,153.32,,02ff41e2-1467-4011-b51e-24653d658e2f,-27.92,153.19,QLD,Tamborine Mountain,debit,authorized,a5daa34992774a2badb837dcb19c1a9f,POS,30-40,2018,10,13,19,18,Saturday,7 days,47838.464
ACC-2890243754,37,19.52,1776.22,1.0,CUS-2695611575,2018-10-13,Joseph,M,-27.93,153.32,,9da67af2-16ee-4b61-a58f-ee570f7468cc,-27.61,153.05,QLD,Calamvale,debit,authorized,9040338cca7647c7ae9443270ea77051,POS,30-40,2018,10,13,21,27,Saturday,7 days,47838.464
ACC-2890243754,37,12.75,1763.47,1.0,CUS-2695611575,2018-10-15,Joseph,M,-27.93,153.32,,f4b5c26b-92a6-48e8-96d1-e6b49943388b,-27.49,153.06,QLD,Camp Hill,debit,authorized,2cc15a9ba97547069320c27ccfc3fd68,SALES-POS,30-40,2018,10,15,19,14,Monday,7 days,47838.464
ACC-2890243754,37,18.2,1745.27,0.0,CUS-2695611575,2018-10-16,Joseph,M,-27.93,153.32,,dd2927c4-ccc2-4aa7-be03-ca93ae8f77ad,-27.98,152.55,QLD,Aratula,debit,authorized,0506ae11c3d44077b98b10a77200247d,SALES-POS,30-40,2018,10,16,15,29,Tuesday,7 days,47838.464
ACC-2890243754,37,20.53,1724.74,1.0,CUS-2695611575,2018-10-16,Joseph,M,-27.93,153.32,,fe7abc57-7936-469d-90fc-1dfa5c738593,-27.98,153.41,QLD,Southport,debit,authorized,856ef842231f42ca97553d8f3abd6469,SALES-POS,30-40,2018,10,16,15,48,Tuesday,7 days,47838.464
ACC-2890243754,37,138.0,1586.74,,CUS-2695611575,2018-10-16,Joseph,M,-27.93,153.32,,,,,,,debit,posted,7ea09421da69441481e52b2e87be323f,PAYMENT,30-40,2018,10,16,21,0,Tuesday,7 days,47838.464
ACC-2890243754,37,4.96,1581.78,1.0,CUS-2695611575,2018-10-17,Joseph,M,-27.93,153.32,,5bdb60f9-60ec-47b4-92be-565abe3d36f7,-28.1,153.44,QLD,Burleigh Heads,debit,authorized,616e73ee4eff483b90ad466aa5ec4ce8,SALES-POS,30-40,2018,10,17,15,45,Wednesday,7 days,47838.464
ACC-2890243754,37,17.61,1564.17,1.0,CUS-2695611575,2018-10-17,Joseph,M,-27.93,153.32,,bfbdc3da-ae50-4375-bbd9-3bffe609274a,-28.1,153.4,QLD,Varsity Lakes,debit,authorized,4ec873a856bd426fabddcf236bfcc913,SALES-POS,30-40,2018,10,17,21,16,Wednesday,7 days,47838.464
ACC-2890243754,37,69.72,1494.45,1.0,CUS-2695611575,2018-10-17,Joseph,M,-27.93,153.32,,3647e656-341b-4fc7-b46e-d4b5fd2c93d4,-33.9,151.2,NSW,Alexandria,debit,authorized,0a8be849024f4aac9f77d0313deb13c9,POS,30-40,2018,10,17,23,27,Wednesday,7 days,47838.464
ACC-2890243754,37,52.0,1442.45,,CUS-2695611575,2018-10-18,Joseph,M,-27.93,153.32,,,,,,,debit,posted,0225e6391faf49db8903633a28d4fa85,PAYMENT,30-40,2018,10,18,3,0,Thursday,7 days,47838.464
ACC-2890243754,37,18.0,1424.45,,CUS-2695611575,2018-10-18,Joseph,M,-27.93,153.32,,,,,,,debit,posted,c0d93a20083548e6a1d68f8cf067edbf,PAYMENT,30-40,2018,10,18,5,0,Thursday,7 days,47838.464
ACC-2890243754,37,21.98,1402.47,1.0,CUS-2695611575,2018-10-18,Joseph,M,-27.93,153.32,,30c5571b-c046-4667-9d68-430f8888ea3a,-27.49,153.06,QLD,Coorparoo,debit,authorized,2b7c83e0cf11424c965d0680dbb043f9,SALES-POS,30-40,2018,10,18,9,18,Thursday,7 days,47838.464
ACC-2890243754,37,13.37,1389.1,1.0,CUS-2695611575,2018-10-18,Joseph,M,-27.93,153.32,,75bc053a-5e96-464f-aa7f-2986c71ebcd3,-27.92,153.34,QLD,Helensvale,debit,authorized,ca8a627b1c9c4f579917fbf6b3d098d2,POS,30-40,2018,10,18,10,53,Thursday,7 days,47838.464
ACC-2890243754,37,12.75,1376.35,1.0,CUS-2695611575,2018-10-18,Joseph,M,-27.93,153.32,,ddf112bb-15d5-4c0f-a0c5-5aa73fcd7ac7,-28.03,153.39,QLD,Clear Island Waters,debit,authorized,740db33e56254d8eb97ed5f06a2f907f,SALES-POS,30-40,2018,10,18,11,23,Thursday,7 days,47838.464
ACC-2890243754,37,43.69,2250.11,1.0,CUS-2695611575,2018-10-21,Joseph,M,-27.93,153.32,,f66f5f5a-ebd4-4fd5-9471-3dbbc4c65894,-27.47,153,QLD,Milton,debit,authorized,bca0df564c104e888427f4cf88b6e249,SALES-POS,30-40,2018,10,21,9,34,Sunday,7 days,47838.464
ACC-2890243754,37,5.67,2244.44,0.0,CUS-2695611575,2018-10-21,Joseph,M,-27.93,153.32,,33f9e5f9-f8ab-4abd-b558-aa5a81b5ba5f,-27.97,153.42,QLD,Southport,debit,authorized,794f857b943e4ca48e1e205be3a57894,SALES-POS,30-40,2018,10,21,9,48,Sunday,7 days,47838.464
ACC-2890243754,37,17.48,2226.96,1.0,CUS-2695611575,2018-10-21,Joseph,M,-27.93,153.32,,96771859-4bff-4c75-8db7-0132179e1380,-27.97,153.42,QLD,Southport,debit,authorized,d6d697cd14fa48d39662c55bb0cb964d,POS,30-40,2018,10,21,10,32,Sunday,7 days,47838.464
ACC-2890243754,37,166.0,2060.96,,CUS-2695611575,2018-10-24,Joseph,M,-27.93,153.32,,,,,,,debit,posted,8bfd1538e37d456682cd2e7b53546ffb,PAYMENT,30-40,2018,10,24,6,0,Wednesday,7 days,47838.464
ACC-2890243754,37,3.64,2057.32,1.0,CUS-2695611575,2018-10-24,Joseph,M,-27.93,153.32,,af2ca819-8779-43d7-adb7-cf050485abd3,-27.92,153.4,QLD,Runaway Bay,debit,authorized,0beb8a4560724d8ca1ee3267e2003d43,POS,30-40,2018,10,24,14,30,Wednesday,7 days,47838.464
ACC-2890243754,37,4.43,2052.89,1.0,CUS-2695611575,2018-10-24,Joseph,M,-27.93,153.32,,d2ed2ec3-a995-4fcf-99f9-1b85ca2c917d,-27.93,153.39,QLD,Biggera Waters,debit,authorized,ef5e344ae0024bbab8204dbc5a49631b,SALES-POS,30-40,2018,10,24,19,24,Wednesday,7 days,47838.464
ACC-2890243754,37,52.0,2000.89,,CUS-2695611575,2018-10-25,Joseph,M,-27.93,153.32,,,,,,,debit,posted,85a164b3336f48feaaa4d194d62ba9b3,PAYMENT,30-40,2018,10,25,3,0,Thursday,7 days,47838.464
ACC-2890243754,37,18.0,1982.89,,CUS-2695611575,2018-10-25,Joseph,M,-27.93,153.32,,,,,,,debit,posted,38a938374ac04e2e9a0baf16f166f1a9,PAYMENT,30-40,2018,10,25,5,0,Thursday,7 days,47838.464
ACC-2890243754,37,19.55,1963.34,1.0,CUS-2695611575,2018-10-25,Joseph,M,-27.93,153.32,,f4160573-2809-4dfb-8590-180a7ae9f43b,-27.98,153.41,QLD,Southport,debit,authorized,ab56e46d62634d6bb5f9923855b9a0b5,POS,30-40,2018,10,25,9,45,Thursday,7 days,47838.464
ACC-2890243754,37,11.82,1951.52,1.0,CUS-2695611575,2018-10-25,Joseph,M,-27.93,153.32,,9641257e-eee4-40dd-8d53-3a7f532050c8,-27.93,153.4,QLD,Biggera Waters,debit,authorized,92feafe16be1436cb16d7c1c579daa5a,SALES-POS,30-40,2018,10,25,9,59,Thursday,7 days,47838.464
ACC-2890243754,37,17.31,1934.21,0.0,CUS-2695611575,2018-10-25,Joseph,M,-27.93,153.32,,ede2a706-042c-4083-b942-27a85e179de4,-37.81,144.95,VIC,West Melbourne,debit,authorized,23505aa24bac4536b213180cc4097281,POS,30-40,2018,10,25,13,21,Thursday,7 days,47838.464
ACC-2890243754,37,26.83,1907.38,0.0,CUS-2695611575,2018-10-25,Joseph,M,-27.93,153.32,,f6cb6b79-8707-4c6d-a6bc-2b2012de5aed,-33.87,151.19,NSW,Pyrmont,debit,authorized,37f9f2c8d4f947038bf655c93acfe968,SALES-POS,30-40,2018,10,25,14,13,Thursday,7 days,47838.464
ACC-2890243754,37,12.94,1894.44,1.0,CUS-2695611575,2018-10-25,Joseph,M,-27.93,153.32,,6e611b46-b2f3-40bb-a965-cca9ac455e9a,-28.01,153.43,QLD,Surfers Paradise,debit,authorized,90f91821c1a94764a44cf6f76c88668e,SALES-POS,30-40,2018,10,25,15,35,Thursday,7 days,47838.464
ACC-2890243754,37,4.49,1889.95,1.0,CUS-2695611575,2018-10-25,Joseph,M,-27.93,153.32,,be57cb22-32af-4722-988b-17380a235734,-27.96,153.38,QLD,Southport,debit,authorized,9450ca83be444de680f9e9ef73da2103,SALES-POS,30-40,2018,10,25,19,47,Thursday,7 days,47838.464
ACC-2890243754,37,127.0,1762.95,,CUS-2695611575,2018-10-26,Joseph,M,-27.93,153.32,,,,,,,debit,posted,fcdd367d12c2499bbf6db15635cc0b36,INTER BANK,30-40,2018,10,26,4,0,Friday,7 days,47838.464
ACC-2890243754,37,55.55,2624.85,1.0,CUS-2695611575,2018-10-26,Joseph,M,-27.93,153.32,,ea1d9ade-efd3-420a-9c92-80de44fb9e1c,-28.01,153.37,QLD,Carrara,debit,authorized,7e21397020024203a76d774dae83397c,SALES-POS,30-40,2018,10,26,14,1,Friday,7 days,47838.464
ACC-2890243754,37,11.98,2612.87,1.0,CUS-2695611575,2018-10-27,Joseph,M,-27.93,153.32,,9b396220-0ff3-473d-8ad3-a169f8b37757,-37.9,145.13,VIC,Notting Hill,debit,authorized,12623c30ad6f452fbfccf3df8beac975,POS,30-40,2018,10,27,3,5,Saturday,7 days,47838.464
ACC-2890243754,37,10.28,2602.59,1.0,CUS-2695611575,2018-10-27,Joseph,M,-27.93,153.32,,e7c8051a-fd6b-486c-84c2-2cf07c925bcf,-27.97,153.42,QLD,Southport,debit,authorized,db040093e1ef41ccb678c07b83f7e3f8,SALES-POS,30-40,2018,10,27,11,11,Saturday,7 days,47838.464
ACC-2890243754,37,15.37,2587.22,1.0,CUS-2695611575,2018-10-27,Joseph,M,-27.93,153.32,,75c749e4-e234-4ce3-aaf4-d058b01426dc,-28.05,153.41,QLD,Mermaid Waters,debit,authorized,1ca9bd4bcc264909a8ef071e3de3845b,POS,30-40,2018,10,27,14,47,Saturday,7 days,47838.464
ACC-2890243754,37,7.86,2579.36,1.0,CUS-2695611575,2018-10-28,Joseph,M,-27.93,153.32,,8e53d164-1cf2-433c-af0f-b49b640125a6,-28.06,153.44,QLD,Mermaid Beach,debit,authorized,7cf008e7f4bc4152a71db91be432271f,POS,30-40,2018,10,28,8,54,Sunday,7 days,47838.464
ACC-2890243754,37,10.04,2569.32,0.0,CUS-2695611575,2018-10-28,Joseph,M,-27.93,153.32,,aba039a4-f264-4f42-84b3-14c2fbceae0e,-28.01,153.39,QLD,Benowa,debit,authorized,1fb891a2480746bbae86cfc9b07af5e9,SALES-POS,30-40,2018,10,28,13,38,Sunday,7 days,47838.464
ACC-2890243754,37,42.3,2527.02,1.0,CUS-2695611575,2018-10-29,Joseph,M,-27.93,153.32,,99dfe23c-965f-4304-a367-889c3727b6b1,-27.71,114.17,WA,Kalbarri,debit,authorized,304f1eb30eed4166beb6e7f43b6235bc,SALES-POS,30-40,2018,10,29,9,5,Monday,7 days,47838.464
ACC-2890243754,37,6.63,2520.39,1.0,CUS-2695611575,2018-10-29,Joseph,M,-27.93,153.32,,504d3f78-bb28-4a71-843f-744521fea465,-27.49,153.04,QLD,Woolloongabba,debit,authorized,acc99274be664b1f893c1b6c8eddb30e,POS,30-40,2018,10,29,9,49,Monday,7 days,47838.464
ACC-2890243754,37,10.55,2509.84,1.0,CUS-2695611575,2018-10-29,Joseph,M,-27.93,153.32,,95cdffb0-3918-4ab1-bd23-a280ce15740d,-27.97,153.41,QLD,Southport,debit,authorized,36c5450592974edb94226384730374cd,POS,30-40,2018,10,29,13,31,Monday,7 days,47838.464
ACC-2890243754,37,32.19,2477.65,1.0,CUS-2695611575,2018-10-31,Joseph,M,-27.93,153.32,,715e470f-063c-46b4-968d-cc343a9fd844,-27.49,152.99,QLD,Toowong,debit,authorized,3e2e0bb98ea94daca9406f07a60b973f,POS,30-40,2018,10,31,11,39,Wednesday,7 days,47838.464
ACC-2890243754,37,11.22,2466.43,0.0,CUS-2695611575,2018-10-31,Joseph,M,-27.93,153.32,,63107a44-156a-4316-9879-9971d1b04018,-28.03,153.43,QLD,Broadbeach,debit,authorized,b7d1797f95904e1985a7a7674ac3e556,POS,30-40,2018,10,31,15,45,Wednesday,7 days,47838.464
ACC-3481401842,25,13.67,259.37,1.0,CUS-1669695324,2018-08-01,Tiffany,F,-31.72,115.74,,38997041-c666-41a4-857b-9aaea10c008d,-32.06,115.76,WA,Fremantle,debit,authorized,daae532bc1114fbd86fca277f349a397,SALES-POS,20-30,2018,8,1,8,28,Wednesday,7 days,63892.207
ACC-3481401842,25,46.0,213.37,,CUS-1669695324,2018-08-02,Tiffany,F,-31.72,115.74,,,,,,,debit,posted,fadf1da0485149ebb62314afcafc9e94,PAYMENT,20-30,2018,8,2,6,0,Thursday,7 days,63892.207
ACC-3481401842,25,26.0,1412.7,,CUS-1669695324,2018-08-04,Tiffany,F,-31.72,115.74,,,,,,,debit,posted,087be2710024472cb4ce36e1ed5067f1,PAYMENT,20-30,2018,8,4,2,0,Saturday,7 days,63892.207
ACC-3481401842,25,14.56,1398.14,1.0,CUS-1669695324,2018-08-04,Tiffany,F,-31.72,115.74,,f8e3fa04-5d47-4c6b-817e-168c069d8a01,-32.55,115.7,WA,Halls Head,debit,authorized,5d067a3a33ee44409f5d635a40577219,SALES-POS,20-30,2018,8,4,20,54,Saturday,7 days,63892.207
ACC-3481401842,25,19.35,1378.79,0.0,CUS-1669695324,2018-08-04,Tiffany,F,-31.72,115.74,,5a2243d3-89d3-46c9-b18c-62ec3f7455f8,-32.03,115.98,WA,Kenwick,debit,authorized,c33c3e9a39614a0a860eccc9fea81b1f,SALES-POS,20-30,2018,8,4,22,10,Saturday,7 days,63892.207
ACC-3481401842,25,11.77,1367.02,1.0,CUS-1669695324,2018-08-04,Tiffany,F,-31.72,115.74,,0d595588-4086-4eea-8769-2050d4e0a7f0,-31.84,115.86,WA,Koondoola,debit,authorized,c43c0856c42548c1bbd0f64e73160700,SALES-POS,20-30,2018,8,4,23,28,Saturday,7 days,63892.207
ACC-3481401842,25,11.68,1355.34,1.0,CUS-1669695324,2018-08-05,Tiffany,F,-31.72,115.74,,a49c26e2-89b2-423a-9efe-f9d74545fa5e,-32.03,115.84,WA,Booragoon,debit,authorized,3b822b274a0f4ff893708f32ef59ac81,SALES-POS,20-30,2018,8,5,19,45,Sunday,7 days,63892.207
ACC-3481401842,25,14.7,1340.64,1.0,CUS-1669695324,2018-08-06,Tiffany,F,-31.72,115.74,,dc0edf81-732c-425d-b76d-e815d16670c6,-33.28,115.74,WA,Australind,debit,authorized,b3d58493af9d4f0bb4f605504b06d76b,POS,20-30,2018,8,6,10,5,Monday,7 days,63892.207
ACC-3481401842,25,2.69,1337.95,1.0,CUS-1669695324,2018-08-06,Tiffany,F,-31.72,115.74,,566e20e5-188d-4e5b-b858-4e487730d3da,-33.34,115.64,WA,South Bunbury,debit,authorized,6cf3e1899db14f518e97cd0ff678e19d,SALES-POS,20-30,2018,8,6,12,5,Monday,7 days,63892.207
ACC-3481401842,25,160.0,1177.95,,CUS-1669695324,2018-08-06,Tiffany,F,-31.72,115.74,,,,,,,debit,posted,24b7282855cf4d90841b13bfdcdcff76,PAYMENT,20-30,2018,8,6,15,0,Monday,7 days,63892.207
ACC-3481401842,25,17.55,1160.4,1.0,CUS-1669695324,2018-08-07,Tiffany,F,-31.72,115.74,,bf381ec0-df2c-4703-98d5-4436b2133ff6,-37.88,145,VIC,Elsternwick,debit,authorized,870fa90ed06c41e3ab4606c804def983,POS,20-30,2018,8,7,9,33,Tuesday,7 days,63892.207
ACC-3481401842,25,12.8,1147.6,1.0,CUS-1669695324,2018-08-07,Tiffany,F,-31.72,115.74,,5d944e72-d87a-44e8-9f19-0331d7d8fad8,-32.53,115.72,WA,Mandurah,debit,authorized,f8d0f70993b745ba95f77762bd42baff,SALES-POS,20-30,2018,8,7,9,50,Tuesday,7 days,63892.207
ACC-3481401842,25,32.0,1115.6,,CUS-1669695324,2018-08-07,Tiffany,F,-31.72,115.74,,,,,,,debit,posted,148ae6595761474dbb5a14357086a076,PAYMENT,20-30,2018,8,7,15,0,Tuesday,7 days,63892.207
ACC-3481401842,25,23.59,1092.01,1.0,CUS-1669695324,2018-08-07,Tiffany,F,-31.72,115.74,,3d184a6d-e776-457e-a21a-597d20e80794,-31.76,116.01,WA,The Vines,debit,authorized,01a2bf8f70aa4c7abe5a9121e6b6424a,SALES-POS,20-30,2018,8,7,20,16,Tuesday,7 days,63892.207
ACC-3481401842,25,19.55,1072.46,1.0,CUS-1669695324,2018-08-08,Tiffany,F,-31.72,115.74,,9181b2ac-7d26-41cf-bc36-4cf6c9be9a74,-31.74,115.77,WA,Joondalup,debit,authorized,5dce148088f743efb1f2d126aa707d02,SALES-POS,20-30,2018,8,8,12,54,Wednesday,7 days,63892.207
ACC-3481401842,25,46.0,1026.46,,CUS-1669695324,2018-08-09,Tiffany,F,-31.72,115.74,,,,,,,debit,posted,38a16d9d38fd48aa9282ab3cfa2a3fa3,PAYMENT,20-30,2018,8,9,6,0,Thursday,7 days,63892.207
ACC-3481401842,25,9.37,1017.09,1.0,CUS-1669695324,2018-08-09,Tiffany,F,-31.72,115.74,,9f94d567-a506-40a8-bc16-d6ac1356e552,-32.1,115.8,WA,Bibra Lake,debit,authorized,7094f9c993194688afda63cafab04d40,SALES-POS,20-30,2018,8,9,9,42,Thursday,7 days,63892.207
ACC-3481401842,25,41.1,975.99,1.0,CUS-1669695324,2018-08-09,Tiffany,F,-31.72,115.74,,f1056208-ecfb-4fd6-bd39-e8127c2f92ba,-32.03,116.07,WA,Carmel,debit,authorized,bed9e15056cd4db9b857f74fcfefcc42,SALES-POS,20-30,2018,8,9,18,55,Thursday,7 days,63892.207
ACC-3481401842,25,307.04,668.95,1.0,CUS-1669695324,2018-08-09,Tiffany,F,-31.72,115.74,,d00d2c9a-883a-4564-806f-54b6533d5472,-33.87,151.21,NSW,Sydney,debit,authorized,a8f1277f73d748569a0143e905a504e4,SALES-POS,20-30,2018,8,9,19,59,Thursday,7 days,63892.207
ACC-3481401842,25,28.78,1865.5,1.0,CUS-1669695324,2018-08-10,Tiffany,F,-31.72,115.74,,58b71a01-cda5-4d0a-bd8e-95dfd1213e89,-31.79,115.83,WA,Pearsall,debit,authorized,2686be814d244dfd9603e5e42cc01c1e,POS,20-30,2018,8,10,14,38,Friday,7 days,63892.207
ACC-3481401842,25,25.69,1839.81,1.0,CUS-1669695324,2018-08-10,Tiffany,F,-31.72,115.74,,78eee674-b201-4512-83c3-3a1f63dafc05,-31.84,115.84,WA,Girrawheen,debit,authorized,7d8cc34a877a410bb5b5ebe7a9cf0d99,SALES-POS,20-30,2018,8,10,14,47,Friday,7 days,63892.207
ACC-3481401842,25,24.12,1815.69,1.0,CUS-1669695324,2018-08-10,Tiffany,F,-31.72,115.74,,93c12eba-91ab-4e03-aa21-977b5159e27a,-31.9,115.8,WA,Woodlands,debit,authorized,019c971cefc240f5a51810dc64574566,SALES-POS,20-30,2018,8,10,14,56,Friday,7 days,63892.207
ACC-3481401842,25,9.26,1806.43,1.0,CUS-1669695324,2018-08-10,Tiffany,F,-31.72,115.74,,1dd691cc-4d60-4ef3-b8c0-7f0a911a93a3,-31.8,115.75,WA,Hillarys,debit,authorized,9750b7ad5bae47fd98db78c85e4a56b5,POS,20-30,2018,8,10,16,19,Friday,7 days,63892.207
ACC-3481401842,25,15.87,1790.56,1.0,CUS-1669695324,2018-08-10,Tiffany,F,-31.72,115.74,,fb2273d1-12e6-418a-bd88-1dbcb1346404,-31.95,115.85,WA,Perth,debit,authorized,27b1a50416cd487bbfaf751d026bd12f,POS,20-30,2018,8,10,16,35,Friday,7 days,63892.207
ACC-3481401842,25,18.93,1771.63,1.0,CUS-1669695324,2018-08-10,Tiffany,F,-31.72,115.74,,2f2c7f33-befc-4e29-86ba-bc73bdf30f20,-32.3,115.74,WA,Safety Bay,debit,authorized,214e0f68ea6045d9a7be5cbaf8bded5f,SALES-POS,20-30,2018,8,10,17,25,Friday,7 days,63892.207
ACC-3481401842,25,20.03,1751.6,1.0,CUS-1669695324,2018-08-10,Tiffany,F,-31.72,115.74,,0383dcca-7752-4cac-87c6-1ff493f0f136,-31.95,141.46,NSW,Broken Hill,debit,authorized,57f36f1419734ed6871d7cab1f6baa21,SALES-POS,20-30,2018,8,10,17,56,Friday,7 days,63892.207
ACC-3481401842,25,15.84,1735.76,1.0,CUS-1669695324,2018-08-10,Tiffany,F,-31.72,115.74,,61dd6bc3-2a83-45b6-b009-fe576ac3359a,-31.82,115.82,WA,Madeley,debit,authorized,4406183a62d349f9b582037f01b375d2,SALES-POS,20-30,2018,8,10,20,24,Friday,7 days,63892.207
ACC-3481401842,25,26.0,1709.76,,CUS-1669695324,2018-08-11,Tiffany,F,-31.72,115.74,,,,,,,debit,posted,47547f4205674745a840415803b67954,PAYMENT,20-30,2018,8,11,2,0,Saturday,7 days,63892.207
ACC-3481401842,25,124.0,1585.76,,CUS-1669695324,2018-08-12,Tiffany,F,-31.72,115.74,,,,,,,debit,posted,639db827c6d045c8bdb9135fc936a5dc,INTER BANK,20-30,2018,8,12,18,0,Sunday,7 days,63892.207
ACC-3481401842,25,134.72,1451.04,1.0,CUS-1669695324,2018-08-12,Tiffany,F,-31.72,115.74,,06bf749a-1db8-41fc-9f26-eb1683974516,-27.45,153.04,QLD,Fortitude Valley,debit,authorized,f24c3ca495e34f139d470c13de91a3ee,POS,20-30,2018,8,12,22,53,Sunday,7 days,63892.207
ACC-3481401842,25,11.43,1439.61,1.0,CUS-1669695324,2018-08-13,Tiffany,F,-31.72,115.74,,1d334244-2f5b-47f0-bee8-a3991b1828d5,-31.99,115.86,WA,Como,debit,authorized,559290e4f2f64e858e60882503a2806b,POS,20-30,2018,8,13,9,2,Monday,7 days,63892.207
ACC-3481401842,25,12.22,1427.39,1.0,CUS-1669695324,2018-08-13,Tiffany,F,-31.72,115.74,,5bef6f4d-3555-4b95-9419-bb8816864048,-37.86,145.09,VIC,Ashburton,debit,authorized,a159c4d549c74aea85aab05f9a7c7989,POS,20-30,2018,8,13,12,19,Monday,7 days,63892.207
ACC-3481401842,25,12.81,1414.58,1.0,CUS-1669695324,2018-08-13,Tiffany,F,-31.72,115.74,,23c131de-6502-4ce9-8b0d-26e2582d37c0,-32.52,115.73,WA,Mandurah,debit,authorized,c6b8eac4da004b51bed0e799642315e8,SALES-POS,20-30,2018,8,13,12,38,Monday,7 days,63892.207
ACC-3481401842,25,7.03,1407.55,1.0,CUS-1669695324,2018-08-14,Tiffany,F,-31.72,115.74,,5e31c726-667e-4b0a-afd1-ab3148311757,-31.69,115.73,WA,Clarkson,debit,authorized,bb605510e55e4c8eb29e62d90a469d4e,POS,20-30,2018,8,14,9,26,Tuesday,7 days,63892.207
ACC-3481401842,25,13.82,1393.73,1.0,CUS-1669695324,2018-08-14,Tiffany,F,-31.72,115.74,,8e83c95f-f8d1-44c1-8cc1-a06fc34b5482,-27.5,153.03,QLD,Annerley,debit,authorized,26857d48f05c4dcab1d89267483325a9,SALES-POS,20-30,2018,8,14,10,22,Tuesday,7 days,63892.207
ACC-3481401842,25,185.78,1207.95,1.0,CUS-1669695324,2018-08-14,Tiffany,F,-31.72,115.74,,5c8ce00d-de54-4328-8eaf-43eb0098264e,-31.91,115.82,WA,Osborne Park,debit,authorized,17323b4a9e9e40c4a72990222207aa97,SALES-POS,20-30,2018,8,14,11,2,Tuesday,7 days,63892.207
ACC-3481401842,25,32.0,1175.95,,CUS-1669695324,2018-08-14,Tiffany,F,-31.72,115.74,,,,,,,debit,posted,1932f070803c42718400a6bd32501eee,PAYMENT,20-30,2018,8,14,15,0,Tuesday,7 days,63892.207
ACC-3481401842,25,15.56,1160.39,1.0,CUS-1669695324,2018-08-14,Tiffany,F,-31.72,115.74,,61dd6bc3-2a83-45b6-b009-fe576ac3359a,-31.82,115.82,WA,Madeley,debit,authorized,717cebc6b2d24d8b88c4e35f2e9d2376,SALES-POS,20-30,2018,8,14,23,23,Tuesday,7 days,63892.207
ACC-3481401842,25,12.37,1148.02,1.0,CUS-1669695324,2018-08-15,Tiffany,F,-31.72,115.74,,b5d118eb-8230-43c1-afc0-c91060a2666a,-31.71,148.66,NSW,Gilgandra,debit,authorized,4968bbf02fa549a88107b2523c645c29,SALES-POS,20-30,2018,8,15,9,49,Wednesday,7 days,63892.207
ACC-3481401842,25,11.12,1136.9,1.0,CUS-1669695324,2018-08-15,Tiffany,F,-31.72,115.74,,165332da-96c4-4df6-b327-5c9ba6953102,-31.69,115.71,WA,Mindarie,debit,authorized,589595fce9b544c192063bf30e72dd68,POS,20-30,2018,8,15,11,55,Wednesday,7 days,63892.207
ACC-3481401842,25,15.98,1120.92,1.0,CUS-1669695324,2018-08-15,Tiffany,F,-31.72,115.74,,73cd9c7c-db2c-42e7-9a9a-7af1c41f9883,-31.9,115.81,WA,Osborne Park,debit,authorized,9bc3eade99b3455da2f8eeb92d00b2f4,POS,20-30,2018,8,15,12,25,Wednesday,7 days,63892.207
ACC-3481401842,25,26.0,2274.25,,CUS-1669695324,2018-08-18,Tiffany,F,-31.72,115.74,,,,,,,debit,posted,d159fb2d8fb14e5d803bc3cb3e71261a,PAYMENT,20-30,2018,8,18,2,0,Saturday,7 days,63892.207
ACC-3481401842,25,3.4,2270.85,1.0,CUS-1669695324,2018-08-18,Tiffany,F,-31.72,115.74,,ece151d2-3e52-4c95-b47c-38cc75b4a517,-33.84,151.21,NSW,North Sydney,debit,authorized,035ead2468024c00a53e14fb729abdce,POS,20-30,2018,8,18,18,1,Saturday,7 days,63892.207
ACC-3481401842,25,12.65,2258.2,1.0,CUS-1669695324,2018-08-18,Tiffany,F,-31.72,115.74,,6eddeaab-425e-4b65-9411-f64db9ff72f8,-31.93,115.94,WA,Redcliffe,debit,authorized,66fc2991efbe45d3b100280dc0aa4de6,SALES-POS,20-30,2018,8,18,23,6,Saturday,7 days,63892.207
ACC-3481401842,25,4.81,2253.39,0.0,CUS-1669695324,2018-08-19,Tiffany,F,-31.72,115.74,,a7c6ec83-1423-4978-83b4-3e3c35528bba,-31.76,150.84,NSW,Murrurundi,debit,authorized,15e92c5cc86b437eab92cceaec3b6218,POS,20-30,2018,8,19,0,13,Sunday,7 days,63892.207
ACC-3481401842,25,5.14,2248.25,1.0,CUS-1669695324,2018-08-19,Tiffany,F,-31.72,115.74,,eec7b6e0-4f57-434a-a40c-4b0b68d29371,-32.23,115.78,WA,Kwinana Beach,debit,authorized,285ed54a965f4af4a54cb032b0fae2b2,SALES-POS,20-30,2018,8,19,0,57,Sunday,7 days,63892.207
ACC-3481401842,25,32.0,2216.25,,CUS-1669695324,2018-08-21,Tiffany,F,-31.72,115.74,,,,,,,debit,posted,ccf574bcfb824282a25eb64966c5e399,PAYMENT,20-30,2018,8,21,15,0,Tuesday,7 days,63892.207
ACC-3481401842,25,46.0,2149.59,,CUS-1669695324,2018-08-23,Tiffany,F,-31.72,115.74,,,,,,,debit,posted,bc892c5f53ce4cc0b4f45982f994cb4a,PAYMENT,20-30,2018,8,23,6,0,Thursday,7 days,63892.207
ACC-3481401842,25,20.66,2195.59,1.0,CUS-1669695324,2018-08-23,Tiffany,F,-31.72,115.74,,5dbd4ab9-1136-4984-9a31-2aba2cd94926,-32.58,115.66,WA,Falcon,debit,authorized,a9bc99dc439b4f2bbc2cb7ad116ab069,SALES-POS,20-30,2018,8,23,6,1,Thursday,7 days,63892.207
ACC-3481401842,25,16.9,2132.69,1.0,CUS-1669695324,2018-08-23,Tiffany,F,-31.72,115.74,,8e984c0d-f986-46c6-808f-a6b757f985e8,-31.95,115.88,WA,East Perth,debit,authorized,796b7463d06545b391fd2a611dc547dc,POS,20-30,2018,8,23,8,11,Thursday,7 days,63892.207
ACC-3481401842,25,4.01,2128.68,1.0,CUS-1669695324,2018-08-23,Tiffany,F,-31.72,115.74,,adceff47-330d-4a20-a181-0b768b83a015,-31.98,115.88,WA,South Perth,debit,authorized,4417348286f4443f9df1bd86e1daec20,POS,20-30,2018,8,23,8,56,Thursday,7 days,63892.207
ACC-3481401842,25,26.0,3328.01,,CUS-1669695324,2018-08-25,Tiffany,F,-31.72,115.74,,,,,,,debit,posted,6e79a9c5d1424067ae80c9f6ae162521,PAYMENT,20-30,2018,8,25,2,0,Saturday,7 days,63892.207
ACC-3481401842,25,82.98,3245.03,1.0,CUS-1669695324,2018-08-25,Tiffany,F,-31.72,115.74,,9866035e-72bf-4438-a864-e870e845c92a,-31.95,115.84,WA,West Perth,debit,authorized,0790e062e0ad493fa35e738833289ed6,SALES-POS,20-30,2018,8,25,15,26,Saturday,7 days,63892.207
ACC-3481401842,25,12.07,3232.96,1.0,CUS-1669695324,2018-08-26,Tiffany,F,-31.72,115.74,,34eb1567-e548-4881-a70b-1de934a9116b,-31.95,115.87,WA,Perth,debit,authorized,09737449da2d4c7c9f5c2878ed9321db,POS,20-30,2018,8,26,9,41,Sunday,7 days,63892.207
ACC-3481401842,25,5.95,3227.01,1.0,CUS-1669695324,2018-08-26,Tiffany,F,-31.72,115.74,,6be1e471-2abb-4704-82fe-e12489c24716,-32.42,115.77,WA,Karnup,debit,authorized,071d27da23e54738921dcc2551e4695b,POS,20-30,2018,8,26,21,11,Sunday,7 days,63892.207
ACC-3481401842,25,22.89,3204.12,1.0,CUS-1669695324,2018-08-28,Tiffany,F,-31.72,115.74,,f0e656b5-fcfc-44a1-b297-29826efcb2a4,-38.02,145.33,VIC,Berwick,debit,authorized,90c8fdc3347b4e0d967638b1538ed558,POS,20-30,2018,8,28,13,53,Tuesday,7 days,63892.207
ACC-3481401842,25,32.0,3172.12,,CUS-1669695324,2018-08-28,Tiffany,F,-31.72,115.74,,,,,,,debit,posted,09a2f2df6701412a9c67f78d282e01af,PAYMENT,20-30,2018,8,28,15,0,Tuesday,7 days,63892.207
ACC-3481401842,25,25.11,3147.01,1.0,CUS-1669695324,2018-08-29,Tiffany,F,-31.72,115.74,,35075912-cb32-4224-bf96-b8f9c7bec968,-31.8,115.75,WA,Hillarys,debit,authorized,2d283d8cecf742ad8923c3ccb75750c7,POS,20-30,2018,8,29,19,44,Wednesday,7 days,63892.207
ACC-3481401842,25,6.26,3140.75,1.0,CUS-1669695324,2018-08-29,Tiffany,F,-31.72,115.74,,51cdcd94-2a4b-458b-b29b-e9dbad358427,-31.92,115.91,WA,Bayswater,debit,authorized,d7565744fbe24129bf671e572cfcd7b7,POS,20-30,2018,8,29,21,10,Wednesday,7 days,63892.207
ACC-3481401842,25,4.57,3136.18,1.0,CUS-1669695324,2018-08-29,Tiffany,F,-31.72,115.74,,03f4de0d-d78b-421a-8a53-30a0d03479eb,-31.8,115.98,WA,Aveley,debit,authorized,606d20eed32049bc8eb9f385cd2499a0,SALES-POS,20-30,2018,8,29,22,23,Wednesday,7 days,63892.207
ACC-3481401842,25,46.0,3090.18,,CUS-1669695324,2018-08-30,Tiffany,F,-31.72,115.74,,,,,,,debit,posted,80b0dc318ae04f7babe17e2a7ebbc7e9,PAYMENT,20-30,2018,8,30,6,0,Thursday,7 days,63892.207
ACC-3481401842,25,9.13,3081.05,1.0,CUS-1669695324,2018-08-30,Tiffany,F,-31.72,115.74,,61a4d6c9-f47c-4f10-984c-024c578d6af0,-32.13,115.86,WA,Success,debit,authorized,57f69df79c1d4400b0bac793f84073b4,SALES-POS,20-30,2018,8,30,14,55,Thursday,7 days,63892.207
ACC-3481401842,25,26.0,4280.38,,CUS-1669695324,2018-09-01,Tiffany,F,-31.72,115.74,,,,,,,debit,posted,37ed6589ae98454988284d6c7e15d5c1,PAYMENT,20-30,2018,9,1,2,0,Saturday,7 days,63892.207
ACC-3481401842,25,11.12,4269.26,1.0,CUS-1669695324,2018-09-02,Tiffany,F,-31.72,115.74,,ac52f8d3-161a-4bc7-92a3-f4beb57bb9dd,-31.99,115.88,WA,Kensington,debit,authorized,a0bd895b8cc0482ca4efa4c93e612368,POS,20-30,2018,9,2,21,5,Sunday,7 days,63892.207
ACC-3481401842,25,30.87,4238.39,1.0,CUS-1669695324,2018-09-02,Tiffany,F,-31.72,115.74,,9904f9e6-144e-4452-ba62-cb41a07a3f96,-31.83,115.77,WA,Duncraig,debit,authorized,c0d05f9903d2470abd5e5d7abd225ea3,SALES-POS,20-30,2018,9,2,21,53,Sunday,7 days,63892.207
ACC-3481401842,25,27.46,4210.93,0.0,CUS-1669695324,2018-09-03,Tiffany,F,-31.72,115.74,,02e67fcd-b41a-4cb4-8b8e-b76c4ac06d96,-31.82,115.82,WA,Madeley,debit,authorized,9758635508f944199fcbdcb5efe256c4,POS,20-30,2018,9,3,8,13,Monday,7 days,63892.207
ACC-3481401842,25,10.02,4200.91,1.0,CUS-1669695324,2018-09-03,Tiffany,F,-31.72,115.74,,a2b45675-f00c-4a65-a2a6-656de2740052,-32.75,115.66,WA,Herron,debit,authorized,8b7e945adde243bfbfaddffaa10e4053,POS,20-30,2018,9,3,10,40,Monday,7 days,63892.207
ACC-3481401842,25,14.71,4186.2,1.0,CUS-1669695324,2018-09-03,Tiffany,F,-31.72,115.74,,b5d118eb-8230-43c1-afc0-c91060a2666a,-31.71,148.66,NSW,Gilgandra,debit,authorized,c0004333ec794cba879a86070ae66f1f,POS,20-30,2018,9,3,10,48,Monday,7 days,63892.207
ACC-3481401842,25,31.62,4154.58,1.0,CUS-1669695324,2018-09-03,Tiffany,F,-31.72,115.74,,d3444b1e-0055-4f5a-98e0-1c6174692a94,-31.94,115.88,WA,Mount Lawley,debit,authorized,79fb70eedba24912bad9939e77f4a930,SALES-POS,20-30,2018,9,3,10,57,Monday,7 days,63892.207
ACC-3481401842,25,13.36,4141.22,1.0,CUS-1669695324,2018-09-03,Tiffany,F,-31.72,115.74,,cec1a590-3bfa-476d-a9bb-3bb1b3b9b334,-31.95,141.46,NSW,Broken Hill,debit,authorized,9022ec014e974e5ebf2b35e786a27e90,POS,20-30,2018,9,3,14,19,Monday,7 days,63892.207
ACC-3481401842,25,33.67,4107.55,1.0,CUS-1669695324,2018-09-04,Tiffany,F,-31.72,115.74,,deb7ade5-9552-4ab1-abff-a0ba6721bb15,-31.71,148.67,NSW,Gilgandra,debit,authorized,d7fdc81df30142fab37cd217f876a3b8,SALES-POS,20-30,2018,9,4,11,27,Tuesday,7 days,63892.207
ACC-3481401842,25,85.27,4022.28,0.0,CUS-1669695324,2018-09-04,Tiffany,F,-31.72,115.74,,2524fe8b-0b41-460d-b7d6-77fdba54657d,-33.81,151.26,NSW,Clontarf,debit,authorized,e2a9f4ec8ad140b49b29856d1963789d,POS,20-30,2018,9,4,14,49,Tuesday,7 days,63892.207
ACC-3481401842,25,32.0,3981.96,,CUS-1669695324,2018-09-04,Tiffany,F,-31.72,115.74,,,,,,,debit,posted,59f52ff3b62844239184c76bba121e9b,PAYMENT,20-30,2018,9,4,15,0,Tuesday,7 days,63892.207
ACC-3481401842,25,8.32,4013.96,0.0,CUS-1669695324,2018-09-04,Tiffany,F,-31.72,115.74,,805f571c-8afb-423a-9260-a1f5a2b5531c,-33.86,151.21,NSW,Sydney,debit,authorized,cfe1154a30ec4efea08e9f483e1c0b17,SALES-POS,20-30,2018,9,4,15,57,Tuesday,7 days,63892.207
ACC-3481401842,25,13.03,3968.93,1.0,CUS-1669695324,2018-09-04,Tiffany,F,-31.72,115.74,,f418dea2-e15a-47e6-be0a-ef0fc802186b,-32.13,115.86,WA,Success,debit,authorized,afa6554c5c1a4b4da1f1b8e73d68d9a9,POS,20-30,2018,9,4,17,43,Tuesday,7 days,63892.207
ACC-3481401842,25,27.0,3941.93,1.0,CUS-1669695324,2018-09-04,Tiffany,F,-31.72,115.74,,ffbeb1bd-0f50-4467-a462-4159237c4a7b,-31.87,115.83,WA,Balcatta,debit,authorized,51dc0b6d1cad42849ee510616a4314ff,SALES-POS,20-30,2018,9,4,19,34,Tuesday,7 days,63892.207
ACC-3481401842,25,14.22,3927.71,1.0,CUS-1669695324,2018-09-04,Tiffany,F,-31.72,115.74,,e8232990-ff4b-4844-a311-b6cd4e435de8,-31.94,152.47,NSW,Glenthorne,debit,authorized,f13cc6c935c341c3af13b92825b2837d,POS,20-30,2018,9,4,23,30,Tuesday,7 days,63892.207
ACC-3481401842,25,43.67,3884.04,0.0,CUS-1669695324,2018-09-05,Tiffany,F,-31.72,115.74,,20ffb3a2-df0b-4376-b14c-4024623e2cda,-27.44,153.04,QLD,Newstead,debit,authorized,1e10f8eaee2443aba847cb4595f9ecf2,SALES-POS,20-30,2018,9,5,9,58,Wednesday,7 days,63892.207
ACC-3481401842,25,23.72,3860.32,1.0,CUS-1669695324,2018-09-05,Tiffany,F,-31.72,115.74,,84fc0377-d8e7-4ebb-b93d-9ce1a2f9fb63,-31.83,115.74,WA,Hillarys,debit,authorized,7e09fc9ee467445b9af4bf851b12c8bd,SALES-POS,20-30,2018,9,5,14,2,Wednesday,7 days,63892.207
ACC-3481401842,25,15.98,3844.34,1.0,CUS-1669695324,2018-09-05,Tiffany,F,-31.72,115.74,,9f8fd064-020f-4bde-aabb-fae0e838589f,-32.29,115.71,WA,Shoalwater,debit,authorized,910f37231b8c4ce0ad323d47f3b4431f,SALES-POS,20-30,2018,9,5,15,55,Wednesday,7 days,63892.207
ACC-3481401842,25,49.76,3794.58,1.0,CUS-1669695324,2018-09-05,Tiffany,F,-31.72,115.74,,0fab4c47-59e6-4978-a65d-921fc447728f,-32.72,151.65,NSW,Hinton,debit,authorized,c9b669934a6f468cad97aa3bac455038,POS,20-30,2018,9,5,16,40,Wednesday,7 days,63892.207
ACC-3481401842,25,46.0,3748.58,,CUS-1669695324,2018-09-06,Tiffany,F,-31.72,115.74,,,,,,,debit,posted,d78d76a7bec34d959aaa96c45867be19,PAYMENT,20-30,2018,9,6,6,0,Thursday,7 days,63892.207
ACC-3481401842,25,20.85,3727.73,0.0,CUS-1669695324,2018-09-06,Tiffany,F,-31.72,115.74,,da8445f9-3ba5-44a2-ae41-00a74102592f,-31.94,115.82,WA,Subiaco,debit,authorized,4ebff8f2dfa0461782360d8262b69acb,SALES-POS,20-30,2018,9,6,8,54,Thursday,7 days,63892.207
ACC-3481401842,25,5.05,3722.68,1.0,CUS-1669695324,2018-09-06,Tiffany,F,-31.72,115.74,,df051ff7-3ad4-4ca5-8c39-59ea9f834cbe,-31.64,116.01,WA,Bullsbrook,debit,authorized,3cd4265f448f41c89954de9a8b02d6a1,SALES-POS,20-30,2018,9,6,9,10,Thursday,7 days,63892.207
ACC-3481401842,25,13.57,3709.11,1.0,CUS-1669695324,2018-09-06,Tiffany,F,-31.72,115.74,,cc1f7a23-9a6f-4b4f-86bb-98fa0bb497a4,-32.55,115.7,WA,Halls Head,debit,authorized,c6686115cfb54de78a5909c4de47ce3a,SALES-POS,20-30,2018,9,6,9,48,Thursday,7 days,63892.207
ACC-3481401842,25,386.02,3323.09,1.0,CUS-1669695324,2018-09-06,Tiffany,F,-31.72,115.74,,4f379cad-d380-4426-b39d-32132f77fe27,-33.87,151.21,NSW,Sydney,debit,authorized,8c5ee5c4c38f44cda7c568255ca75fb9,SALES-POS,20-30,2018,9,6,10,39,Thursday,7 days,63892.207
ACC-3481401842,25,160.0,3141.65,,CUS-1669695324,2018-09-06,Tiffany,F,-31.72,115.74,,,,,,,debit,posted,e55ee43b35fd4b8fb5e019923fae5e95,PAYMENT,20-30,2018,9,6,15,0,Thursday,7 days,63892.207
ACC-3481401842,25,21.44,3301.65,1.0,CUS-1669695324,2018-09-06,Tiffany,F,-31.72,115.74,,e3c60eca-6c21-4870-88ab-5323f1dfc6e4,-31.81,116,WA,Henley Brook,debit,authorized,cbe3f3db95104f9da890336e9c16acc3,POS,20-30,2018,9,6,15,6,Thursday,7 days,63892.207
ACC-3481401842,25,29.57,3112.08,1.0,CUS-1669695324,2018-09-07,Tiffany,F,-31.72,115.74,,04353484-7e25-4562-af6a-2883c7a8d736,-31.76,115.77,WA,Joondalup,debit,authorized,6a7c2cec07774edfb20d785709f21c9a,POS,20-30,2018,9,7,11,5,Friday,7 days,63892.207
ACC-3481401842,25,8.33,4329.08,0.0,CUS-1669695324,2018-09-07,Tiffany,F,-31.72,115.74,,1fce28f6-d100-47b3-aa4f-5a39b577ce7a,-31.83,115.83,WA,Girrawheen,debit,authorized,6ab4577d4dfd4ed8a443362bdf7a2785,POS,20-30,2018,9,7,19,51,Friday,7 days,63892.207
ACC-3481401842,25,26.0,4303.08,,CUS-1669695324,2018-09-08,Tiffany,F,-31.72,115.74,,,,,,,debit,posted,2c1131d155c8472fa085bf900e787b86,PAYMENT,20-30,2018,9,8,2,0,Saturday,7 days,63892.207
ACC-3481401842,25,25.26,4277.82,1.0,CUS-1669695324,2018-09-08,Tiffany,F,-31.72,115.74,,78eee674-b201-4512-83c3-3a1f63dafc05,-31.84,115.84,WA,Girrawheen,debit,authorized,9d10ea7cc3e141c08da35efff22046d8,SALES-POS,20-30,2018,9,8,9,11,Saturday,7 days,63892.207
ACC-3481401842,25,2.35,4275.47,1.0,CUS-1669695324,2018-09-08,Tiffany,F,-31.72,115.74,,e02809a8-154d-4a60-b5c5-b841e4b334bf,-31.95,115.86,WA,Perth,debit,authorized,d4060a9f3a8d448fbbde45fa29852dd0,POS,20-30,2018,9,8,11,52,Saturday,7 days,63892.207
ACC-3481401842,25,17.08,4258.39,1.0,CUS-1669695324,2018-09-08,Tiffany,F,-31.72,115.74,,9f8fd064-020f-4bde-aabb-fae0e838589f,-32.29,115.71,WA,Shoalwater,debit,authorized,aeae5ce711284e01af5f23f2004a542b,SALES-POS,20-30,2018,9,8,14,59,Saturday,7 days,63892.207
ACC-3481401842,25,15.95,4242.44,1.0,CUS-1669695324,2018-09-08,Tiffany,F,-31.72,115.74,,2188994a-f42a-4f61-8bb0-b993c7cd8f72,-33.33,115.64,WA,Bunbury,debit,authorized,fb0a16c53cc84c7aa2590ba77ec57f0e,SALES-POS,20-30,2018,9,8,19,40,Saturday,7 days,63892.207
ACC-3481401842,25,18.53,4223.91,1.0,CUS-1669695324,2018-09-09,Tiffany,F,-31.72,115.74,,8c2d75c6-eb2d-4aaa-9978-3c77872d80b1,-31.95,115.86,WA,Perth,debit,authorized,9174e816cad24d3b8d752bb90d53caf7,POS,20-30,2018,9,9,10,11,Sunday,7 days,63892.207
ACC-3481401842,25,14.93,4208.98,1.0,CUS-1669695324,2018-09-09,Tiffany,F,-31.72,115.74,,60a6942b-58ed-4908-a17c-7a5447146cbb,-32.12,115.83,WA,Yangebup,debit,authorized,7579c3a0d2194bd0bdb60b0bcabd4d77,POS,20-30,2018,9,9,14,32,Sunday,7 days,63892.207
ACC-3481401842,25,18.29,4190.69,0.0,CUS-1669695324,2018-09-10,Tiffany,F,-31.72,115.74,,428f9cbe-9d7a-41b8-af5b-a9fa0cf63866,-31.79,132.23,SA,Coorabie,debit,authorized,e11bf6750a08414a99dd7e0ff6874d1f,POS,20-30,2018,9,10,8,29,Monday,7 days,63892.207
ACC-3481401842,25,26.73,4163.96,1.0,CUS-1669695324,2018-09-10,Tiffany,F,-31.72,115.74,,5d340b94-d239-4bab-934e-28015baadb08,-31.91,152.46,NSW,Taree,debit,authorized,1f151f58140444d181625769efcbd95c,SALES-POS,20-30,2018,9,10,10,4,Monday,7 days,63892.207
ACC-3481401842,25,32.0,4131.96,,CUS-1669695324,2018-09-11,Tiffany,F,-31.72,115.74,,,,,,,debit,posted,41733f2d117144f298585dd7962ef2f4,PAYMENT,20-30,2018,9,11,15,0,Tuesday,7 days,63892.207
ACC-3481401842,25,124.0,4007.96,,CUS-1669695324,2018-09-12,Tiffany,F,-31.72,115.74,,,,,,,debit,posted,d9668efd3cf44bfbbff42e19a5615582,INTER BANK,20-30,2018,9,12,18,0,Wednesday,7 days,63892.207
ACC-3481401842,25,46.0,3961.96,,CUS-1669695324,2018-09-13,Tiffany,F,-31.72,115.74,,,,,,,debit,posted,9d898f4ca2784c6cb5e48b43a4a74cf0,PAYMENT,20-30,2018,9,13,6,0,Thursday,7 days,63892.207
ACC-3481401842,25,30.28,5157.01,1.0,CUS-1669695324,2018-09-14,Tiffany,F,-31.72,115.74,,06f59793-056a-48f0-894d-006f02dc2439,-31.96,115.9,WA,Burswood,debit,authorized,9862e7b5a0af431c9cdee8cf8916b38c,POS,20-30,2018,9,14,16,20,Friday,7 days,63892.207
ACC-3481401842,25,4.69,5152.32,1.0,CUS-1669695324,2018-09-14,Tiffany,F,-31.72,115.74,,68ad62a0-9970-4b22-8d51-6257b882f2ec,-31.84,115.84,WA,Girrawheen,debit,authorized,3df00abf1d8d4590971b4f05ae78895a,SALES-POS,20-30,2018,9,14,16,53,Friday,7 days,63892.207
ACC-3481401842,25,26.0,5126.32,,CUS-1669695324,2018-09-15,Tiffany,F,-31.72,115.74,,,,,,,debit,posted,9588983a3a1e44ccb3d3af577d921d9f,PAYMENT,20-30,2018,9,15,2,0,Saturday,7 days,63892.207
ACC-3481401842,25,32.0,5094.32,,CUS-1669695324,2018-09-18,Tiffany,F,-31.72,115.74,,,,,,,debit,posted,1ddb4e16c2624897bb78e79b3c6b87ca,PAYMENT,20-30,2018,9,18,15,0,Tuesday,7 days,63892.207
ACC-3481401842,25,46.0,5048.32,,CUS-1669695324,2018-09-20,Tiffany,F,-31.72,115.74,,,,,,,debit,posted,5308d962b65942b8a3e5a2af4b0ad061,PAYMENT,20-30,2018,9,20,6,0,Thursday,7 days,63892.207
ACC-3481401842,25,26.18,5022.14,1.0,CUS-1669695324,2018-09-20,Tiffany,F,-31.72,115.74,,bbb440c1-b963-49c8-9e86-6497055b9f1a,-31.82,115.82,WA,Madeley,debit,authorized,6752d6e9f4ed47eabaefa6b90fe314b9,POS,20-30,2018,9,20,15,20,Thursday,7 days,63892.207
ACC-3481401842,25,31.83,4990.31,1.0,CUS-1669695324,2018-09-20,Tiffany,F,-31.72,115.74,,feff3519-afd1-4bf9-84f8-7add57b84d0d,-31.95,115.86,WA,Perth,debit,authorized,07e9c5bf2df9445098204d0583cfe2a2,SALES-POS,20-30,2018,9,20,19,29,Thursday,7 days,63892.207
ACC-3481401842,25,40.67,4949.64,1.0,CUS-1669695324,2018-09-20,Tiffany,F,-31.72,115.74,,a2074a5f-2cc1-4dae-af9a-4fd4b6151d24,-32.48,137.76,SA,Port Augusta West,debit,authorized,76733a3520ab4163a01969c13b643bb7,POS,20-30,2018,9,20,22,4,Thursday,7 days,63892.207
ACC-3481401842,25,32.36,4917.28,1.0,CUS-1669695324,2018-09-20,Tiffany,F,-31.72,115.74,,deb7ade5-9552-4ab1-abff-a0ba6721bb15,-31.71,148.67,NSW,Gilgandra,debit,authorized,441750b39dce472880f0ad492ae074dd,POS,20-30,2018,9,20,22,54,Thursday,7 days,63892.207
ACC-3481401842,25,29.34,4887.94,1.0,CUS-1669695324,2018-09-21,Tiffany,F,-31.72,115.74,,336ca04c-f848-4d67-8eee-aab0764ad90c,-32.25,115.77,WA,Kwinana Beach,debit,authorized,eb571c53a8944b42b0237c69c538304c,POS,20-30,2018,9,21,1,13,Friday,7 days,63892.207
ACC-3481401842,25,26.0,6087.27,,CUS-1669695324,2018-09-22,Tiffany,F,-31.72,115.74,,,,,,,debit,posted,4d0ed990f68e4538b527f8c075987060,PAYMENT,20-30,2018,9,22,2,0,Saturday,7 days,63892.207
ACC-3481401842,25,19.04,6068.23,1.0,CUS-1669695324,2018-09-22,Tiffany,F,-31.72,115.74,,326be4c0-2e6d-4b4a-bc3d-c26abe723c9f,-32.06,115.78,WA,Hilton,debit,authorized,86f4149501814352b21988933d652014,POS,20-30,2018,9,22,17,47,Saturday,7 days,63892.207
ACC-3481401842,25,32.0,6036.23,,CUS-1669695324,2018-09-25,Tiffany,F,-31.72,115.74,,,,,,,debit,posted,184e0f55988747e894ebfe932c79499c,PAYMENT,20-30,2018,9,25,15,0,Tuesday,7 days,63892.207
ACC-3481401842,25,32.09,6004.14,1.0,CUS-1669695324,2018-09-26,Tiffany,F,-31.72,115.74,,80f6b033-db3e-4b4c-8762-be1242ba365b,-31.69,115.71,WA,Mindarie,debit,authorized,c4ddb6bef95c426ba5eeb5abd2df6d7b,SALES-POS,20-30,2018,9,26,9,22,Wednesday,7 days,63892.207
ACC-3481401842,25,355.24,5648.9,1.0,CUS-1669695324,2018-09-26,Tiffany,F,-31.72,115.74,,99d1fdb8-4968-4f4f-a632-a7489c3e59e8,-31.81,115.79,WA,Kingsley,debit,authorized,ad0b75c2c99d4fbbb04f219e81abc36e,SALES-POS,20-30,2018,9,26,9,42,Wednesday,7 days,63892.207
ACC-3481401842,25,16.0,5632.9,1.0,CUS-1669695324,2018-09-26,Tiffany,F,-31.72,115.74,,af46b006-44d1-4a57-b83a-4c9d4e6f02d7,-31.76,150.83,NSW,Murrurundi,debit,authorized,28529722dc7741acab4adecb9252dce3,SALES-POS,20-30,2018,9,26,15,7,Wednesday,7 days,63892.207
ACC-3481401842,25,45.92,5586.98,1.0,CUS-1669695324,2018-09-26,Tiffany,F,-31.72,115.74,,4d0051b3-91be-4db7-b397-ac82ea844118,-33.84,151.21,NSW,North Sydney,debit,authorized,a75d510ec532478fae12615bfda61978,POS,20-30,2018,9,26,15,36,Wednesday,7 days,63892.207
ACC-3481401842,25,30.49,5556.49,0.0,CUS-1669695324,2018-09-26,Tiffany,F,-31.72,115.74,,02297942-9ba5-4c0b-a137-df06bfab514a,-32.58,115.66,WA,Falcon (Miami Beach),debit,authorized,95c7f24c834145088241ebe2d045500c,SALES-POS,20-30,2018,9,26,17,28,Wednesday,7 days,63892.207
ACC-3481401842,25,10.19,5546.3,1.0,CUS-1669695324,2018-09-26,Tiffany,F,-31.72,115.74,,8ea6bab0-ce49-45c7-bbf7-8a9ded87d561,-31.75,115.77,WA,Joondalup,debit,authorized,9af23879bd814f02ad62e15db3a11ecc,POS,20-30,2018,9,26,19,2,Wednesday,7 days,63892.207
ACC-3481401842,25,97.16,5449.14,1.0,CUS-1669695324,2018-09-26,Tiffany,F,-31.72,115.74,,55ff1fc2-4da0-42ae-ae7d-193ac4cf8db2,-33.9,151.2,NSW,Waterloo,debit,authorized,c4c99929844b4474806a847398c3c531,SALES-POS,20-30,2018,9,26,19,38,Wednesday,7 days,63892.207
ACC-3481401842,25,17.58,5431.56,1.0,CUS-1669695324,2018-09-26,Tiffany,F,-31.72,115.74,,0173023e-1e86-4c63-b038-62161f86bb6d,-31.8,115.79,WA,Woodvale,debit,authorized,23032da6d7424c50922d134302ebc5da,POS,20-30,2018,9,26,20,32,Wednesday,7 days,63892.207
ACC-3481401842,25,13.18,5418.38,1.0,CUS-1669695324,2018-09-26,Tiffany,F,-31.72,115.74,,148877ad-7021-4558-a5a0-87fff5a0277e,-31.78,115.79,WA,Woodvale,debit,authorized,64f03132dc56436888a8fcfeb9dbcc4f,SALES-POS,20-30,2018,9,26,21,46,Wednesday,7 days,63892.207
ACC-3481401842,25,46.0,5372.38,,CUS-1669695324,2018-09-27,Tiffany,F,-31.72,115.74,,,,,,,debit,posted,08dab95cefae44b6ae2a2a4655cd265c,PAYMENT,20-30,2018,9,27,6,0,Thursday,7 days,63892.207
ACC-3481401842,25,13.63,5358.75,1.0,CUS-1669695324,2018-09-27,Tiffany,F,-31.72,115.74,,b5d118eb-8230-43c1-afc0-c91060a2666a,-31.71,148.66,NSW,Gilgandra,debit,authorized,1b66052e02934b6dbe49769f702e071f,POS,20-30,2018,9,27,8,56,Thursday,7 days,63892.207
ACC-3481401842,25,25.65,5333.1,1.0,CUS-1669695324,2018-09-27,Tiffany,F,-31.72,115.74,,b7c8aa4f-d59d-4753-8aee-7689974e9107,-31.83,115.82,WA,Greenwood,debit,authorized,083f8d3885a34c2faf45b237488acba8,SALES-POS,20-30,2018,9,27,9,18,Thursday,7 days,63892.207
ACC-3481401842,25,17.5,5315.6,1.0,CUS-1669695324,2018-09-27,Tiffany,F,-31.72,115.74,,f8dcccf4-6ce1-4e04-94de-8390572e59e4,-31.9,115.8,WA,Innaloo,debit,authorized,f024e539d9184e27a13d2380e88de540,POS,20-30,2018,9,27,9,38,Thursday,7 days,63892.207
ACC-3481401842,25,23.52,5292.08,1.0,CUS-1669695324,2018-09-27,Tiffany,F,-31.72,115.74,,6c84c219-96ea-4c6f-9de5-0a28bcaec62f,-32.01,152.47,NSW,Rainbow Flat,debit,authorized,90664545bc814711b7fe081b713f118f,SALES-POS,20-30,2018,9,27,9,46,Thursday,7 days,63892.207
ACC-3481401842,25,23.8,5268.28,1.0,CUS-1669695324,2018-09-27,Tiffany,F,-31.72,115.74,,e8e3598a-d91c-4aab-ae01-61196aa23bc5,-31.78,115.97,WA,Ellenbrook,debit,authorized,e06dc835fb5d48c3baddb3296e058f0e,POS,20-30,2018,9,27,9,58,Thursday,7 days,63892.207
ACC-3481401842,25,37.29,5230.99,1.0,CUS-1669695324,2018-09-27,Tiffany,F,-31.72,115.74,,952e524e-2fd0-4825-af12-d09b52665f8b,-31.8,115.75,WA,Kallaroo,debit,authorized,1c9f0cec890444448b8b237b0690f7c5,POS,20-30,2018,9,27,11,6,Thursday,7 days,63892.207
ACC-3481401842,25,8.98,5222.01,1.0,CUS-1669695324,2018-09-27,Tiffany,F,-31.72,115.74,,77b930b1-1493-40f3-b90d-4c6ea273d856,-31.85,115.78,WA,Carine,debit,authorized,e3ce9e17f4974bc59e71cd5d83a91202,POS,20-30,2018,9,27,23,40,Thursday,7 days,63892.207
ACC-3481401842,25,40.13,5181.88,1.0,CUS-1669695324,2018-09-28,Tiffany,F,-31.72,115.74,,86c9064d-0486-4ca1-93d2-66d62243c1d0,-33.85,151.07,NSW,Sydney Olympic Park,debit,authorized,a009962d464243a7b7394806f6704c8c,SALES-POS,20-30,2018,9,28,9,41,Friday,7 days,63892.207
ACC-3481401842,25,22.8,6384.41,1.0,CUS-1669695324,2018-09-28,Tiffany,F,-31.72,115.74,,c0fb68c6-935b-47ae-8594-e3da036d0f94,-28,153.36,QLD,Gold Coast,debit,authorized,957bd7c271ad42d79d6336e3981246dc,SALES-POS,20-30,2018,9,28,17,3,Friday,7 days,63892.207
ACC-3481401842,25,3.4,6381.01,1.0,CUS-1669695324,2018-09-28,Tiffany,F,-31.72,115.74,,03f4de0d-d78b-421a-8a53-30a0d03479eb,-31.8,115.98,WA,Aveley,debit,authorized,411ebb051b0a434790238c3458c988bb,SALES-POS,20-30,2018,9,28,17,59,Friday,7 days,63892.207
ACC-3481401842,25,26.0,6355.01,,CUS-1669695324,2018-09-29,Tiffany,F,-31.72,115.74,,,,,,,debit,posted,c77d29133d72404796c0ae43cfdeafa5,PAYMENT,20-30,2018,9,29,2,0,Saturday,7 days,63892.207
ACC-3481401842,25,28.54,6326.47,1.0,CUS-1669695324,2018-10-02,Tiffany,F,-31.72,115.74,,14c21950-101c-4dc1-9610-0c96ac11fe6a,-32.29,115.75,WA,Rockingham,debit,authorized,91a9f0608c1d47e28f2f54225915da9b,SALES-POS,20-30,2018,10,2,1,26,Tuesday,7 days,63892.207
ACC-3481401842,25,14.92,6311.55,1.0,CUS-1669695324,2018-10-02,Tiffany,F,-31.72,115.74,,5f7e261c-4366-49a3-baf6-0257e0017c8a,-31.83,116.02,WA,Herne Hill,debit,authorized,687c796632744c54b4bb2a17cfc6ab3d,SALES-POS,20-30,2018,10,2,8,41,Tuesday,7 days,63892.207
ACC-3481401842,25,22.18,6289.37,1.0,CUS-1669695324,2018-10-02,Tiffany,F,-31.72,115.74,,1874e396-93f8-456a-b616-5ea12c6da8df,-32.35,115.76,WA,Warnbro,debit,authorized,2f284a28279741af8abe310e98f66b67,SALES-POS,20-30,2018,10,2,9,31,Tuesday,7 days,63892.207
ACC-3481401842,25,38.43,6250.94,1.0,CUS-1669695324,2018-10-02,Tiffany,F,-31.72,115.74,,fa2bf76e-c908-4516-9763-a8539c144f95,-37.97,145.09,VIC,Moorabbin Airport,debit,authorized,1042c465d13146a6af6fdcae2a3d8cdf,POS,20-30,2018,10,2,9,40,Tuesday,7 days,63892.207
ACC-3481401842,25,21.04,6229.9,1.0,CUS-1669695324,2018-10-02,Tiffany,F,-31.72,115.74,,eede4b22-9658-40ae-8775-03c14ca868ac,-31.98,115.79,WA,Claremont,debit,authorized,af66ba202128468a9f9c5401b89804d8,SALES-POS,20-30,2018,10,2,9,53,Tuesday,7 days,63892.207
ACC-3481401842,25,14.95,6214.95,1.0,CUS-1669695324,2018-10-02,Tiffany,F,-31.72,115.74,,a6448b7f-1de5-47d5-bb6f-988fb1212955,-32.26,148.63,NSW,Dubbo,debit,authorized,27194f8702154a18ae957fb5baf021db,POS,20-30,2018,10,2,11,12,Tuesday,7 days,63892.207
ACC-3481401842,25,32.0,6128.66,,CUS-1669695324,2018-10-02,Tiffany,F,-31.72,115.74,,,,,,,debit,posted,f6b1504984604d5bab04483cbdd6c2db,PAYMENT,20-30,2018,10,2,15,0,Tuesday,7 days,63892.207
ACC-3481401842,25,54.29,6160.66,1.0,CUS-1669695324,2018-10-02,Tiffany,F,-31.72,115.74,,d4caaefd-864d-4b52-8040-0139e86f4169,-31.78,115.97,WA,Wa,debit,authorized,3175896cb7a645dcbc9dd65513889e4b,SALES-POS,20-30,2018,10,2,15,23,Tuesday,7 days,63892.207
ACC-3481401842,25,46.0,6082.66,,CUS-1669695324,2018-10-04,Tiffany,F,-31.72,115.74,,,,,,,debit,posted,c3c527e4e3fd47e18e31f0d3b72c9ce5,PAYMENT,20-30,2018,10,4,6,0,Thursday,7 days,63892.207
ACC-3481401842,25,16.7,6065.96,1.0,CUS-1669695324,2018-10-04,Tiffany,F,-31.72,115.74,,04f17878-2c1e-4cf7-a6d6-3d60a18e3dfe,-31.8,115.75,WA,Hillarys,debit,authorized,c9a6fbef2b7541a88ec876684fee17fe,POS,20-30,2018,10,4,9,13,Thursday,7 days,63892.207
ACC-3481401842,25,13.0,6052.96,1.0,CUS-1669695324,2018-10-04,Tiffany,F,-31.72,115.74,,b5d118eb-8230-43c1-afc0-c91060a2666a,-31.71,148.66,NSW,Gilgandra,debit,authorized,7c3cc12a4d814e38a3f3d2cc6af17feb,POS,20-30,2018,10,4,9,17,Thursday,7 days,63892.207
ACC-3481401842,25,12.79,6040.17,0.0,CUS-1669695324,2018-10-05,Tiffany,F,-31.72,115.74,,d75b1665-af5d-40ca-a3c1-146e3225dbab,-31.65,152.8,NSW,Laurieton,debit,authorized,1e42ffd380e544a7b4ed065b6ee6700f,SALES-POS,20-30,2018,10,5,7,59,Friday,7 days,63892.207
ACC-3481401842,25,18.58,6021.59,0.0,CUS-1669695324,2018-10-05,Tiffany,F,-31.72,115.74,,e2a28746-76b0-4d0c-8df9-2376ce7c6028,-32.03,115.84,WA,Booragoon,debit,authorized,d75cc0409f2f48d2971da7b6da91e2ae,POS,20-30,2018,10,5,9,14,Friday,7 days,63892.207
ACC-3481401842,25,7.98,6013.61,1.0,CUS-1669695324,2018-10-05,Tiffany,F,-31.72,115.74,,4fe3642e-1e41-409c-80f7-444a531ba62f,-31.57,129.96,SA,Nullarbor,debit,authorized,9582848128af45d08715fc503e0ed5f9,POS,20-30,2018,10,5,10,3,Friday,7 days,63892.207
ACC-3481401842,25,66.64,5946.97,1.0,CUS-1669695324,2018-10-05,Tiffany,F,-31.72,115.74,,79ef2a69-e119-4d7b-a33c-7099f65c8c5d,-31.79,115.82,WA,Wangara,debit,authorized,6b3bcd482f5b41cfbc103c67d2a1cb0a,SALES-POS,20-30,2018,10,5,10,51,Friday,7 days,63892.207
ACC-3481401842,25,26.0,7146.3,,CUS-1669695324,2018-10-06,Tiffany,F,-31.72,115.74,,,,,,,debit,posted,eda553cd2771444ba1b1cbc1255511db,PAYMENT,20-30,2018,10,6,2,0,Saturday,7 days,63892.207
ACC-3481401842,25,13.75,7132.55,0.0,CUS-1669695324,2018-10-06,Tiffany,F,-31.72,115.74,,18457d6a-d736-4eb3-885d-d34f13ffcad3,-31.74,115.77,WA,Joondalup,debit,authorized,7293712634754581bf38e870ffc8d8d4,SALES-POS,20-30,2018,10,6,12,53,Saturday,7 days,63892.207
ACC-3481401842,25,66.44,7066.11,1.0,CUS-1669695324,2018-10-06,Tiffany,F,-31.72,115.74,,79ef2a69-e119-4d7b-a33c-7099f65c8c5d,-31.79,115.82,WA,Wangara,debit,authorized,e21d84cbf77742e1a9e607deca3a0ddb,SALES-POS,20-30,2018,10,6,14,59,Saturday,7 days,63892.207
ACC-3481401842,25,160.0,6906.11,,CUS-1669695324,2018-10-06,Tiffany,F,-31.72,115.74,,,,,,,debit,posted,33f85704dd5c4b00b69ec424d6a08129,PAYMENT,20-30,2018,10,6,15,0,Saturday,7 days,63892.207
ACC-3481401842,25,48.39,6857.72,1.0,CUS-1669695324,2018-10-06,Tiffany,F,-31.72,115.74,,2be09a29-2f79-4cb3-9ed2-36594d0138d4,-31.67,150.15,NSW,Yarraman,debit,authorized,0e16731e6e524977b93371e7405665f5,SALES-POS,20-30,2018,10,6,18,39,Saturday,7 days,63892.207
ACC-3481401842,25,26.95,6830.77,1.0,CUS-1669695324,2018-10-06,Tiffany,F,-31.72,115.74,,258425db-044e-4e77-b6a5-c6a060c50d1f,-31.97,115.85,WA,South Perth,debit,authorized,600168c1838a4e7fb61c4bebc142368e,SALES-POS,20-30,2018,10,6,21,47,Saturday,7 days,63892.207
ACC-3481401842,25,35.14,6795.63,0.0,CUS-1669695324,2018-10-06,Tiffany,F,-31.72,115.74,,deb7ade5-9552-4ab1-abff-a0ba6721bb15,-31.71,148.67,NSW,Gilgandra,debit,authorized,c8d202839ab245d195a75efad965f926,POS,20-30,2018,10,6,22,39,Saturday,7 days,63892.207
ACC-3481401842,25,20.15,6775.48,1.0,CUS-1669695324,2018-10-07,Tiffany,F,-31.72,115.74,,50f0c409-1887-4c6a-9739-463c06b290bf,-32.13,115.8,WA,Beeliar,debit,authorized,1a04a4e0d6874bd39e7743b4c4fbc5a3,POS,20-30,2018,10,7,14,31,Sunday,7 days,63892.207
ACC-3481401842,25,17.67,6757.81,1.0,CUS-1669695324,2018-10-07,Tiffany,F,-31.72,115.74,,428f9cbe-9d7a-41b8-af5b-a9fa0cf63866,-31.79,132.23,SA,Coorabie,debit,authorized,b4014d3d4aba4a8cbe2b5fd834d1542c,SALES-POS,20-30,2018,10,7,15,9,Sunday,7 days,63892.207
ACC-3481401842,25,9.5,6748.31,1.0,CUS-1669695324,2018-10-07,Tiffany,F,-31.72,115.74,,e251231c-4d2b-4fc7-92c4-6c9ece3b0df4,-31.98,115.78,WA,Claremont,debit,authorized,3f654e46b8994d5fb4831d0ca09a82a2,SALES-POS,20-30,2018,10,7,20,5,Sunday,7 days,63892.207
ACC-3481401842,25,9.77,6738.54,0.0,CUS-1669695324,2018-10-07,Tiffany,F,-31.72,115.74,,cab9d51e-784c-4de4-a48e-c366e9a0ba86,-31.65,116.68,WA,Northam,debit,authorized,878567a4a3684d39b1d21ed4ea41d8b2,POS,20-30,2018,10,7,20,15,Sunday,7 days,63892.207
ACC-3481401842,25,58.53,6680.01,1.0,CUS-1669695324,2018-10-07,Tiffany,F,-31.72,115.74,,6794750f-0e22-47dc-919d-15fbd624bf41,-31.83,115.77,WA,Duncraig,debit,authorized,c78b305a9096443cbeeb0d94666305f7,SALES-POS,20-30,2018,10,7,21,45,Sunday,7 days,63892.207
ACC-3481401842,25,31.97,6648.04,1.0,CUS-1669695324,2018-10-08,Tiffany,F,-31.72,115.74,,99086730-8a30-4de8-8e8b-fed09c6e75fb,-31.95,115.87,WA,East Perth,debit,authorized,7da58199efed4580916db2c3d402f1b9,POS,20-30,2018,10,8,10,41,Monday,7 days,63892.207
ACC-3481401842,25,32.0,6616.04,,CUS-1669695324,2018-10-09,Tiffany,F,-31.72,115.74,,,,,,,debit,posted,346f5324e15d4406980c7bae0ff0a233,PAYMENT,20-30,2018,10,9,15,0,Tuesday,7 days,63892.207
ACC-3481401842,25,26.72,6589.32,1.0,CUS-1669695324,2018-10-10,Tiffany,F,-31.72,115.74,,bbec92e9-8f51-413f-a4b5-431f3b34d391,-31.84,115.81,WA,Warwick,debit,authorized,167bf102b4e146a1aa7b328df6a94600,SALES-POS,20-30,2018,10,10,8,18,Wednesday,7 days,63892.207
ACC-3481401842,25,24.3,6565.02,1.0,CUS-1669695324,2018-10-10,Tiffany,F,-31.72,115.74,,5c7cd84e-2d88-4be4-9f99-f7e4bcbf92e6,-32.03,115.8,WA,Attadale,debit,authorized,792c18bfe7f74d35bbf0c68a6038cca9,SALES-POS,20-30,2018,10,10,8,27,Wednesday,7 days,63892.207
ACC-3481401842,25,14.53,6550.49,1.0,CUS-1669695324,2018-10-10,Tiffany,F,-31.72,115.74,,67465c3b-c1f2-4d55-b37e-c2a0081ab212,-31.9,115.9,WA,Morley,debit,authorized,aab192ec5397413897be664feb123d29,POS,20-30,2018,10,10,8,53,Wednesday,7 days,63892.207
ACC-3481401842,25,23.27,6527.22,0.0,CUS-1669695324,2018-10-10,Tiffany,F,-31.72,115.74,,afa8342a-5a71-4aee-a32b-e4904ae91f44,-31.9,115.9,WA,Morley,debit,authorized,059e85f529cc42afaa521158c0b64cbd,POS,20-30,2018,10,10,9,32,Wednesday,7 days,63892.207
ACC-3481401842,25,46.0,6481.22,,CUS-1669695324,2018-10-11,Tiffany,F,-31.72,115.74,,,,,,,debit,posted,56a85475dd2949eebe22feda494a86ec,PAYMENT,20-30,2018,10,11,6,0,Thursday,7 days,63892.207
ACC-3481401842,25,23.02,6458.2,1.0,CUS-1669695324,2018-10-11,Tiffany,F,-31.72,115.74,,c550ff25-3982-4a9a-8483-db35590de548,-33.03,115.73,WA,Myalup,debit,authorized,288e3efdcca6449ba92ac34d489ac168,POS,20-30,2018,10,11,9,59,Thursday,7 days,63892.207
ACC-3481401842,25,14.54,6443.66,1.0,CUS-1669695324,2018-10-11,Tiffany,F,-31.72,115.74,,de9e8d67-1e9e-4964-8b10-c2b4f65135b1,-32.13,133.68,SA,Ceduna,debit,authorized,6b741e7086ee45d7bdffe6af65164c06,POS,20-30,2018,10,11,21,34,Thursday,7 days,63892.207
ACC-3481401842,25,124.0,7544.99,,CUS-1669695324,2018-10-12,Tiffany,F,-31.72,115.74,,,,,,,debit,posted,221ed8df974f41f0a7b11489f69b01e8,INTER BANK,20-30,2018,10,12,18,0,Friday,7 days,63892.207
ACC-3481401842,25,26.0,7518.99,,CUS-1669695324,2018-10-13,Tiffany,F,-31.72,115.74,,,,,,,debit,posted,93b7f8f1914244c6b6391fbbcc5d21df,PAYMENT,20-30,2018,10,13,2,0,Saturday,7 days,63892.207
ACC-3481401842,25,25.14,7493.85,1.0,CUS-1669695324,2018-10-13,Tiffany,F,-31.72,115.74,,71a4a4c9-03e7-439c-9398-4ad37d33f07f,-32.07,115.82,WA,Kardinya,debit,authorized,a581b3ef898e4d9e9352b180dbaec3d3,POS,20-30,2018,10,13,18,14,Saturday,7 days,63892.207
ACC-3481401842,25,15.14,7478.71,1.0,CUS-1669695324,2018-10-13,Tiffany,F,-31.72,115.74,,2c24f9fd-bb73-4def-873a-372793029d02,-33.36,115.63,WA,Withers,debit,authorized,671c9153931641f2b643613d8b39ca6e,POS,20-30,2018,10,13,18,55,Saturday,7 days,63892.207
ACC-3481401842,25,4.21,7474.5,1.0,CUS-1669695324,2018-10-14,Tiffany,F,-31.72,115.74,,a7c6ec83-1423-4978-83b4-3e3c35528bba,-31.76,150.84,NSW,Murrurundi,debit,authorized,dc82892850134f489ee633138fd3960e,POS,20-30,2018,10,14,1,23,Sunday,7 days,63892.207
ACC-3481401842,25,18.18,7456.32,1.0,CUS-1669695324,2018-10-14,Tiffany,F,-31.72,115.74,,d2f77f77-a2e6-4288-ac29-97e23e224f94,-31.83,115.81,WA,Greenwood,debit,authorized,8e5e238f92c14b578a4cd674324b3db4,SALES-POS,20-30,2018,10,14,10,19,Sunday,7 days,63892.207
ACC-3481401842,25,14.08,7442.24,0.0,CUS-1669695324,2018-10-14,Tiffany,F,-31.72,115.74,,d75b1665-af5d-40ca-a3c1-146e3225dbab,-31.65,152.8,NSW,Laurieton,debit,authorized,49a022b61b334fb79e43ee4f060887f3,SALES-POS,20-30,2018,10,14,11,17,Sunday,7 days,63892.207
ACC-3481401842,25,4.23,7438.01,0.0,CUS-1669695324,2018-10-14,Tiffany,F,-31.72,115.74,,a7fc9d32-5614-4a92-9f8c-2a834bf2bbcf,-31.99,115.87,WA,Como,debit,authorized,aa7154223d8143ffad5031c39e275bc9,POS,20-30,2018,10,14,14,23,Sunday,7 days,63892.207
ACC-3481401842,25,51.32,7386.69,1.0,CUS-1669695324,2018-10-14,Tiffany,F,-31.72,115.74,,e3d8ae19-3768-4035-bfed-9247ebc4b7fa,-32.02,115.94,WA,Cannington,debit,authorized,41346137c89f42d0be0c352a44e28f56,SALES-POS,20-30,2018,10,14,20,58,Sunday,7 days,63892.207
ACC-3481401842,25,10.93,7375.76,1.0,CUS-1669695324,2018-10-14,Tiffany,F,-31.72,115.74,,37bde927-5d7e-4cc4-81a1-0495d9f1e034,-31.65,152.8,NSW,Laurieton,debit,authorized,f102e1fa9c344edf9d1e38ccff5cce8b,POS,20-30,2018,10,14,21,8,Sunday,7 days,63892.207
ACC-3481401842,25,32.0,7343.76,,CUS-1669695324,2018-10-16,Tiffany,F,-31.72,115.74,,,,,,,debit,posted,94e04213612d43bd82ae376ddf6c61d5,PAYMENT,20-30,2018,10,16,15,0,Tuesday,7 days,63892.207
ACC-3481401842,25,26.83,7316.93,1.0,CUS-1669695324,2018-10-16,Tiffany,F,-31.72,115.74,,13135f2d-c816-407c-bab7-92c899699b90,-31.64,152.82,NSW,North Haven,debit,authorized,94cdd677e1ec4a0fa8b0ce1f372f5271,SALES-POS,20-30,2018,10,16,18,27,Tuesday,7 days,63892.207
ACC-3481401842,25,11.9,7305.03,1.0,CUS-1669695324,2018-10-17,Tiffany,F,-31.72,115.74,,60913e24-0ec9-4129-af9d-59a513c50558,-31.91,152.46,NSW,Taree,debit,authorized,a7d34715fea44cc38514ba6346938cc1,POS,20-30,2018,10,17,9,13,Wednesday,7 days,63892.207
ACC-3481401842,25,54.98,7250.05,1.0,CUS-1669695324,2018-10-17,Tiffany,F,-31.72,115.74,,c93d3a14-a29c-4fde-b1df-93b331a66ffc,-33.8,151.18,NSW,Chatswood,debit,authorized,fa8c24c953cb438bbfc42243e334472e,POS,20-30,2018,10,17,9,59,Wednesday,7 days,63892.207
ACC-3481401842,25,32.41,7217.64,1.0,CUS-1669695324,2018-10-17,Tiffany,F,-31.72,115.74,,067767c3-69be-4909-95ab-d2615b66e6c7,-31.83,115.85,WA,Alexander Heights,debit,authorized,be2aac1a0ab94084acfafb5ebe5a2674,POS,20-30,2018,10,17,11,21,Wednesday,7 days,63892.207
ACC-3481401842,25,53.96,7163.68,1.0,CUS-1669695324,2018-10-17,Tiffany,F,-31.72,115.74,,56a95a99-0036-4727-a604-b8afcad982b1,-31.67,115.72,WA,Merriwa,debit,authorized,450614b829814e5d8bbfe7c85216bff3,POS,20-30,2018,10,17,15,51,Wednesday,7 days,63892.207
ACC-3481401842,25,14.21,7149.47,1.0,CUS-1669695324,2018-10-18,Tiffany,F,-31.72,115.74,,8a01afe8-1468-4e9f-8152-ccb237b7c614,-32.29,115.74,WA,Rockingham,debit,authorized,58ead64a308f41b19aa3d203a8fca5ab,POS,20-30,2018,10,18,4,14,Thursday,7 days,63892.207
ACC-3481401842,25,46.0,7103.47,,CUS-1669695324,2018-10-18,Tiffany,F,-31.72,115.74,,,,,,,debit,posted,e2887c977dc14f37852a5d79f5b27979,PAYMENT,20-30,2018,10,18,6,0,Thursday,7 days,63892.207
ACC-3481401842,25,17.15,7086.32,1.0,CUS-1669695324,2018-10-18,Tiffany,F,-31.72,115.74,,af46b006-44d1-4a57-b83a-4c9d4e6f02d7,-31.76,150.83,NSW,Murrurundi,debit,authorized,7692bb3af48546539a78fe0f3bf72cec,POS,20-30,2018,10,18,8,3,Thursday,7 days,63892.207
ACC-3481401842,25,9.24,7077.08,1.0,CUS-1669695324,2018-10-18,Tiffany,F,-31.72,115.74,,68978a51-7a39-4e02-ad86-03c3ba8b72f1,-31.71,115.79,WA,Carramar,debit,authorized,6f1b43e0a01949f9ba6a8538bc208821,POS,20-30,2018,10,18,9,9,Thursday,7 days,63892.207
ACC-3481401842,25,26.0,8276.41,,CUS-1669695324,2018-10-20,Tiffany,F,-31.72,115.74,,,,,,,debit,posted,59e26a605b7740bea2b87be64b6e14c8,PAYMENT,20-30,2018,10,20,2,0,Saturday,7 days,63892.207
ACC-3481401842,25,28.96,8247.45,1.0,CUS-1669695324,2018-10-22,Tiffany,F,-31.72,115.74,,7ed90641-b744-4b56-9be6-5e1a399a5d4a,-32.47,115.76,WA,Lakelands,debit,authorized,3f96f4432792467ba2a9c54243ef2d89,POS,20-30,2018,10,22,9,28,Monday,7 days,63892.207
ACC-3481401842,25,27.14,8220.31,1.0,CUS-1669695324,2018-10-22,Tiffany,F,-31.72,115.74,,96741fed-bcec-44fd-941a-1f606bd107ed,-31.8,115.75,WA,Hillarys,debit,authorized,01dc9f1352d0403a84157248f83f36df,SALES-POS,20-30,2018,10,22,9,40,Monday,7 days,63892.207
ACC-3481401842,25,14.66,8205.65,1.0,CUS-1669695324,2018-10-22,Tiffany,F,-31.72,115.74,,af46b006-44d1-4a57-b83a-4c9d4e6f02d7,-31.76,150.83,NSW,Murrurundi,debit,authorized,f77755e88b3642778d1c8e4b917c2aab,POS,20-30,2018,10,22,9,59,Monday,7 days,63892.207
ACC-3481401842,25,22.28,8183.37,1.0,CUS-1669695324,2018-10-22,Tiffany,F,-31.72,115.74,,600727c2-601e-4d6e-a3af-5464c3a2f402,-31.91,152.45,NSW,Taree West,debit,authorized,a99bc2c211cd49f3988cad74b1069f17,POS,20-30,2018,10,22,10,55,Monday,7 days,63892.207
ACC-3481401842,25,3.33,8180.04,1.0,CUS-1669695324,2018-10-22,Tiffany,F,-31.72,115.74,,a7fc9d32-5614-4a92-9f8c-2a834bf2bbcf,-31.99,115.87,WA,Como,debit,authorized,dc8e16b9093643a5a2187d1f29d8a141,POS,20-30,2018,10,22,13,48,Monday,7 days,63892.207
ACC-3481401842,25,14.05,8165.99,1.0,CUS-1669695324,2018-10-23,Tiffany,F,-31.72,115.74,,bedfaec0-2483-449c-9d0f-b8492469a4a2,-31.91,152.46,NSW,Taree,debit,authorized,d7600bbb46e74b0d8fc3d5c374ef765c,SALES-POS,20-30,2018,10,23,9,58,Tuesday,7 days,63892.207
ACC-3481401842,25,17.72,8148.27,1.0,CUS-1669695324,2018-10-23,Tiffany,F,-31.72,115.74,,8e984c0d-f986-46c6-808f-a6b757f985e8,-31.95,115.88,WA,East Perth,debit,authorized,2fc52ac8e076478d8a68993d05f368e4,SALES-POS,20-30,2018,10,23,11,35,Tuesday,7 days,63892.207
ACC-3481401842,25,32.0,8116.27,,CUS-1669695324,2018-10-23,Tiffany,F,-31.72,115.74,,,,,,,debit,posted,a3a2e863421d446b99dcafc931a91c44,PAYMENT,20-30,2018,10,23,15,0,Tuesday,7 days,63892.207
ACC-3481401842,25,5.37,8110.9,1.0,CUS-1669695324,2018-10-25,Tiffany,F,-31.72,115.74,,dbb1b4e2-04ae-4f77-b40c-7ea9495c7f21,-31.87,115.84,WA,Westminster,debit,authorized,967b9ec189174142a301ef5a264b0e5d,POS,20-30,2018,10,25,4,13,Thursday,7 days,63892.207
ACC-3481401842,25,46.0,8064.9,,CUS-1669695324,2018-10-25,Tiffany,F,-31.72,115.74,,,,,,,debit,posted,1db70ef1fba2478dbfe9ef344d2647e2,PAYMENT,20-30,2018,10,25,6,0,Thursday,7 days,63892.207
ACC-3481401842,25,32.08,8032.82,1.0,CUS-1669695324,2018-10-25,Tiffany,F,-31.72,115.74,,78850610-c975-4e9d-8736-0c20b9111921,-33.34,115.66,WA,Bunbury,debit,authorized,7f147fd84fca4cafb40fc6a1b5536666,SALES-POS,20-30,2018,10,25,8,5,Thursday,7 days,63892.207
ACC-3481401842,25,17.81,8015.01,1.0,CUS-1669695324,2018-10-25,Tiffany,F,-31.72,115.74,,8c2d75c6-eb2d-4aaa-9978-3c77872d80b1,-31.95,115.86,WA,Perth,debit,authorized,1fc7889e8d1548d0b8af84b4cfb49749,SALES-POS,20-30,2018,10,25,8,20,Thursday,7 days,63892.207
ACC-3481401842,25,7.2,8007.81,1.0,CUS-1669695324,2018-10-25,Tiffany,F,-31.72,115.74,,9089e516-f497-4a9a-9613-1878b51f1be0,-31.98,115.82,WA,Crawley,debit,authorized,56f01118c3f049d19f4389b3d14be183,SALES-POS,20-30,2018,10,25,10,15,Thursday,7 days,63892.207
ACC-3481401842,25,26.0,9207.14,,CUS-1669695324,2018-10-27,Tiffany,F,-31.72,115.74,,,,,,,debit,posted,c6e43101f106440a921aa99038008cb5,PAYMENT,20-30,2018,10,27,2,0,Saturday,7 days,63892.207
ACC-3481401842,25,34.82,9172.32,1.0,CUS-1669695324,2018-10-27,Tiffany,F,-31.72,115.74,,deb7ade5-9552-4ab1-abff-a0ba6721bb15,-31.71,148.67,NSW,Gilgandra,debit,authorized,e5c4d5b2818d4f688ecb5390dc4ba35c,SALES-POS,20-30,2018,10,27,21,1,Saturday,7 days,63892.207
ACC-3481401842,25,8.88,9163.44,1.0,CUS-1669695324,2018-10-27,Tiffany,F,-31.72,115.74,,a6ea44a1-11e5-434e-91b3-358ff633071b,-31.98,115.77,WA,Claremont,debit,authorized,d18967b8dc83468b832dd49ee6ce6a87,POS,20-30,2018,10,27,22,31,Saturday,7 days,63892.207
ACC-3481401842,25,13.78,9149.66,1.0,CUS-1669695324,2018-10-28,Tiffany,F,-31.72,115.74,,bedfaec0-2483-449c-9d0f-b8492469a4a2,-31.91,152.46,NSW,Taree,debit,authorized,1538aa3aa99f45be86bf9f914b40db90,POS,20-30,2018,10,28,10,56,Sunday,7 days,63892.207
ACC-3481401842,25,8.2,9141.46,1.0,CUS-1669695324,2018-10-28,Tiffany,F,-31.72,115.74,,272f1b11-5223-470a-ba5c-751c45ce2e27,-32.13,116,WA,Kelmscott,debit,authorized,df85d1eadb4b4964ae0a9c9cb3379756,SALES-POS,20-30,2018,10,28,12,44,Sunday,7 days,63892.207
ACC-3481401842,25,28.1,9113.36,1.0,CUS-1669695324,2018-10-28,Tiffany,F,-31.72,115.74,,c3d96ed9-62a3-4df6-97e6-79181f5ceb30,-32.01,115.84,WA,Applecross,debit,authorized,8632bd61ac134433a078ead71ff93e74,SALES-POS,20-30,2018,10,28,19,1,Sunday,7 days,63892.207
ACC-3481401842,25,15.64,9097.72,0.0,CUS-1669695324,2018-10-28,Tiffany,F,-31.72,115.74,,af46b006-44d1-4a57-b83a-4c9d4e6f02d7,-31.76,150.83,NSW,Murrurundi,debit,authorized,a28e4f17bc0e4940916462fb36978130,SALES-POS,20-30,2018,10,28,21,28,Sunday,7 days,63892.207
ACC-3481401842,25,10.07,9087.65,1.0,CUS-1669695324,2018-10-29,Tiffany,F,-31.72,115.74,,d06b5e6d-e48c-402c-a1d7-b01531f76c99,-31.95,115.85,WA,Perth,debit,authorized,5767a7de55e840bfa62ae95311693eb0,SALES-POS,20-30,2018,10,29,1,45,Monday,7 days,63892.207
ACC-3481401842,25,13.3,9074.35,1.0,CUS-1669695324,2018-10-29,Tiffany,F,-31.72,115.74,,b5d118eb-8230-43c1-afc0-c91060a2666a,-31.71,148.66,NSW,Gilgandra,debit,authorized,5032d5749fa24d7f9a9c46deb8707028,POS,20-30,2018,10,29,10,10,Monday,7 days,63892.207
ACC-3481401842,25,27.29,9047.06,0.0,CUS-1669695324,2018-10-29,Tiffany,F,-31.72,115.74,,e37d099f-f623-4bad-9a0f-1db919b608ff,-31.89,115.9,WA,Morley,debit,authorized,8087e5334bda4477a9586c0b47afada6,POS,20-30,2018,10,29,14,42,Monday,7 days,63892.207
ACC-3481401842,25,32.0,9015.06,,CUS-1669695324,2018-10-30,Tiffany,F,-31.72,115.74,,,,,,,debit,posted,5adc220a4d6a4a28a20cffe4c9c426ec,PAYMENT,20-30,2018,10,30,15,0,Tuesday,7 days,63892.207
ACC-2615038700,43,12.08,30583.15,0.0,CUS-3255104878,2018-08-01,Emily,F,-38.03,145.35,,354f40cb-55bc-4a81-a00d-c7faede29f8b,-38.01,145.09,VIC,Mordialloc,debit,authorized,49417bad354f4137971a954c26657e2d,POS,40-50,2018,8,1,8,47,Wednesday,7 days,34645.279
ACC-2615038700,43,937.73,29645.42,1.0,CUS-3255104878,2018-08-01,Emily,F,-38.03,145.35,,07df1647-c4aa-479b-a7c2-1952aafbc6bb,-38.03,145.21,VIC,Dandenong South,debit,authorized,44806f4994f249e9a7411776530e0ff6,POS,40-50,2018,8,1,10,55,Wednesday,7 days,34645.279
ACC-2615038700,43,501.67,29143.75,1.0,CUS-3255104878,2018-08-01,Emily,F,-38.03,145.35,,54b35383-6f69-453b-be91-b63005b97135,-16.47,145.35,QLD,Mossman Gorge,debit,authorized,3972bef449b54d3b9db6bc77e1c8d165,SALES-POS,40-50,2018,8,1,11,31,Wednesday,7 days,34645.279
ACC-2615038700,43,15.64,29128.11,0.0,CUS-3255104878,2018-08-01,Emily,F,-38.03,145.35,,47fc3b6a-6e2d-4cd1-87ce-00360cf62893,-38.02,144.4,VIC,Lara,debit,authorized,74c7d8e7a52c411ca0457469d55d5a92,POS,40-50,2018,8,1,13,45,Wednesday,7 days,34645.279
ACC-2615038700,43,560.0,28568.11,,CUS-3255104878,2018-08-04,Emily,F,-38.03,145.35,,,,,,,debit,posted,e5f74049a432462fa9417ca2c4002add,PAYMENT,40-50,2018,8,4,12,0,Saturday,7 days,34645.279
ACC-2615038700,43,29.86,28538.25,1.0,CUS-3255104878,2018-08-04,Emily,F,-38.03,145.35,,e7535b13-1b7c-4f68-a30a-bf70c0d8da06,-37.82,145.04,VIC,Hawthorn,debit,authorized,030a70177b634e619ffa7e8639c7a0e0,POS,40-50,2018,8,4,20,27,Saturday,7 days,34645.279
ACC-2615038700,43,38.0,28486.99,,CUS-3255104878,2018-08-05,Emily,F,-38.03,145.35,,,,,,,debit,posted,0c0519d50eb34d66895efead3d243020,INTER BANK,40-50,2018,8,5,11,0,Sunday,7 days,34645.279
ACC-2615038700,43,13.26,28524.99,1.0,CUS-3255104878,2018-08-05,Emily,F,-38.03,145.35,,0b90bfd8-f29a-4398-b479-b9b438189819,-38.02,145.31,VIC,Narre Warren,debit,authorized,a03d917faa914be0a8c1ba1dc5a9403b,POS,40-50,2018,8,5,11,16,Sunday,7 days,34645.279
ACC-2615038700,43,36.5,28450.49,0.0,CUS-3255104878,2018-08-05,Emily,F,-38.03,145.35,,a8960f5e-08b3-4ce8-bf6a-535ceaecc77a,-38.01,145.2,VIC,Dandenong South,debit,authorized,9dc69a1f5a574a4d97b496cf8d28fee1,POS,40-50,2018,8,5,20,19,Sunday,7 days,34645.279
ACC-2615038700,43,2.93,29111.99,1.0,CUS-3255104878,2018-08-08,Emily,F,-38.03,145.35,,23d2ea4f-3755-4a82-a682-6fec8133be9b,-38.02,144.41,VIC,Lara,debit,authorized,94d997785fd84f73adfa5ab74def4b4f,POS,40-50,2018,8,8,8,39,Wednesday,7 days,34645.279
ACC-2615038700,43,101.0,29010.99,,CUS-3255104878,2018-08-09,Emily,F,-38.03,145.35,,,,,,,debit,posted,e61b527af84f487a870a198175b5ad75,PAYMENT,40-50,2018,8,9,15,0,Thursday,7 days,34645.279
ACC-2615038700,43,25.89,28985.1,1.0,CUS-3255104878,2018-08-10,Emily,F,-38.03,145.35,,c5801b5d-b99f-4d19-88a3-385b70722a0e,-38.01,145.09,VIC,Mordialloc,debit,authorized,a08c525e81f4437c90760d2e337a45da,SALES-POS,40-50,2018,8,10,20,41,Friday,7 days,34645.279
ACC-2615038700,43,16.23,28968.87,1.0,CUS-3255104878,2018-08-11,Emily,F,-38.03,145.35,,20ce6128-7d1e-4e69-b6ae-570eb138e741,-37.73,144.93,VIC,Pascoe Vale,debit,authorized,93e095543f674ffcb372cb86d64c465a,SALES-POS,40-50,2018,8,11,19,8,Saturday,7 days,34645.279
ACC-2615038700,43,7.16,28961.71,1.0,CUS-3255104878,2018-08-11,Emily,F,-38.03,145.35,,4c7536b8-a973-48b5-8a37-343e2644660c,-38.01,145.09,VIC,Mordialloc,debit,authorized,8458e2fe608e40759f5c2630e4c3bb17,POS,40-50,2018,8,11,19,41,Saturday,7 days,34645.279
ACC-2615038700,43,14.74,28946.97,0.0,CUS-3255104878,2018-08-11,Emily,F,-38.03,145.35,,f126cc21-a244-467a-a580-a3225bc2775e,-38.01,144.49,VIC,Point Wilson,debit,authorized,cbb91d9c4612430192195fec1509241b,SALES-POS,40-50,2018,8,11,20,1,Saturday,7 days,34645.279
ACC-2615038700,43,38.0,28908.97,,CUS-3255104878,2018-08-12,Emily,F,-38.03,145.35,,,,,,,debit,posted,d4561770124d487988ec99c936e43698,INTER BANK,40-50,2018,8,12,11,0,Sunday,7 days,34645.279
ACC-2615038700,43,64.5,29470.71,0.0,CUS-3255104878,2018-08-17,Emily,F,-38.03,145.35,,c287e5be-17a3-49ad-80ef-3bd295033671,-37.58,143.87,VIC,Golden Point,debit,authorized,e8a510baaa0646b2987c4d3bcf76fb5a,SALES-POS,40-50,2018,8,17,0,22,Friday,7 days,34645.279
ACC-2615038700,43,28.35,29442.36,1.0,CUS-3255104878,2018-08-17,Emily,F,-38.03,145.35,,812729f9-ab3a-4762-8d25-b9e678d96abc,-37.58,144.71,VIC,Sunbury,debit,authorized,93942931bb83485e9b6a93e404a6b266,POS,40-50,2018,8,17,15,24,Friday,7 days,34645.279
ACC-2615038700,43,4.21,29438.15,1.0,CUS-3255104878,2018-08-17,Emily,F,-38.03,145.35,,b8e909a7-ce93-4615-872e-16a365897290,-37.73,144.89,VIC,Essendon Fields,debit,authorized,2540630a82344e6c91a288266468daf0,SALES-POS,40-50,2018,8,17,17,29,Friday,7 days,34645.279
ACC-2615038700,43,12.16,29425.99,1.0,CUS-3255104878,2018-08-18,Emily,F,-38.03,145.35,,ef31d697-3d29-4f5b-b21a-98ceda056248,-38.01,145.21,VIC,Dandenong South,debit,authorized,d401d8857a49487abc0bd02e68bfe695,SALES-POS,40-50,2018,8,18,11,34,Saturday,7 days,34645.279
ACC-2615038700,43,46.0,29379.99,1.0,CUS-3255104878,2018-08-18,Emily,F,-38.03,145.35,,3c5b0f0a-c9a7-4728-afd2-ad2057375228,-37.78,145.32,VIC,Mooroolbark,debit,authorized,0001043c134f43bda3e3d87b2ee79c9c,SALES-POS,40-50,2018,8,18,12,59,Saturday,7 days,34645.279
ACC-2615038700,43,38.0,29341.99,,CUS-3255104878,2018-08-19,Emily,F,-38.03,145.35,,,,,,,debit,posted,ae93ac9d3d154eb8bc7ddb2f26557eb9,INTER BANK,40-50,2018,8,19,11,0,Sunday,7 days,34645.279
ACC-2615038700,43,178.28,29828.14,1.0,CUS-3255104878,2018-08-22,Emily,F,-38.03,145.35,,0d607b5d-581e-461d-b6b7-91f0bf8bb205,-38.04,145.11,VIC,Edithvale,debit,authorized,a08afa3ec69a4810a82702f5998f3a22,SALES-POS,40-50,2018,8,22,14,49,Wednesday,7 days,34645.279
ACC-2615038700,43,9.83,29818.31,0.0,CUS-3255104878,2018-08-23,Emily,F,-38.03,145.35,,ca76c244-2b13-4760-8832-3d02d0ef8bae,-33.88,151.21,NSW,Surry Hills,debit,authorized,fb4a580f8f3e45129be0f2bd1b07f019,SALES-POS,40-50,2018,8,23,19,55,Thursday,7 days,34645.279
ACC-2615038700,43,38.0,29780.31,,CUS-3255104878,2018-08-26,Emily,F,-38.03,145.35,,,,,,,debit,posted,f7662e878e6142e5a93b61e04be640df,INTER BANK,40-50,2018,8,26,11,0,Sunday,7 days,34645.279
ACC-2615038700,43,38.0,30406.74,,CUS-3255104878,2018-09-02,Emily,F,-38.03,145.35,,,,,,,debit,posted,7aae7f617c374daaa3afd831227513a5,INTER BANK,40-50,2018,9,2,11,0,Sunday,7 days,34645.279
ACC-2615038700,43,1270.0,29801.17,,CUS-3255104878,2018-09-08,Emily,F,-38.03,145.35,,,,,,,debit,posted,5cf718112fe042deb489eb604baff8a3,PAYMENT,40-50,2018,9,8,22,0,Saturday,7 days,34645.279
ACC-2615038700,43,38.0,29763.17,,CUS-3255104878,2018-09-09,Emily,F,-38.03,145.35,,,,,,,debit,posted,3e07636dd9d6436f8d34ba284cdd44e9,INTER BANK,40-50,2018,9,9,11,0,Sunday,7 days,34645.279
ACC-2615038700,43,101.0,29662.17,,CUS-3255104878,2018-09-09,Emily,F,-38.03,145.35,,,,,,,debit,posted,e7cf8392cf314f97bfc7cf9c6de019e9,PAYMENT,40-50,2018,9,9,15,0,Sunday,7 days,34645.279
ACC-2615038700,43,7.17,30319.43,1.0,CUS-3255104878,2018-09-11,Emily,F,-38.03,145.35,,5b4441b9-71ee-4ff2-9946-286d37e65be4,-37.82,144.97,VIC,Melbourne,debit,authorized,e68744769f0d4b5197476ebfe4c7e098,POS,40-50,2018,9,11,13,26,Tuesday,7 days,34645.279
ACC-2615038700,43,30.94,30288.49,1.0,CUS-3255104878,2018-09-12,Emily,F,-38.03,145.35,,42ad63fa-ddda-481b-95dd-80bdc3e3851a,-37.74,144.97,VIC,Coburg,debit,authorized,faa80613813344e583e7a11fadfbcc76,SALES-POS,40-50,2018,9,12,9,36,Wednesday,7 days,34645.279
ACC-2615038700,43,38.0,30250.49,,CUS-3255104878,2018-09-16,Emily,F,-38.03,145.35,,,,,,,debit,posted,97106d15ebd7461ca5479b2517264853,INTER BANK,40-50,2018,9,16,11,0,Sunday,7 days,34645.279
ACC-2615038700,43,38.0,30876.92,,CUS-3255104878,2018-09-23,Emily,F,-38.03,145.35,,,,,,,debit,posted,90aa5c0692874fb097954fd68c659d46,INTER BANK,40-50,2018,9,23,11,0,Sunday,7 days,34645.279
ACC-2615038700,43,38.0,31503.35,,CUS-3255104878,2018-09-30,Emily,F,-38.03,145.35,,,,,,,debit,posted,db3201579afc47888d43c68af1faa882,INTER BANK,40-50,2018,9,30,11,0,Sunday,7 days,34645.279
ACC-2615038700,43,38.0,32129.78,,CUS-3255104878,2018-10-07,Emily,F,-38.03,145.35,,,,,,,debit,posted,9b2df198605f4bf782c716d233bd312c,INTER BANK,40-50,2018,10,7,11,0,Sunday,7 days,34645.279
ACC-2615038700,43,101.0,32693.21,,CUS-3255104878,2018-10-09,Emily,F,-38.03,145.35,,,,,,,debit,posted,0237ddf8d38a43d39c15ae5b4f624426,PAYMENT,40-50,2018,10,9,15,0,Tuesday,7 days,34645.279
ACC-2615038700,43,38.0,32655.21,,CUS-3255104878,2018-10-14,Emily,F,-38.03,145.35,,,,,,,debit,posted,f3ee67d6a5ed4c7f9f7d36a9dd8aa0cc,INTER BANK,40-50,2018,10,14,11,0,Sunday,7 days,34645.279
ACC-2615038700,43,38.0,33281.64,,CUS-3255104878,2018-10-21,Emily,F,-38.03,145.35,,,,,,,debit,posted,223a8c642ece4461a0dc87636cc4e059,INTER BANK,40-50,2018,10,21,11,0,Sunday,7 days,34645.279
ACC-2615038700,43,38.0,33908.07,,CUS-3255104878,2018-10-28,Emily,F,-38.03,145.35,,,,,,,debit,posted,7817350917ac4abfbf61f25f259ecbdc,INTER BANK,40-50,2018,10,28,11,0,Sunday,7 days,34645.279
ACC-966140392,21,72.12,793.64,1.0,CUS-537508723,2018-08-01,Joseph,M,-37.97,147.08,,7ec296e9-6feb-46b0-b755-115ce31678c1,-33.8,151.18,NSW,Chatswood,debit,authorized,80005b72314045ff9b7d48b6f2b63615,POS,20-30,2018,8,1,8,57,Wednesday,14 days,67079.439
ACC-966140392,21,30.0,763.64,,CUS-537508723,2018-08-01,Joseph,M,-37.97,147.08,,,,,,,debit,posted,6d12e9e1c9fe4f899b04c2e1f40fb790,PAYMENT,20-30,2018,8,1,10,0,Wednesday,14 days,67079.439
ACC-966140392,21,12.89,750.75,1.0,CUS-537508723,2018-08-01,Joseph,M,-37.97,147.08,,9f0244d9-2b86-4065-85dc-6c2089ddc749,-37.91,145.16,VIC,Wheelers Hill,debit,authorized,afdd21bfccd949c9b24480909c86de1e,SALES-POS,20-30,2018,8,1,15,39,Wednesday,14 days,67079.439
ACC-966140392,21,35.0,715.75,,CUS-537508723,2018-08-02,Joseph,M,-37.97,147.08,,,,,,,debit,posted,9a133bff514740489dae8a1541cd6787,PAYMENT,20-30,2018,8,2,12,0,Thursday,14 days,67079.439
ACC-966140392,21,130.0,585.75,,CUS-537508723,2018-08-03,Joseph,M,-37.97,147.08,,,,,,,debit,posted,0912e727aeef49879c308d14f8e557e9,PAYMENT,20-30,2018,8,3,11,0,Friday,14 days,67079.439
ACC-966140392,21,10.22,3148.44,1.0,CUS-537508723,2018-08-04,Joseph,M,-37.97,147.08,,354f40cb-55bc-4a81-a00d-c7faede29f8b,-38.01,145.09,VIC,Mordialloc,debit,authorized,403a683e95854861bd87cc57a8db8c4e,SALES-POS,20-30,2018,8,4,11,3,Saturday,14 days,67079.439
ACC-966140392,21,19.69,3128.75,1.0,CUS-537508723,2018-08-04,Joseph,M,-37.97,147.08,,19213a49-6d92-4728-a9b8-e42d8be8f0d7,-38.05,145.12,VIC,Chelsea,debit,authorized,82f9c5632e7243c7a28902386625ca43,SALES-POS,20-30,2018,8,4,12,31,Saturday,14 days,67079.439
ACC-966140392,21,7.16,3121.59,1.0,CUS-537508723,2018-08-04,Joseph,M,-37.97,147.08,,e3599c35-de73-4ee4-8cf9-ebd6c671aaf5,-38.15,144.36,VIC,Geelong,debit,authorized,8367242d2bbb433e82138b72b338909c,SALES-POS,20-30,2018,8,4,14,7,Saturday,14 days,67079.439
ACC-966140392,21,30.0,3091.59,,CUS-537508723,2018-08-08,Joseph,M,-37.97,147.08,,,,,,,debit,posted,e8d7c7f6a0d745e2b552205d4147b887,PAYMENT,20-30,2018,8,8,10,0,Wednesday,14 days,67079.439
ACC-966140392,21,18.17,3073.42,1.0,CUS-537508723,2018-08-08,Joseph,M,-37.97,147.08,,f41d81a6-48d8-4005-abdb-8364e540d4c9,-38.12,145.19,VIC,Carrum Downs,debit,authorized,0270c688e3594421b27d0fbe52ed9b0b,POS,20-30,2018,8,8,11,1,Wednesday,14 days,67079.439
ACC-966140392,21,7.26,3066.16,1.0,CUS-537508723,2018-08-08,Joseph,M,-37.97,147.08,,ca76c244-2b13-4760-8832-3d02d0ef8bae,-33.88,151.21,NSW,Surry Hills,debit,authorized,0a8f26177a014ac3801f69751d84b546,POS,20-30,2018,8,8,13,32,Wednesday,14 days,67079.439
ACC-966140392,21,23.72,3042.44,1.0,CUS-537508723,2018-08-08,Joseph,M,-37.97,147.08,,f138be59-da55-4761-b323-77ad782c8992,-37.91,144.67,VIC,Werribee,debit,authorized,0c83ef255cd8490e99801b949a78235e,POS,20-30,2018,8,8,13,51,Wednesday,14 days,67079.439
ACC-966140392,21,19.5,3022.94,1.0,CUS-537508723,2018-08-09,Joseph,M,-37.97,147.08,,56144881-5000-45b0-a9ac-84f4d2165205,-38.05,145.12,VIC,Chelsea,debit,authorized,41f9554489474fd4a8794a9cd2f48df6,SALES-POS,20-30,2018,8,9,9,23,Thursday,14 days,67079.439
ACC-966140392,21,25.03,2997.91,1.0,CUS-537508723,2018-08-09,Joseph,M,-37.97,147.08,,53337b71-5833-4618-aa68-0a454e5e72b5,-41.44,147.14,TAS,Launceston,debit,authorized,e4f8d71734584eaeac7412e919b7c6ed,SALES-POS,20-30,2018,8,9,9,27,Thursday,14 days,67079.439
ACC-966140392,21,247.66,2750.25,0.0,CUS-537508723,2018-08-09,Joseph,M,-37.97,147.08,,91287e52-e392-47c6-8f7c-b94c41f7626c,-33.86,151.2,NSW,Sydney,debit,authorized,a1e3a6aa22814f50bc1f9b4987647111,POS,20-30,2018,8,9,11,21,Thursday,14 days,67079.439
ACC-966140392,21,35.0,2693.6,,CUS-537508723,2018-08-09,Joseph,M,-37.97,147.08,,,,,,,debit,posted,bd282d20c6434d3db583df463a6e28e2,PAYMENT,20-30,2018,8,9,12,0,Thursday,14 days,67079.439
ACC-966140392,21,21.65,2728.6,1.0,CUS-537508723,2018-08-09,Joseph,M,-37.97,147.08,,861d1f14-dbd8-48cf-812b-28cd71caae62,-37.85,144.99,VIC,Prahran,debit,authorized,42e71949504a4709abb1027683a31976,POS,20-30,2018,8,9,12,28,Thursday,14 days,67079.439
ACC-966140392,21,29.87,2663.73,1.0,CUS-537508723,2018-08-09,Joseph,M,-37.97,147.08,,951254dc-11b5-41d3-ab9a-46a9e8f78897,-38.22,145.04,VIC,Mornington,debit,authorized,3b58c2601f964fd6846cddc4abe4a39c,SALES-POS,20-30,2018,8,9,14,31,Thursday,14 days,67079.439
ACC-966140392,21,11.24,2652.49,1.0,CUS-537508723,2018-08-09,Joseph,M,-37.97,147.08,,38ffa834-11d6-461a-a748-bd3df9d4db57,-36.12,146.88,VIC,Wodonga,debit,authorized,f19e7107094049cfa59375b6c0a6ec43,POS,20-30,2018,8,9,16,5,Thursday,14 days,67079.439
ACC-966140392,21,16.72,2635.77,0.0,CUS-537508723,2018-08-10,Joseph,M,-37.97,147.08,,e109991a-933b-4769-8b19-1b2aef18e785,-37.75,145,VIC,Preston,debit,authorized,2cebdee22e894c41844974d8b7e3009f,POS,20-30,2018,8,10,17,4,Friday,14 days,67079.439
ACC-966140392,21,51.9,2583.87,1.0,CUS-537508723,2018-08-12,Joseph,M,-37.97,147.08,,1f710525-86cc-4923-ba90-6395e503cacc,-26.42,147.11,QLD,Morven,debit,authorized,2f1061e7d87348dc9d38aecd29221071,SALES-POS,20-30,2018,8,12,14,53,Sunday,14 days,67079.439
ACC-966140392,21,35.65,2548.22,1.0,CUS-537508723,2018-08-12,Joseph,M,-37.97,147.08,,b6ff89a1-18dd-4d77-b807-47f511ed3fee,-38.03,145.27,VIC,Hampton Park,debit,authorized,75fe783e989544309e4d450af0e54da4,POS,20-30,2018,8,12,15,5,Sunday,14 days,67079.439
ACC-966140392,21,17.01,2531.21,1.0,CUS-537508723,2018-08-12,Joseph,M,-37.97,147.08,,ac6175a9-eab7-4901-99d9-a3e5d46b16bb,-37.98,145.07,VIC,Mentone,debit,authorized,3f3f77027c474e8587264e0f8b77001e,SALES-POS,20-30,2018,8,12,17,54,Sunday,14 days,67079.439
ACC-966140392,21,28.64,2502.57,1.0,CUS-537508723,2018-08-12,Joseph,M,-37.97,147.08,,4c6dbe59-19c1-4fb7-8e1b-01ddd574619a,-37.91,145.03,VIC,Mckinnon,debit,authorized,c2048e42cc6942d3aef34df89ce07d16,POS,20-30,2018,8,12,18,18,Sunday,14 days,67079.439
ACC-966140392,21,20.1,2482.47,1.0,CUS-537508723,2018-08-12,Joseph,M,-37.97,147.08,,56144881-5000-45b0-a9ac-84f4d2165205,-38.05,145.12,VIC,Chelsea,debit,authorized,fc0c18b286ef4136b4e34a97a74032ac,SALES-POS,20-30,2018,8,12,22,16,Sunday,14 days,67079.439
ACC-966140392,21,10.01,2472.46,0.0,CUS-537508723,2018-08-13,Joseph,M,-37.97,147.08,,6a61a773-11dd-4438-91dc-acffdc81bf59,-36.05,146.93,NSW,Lavington,debit,authorized,006f490ba5934da8865fd3979cb8d05d,SALES-POS,20-30,2018,8,13,1,53,Monday,14 days,67079.439
ACC-966140392,21,11.32,2461.14,1.0,CUS-537508723,2018-08-13,Joseph,M,-37.97,147.08,,248349a3-93c9-43bc-8fa6-0f8b69f351bd,-38.2,144.32,VIC,Waurn Ponds,debit,authorized,25fa29425f094c49bbbcb4cae0a964d8,SALES-POS,20-30,2018,8,13,9,6,Monday,14 days,67079.439
ACC-966140392,21,14.06,2447.08,1.0,CUS-537508723,2018-08-13,Joseph,M,-37.97,147.08,,cc0c026f-5ebb-4b23-b753-fb7a11f5c133,-37.86,144.98,VIC,Saint Kilda,debit,authorized,37ba1f8bea1f4471a57fcc15faeb37fd,SALES-POS,20-30,2018,8,13,9,28,Monday,14 days,67079.439
ACC-966140392,21,10.75,2436.33,0.0,CUS-537508723,2018-08-13,Joseph,M,-37.97,147.08,,125e0d1e-b936-452d-93ad-b36eeb7cda80,-38.18,144.34,VIC,Belmont,debit,authorized,4b81567cef02445c8848de644d6814e9,SALES-POS,20-30,2018,8,13,9,32,Monday,14 days,67079.439
ACC-966140392,21,134.0,2293.77,,CUS-537508723,2018-08-13,Joseph,M,-37.97,147.08,,,,,,,debit,posted,bac9a5dbdbd24f8d83ddbfee480c700a,PAYMENT,20-30,2018,8,13,10,0,Monday,14 days,67079.439
ACC-966140392,21,8.56,2427.77,1.0,CUS-537508723,2018-08-13,Joseph,M,-37.97,147.08,,9086ea81-45b4-474e-b4a8-c02122a8c889,-41.54,147.2,TAS,Western Junction,debit,authorized,7e90072ccadf47b0b48497cbbca86613,POS,20-30,2018,8,13,10,5,Monday,14 days,67079.439
ACC-966140392,21,15.18,2278.59,1.0,CUS-537508723,2018-08-14,Joseph,M,-37.97,147.08,,5c7e5efa-4a1f-474c-9423-797540a56bc0,-37.74,144.8,VIC,Saint Albans,debit,authorized,5b785b0473fe4153a415a5d329468bb4,SALES-POS,20-30,2018,8,14,7,27,Tuesday,14 days,67079.439
ACC-966140392,21,26.4,2252.19,1.0,CUS-537508723,2018-08-14,Joseph,M,-37.97,147.08,,cd6c7273-2edc-4b22-8dd9-032915e86916,-38.09,145.13,VIC,Seaford,debit,authorized,d4efc224340549f6a66290bdb3088baa,POS,20-30,2018,8,14,8,43,Tuesday,14 days,67079.439
ACC-966140392,21,9.66,2242.53,1.0,CUS-537508723,2018-08-14,Joseph,M,-37.97,147.08,,3c74a77d-4845-47e4-a9eb-719adc4fb045,-38.15,145.2,VIC,Langwarrin,debit,authorized,d2707a22198441199d5465640ceb4419,POS,20-30,2018,8,14,9,4,Tuesday,14 days,67079.439
ACC-966140392,21,30.0,2212.53,,CUS-537508723,2018-08-15,Joseph,M,-37.97,147.08,,,,,,,debit,posted,0618623dc04e42b48811069960057dbb,PAYMENT,20-30,2018,8,15,10,0,Wednesday,14 days,67079.439
ACC-966140392,21,33.94,2178.59,1.0,CUS-537508723,2018-08-15,Joseph,M,-37.97,147.08,,b729d4db-f4f3-46a3-8524-cb985f538617,-37.77,144.95,VIC,Brunswick,debit,authorized,c39ff03c1b8c41f4a05a2a03e2f5f9c0,POS,20-30,2018,8,15,14,26,Wednesday,14 days,67079.439
ACC-966140392,21,9.69,2168.9,1.0,CUS-537508723,2018-08-15,Joseph,M,-37.97,147.08,,c30b53dc-f76d-4850-af12-824fc0976589,-38.01,145.16,VIC,Keysborough,debit,authorized,7163b31555964feeb06c890ade49d9a2,POS,20-30,2018,8,15,16,43,Wednesday,14 days,67079.439
ACC-966140392,21,16.18,2152.72,1.0,CUS-537508723,2018-08-15,Joseph,M,-37.97,147.08,,a83cc4b9-cc95-4f83-b47a-d3a67eb87967,-37.84,145.17,VIC,Forest Hill,debit,authorized,8c4869c61af0480793c244041398e501,POS,20-30,2018,8,15,19,8,Wednesday,14 days,67079.439
ACC-966140392,21,12.46,2140.26,1.0,CUS-537508723,2018-08-15,Joseph,M,-37.97,147.08,,072aacff-7e3c-499e-b00a-052a6ee882f7,-42.74,147.23,TAS,Bridgewater,debit,authorized,07179500885c41fda1318c4f43f69b0f,POS,20-30,2018,8,15,23,57,Wednesday,14 days,67079.439
ACC-966140392,21,29.36,3354.67,1.0,CUS-537508723,2018-08-18,Joseph,M,-37.97,147.08,,e58a6e08-d5dd-4146-9b9b-6aedd7e98905,-37.75,144.95,VIC,Brunswick West,debit,authorized,f9904b9331554ec2a3936d3daaced0fd,SALES-POS,20-30,2018,8,18,10,46,Saturday,14 days,67079.439
ACC-966140392,21,90.9,3263.77,1.0,CUS-537508723,2018-08-18,Joseph,M,-37.97,147.08,,b00246e3-090c-4ac5-a918-3871f12666f2,-37.72,145.14,VIC,Eltham,debit,authorized,7801349e3c5c482f94f8ef40d51f4d81,SALES-POS,20-30,2018,8,18,20,49,Saturday,14 days,67079.439
ACC-966140392,21,12.89,3250.88,1.0,CUS-537508723,2018-08-18,Joseph,M,-37.97,147.08,,ce1f95bd-aa19-401a-8e9d-b2084ea9da99,-37.91,145.16,VIC,Wheelers Hill,debit,authorized,3bae3a0967b8410a9d34712680108a48,SALES-POS,20-30,2018,8,18,21,14,Saturday,14 days,67079.439
ACC-966140392,21,24.7,3226.18,0.0,CUS-537508723,2018-08-18,Joseph,M,-37.97,147.08,,85fb518d-9542-4cc4-bff3-710cd2cdf72c,-37.94,145,VIC,Hampton,debit,authorized,5abdd05927b04f4a9a72c460377c47a8,POS,20-30,2018,8,18,21,44,Saturday,14 days,67079.439
ACC-966140392,21,30.0,3196.18,,CUS-537508723,2018-08-22,Joseph,M,-37.97,147.08,,,,,,,debit,posted,d99b7fba2e81478098e1caaa3362c56f,PAYMENT,20-30,2018,8,22,10,0,Wednesday,14 days,67079.439
ACC-966140392,21,35.0,3161.18,,CUS-537508723,2018-08-23,Joseph,M,-37.97,147.08,,,,,,,debit,posted,9439ebb2ec934e0f9492552ee933a6af,PAYMENT,20-30,2018,8,23,12,0,Thursday,14 days,67079.439
ACC-966140392,21,9.62,3151.56,1.0,CUS-537508723,2018-08-24,Joseph,M,-37.97,147.08,,feb098d1-9a5b-46e0-a09a-5ecb1316eabf,-37.87,144.78,VIC,Altona Meadows,debit,authorized,be7f3c544a8142fc8eab10a1f047df63,SALES-POS,20-30,2018,8,24,1,10,Friday,14 days,67079.439
ACC-966140392,21,24.05,3127.51,0.0,CUS-537508723,2018-08-24,Joseph,M,-37.97,147.08,,4f4bcf97-ac15-4e8d-b5e3-973a6e2eb073,-37.74,145.03,VIC,Preston,debit,authorized,dfa4b47163904324a9062087d36fb81b,POS,20-30,2018,8,24,6,49,Friday,14 days,67079.439
ACC-966140392,21,19.8,3107.71,0.0,CUS-537508723,2018-08-24,Joseph,M,-37.97,147.08,,4212ecd1-709b-4d32-910b-ebc0eb1f5b47,-37.86,145.35,VIC,Sassafras,debit,authorized,467c9be052d94a558357f2606be7236b,SALES-POS,20-30,2018,8,24,11,57,Friday,14 days,67079.439
ACC-966140392,21,14.3,3093.41,1.0,CUS-537508723,2018-08-24,Joseph,M,-37.97,147.08,,ad39de1d-4bb5-485a-8daa-c963ec5f6b5b,-38.2,144.32,VIC,Grovedale,debit,authorized,6b67538e5d66474e9dd9cd95351f8802,POS,20-30,2018,8,24,12,12,Friday,14 days,67079.439
ACC-966140392,21,7.25,3086.16,0.0,CUS-537508723,2018-08-25,Joseph,M,-37.97,147.08,,9048af37-4a3d-496f-a9d6-25ce11dbe914,-37.78,144.82,VIC,Glengala,debit,authorized,df581b50c42447c390b4bbe7776b6a3a,SALES-POS,20-30,2018,8,25,20,17,Saturday,14 days,67079.439
ACC-966140392,21,17.64,3068.52,1.0,CUS-537508723,2018-08-25,Joseph,M,-37.97,147.08,,c097cbd3-b786-4846-ade9-9a50299dbed2,-38.15,145.17,VIC,Frankston,debit,authorized,9d480248da644e1a8c7e0f72550651cc,SALES-POS,20-30,2018,8,25,21,19,Saturday,14 days,67079.439
ACC-966140392,21,36.32,3032.2,1.0,CUS-537508723,2018-08-25,Joseph,M,-37.97,147.08,,910fa126-9077-43be-bf41-fa7072d5f0be,-38.22,145.04,VIC,Mornington,debit,authorized,8614bc9beacc462b875a1648bd1c8f52,SALES-POS,20-30,2018,8,25,21,24,Saturday,14 days,67079.439
ACC-966140392,21,12.9,3019.3,1.0,CUS-537508723,2018-08-25,Joseph,M,-37.97,147.08,,c3a5e1a8-83ce-47a6-a37f-5357fcf0137e,-37.89,145.09,VIC,Oakleigh,debit,authorized,f88de39c080e4a49bb74b84b0db2a411,POS,20-30,2018,8,25,21,29,Saturday,14 days,67079.439
ACC-966140392,21,24.14,2995.16,1.0,CUS-537508723,2018-08-26,Joseph,M,-37.97,147.08,,bfc2e4e8-43e2-4473-9a42-01eeaa5bc568,-37.86,145.03,VIC,Malvern,debit,authorized,3e967d3b418a41d1b1ea7196d23443c5,SALES-POS,20-30,2018,8,26,11,51,Sunday,14 days,67079.439
ACC-966140392,21,21.47,2973.69,1.0,CUS-537508723,2018-08-27,Joseph,M,-37.97,147.08,,df08814b-3453-493e-8e5f-067ea52e1c22,-37.75,145.35,VIC,Lilydale,debit,authorized,21166c9011c54561a1ac5cf7293966eb,SALES-POS,20-30,2018,8,27,6,49,Monday,14 days,67079.439
ACC-966140392,21,30.33,2943.36,1.0,CUS-537508723,2018-08-27,Joseph,M,-37.97,147.08,,e33c4e9c-f14d-4ce4-90d4-369e532d0f79,-37.99,145.03,VIC,Beaumaris,debit,authorized,d6fb0977bf57425fb5fb49da722f75a7,SALES-POS,20-30,2018,8,27,10,34,Monday,14 days,67079.439
ACC-966140392,21,559.33,2384.03,1.0,CUS-537508723,2018-08-28,Joseph,M,-37.97,147.08,,1fd2c765-a10e-4108-b8d7-5a0aee909226,-36.11,146.87,VIC,West Wodonga,debit,authorized,3d3235a052d24736a936a84cbdb07ca9,POS,20-30,2018,8,28,9,36,Tuesday,14 days,67079.439
ACC-966140392,21,30.0,2354.03,,CUS-537508723,2018-08-29,Joseph,M,-37.97,147.08,,,,,,,debit,posted,1d15216d696941ecab584430c5d10062,PAYMENT,20-30,2018,8,29,10,0,Wednesday,14 days,67079.439
ACC-966140392,21,14.7,2339.33,0.0,CUS-537508723,2018-08-30,Joseph,M,-37.97,147.08,,bfb6a27c-139c-4728-9be7-d1b68e430cb2,-27.47,153.03,QLD,Brisbane City,debit,authorized,31e0ee839b314ce5b2245e3b5d303189,POS,20-30,2018,8,30,8,15,Thursday,14 days,67079.439
ACC-966140392,21,31.66,2307.67,1.0,CUS-537508723,2018-08-30,Joseph,M,-37.97,147.08,,79dabde3-141d-4363-9b6d-043d695cba32,-37.91,145.01,VIC,Melbourne,debit,authorized,767ef2b449d8492dae892959115f31a5,POS,20-30,2018,8,30,8,26,Thursday,14 days,67079.439
ACC-966140392,21,10.19,2297.48,1.0,CUS-537508723,2018-08-30,Joseph,M,-37.97,147.08,,078398fa-9310-47fa-9946-f04d3f182307,-37.8,144.99,VIC,Collingwood,debit,authorized,b10d927e66e049f285f508feda8bbf43,SALES-POS,20-30,2018,8,30,11,9,Thursday,14 days,67079.439
ACC-966140392,21,10.1,2287.38,1.0,CUS-537508723,2018-08-30,Joseph,M,-37.97,147.08,,93d9b4fe-7a24-47fb-a72e-05961625e9a8,-37.77,144.89,VIC,Maribyrnong,debit,authorized,74f271dc3676462db33f8a9ba63fd045,SALES-POS,20-30,2018,8,30,11,27,Thursday,14 days,67079.439
ACC-966140392,21,35.0,2252.38,,CUS-537508723,2018-08-30,Joseph,M,-37.97,147.08,,,,,,,debit,posted,4965de38c7cb47b19ec1af98dffa03ac,PAYMENT,20-30,2018,8,30,12,0,Thursday,14 days,67079.439
ACC-966140392,21,8.89,2243.49,1.0,CUS-537508723,2018-08-31,Joseph,M,-37.97,147.08,,f18e2613-241a-403c-82e4-5dcd4b454f9c,-37.9,145.04,VIC,Ormond,debit,authorized,009a7fe21a444b37bf62e898b7d30164,SALES-POS,20-30,2018,8,31,17,57,Friday,14 days,67079.439
ACC-966140392,21,130.0,4686.4,,CUS-537508723,2018-09-03,Joseph,M,-37.97,147.08,,,,,,,debit,posted,f13a78e18c0d4eb4b4d737bdbe1be0b8,PAYMENT,20-30,2018,9,3,11,0,Monday,14 days,67079.439
ACC-966140392,21,30.0,4656.4,,CUS-537508723,2018-09-05,Joseph,M,-37.97,147.08,,,,,,,debit,posted,b582f8eb9eba4b639b6f53ccd4ce172f,PAYMENT,20-30,2018,9,5,10,0,Wednesday,14 days,67079.439
ACC-966140392,21,35.0,4621.4,,CUS-537508723,2018-09-06,Joseph,M,-37.97,147.08,,,,,,,debit,posted,3e0a96b322a44fbc8b926f165fdc5875,PAYMENT,20-30,2018,9,6,12,0,Thursday,14 days,67079.439
ACC-966140392,21,30.0,4591.4,,CUS-537508723,2018-09-12,Joseph,M,-37.97,147.08,,,,,,,debit,posted,67dbcffdc2bd45449380d73e178ba1d9,PAYMENT,20-30,2018,9,12,10,0,Wednesday,14 days,67079.439
ACC-966140392,21,14.05,4577.35,1.0,CUS-537508723,2018-09-12,Joseph,M,-37.97,147.08,,63431a9c-2ef8-4229-b2bf-ce794432d32a,-38.15,144.36,VIC,Geelong,debit,authorized,53a0a2f59bb3483e8de5e43ef51179b9,SALES-POS,20-30,2018,9,12,22,51,Wednesday,14 days,67079.439
ACC-966140392,21,10.89,4566.46,1.0,CUS-537508723,2018-09-13,Joseph,M,-37.97,147.08,,c34d1bb1-04b3-407e-b7e6-45ef0b497902,-37.93,145.16,VIC,Springvale,debit,authorized,94a1671e280d4f9f88c6fd8dc184c6f2,POS,20-30,2018,9,13,8,4,Thursday,14 days,67079.439
ACC-966140392,21,134.0,4432.46,,CUS-537508723,2018-09-13,Joseph,M,-37.97,147.08,,,,,,,debit,posted,b55028fdaa2b408db952f4443aa52f9e,PAYMENT,20-30,2018,9,13,10,0,Thursday,14 days,67079.439
ACC-966140392,21,35.0,4397.46,,CUS-537508723,2018-09-13,Joseph,M,-37.97,147.08,,,,,,,debit,posted,a0a9210958ba434c999f1271456ffc40,PAYMENT,20-30,2018,9,13,12,0,Thursday,14 days,67079.439
ACC-966140392,21,25.56,4371.9,1.0,CUS-537508723,2018-09-13,Joseph,M,-37.97,147.08,,5e82896e-3f00-48c9-bd27-492f15439b39,-37.94,145.1,VIC,Clarinda,debit,authorized,20d86ac400c54651a3f30a5575ace95e,SALES-POS,20-30,2018,9,13,20,56,Thursday,14 days,67079.439
ACC-966140392,21,12.09,4359.81,1.0,CUS-537508723,2018-09-13,Joseph,M,-37.97,147.08,,e6988ff9-81da-4d27-98ff-4835a1ad5dd4,-37.9,145.23,VIC,Knoxfield,debit,authorized,8cfbc07bdbf94710bbd678c8c3e603b4,SALES-POS,20-30,2018,9,13,21,11,Thursday,14 days,67079.439
ACC-966140392,21,13.38,4346.43,1.0,CUS-537508723,2018-09-13,Joseph,M,-37.97,147.08,,3fe81527-e10f-4341-a789-d227e7180dab,-38.1,145.19,VIC,Carrum Downs,debit,authorized,60675430514d459fbf25bea70df26f89,SALES-POS,20-30,2018,9,13,21,25,Thursday,14 days,67079.439
ACC-966140392,21,12.69,6906.65,1.0,CUS-537508723,2018-09-17,Joseph,M,-37.97,147.08,,7a5aae8a-3a6b-40f3-bfcf-ba3cf9921e89,-37.87,144.98,VIC,Saint Kilda,debit,authorized,6a48aa1718ac4f27bd76632e8a90c2e0,SALES-POS,20-30,2018,9,17,2,59,Monday,14 days,67079.439
ACC-966140392,21,5.92,6900.73,1.0,CUS-537508723,2018-09-17,Joseph,M,-37.97,147.08,,7a65c43b-9ab1-4141-8103-4473582620bd,-37.91,145.13,VIC,Clayton,debit,authorized,c02a289c0e624047911f408e20c1f369,SALES-POS,20-30,2018,9,17,9,54,Monday,14 days,67079.439
ACC-966140392,21,15.1,6885.63,1.0,CUS-537508723,2018-09-17,Joseph,M,-37.97,147.08,,fcaa0c28-b805-4869-acef-6ffb8381916a,-37.82,144.96,VIC,Melbourne,debit,authorized,66827939c3394830a50418a58dff5e5b,SALES-POS,20-30,2018,9,17,12,34,Monday,14 days,67079.439
ACC-966140392,21,14.47,6871.16,1.0,CUS-537508723,2018-09-18,Joseph,M,-37.97,147.08,,945cc016-0daf-4285-89d3-ef76df6e477a,-37.82,145.03,VIC,Hawthorn,debit,authorized,877f6be36d594b9e9c7ee2d97096aab7,SALES-POS,20-30,2018,9,18,17,10,Tuesday,14 days,67079.439
ACC-966140392,21,30.0,6791.24,,CUS-537508723,2018-09-19,Joseph,M,-37.97,147.08,,,,,,,debit,posted,486dd471477f4e6d9bccca91fd3b51c8,PAYMENT,20-30,2018,9,19,10,0,Wednesday,14 days,67079.439
ACC-966140392,21,19.58,6851.58,1.0,CUS-537508723,2018-09-19,Joseph,M,-37.97,147.08,,4c4bfc7b-72a9-493f-91fe-f540f55dbe1c,-37.86,145.03,VIC,Armadale,debit,authorized,a4a10e14934341abaa4ea0dbbb4e117f,POS,20-30,2018,9,19,10,36,Wednesday,14 days,67079.439
ACC-966140392,21,9.07,6842.51,1.0,CUS-537508723,2018-09-19,Joseph,M,-37.97,147.08,,ab1f8945-4a5e-40b8-9875-08d15b2c7c73,-37.75,145.04,VIC,Heidelberg West,debit,authorized,5d4569d2673b49f8b0b112f5eb1f6daa,POS,20-30,2018,9,19,10,45,Wednesday,14 days,67079.439
ACC-966140392,21,21.27,6821.24,0.0,CUS-537508723,2018-09-19,Joseph,M,-37.97,147.08,,f600d2d8-6d0d-49ed-896e-474109610f19,-37.97,145.25,VIC,Endeavour Hills,debit,authorized,85d9a2cb422240aca2e4c6382043c770,SALES-POS,20-30,2018,9,19,10,54,Wednesday,14 days,67079.439
ACC-966140392,21,35.29,6755.95,1.0,CUS-537508723,2018-09-19,Joseph,M,-37.97,147.08,,df25a4bb-4407-4b91-b269-aa94f6b78ae7,-38.2,144.32,VIC,Highton,debit,authorized,48c581b258104f1b97423c0359ef323f,POS,20-30,2018,9,19,11,33,Wednesday,14 days,67079.439
ACC-966140392,21,79.87,6676.08,0.0,CUS-537508723,2018-09-19,Joseph,M,-37.97,147.08,,9633dc31-66bc-4b99-b578-fba71694452c,-31.96,115.91,WA,Rivervale,debit,authorized,734c10ece9de42c1a4b0eb834f398d7b,POS,20-30,2018,9,19,11,45,Wednesday,14 days,67079.439
ACC-966140392,21,31.48,6644.6,1.0,CUS-537508723,2018-09-19,Joseph,M,-37.97,147.08,,ffcc5e3d-1bb8-4357-9e08-7ac5e20ed4c9,-38.1,145.19,VIC,Carrum Downs,debit,authorized,0632fe91ba5e4f7ba969d33ed25df4c4,POS,20-30,2018,9,19,15,7,Wednesday,14 days,67079.439
ACC-966140392,21,19.38,6625.22,1.0,CUS-537508723,2018-09-20,Joseph,M,-37.97,147.08,,a6a61ac0-2d37-4dc2-89eb-4cb5fce379d1,-37.93,145.12,VIC,Clayton,debit,authorized,6d8192f6becb443aa5c2e6c25df6ff4e,SALES-POS,20-30,2018,9,20,9,18,Thursday,14 days,67079.439
ACC-966140392,21,35.0,6590.22,,CUS-537508723,2018-09-20,Joseph,M,-37.97,147.08,,,,,,,debit,posted,62310079764f475c80f8cd2c2f6593d7,PAYMENT,20-30,2018,9,20,12,0,Thursday,14 days,67079.439
ACC-966140392,21,30.0,6560.22,,CUS-537508723,2018-09-26,Joseph,M,-37.97,147.08,,,,,,,debit,posted,b42edf5255c44122b83b3a030f853f99,PAYMENT,20-30,2018,9,26,10,0,Wednesday,14 days,67079.439
ACC-966140392,21,35.0,6525.22,,CUS-537508723,2018-09-27,Joseph,M,-37.97,147.08,,,,,,,debit,posted,0ae1432f3ae74278a6cfd8f94ee90eb4,PAYMENT,20-30,2018,9,27,12,0,Thursday,14 days,67079.439
ACC-966140392,21,11.45,9086.68,1.0,CUS-537508723,2018-09-28,Joseph,M,-37.97,147.08,,478dc76b-dee4-4268-b69f-a36a60d13f9e,-37.92,145.06,VIC,Bentleigh East,debit,authorized,30c7522c153c4e2fb02397315a54622d,SALES-POS,20-30,2018,9,28,21,30,Friday,14 days,67079.439
ACC-966140392,21,16.24,9070.44,1.0,CUS-537508723,2018-09-28,Joseph,M,-37.97,147.08,,86dfcc0a-0f57-448b-ba3c-b63b39fbfb54,-38.12,145.15,VIC,Frankston North,debit,authorized,0bf3fba6caae41adb397d517ba19b597,SALES-POS,20-30,2018,9,28,23,23,Friday,14 days,67079.439
ACC-966140392,21,11.31,9059.13,0.0,CUS-537508723,2018-09-28,Joseph,M,-37.97,147.08,,0e8eb53e-c9d9-4bf5-b5ac-27460a032092,-37.91,145.21,VIC,Scoresby,debit,authorized,f6bf86255fc14bd1a736166fbd58693d,SALES-POS,20-30,2018,9,28,23,46,Friday,14 days,67079.439
ACC-966140392,21,425.32,8633.81,0.0,CUS-537508723,2018-09-29,Joseph,M,-37.97,147.08,,54f1e39c-55ce-4e75-96e4-b03580738c32,-37.86,145.03,VIC,Malvern,debit,authorized,fbf7b13dd6a64d82ab0b731b59f3186c,SALES-POS,20-30,2018,9,29,1,21,Saturday,14 days,67079.439
ACC-966140392,21,10.98,8622.83,1.0,CUS-537508723,2018-09-29,Joseph,M,-37.97,147.08,,71e18880-0ff1-42e4-9aec-3a5ba0604260,-37.82,145.12,VIC,Box Hill,debit,authorized,8de1c5377d9d4417af0cc24a66ee6c8b,SALES-POS,20-30,2018,9,29,1,56,Saturday,14 days,67079.439
ACC-966140392,21,21.7,8601.13,0.0,CUS-537508723,2018-09-29,Joseph,M,-37.97,147.08,,6f0bdb12-9535-4a76-b792-30d9f006ca6a,-38.19,144.46,VIC,Leopold,debit,authorized,dd6908c9a66d4e40855556cd3c071983,POS,20-30,2018,9,29,15,53,Saturday,14 days,67079.439
ACC-966140392,21,8.66,8592.47,1.0,CUS-537508723,2018-09-29,Joseph,M,-37.97,147.08,,11d01dae-25ae-4e8d-80d4-845096332ee7,-37.95,145,VIC,Sandringham,debit,authorized,9222738601e4404c9ce54b68949ae579,SALES-POS,20-30,2018,9,29,21,34,Saturday,14 days,67079.439
ACC-966140392,21,15.26,8577.21,1.0,CUS-537508723,2018-09-30,Joseph,M,-37.97,147.08,,cf4cd272-bc86-4838-936e-ac5d551ff87c,-37.89,145.04,VIC,Glen Huntly,debit,authorized,faf24cd4c5e643058fd320faa80b056b,SALES-POS,20-30,2018,9,30,9,10,Sunday,14 days,67079.439
ACC-966140392,21,18.65,8558.56,1.0,CUS-537508723,2018-09-30,Joseph,M,-37.97,147.08,,264d431b-9a9d-40ee-8b87-5924037d046f,-37.93,145.12,VIC,Clayton,debit,authorized,14fc30410e55499aa165ad69d1eb058d,SALES-POS,20-30,2018,9,30,10,22,Sunday,14 days,67079.439
ACC-966140392,21,14.09,8544.47,0.0,CUS-537508723,2018-10-01,Joseph,M,-37.97,147.08,,fb6deb11-16b9-4b98-b77a-f56f29807599,-38.02,145.31,VIC,Narre Warren,debit,authorized,df0349766cf4436e8bf7e946f37c8ffe,SALES-POS,20-30,2018,10,1,9,13,Monday,14 days,67079.439
ACC-966140392,21,25.62,8518.85,0.0,CUS-537508723,2018-10-01,Joseph,M,-37.97,147.08,,ede2a706-042c-4083-b942-27a85e179de4,-37.81,144.95,VIC,West Melbourne,debit,authorized,662d21e64e674ad897f91d9bfb97c30b,SALES-POS,20-30,2018,10,1,9,37,Monday,14 days,67079.439
ACC-966140392,21,12.71,8506.14,1.0,CUS-537508723,2018-10-01,Joseph,M,-37.97,147.08,,695d537e-8079-4c0c-80c8-caaea7a5de2b,-37.85,144.98,VIC,Melbourne,debit,authorized,09868f2c1b8e49ad978145c6b491787d,POS,20-30,2018,10,1,16,30,Monday,14 days,67079.439
ACC-966140392,21,12.27,8493.87,1.0,CUS-537508723,2018-10-01,Joseph,M,-37.97,147.08,,1832158b-7c45-4e17-9239-b7d7fef46969,-38.02,145.31,VIC,Narre Warren,debit,authorized,5404718154964673a6d94ce19a95b1d5,POS,20-30,2018,10,1,18,31,Monday,14 days,67079.439
ACC-966140392,21,19.62,8474.25,1.0,CUS-537508723,2018-10-01,Joseph,M,-37.97,147.08,,6fb13b2f-e45e-414d-ac6d-b1bc2771aae5,-37.76,145.07,VIC,Heidelberg,debit,authorized,895ee620f9224c5daf5e5d7e1e14db76,SALES-POS,20-30,2018,10,1,21,16,Monday,14 days,67079.439
ACC-966140392,21,7.8,8466.45,1.0,CUS-537508723,2018-10-01,Joseph,M,-37.97,147.08,,0fad5ec9-8473-466d-9892-b4702214d476,-37.81,144.96,VIC,Melbourne,debit,authorized,488a9173053b43358fde38519bcbd5e5,POS,20-30,2018,10,1,22,54,Monday,14 days,67079.439
ACC-966140392,21,355.0,8111.45,,CUS-537508723,2018-10-02,Joseph,M,-37.97,147.08,,,,,,,debit,posted,a3175a71197846feadaf45b5b1cda849,PHONE BANK,20-30,2018,10,2,16,0,Tuesday,14 days,67079.439
ACC-966140392,21,30.0,8081.45,,CUS-537508723,2018-10-03,Joseph,M,-37.97,147.08,,,,,,,debit,posted,ddd2d87e84b44d7aa34385d51ceaf4f1,PAYMENT,20-30,2018,10,3,10,0,Wednesday,14 days,67079.439
ACC-966140392,21,130.0,7951.45,,CUS-537508723,2018-10-03,Joseph,M,-37.97,147.08,,,,,,,debit,posted,ff63d12b4cd64aba9dfe9c2bf1e670a1,PAYMENT,20-30,2018,10,3,11,0,Wednesday,14 days,67079.439
ACC-966140392,21,35.0,7916.45,,CUS-537508723,2018-10-04,Joseph,M,-37.97,147.08,,,,,,,debit,posted,f90d52ba6b944977b8e2e5234cc82b3c,PAYMENT,20-30,2018,10,4,12,0,Thursday,14 days,67079.439
ACC-966140392,21,35.94,7880.51,1.0,CUS-537508723,2018-10-06,Joseph,M,-37.97,147.08,,37604217-ac5b-4e40-a085-42ee3d7a123e,-37.78,144.96,VIC,Brunswick,debit,authorized,390a1f7a11954d2981d6d9dd2ff2ee0c,POS,20-30,2018,10,6,9,33,Saturday,14 days,67079.439
ACC-966140392,21,20.3,7860.21,1.0,CUS-537508723,2018-10-06,Joseph,M,-37.97,147.08,,237b667f-5419-4bf8-b4ab-8eaeaef27bbb,-37.95,145.15,VIC,Springvale,debit,authorized,67192d49ab8647f3941105a451605392,SALES-POS,20-30,2018,10,6,13,10,Saturday,14 days,67079.439
ACC-966140392,21,7.21,7853.0,0.0,CUS-537508723,2018-10-06,Joseph,M,-37.97,147.08,,6e268cb4-abc2-41b1-9f90-beac7955627f,-37.82,145.04,VIC,Hawthorn,debit,authorized,3fd660516f6b4e45aba845cb5e0e1c04,SALES-POS,20-30,2018,10,6,16,12,Saturday,14 days,67079.439
ACC-966140392,21,47.44,7805.56,1.0,CUS-537508723,2018-10-06,Joseph,M,-37.97,147.08,,ae5f353c-afd0-4ed5-a4e3-d8b5bf48b5ec,-34.92,138.6,SA,Adelaide,debit,authorized,8aff2caf568b4277a6b8edfba04c05d2,SALES-POS,20-30,2018,10,6,19,12,Saturday,14 days,67079.439
ACC-966140392,21,12.89,7792.67,0.0,CUS-537508723,2018-10-07,Joseph,M,-37.97,147.08,,b20acad9-d213-4bb0-805b-f5ad645de4c0,-37.94,145,VIC,Hampton,debit,authorized,c2e2c64fb69a4e208519d332a55f54f8,SALES-POS,20-30,2018,10,7,2,1,Sunday,14 days,67079.439
ACC-966140392,21,23.36,7769.31,1.0,CUS-537508723,2018-10-08,Joseph,M,-37.97,147.08,,1ab16d9d-9d56-4e7f-8357-e056ab821766,-37.91,145.34,VIC,Tecoma,debit,authorized,695f14d921af47e2909e3d428322ef10,SALES-POS,20-30,2018,10,8,9,47,Monday,14 days,67079.439
ACC-966140392,21,16.27,7753.04,1.0,CUS-537508723,2018-10-08,Joseph,M,-37.97,147.08,,853f8f58-3ee4-4939-b473-e1027e041466,-37.77,144.92,VIC,Ascot Vale,debit,authorized,f19bf2f5de5a45adb84570229d12441f,SALES-POS,20-30,2018,10,8,15,41,Monday,14 days,67079.439
ACC-966140392,21,9.5,7743.54,1.0,CUS-537508723,2018-10-08,Joseph,M,-37.97,147.08,,726163b3-2537-4e5f-a06d-021292b02d1c,-37.81,144.97,VIC,Melbourne,debit,authorized,ec748c71a0844e2f8fea0825fcc82af8,SALES-POS,20-30,2018,10,8,19,25,Monday,14 days,67079.439
ACC-966140392,21,10.55,7732.99,0.0,CUS-537508723,2018-10-08,Joseph,M,-37.97,147.08,,0c8856c2-d9ba-4ae4-8e61-c824f3d0025b,-38.19,144.37,VIC,Breakwater,debit,authorized,15e8602b8edb4c999996daaa0f430858,SALES-POS,20-30,2018,10,8,21,5,Monday,14 days,67079.439
ACC-966140392,21,84.05,7648.94,0.0,CUS-537508723,2018-10-09,Joseph,M,-37.97,147.08,,19e5d2d7-988b-44ff-a1b0-7523717189c3,-33.87,151.21,NSW,Sydney,debit,authorized,eb1041d28fe44141bb4e29ad7d118cd6,SALES-POS,20-30,2018,10,9,21,9,Tuesday,14 days,67079.439
ACC-966140392,21,30.0,7618.94,,CUS-537508723,2018-10-10,Joseph,M,-37.97,147.08,,,,,,,debit,posted,e319b11eb0184d0ab380a8af5b2c082a,PAYMENT,20-30,2018,10,10,10,0,Wednesday,14 days,67079.439
ACC-966140392,21,35.0,7583.94,,CUS-537508723,2018-10-11,Joseph,M,-37.97,147.08,,,,,,,debit,posted,9f079ee9e21c41c88680725a8c988955,PAYMENT,20-30,2018,10,11,12,0,Thursday,14 days,67079.439
ACC-966140392,21,134.0,10022.85,,CUS-537508723,2018-10-13,Joseph,M,-37.97,147.08,,,,,,,debit,posted,cbf53693cce54aad8efe350256110117,PAYMENT,20-30,2018,10,13,10,0,Saturday,14 days,67079.439
ACC-966140392,21,17.36,10005.49,1.0,CUS-537508723,2018-10-13,Joseph,M,-37.97,147.08,,b709a204-da73-41e7-bcf4-fefec011912e,-37.93,145.1,VIC,Oakleigh South,debit,authorized,6c1b202f0c9143adafdca48301ae3a70,SALES-POS,20-30,2018,10,13,14,29,Saturday,14 days,67079.439
ACC-966140392,21,30.0,9975.49,,CUS-537508723,2018-10-17,Joseph,M,-37.97,147.08,,,,,,,debit,posted,913179f285a3407caaf44786bc30bc5d,PAYMENT,20-30,2018,10,17,10,0,Wednesday,14 days,67079.439
ACC-966140392,21,35.0,9940.49,,CUS-537508723,2018-10-18,Joseph,M,-37.97,147.08,,,,,,,debit,posted,fbaaa8a65cac4ac6bd00a67027748364,PAYMENT,20-30,2018,10,18,12,0,Thursday,14 days,67079.439
ACC-966140392,21,35.84,9904.65,1.0,CUS-537508723,2018-10-21,Joseph,M,-37.97,147.08,,85a5071c-3b9f-435b-8481-85fdf7d1c78f,-38.04,145.14,VIC,Chelsea Heights,debit,authorized,3c6dc095d7664377b6ea53b08c83deb4,POS,20-30,2018,10,21,12,46,Sunday,14 days,67079.439
ACC-966140392,21,9.51,9895.14,1.0,CUS-537508723,2018-10-21,Joseph,M,-37.97,147.08,,885220a2-2c75-4709-85a8-54c7ad4ee65e,-37.79,144.93,VIC,Flemington,debit,authorized,2b7390cd5c72499fa5f49b937cda7779,SALES-POS,20-30,2018,10,21,13,4,Sunday,14 days,67079.439
ACC-966140392,21,9.12,9886.02,1.0,CUS-537508723,2018-10-21,Joseph,M,-37.97,147.08,,ac9f582e-054e-483a-97c1-f276da0691ef,-37.83,144.95,VIC,South Melbourne,debit,authorized,af7fac477fea42bfaccd7aa0d983113f,SALES-POS,20-30,2018,10,21,13,41,Sunday,14 days,67079.439
ACC-966140392,21,8.19,9877.83,1.0,CUS-537508723,2018-10-24,Joseph,M,-37.97,147.08,,ae69a7c0-72bb-400e-91e4-5c390739aaaf,-38.03,145.2,VIC,Dandenong South,debit,authorized,702f946987b64817bf6a144bd4344b9a,POS,20-30,2018,10,24,4,48,Wednesday,14 days,67079.439
ACC-966140392,21,30.0,9847.83,,CUS-537508723,2018-10-24,Joseph,M,-37.97,147.08,,,,,,,debit,posted,52d9f2ac49e04ee3938d7c19646bd1fe,PAYMENT,20-30,2018,10,24,10,0,Wednesday,14 days,67079.439
ACC-966140392,21,35.0,9812.83,,CUS-537508723,2018-10-25,Joseph,M,-37.97,147.08,,,,,,,debit,posted,4f3d3dcbcfb2493299b853842432279d,PAYMENT,20-30,2018,10,25,12,0,Thursday,14 days,67079.439
ACC-966140392,21,15.67,9797.16,1.0,CUS-537508723,2018-10-26,Joseph,M,-37.97,147.08,,ba21da3a-f63d-4e65-a4f1-14112c466406,-37.93,145.19,VIC,Mulgrave,debit,authorized,327aeb5b04934a3e943c0c21da558087,POS,20-30,2018,10,26,11,22,Friday,14 days,67079.439
ACC-966140392,21,14.85,9782.31,1.0,CUS-537508723,2018-10-26,Joseph,M,-37.97,147.08,,6e53a85a-92d6-4b9b-a5b2-2652146a0af6,-37.81,144.96,VIC,Melbourne,debit,authorized,ae6bea406fa14901a78f92c05b8803b6,SALES-POS,20-30,2018,10,26,11,47,Friday,14 days,67079.439
ACC-966140392,21,10.88,9771.43,1.0,CUS-537508723,2018-10-26,Joseph,M,-37.97,147.08,,fe1d02d0-77d1-46d3-9a1e-9b7ace613d16,-37.83,145.12,VIC,Box Hill,debit,authorized,e0052ac827cc40cc92202f42c11fe5f7,POS,20-30,2018,10,26,11,56,Friday,14 days,67079.439
ACC-966140392,21,39.17,12305.17,1.0,CUS-537508723,2018-10-27,Joseph,M,-37.97,147.08,,3548afe8-7f2b-4fe3-9ece-bdf6b1398099,-33.95,150.96,NSW,Hammondville,debit,authorized,24dad609720244119fd15482c5db7420,SALES-POS,20-30,2018,10,27,10,4,Saturday,14 days,67079.439
ACC-966140392,21,21.81,12283.36,1.0,CUS-537508723,2018-10-27,Joseph,M,-37.97,147.08,,a08c5265-2002-4493-a95f-8c1d59a3446d,-42.91,147.35,TAS,Sandy Bay,debit,authorized,29d82cd57b784bdfae70678de78d9bdb,SALES-POS,20-30,2018,10,27,11,3,Saturday,14 days,67079.439
ACC-966140392,21,11.07,12272.29,1.0,CUS-537508723,2018-10-27,Joseph,M,-37.97,147.08,,f89cf00d-bc58-4977-95c0-dc1050540ad9,-42.88,147.33,TAS,Hobart,debit,authorized,6ba7dac10a0144a19aad19fa1a453aad,POS,20-30,2018,10,27,17,35,Saturday,14 days,67079.439
ACC-966140392,21,20.67,12251.62,0.0,CUS-537508723,2018-10-28,Joseph,M,-37.97,147.08,,0f4d5669-f8ca-4b3c-b7f1-d0a2b9a5f90d,-38.15,145.12,VIC,Frankston,debit,authorized,eee197069dd843e0b629141c35051190,POS,20-30,2018,10,28,2,14,Sunday,14 days,67079.439
ACC-966140392,21,107.34,12144.28,1.0,CUS-537508723,2018-10-28,Joseph,M,-37.97,147.08,,7aa35faa-c607-489f-b7ea-226b095b16ee,-37.82,144.96,VIC,Melbourne,debit,authorized,89514ba0ddf54f04beb210a00bda37c5,POS,20-30,2018,10,28,2,54,Sunday,14 days,67079.439
ACC-966140392,21,14.67,12129.61,1.0,CUS-537508723,2018-10-28,Joseph,M,-37.97,147.08,,afdd0364-7f76-434d-aad3-81177eaeb0db,-37.86,144.67,VIC,Tarneit,debit,authorized,9f97fabe33bd492f98c7a30c97dd3d1f,SALES-POS,20-30,2018,10,28,4,34,Sunday,14 days,67079.439
ACC-966140392,21,9.73,12119.88,1.0,CUS-537508723,2018-10-28,Joseph,M,-37.97,147.08,,5e7e7bf9-49f9-4a68-bde4-edf09a454dc9,-37.82,144.97,VIC,Melbourne,debit,authorized,069ecfcd20e441349488ea8593fd673c,SALES-POS,20-30,2018,10,28,14,53,Sunday,14 days,67079.439
ACC-966140392,21,23.69,12096.19,1.0,CUS-537508723,2018-10-28,Joseph,M,-37.97,147.08,,7bc5155f-c2ec-489f-a72c-08103116090b,-38.15,145.17,VIC,Frankston,debit,authorized,63f4f6df4f9a4706a93d0774fabd7e18,SALES-POS,20-30,2018,10,28,15,35,Sunday,14 days,67079.439
ACC-966140392,21,13.76,12082.43,1.0,CUS-537508723,2018-10-28,Joseph,M,-37.97,147.08,,8b52747a-ff7a-499c-8562-983cac682853,-37.76,145.02,VIC,Thornbury,debit,authorized,b6c4cb7465aa45d798c04f95e4b5ef63,SALES-POS,20-30,2018,10,28,15,56,Sunday,14 days,67079.439
ACC-966140392,21,11.27,12071.16,0.0,CUS-537508723,2018-10-28,Joseph,M,-37.97,147.08,,00a628aa-244d-4ab3-add4-95202d76fd98,-37.72,145.14,VIC,Eltham,debit,authorized,8282478f784e4a01a4e9dfd57f3230d2,POS,20-30,2018,10,28,21,51,Sunday,14 days,67079.439
ACC-966140392,21,30.0,12041.16,,CUS-537508723,2018-10-31,Joseph,M,-37.97,147.08,,,,,,,debit,posted,fa816ef7318643799f78c14ffd2d1a01,PAYMENT,20-30,2018,10,31,10,0,Wednesday,14 days,67079.439
ACC-354106658,39,25.0,4474.38,,CUS-2376382098,2018-08-01,Christine,F,-33.80,151.04,,,,,,,debit,posted,f8cbe52460864f5fa77728f4a9e08997,INTER BANK,30-40,2018,8,1,9,0,Wednesday,0 days,119081.90000000002
ACC-354106658,39,46.12,4428.26,1.0,CUS-2376382098,2018-08-02,Christine,F,-33.80,151.04,,ca74915b-4aca-4bfe-9b5c-2c2193e9426e,-37.82,144.96,VIC,Melbourne,debit,authorized,121428005e504a0380d6069b7767528b,SALES-POS,30-40,2018,8,2,8,59,Thursday,0 days,119081.90000000002
ACC-354106658,39,52.0,4376.26,,CUS-2376382098,2018-08-02,Christine,F,-33.80,151.04,,,,,,,debit,posted,730b11e7065e47a8853639cbb8b45688,PAYMENT,30-40,2018,8,2,23,0,Thursday,0 days,119081.90000000002
ACC-354106658,39,49.75,4326.51,1.0,CUS-2376382098,2018-08-03,Christine,F,-33.80,151.04,,c2daff28-6776-42f6-a837-5a2f8c87d609,-33.81,151.2,NSW,Willoughby,debit,authorized,e046a984918c4226884e7d2d287c7816,POS,30-40,2018,8,3,11,35,Friday,0 days,119081.90000000002
ACC-354106658,39,28.69,4297.82,1.0,CUS-2376382098,2018-08-03,Christine,F,-33.80,151.04,,ecc0b9d5-ce2a-4eec-8507-13f65df181da,-33.91,151.1,NSW,Campsie,debit,authorized,8c119216afdb49178ebf7f2199a045a7,POS,30-40,2018,8,3,15,13,Friday,0 days,119081.90000000002
ACC-354106658,39,37.6,4260.22,1.0,CUS-2376382098,2018-08-03,Christine,F,-33.80,151.04,,d30a9815-fb73-4380-ae4c-a42c87c2fd05,-33.68,138.94,SA,Burra,debit,authorized,421ae381279443fbab8ee5655071a78d,POS,30-40,2018,8,3,16,12,Friday,0 days,119081.90000000002
ACC-354106658,39,15.77,4244.45,1.0,CUS-2376382098,2018-08-03,Christine,F,-33.80,151.04,,d18ce96d-a41c-43d6-9170-94e2f59f3840,-33.97,151.13,NSW,Kogarah,debit,authorized,aba4aa544f5f4dd0a2246d6c6b5650c0,SALES-POS,30-40,2018,8,3,18,35,Friday,0 days,119081.90000000002
ACC-354106658,39,28.92,4215.53,1.0,CUS-2376382098,2018-08-03,Christine,F,-33.80,151.04,,bc8639dd-db46-4f51-9c13-93967cd95dd1,-33.87,151.2,NSW,Sydney,debit,authorized,58f14ce4944b4042a0f48c47a6385d4e,SALES-POS,30-40,2018,8,3,19,54,Friday,0 days,119081.90000000002
ACC-354106658,39,21.0,4194.53,,CUS-2376382098,2018-08-07,Christine,F,-33.80,151.04,,,,,,,debit,posted,c6498dfb87314331a9f13f95c79cdb12,PAYMENT,30-40,2018,8,7,6,0,Tuesday,0 days,119081.90000000002
ACC-354106658,39,25.0,4169.53,,CUS-2376382098,2018-08-08,Christine,F,-33.80,151.04,,,,,,,debit,posted,1f3910982d08493e9428710f11699d43,INTER BANK,30-40,2018,8,8,9,0,Wednesday,0 days,119081.90000000002
ACC-354106658,39,52.0,4117.53,,CUS-2376382098,2018-08-09,Christine,F,-33.80,151.04,,,,,,,debit,posted,c44ff710e6ad44b7b2ecfbb2aea6bf96,PAYMENT,30-40,2018,8,9,23,0,Thursday,0 days,119081.90000000002
ACC-354106658,39,26.36,4091.17,0.0,CUS-2376382098,2018-08-12,Christine,F,-33.80,151.04,,80cb859e-1566-4149-81c6-64919c4414cb,-34.03,151.1,NSW,Miranda,debit,authorized,585f368750ba406d8432284b6563298d,POS,30-40,2018,8,12,12,46,Sunday,0 days,119081.90000000002
ACC-354106658,39,109.0,3982.17,,CUS-2376382098,2018-08-12,Christine,F,-33.80,151.04,,,,,,,debit,posted,c51400225a504034820518acac3ef8e5,PAYMENT,30-40,2018,8,12,15,0,Sunday,0 days,119081.90000000002
ACC-354106658,39,21.0,3961.17,,CUS-2376382098,2018-08-14,Christine,F,-33.80,151.04,,,,,,,debit,posted,e43b61ec005b49eeb406776ebd57c28c,PAYMENT,30-40,2018,8,14,6,0,Tuesday,0 days,119081.90000000002
ACC-354106658,39,284.92,3676.25,1.0,CUS-2376382098,2018-08-14,Christine,F,-33.80,151.04,,5be22823-81f9-478a-9608-b932473ed1b4,-33.87,151.2,NSW,Barangaroo,debit,authorized,e1f6216f8d2c4ca79c913982a79b4b65,SALES-POS,30-40,2018,8,14,9,21,Tuesday,0 days,119081.90000000002
ACC-354106658,39,25.0,3651.25,,CUS-2376382098,2018-08-15,Christine,F,-33.80,151.04,,,,,,,debit,posted,33c3d423b01a4338a6c44fe102534e3d,INTER BANK,30-40,2018,8,15,9,0,Wednesday,0 days,119081.90000000002
ACC-354106658,39,34.15,8720.61,1.0,CUS-2376382098,2018-08-15,Christine,F,-33.80,151.04,,29d82c94-2c19-43d1-be59-3f99921059e1,-33.83,151.23,NSW,Cremorne,debit,authorized,33957e411abf44f7936852ce713b213a,POS,30-40,2018,8,15,17,10,Wednesday,0 days,119081.90000000002
ACC-354106658,39,137.0,8583.61,,CUS-2376382098,2018-08-15,Christine,F,-33.80,151.04,,,,,,,debit,posted,7b59389278b049c0b3cd6a2210404eb2,PAYMENT,30-40,2018,8,15,23,0,Wednesday,0 days,119081.90000000002
ACC-354106658,39,27.29,8460.57,1.0,CUS-2376382098,2018-08-17,Christine,F,-33.80,151.04,,9d3c52cd-6479-45c6-b550-c99c23112624,-33.96,137.71,SA,Kadina,debit,authorized,4f90123a59204692a97b55165b637412,POS,30-40,2018,8,17,10,46,Friday,0 days,119081.90000000002
ACC-354106658,39,177.0,8283.57,,CUS-2376382098,2018-08-17,Christine,F,-33.80,151.04,,,,,,,debit,posted,7d68ca2d0ae3492080795a46a709df34,PHONE BANK,30-40,2018,8,17,13,0,Friday,0 days,119081.90000000002
ACC-354106658,39,29.41,8254.16,1.0,CUS-2376382098,2018-08-17,Christine,F,-33.80,151.04,,6354fdd7-4032-4c81-b13a-bf4bd916bb2d,-33.76,151.28,NSW,Brookvale,debit,authorized,ef68aff5b9f24eb1a390f87038905b6e,SALES-POS,30-40,2018,8,17,14,27,Friday,0 days,119081.90000000002
ACC-354106658,39,66.48,8187.68,1.0,CUS-2376382098,2018-08-17,Christine,F,-33.80,151.04,,5cd13a16-b6cc-46d3-b5c4-18e4f10114ac,-33.67,115.35,WA,Busselton,debit,authorized,50647a4026af427a982e58b40f583b40,SALES-POS,30-40,2018,8,17,19,39,Friday,0 days,119081.90000000002
ACC-354106658,39,30.39,8157.29,1.0,CUS-2376382098,2018-08-17,Christine,F,-33.80,151.04,,da6d4fb2-f5dd-4dcd-b066-b487e1238943,-33.78,151.12,NSW,North Ryde,debit,authorized,0dc38365c18b4a078148304460120f58,SALES-POS,30-40,2018,8,17,21,53,Friday,0 days,119081.90000000002
ACC-354106658,39,29.57,8127.72,1.0,CUS-2376382098,2018-08-17,Christine,F,-33.80,151.04,,d1eb59dc-1878-4f0c-ae70-99221c4389f4,-33.94,151.22,NSW,Eastgardens,debit,authorized,fd92acaa35ad4995a1602d2dbacca378,SALES-POS,30-40,2018,8,17,22,26,Friday,0 days,119081.90000000002
ACC-354106658,39,24.38,8103.34,1.0,CUS-2376382098,2018-08-18,Christine,F,-33.80,151.04,,4aa2f5c6-8f6f-4d4d-b2d8-fe7b630250c6,-33.76,151.15,NSW,Gordon,debit,authorized,3ac2b6912fca43daa3f0062c4ab13ff8,POS,30-40,2018,8,18,1,14,Saturday,0 days,119081.90000000002
ACC-354106658,39,33.95,8069.39,0.0,CUS-2376382098,2018-08-19,Christine,F,-33.80,151.04,,cd5b819a-b1c9-4e6d-bc59-d6d344258ef9,-33.77,150.91,NSW,Blacktown,debit,authorized,ed8d46e15e3940619bb42050843b3083,POS,30-40,2018,8,19,9,21,Sunday,0 days,119081.90000000002
ACC-354106658,39,54.08,8015.31,0.0,CUS-2376382098,2018-08-20,Christine,F,-33.80,151.04,,e7478dc3-3708-4b13-9852-871c2381bfb5,-33.7,151.1,NSW,Hornsby,debit,authorized,2e34e5faf149450dad9b34f6fe18588c,POS,30-40,2018,8,20,12,10,Monday,0 days,119081.90000000002
ACC-354106658,39,66.61,7948.7,1.0,CUS-2376382098,2018-08-20,Christine,F,-33.80,151.04,,d37be0e7-aec7-4bff-813f-5bf707e2fb76,-33.7,151.21,NSW,Terrey Hills,debit,authorized,e5a7ee3e9295482fb14de2bde84f0b28,POS,30-40,2018,8,20,15,39,Monday,0 days,119081.90000000002
ACC-354106658,39,21.0,7927.7,,CUS-2376382098,2018-08-21,Christine,F,-33.80,151.04,,,,,,,debit,posted,216b124ac877418cb955f8a2732f540c,PAYMENT,30-40,2018,8,21,6,0,Tuesday,0 days,119081.90000000002
ACC-354106658,39,13.12,7914.58,1.0,CUS-2376382098,2018-08-21,Christine,F,-33.80,151.04,,d7aefc27-9552-4496-aa5b-91fc25bc95ba,-33.89,151.23,NSW,Paddington,debit,authorized,e9bda08fee4d45a5b0e5e6b5430471a8,SALES-POS,30-40,2018,8,21,11,13,Tuesday,0 days,119081.90000000002
ACC-354106658,39,24.74,7889.84,1.0,CUS-2376382098,2018-08-21,Christine,F,-33.80,151.04,,3fe39368-22a6-41e2-a2ed-63f5093c9ff4,-33.99,150.86,NSW,Ingleburn,debit,authorized,ee2a486d0d3c46599edfa52f6be9ef71,POS,30-40,2018,8,21,14,25,Tuesday,0 days,119081.90000000002
ACC-354106658,39,20.62,7869.22,1.0,CUS-2376382098,2018-08-22,Christine,F,-33.80,151.04,,87569114-2e5c-4694-bcd8-f7ae8f7e12b3,-33.94,151.18,NSW,Sydney,debit,authorized,aa4063700abc484894bf9a76ce5c3a5b,POS,30-40,2018,8,22,7,59,Wednesday,0 days,119081.90000000002
ACC-354106658,39,43.87,7825.35,1.0,CUS-2376382098,2018-08-22,Christine,F,-33.80,151.04,,5fd42700-58fe-4fb5-8770-360170b5d3a5,-33.73,151.3,NSW,Collaroy,debit,authorized,372cda02f5d94883b8f9590f61a45610,SALES-POS,30-40,2018,8,22,8,31,Wednesday,0 days,119081.90000000002
ACC-354106658,39,25.0,7800.35,,CUS-2376382098,2018-08-22,Christine,F,-33.80,151.04,,,,,,,debit,posted,ae63f4fb015e436da36446ba2ed5f19a,INTER BANK,30-40,2018,8,22,9,0,Wednesday,0 days,119081.90000000002
ACC-354106658,39,44.53,7755.82,1.0,CUS-2376382098,2018-08-22,Christine,F,-33.80,151.04,,172c4e09-0649-4e08-b3fc-38b3f0e48210,-29.77,151.11,NSW,Inverell,debit,authorized,27068b8265574b69a8ae007dd84ea7a1,POS,30-40,2018,8,22,17,52,Wednesday,0 days,119081.90000000002
ACC-354106658,39,52.0,7703.82,,CUS-2376382098,2018-08-23,Christine,F,-33.80,151.04,,,,,,,debit,posted,64e5394e75ee4a95bf4a8e1abc3fae6b,PAYMENT,30-40,2018,8,23,23,0,Thursday,0 days,119081.90000000002
ACC-354106658,39,46.12,7657.7,0.0,CUS-2376382098,2018-08-24,Christine,F,-33.80,151.04,,454a31b8-603a-4a55-b24d-ac76c0038ef3,-33.77,150.82,NSW,Mount Druitt,debit,authorized,6c1cd8ac42e7426d88aec41be5dd524a,SALES-POS,30-40,2018,8,24,4,7,Friday,0 days,119081.90000000002
ACC-354106658,39,41.94,7615.76,0.0,CUS-2376382098,2018-08-25,Christine,F,-33.80,151.04,,5a3c3a04-69ec-4c07-beb1-64e96cd3bceb,-33.66,115.36,WA,Busselton,debit,authorized,081aa7dc4573496e8f0517e199c18292,POS,30-40,2018,8,25,17,3,Saturday,0 days,119081.90000000002
ACC-354106658,39,21.0,7594.76,,CUS-2376382098,2018-08-28,Christine,F,-33.80,151.04,,,,,,,debit,posted,bbc7c12824114ffa8e1161e5418032c1,PAYMENT,30-40,2018,8,28,6,0,Tuesday,0 days,119081.90000000002
ACC-354106658,39,25.0,7569.76,,CUS-2376382098,2018-08-29,Christine,F,-33.80,151.04,,,,,,,debit,posted,9fc1c1cf14ff4c95b0deeef3d44fc579,INTER BANK,30-40,2018,8,29,9,0,Wednesday,0 days,119081.90000000002
ACC-354106658,39,52.0,7517.76,,CUS-2376382098,2018-08-30,Christine,F,-33.80,151.04,,,,,,,debit,posted,8c6a9be544db4ba7b1af98ad5b9d0a5f,PAYMENT,30-40,2018,8,30,23,0,Thursday,0 days,119081.90000000002
ACC-354106658,39,773.99,6743.77,1.0,CUS-2376382098,2018-09-01,Christine,F,-33.80,151.04,,2d9bae98-81ec-4c16-8b72-2d19123eafda,-33.87,151.2,NSW,Sydney,debit,authorized,21b59ddabb91482db1237a299a701c95,SALES-POS,30-40,2018,9,1,21,35,Saturday,0 days,119081.90000000002
ACC-354106658,39,50.27,6693.5,1.0,CUS-2376382098,2018-09-01,Christine,F,-33.80,151.04,,123f64f0-fcb1-44d3-80c8-3f7febf31fcd,-34,151.04,NSW,Illawong,debit,authorized,58483d8c233142259cf2ca3977be4849,SALES-POS,30-40,2018,9,1,21,48,Saturday,0 days,119081.90000000002
ACC-354106658,39,38.46,6655.04,1.0,CUS-2376382098,2018-09-03,Christine,F,-33.80,151.04,,3800fde8-2b82-4dea-a497-41cbcae043a7,-33.7,151.1,NSW,Hornsby,debit,authorized,6b34a7b14e4944d3a35aa9c714005f08,SALES-POS,30-40,2018,9,3,9,18,Monday,0 days,119081.90000000002
ACC-354106658,39,24.1,6630.94,1.0,CUS-2376382098,2018-09-03,Christine,F,-33.80,151.04,,a85c8d6d-10b9-45ac-bddb-c5cc93702a47,-33.8,150.88,NSW,Eastern Creek,debit,authorized,dd159221b36b4faaa2b1a447a2b2ae1c,SALES-POS,30-40,2018,9,3,20,47,Monday,0 days,119081.90000000002
ACC-354106658,39,38.47,6592.47,0.0,CUS-2376382098,2018-09-03,Christine,F,-33.80,151.04,,28ee26b2-8127-40b6-91b6-73b25bdbbfc0,-33.83,138.61,SA,Clare,debit,authorized,74be29539b984eaea7225c2201ee8e79,POS,30-40,2018,9,3,21,26,Monday,0 days,119081.90000000002
ACC-354106658,39,21.0,6571.47,,CUS-2376382098,2018-09-04,Christine,F,-33.80,151.04,,,,,,,debit,posted,10401a617f71491e87dec24b6a37ca58,PAYMENT,30-40,2018,9,4,6,0,Tuesday,0 days,119081.90000000002
ACC-354106658,39,15.41,6556.06,1.0,CUS-2376382098,2018-09-04,Christine,F,-33.80,151.04,,299e5fa9-ae12-4cc4-8d2c-d06c965e16a1,-33.79,151.08,NSW,Eastwood,debit,authorized,19e36557ea4140b898cbec47cbdd1eb7,POS,30-40,2018,9,4,9,3,Tuesday,0 days,119081.90000000002
ACC-354106658,39,53.28,6502.78,1.0,CUS-2376382098,2018-09-04,Christine,F,-33.80,151.04,,53ce8b30-cd0e-48dd-b29a-555ca3388891,-33.91,151.16,NSW,Marrickville,debit,authorized,95179e33982440118288a2de22ddec6c,POS,30-40,2018,9,4,9,29,Tuesday,0 days,119081.90000000002
ACC-354106658,39,33.62,6469.16,1.0,CUS-2376382098,2018-09-04,Christine,F,-33.80,151.04,,79bbf88b-9a4e-4dbe-809a-e52fccdb2121,-34.04,151.12,NSW,Caringbah,debit,authorized,908d336302f64d9fb0769c804a505094,POS,30-40,2018,9,4,18,59,Tuesday,0 days,119081.90000000002
ACC-354106658,39,21.86,6447.3,1.0,CUS-2376382098,2018-09-04,Christine,F,-33.80,151.04,,f702da3a-8d3d-4878-a2bf-085dd402f5f2,-33.86,121.89,WA,Esperance,debit,authorized,619ae2a8324a45bd9aa560e0fe729718,POS,30-40,2018,9,4,22,37,Tuesday,0 days,119081.90000000002
ACC-354106658,39,25.0,6388.0,,CUS-2376382098,2018-09-05,Christine,F,-33.80,151.04,,,,,,,debit,posted,96e89d1027394202822bfe2c9d2615d0,INTER BANK,30-40,2018,9,5,9,0,Wednesday,0 days,119081.90000000002
ACC-354106658,39,34.3,6413.0,1.0,CUS-2376382098,2018-09-05,Christine,F,-33.80,151.04,,f22d3ad1-812d-4c78-ac5c-9427659117d6,-34.51,144.84,NSW,Hay,debit,authorized,84281a4dd34346f293b71c3fb7ce74b4,SALES-POS,30-40,2018,9,5,9,24,Wednesday,0 days,119081.90000000002
ACC-354106658,39,12.64,6375.36,1.0,CUS-2376382098,2018-09-06,Christine,F,-33.80,151.04,,b63f9bd0-0cf9-4359-9e10-678b3557f88e,-33.85,150.97,NSW,Guildford,debit,authorized,fef0db916b2845ff8f56957de910cf36,POS,30-40,2018,9,6,18,49,Thursday,0 days,119081.90000000002
ACC-354106658,39,52.0,6323.36,,CUS-2376382098,2018-09-06,Christine,F,-33.80,151.04,,,,,,,debit,posted,2c658ed6e0ab49759c5fb68266b326f6,PAYMENT,30-40,2018,9,6,23,0,Thursday,0 days,119081.90000000002
ACC-354106658,39,36.59,6286.77,1.0,CUS-2376382098,2018-09-07,Christine,F,-33.80,151.04,,536cff51-6a01-4afd-aa49-c8f5a2431f22,-33.88,150.88,NSW,Edensor Park,debit,authorized,341b5837c0974b15bd7a57fa446626e4,SALES-POS,30-40,2018,9,7,8,43,Friday,0 days,119081.90000000002
ACC-354106658,39,23.75,6263.02,0.0,CUS-2376382098,2018-09-07,Christine,F,-33.80,151.04,,417a6024-581d-407c-b221-05735c043097,-33.74,151.3,NSW,Collaroy,debit,authorized,74ecfee8cceb4cfb93d158791b2201cf,SALES-POS,30-40,2018,9,7,11,34,Friday,0 days,119081.90000000002
ACC-354106658,39,32.84,6230.18,1.0,CUS-2376382098,2018-09-07,Christine,F,-33.80,151.04,,c820cbba-1091-469c-8415-459245680b7c,-34.47,138.99,SA,Nuriootpa,debit,authorized,540f22abd5b74455a6761b0cbed93576,POS,30-40,2018,9,7,15,13,Friday,0 days,119081.90000000002
ACC-354106658,39,19.7,6210.48,1.0,CUS-2376382098,2018-09-09,Christine,F,-33.80,151.04,,23c4718d-2163-4604-a9c7-362231883943,-33.8,151.18,NSW,Chatswood,debit,authorized,d3e7b7f7c711484c9e0b6a5739aeba53,POS,30-40,2018,9,9,20,22,Sunday,0 days,119081.90000000002
ACC-354106658,39,21.44,6189.04,1.0,CUS-2376382098,2018-09-10,Christine,F,-33.80,151.04,,03a3ec31-b8b8-411a-b814-77ef8f4bfd33,-33.89,151.21,NSW,Surry Hills,debit,authorized,270bc8a1335c4c79a584d7e51a2f3f1e,POS,30-40,2018,9,10,16,35,Monday,0 days,119081.90000000002
ACC-354106658,39,17.48,6171.56,1.0,CUS-2376382098,2018-09-11,Christine,F,-33.80,151.04,,bca5985f-e048-4651-9a86-3b1e73c3b0db,-33.88,151.19,NSW,Glebe,debit,authorized,400c5e2e11914cf2b4afa87ca641d146,SALES-POS,30-40,2018,9,11,1,41,Tuesday,0 days,119081.90000000002
ACC-354106658,39,21.0,6150.56,,CUS-2376382098,2018-09-11,Christine,F,-33.80,151.04,,,,,,,debit,posted,f881aaf307d749c1adaec4c1390232f7,PAYMENT,30-40,2018,9,11,6,0,Tuesday,0 days,119081.90000000002
ACC-354106658,39,124.14,6026.42,1.0,CUS-2376382098,2018-09-11,Christine,F,-33.80,151.04,,f0ae3f23-1564-4a89-bb6e-c020b7a3e5a7,-33.82,151,NSW,Parramatta,debit,authorized,a40605f83ff54804aa085f941ef7d1c3,SALES-POS,30-40,2018,9,11,8,0,Tuesday,0 days,119081.90000000002
ACC-354106658,39,21.1,6005.32,1.0,CUS-2376382098,2018-09-11,Christine,F,-33.80,151.04,,bed106de-a246-40d9-80ba-8f470ba89507,-33.81,151.18,NSW,Artarmon,debit,authorized,73d32efbd3714800acefcc111e6e5d69,POS,30-40,2018,9,11,14,35,Tuesday,0 days,119081.90000000002
ACC-354106658,39,25.0,5980.32,,CUS-2376382098,2018-09-12,Christine,F,-33.80,151.04,,,,,,,debit,posted,7b982d1e80dd4ab3a761a7b2c5b7586f,INTER BANK,30-40,2018,9,12,9,0,Wednesday,0 days,119081.90000000002
ACC-354106658,39,31.78,5948.54,1.0,CUS-2376382098,2018-09-12,Christine,F,-33.80,151.04,,4c73b458-7a86-4664-b68f-16a2c0a186fe,-34.3,150.94,NSW,Austinmer,debit,authorized,a5ac2a3e4dae433ba931c21b157fc2ed,SALES-POS,30-40,2018,9,12,11,22,Wednesday,0 days,119081.90000000002
ACC-354106658,39,109.0,5839.54,,CUS-2376382098,2018-09-12,Christine,F,-33.80,151.04,,,,,,,debit,posted,487a4c9e30cb4b458764ee73ac58d161,PAYMENT,30-40,2018,9,12,15,0,Wednesday,0 days,119081.90000000002
ACC-354106658,39,52.0,5787.54,,CUS-2376382098,2018-09-13,Christine,F,-33.80,151.04,,,,,,,debit,posted,b80818ae33274d4fbb1adbbe31380694,PAYMENT,30-40,2018,9,13,23,0,Thursday,0 days,119081.90000000002
ACC-354106658,39,30.75,15963.81,1.0,CUS-2376382098,2018-09-15,Christine,F,-33.80,151.04,,2d013734-3385-47fe-bfdc-c1bc443baf16,-33.87,151.21,NSW,Sydney,debit,authorized,68968029d80e4664bef903fbde717089,SALES-POS,30-40,2018,9,15,2,35,Saturday,0 days,119081.90000000002
ACC-354106658,39,116.33,15847.48,1.0,CUS-2376382098,2018-09-15,Christine,F,-33.80,151.04,,0888ed2d-076f-4688-a446-28a0af4cc360,-33.87,151.21,NSW,Sydney,debit,authorized,ddb15b88658c4f148a30d7a10137b365,POS,30-40,2018,9,15,10,39,Saturday,0 days,119081.90000000002
ACC-354106658,39,7.44,15840.04,1.0,CUS-2376382098,2018-09-15,Christine,F,-33.80,151.04,,0369df1c-a7cc-4873-819a-c7135b704cae,-33.89,151.2,NSW,Chippendale,debit,authorized,0f2ad050dd35407e8c7bb2904a6fb052,SALES-POS,30-40,2018,9,15,11,59,Saturday,0 days,119081.90000000002
ACC-354106658,39,41.33,15798.71,1.0,CUS-2376382098,2018-09-15,Christine,F,-33.80,151.04,,f26401e1-93c1-4dc9-92e2-79cd25e902e2,-33.77,151.26,NSW,Brookvale,debit,authorized,f7c2569775ea4e52bb5a07b41f5a3913,POS,30-40,2018,9,15,14,56,Saturday,0 days,119081.90000000002
ACC-354106658,39,137.0,15608.16,,CUS-2376382098,2018-09-15,Christine,F,-33.80,151.04,,,,,,,debit,posted,6934d79c560948eeb73af67283611436,PAYMENT,30-40,2018,9,15,23,0,Saturday,0 days,119081.90000000002
ACC-354106658,39,53.55,15745.16,1.0,CUS-2376382098,2018-09-15,Christine,F,-33.80,151.04,,8efb7fb3-663d-45c3-b6fc-5fc9e5fc6835,-33.79,151.2,NSW,Chatswood,debit,authorized,9037edf66bcb45cc9a507a201630b4cf,SALES-POS,30-40,2018,9,15,23,40,Saturday,0 days,119081.90000000002
ACC-354106658,39,16.09,15592.07,0.0,CUS-2376382098,2018-09-16,Christine,F,-33.80,151.04,,72cdcf17-312b-49c3-9fbe-bd3cdcf97d42,-37.81,144.95,VIC,West Melbourne,debit,authorized,493c25d1fbde4787bf426e0743122891,SALES-POS,30-40,2018,9,16,20,53,Sunday,0 days,119081.90000000002
ACC-354106658,39,177.0,15415.07,,CUS-2376382098,2018-09-17,Christine,F,-33.80,151.04,,,,,,,debit,posted,0f0769438f484187bc3c11185d04d6b9,PHONE BANK,30-40,2018,9,17,13,0,Monday,0 days,119081.90000000002
ACC-354106658,39,21.0,15394.07,,CUS-2376382098,2018-09-18,Christine,F,-33.80,151.04,,,,,,,debit,posted,ee490865650a438590a3913798887207,PAYMENT,30-40,2018,9,18,6,0,Tuesday,0 days,119081.90000000002
ACC-354106658,39,48.69,15345.38,1.0,CUS-2376382098,2018-09-18,Christine,F,-33.80,151.04,,19778b77-0a69-41f6-af81-346746d14a87,-34.19,150.57,NSW,Thirlmere,debit,authorized,2c90975c6749462cb661131ee1418648,SALES-POS,30-40,2018,9,18,23,37,Tuesday,0 days,119081.90000000002
ACC-354106658,39,17.84,15327.54,0.0,CUS-2376382098,2018-09-19,Christine,F,-33.80,151.04,,fb652c27-58b0-4257-9b10-bfef39163eac,-33.91,151.24,NSW,Randwick,debit,authorized,d866a7501e254441b8b3939703eddfb3,SALES-POS,30-40,2018,9,19,4,18,Wednesday,0 days,119081.90000000002
ACC-354106658,39,25.0,15302.54,,CUS-2376382098,2018-09-19,Christine,F,-33.80,151.04,,,,,,,debit,posted,9fecbe7538e3413eacaa72cc451da3aa,INTER BANK,30-40,2018,9,19,9,0,Wednesday,0 days,119081.90000000002
ACC-354106658,39,52.0,15250.54,,CUS-2376382098,2018-09-20,Christine,F,-33.80,151.04,,,,,,,debit,posted,b584698e9bda451c9eddd6f3d860c207,PAYMENT,30-40,2018,9,20,23,0,Thursday,0 days,119081.90000000002
ACC-354106658,39,28.82,15221.72,1.0,CUS-2376382098,2018-09-23,Christine,F,-33.80,151.04,,40dc1e2c-3dbf-4bcd-bdf2-b245b2220dd4,-33.83,151.09,NSW,Rhodes,debit,authorized,d2dbb2184785448abcbbf3b410369e53,SALES-POS,30-40,2018,9,23,22,6,Sunday,0 days,119081.90000000002
ACC-354106658,39,23.07,15198.65,1.0,CUS-2376382098,2018-09-23,Christine,F,-33.80,151.04,,1cdec35f-7743-4869-8861-8c365aa1a7f1,-33.87,151.22,NSW,Potts Point,debit,authorized,1bccd4772a3b40478383f6ea5e90f9e0,POS,30-40,2018,9,23,22,20,Sunday,0 days,119081.90000000002
ACC-354106658,39,80.03,15118.62,1.0,CUS-2376382098,2018-09-23,Christine,F,-33.80,151.04,,697448fa-d29b-483e-98bd-ad3cfb8896e4,-33.89,151.21,NSW,Surry Hills,debit,authorized,45c3a36e5c9147b79b7406aec5d790fe,POS,30-40,2018,9,23,23,44,Sunday,0 days,119081.90000000002
ACC-354106658,39,49.6,15069.02,0.0,CUS-2376382098,2018-09-24,Christine,F,-33.80,151.04,,dcbffa0f-62ec-4f68-a8ab-43234ba5c379,-33.88,151.23,NSW,Edgecliff,debit,authorized,e14c3b4d4be9482088a7490c190c2132,SALES-POS,30-40,2018,9,24,9,5,Monday,0 days,119081.90000000002
ACC-354106658,39,13.73,15055.29,1.0,CUS-2376382098,2018-09-24,Christine,F,-33.80,151.04,,300c81b1-02d5-4885-9556-cec6a8bd4267,-33.92,151.08,NSW,Lakemba,debit,authorized,63ae448ebe424f1a9a66c09c74693617,SALES-POS,30-40,2018,9,24,11,1,Monday,0 days,119081.90000000002
ACC-354106658,39,21.0,15034.29,,CUS-2376382098,2018-09-25,Christine,F,-33.80,151.04,,,,,,,debit,posted,887cda8bfa4d484899fbf070d3b3b7d3,PAYMENT,30-40,2018,9,25,6,0,Tuesday,0 days,119081.90000000002
ACC-354106658,39,18.87,15015.42,1.0,CUS-2376382098,2018-09-25,Christine,F,-33.80,151.04,,40a4fa1b-638a-4e4d-b4c6-b789ee803990,-33.88,151.21,NSW,Surry Hills,debit,authorized,9126c14fe5fd4136a585acc8e993b562,SALES-POS,30-40,2018,9,25,11,25,Tuesday,0 days,119081.90000000002
ACC-354106658,39,38.05,14977.37,1.0,CUS-2376382098,2018-09-25,Christine,F,-33.80,151.04,,a0e0fd63-ada8-4ee4-8796-1c439426c510,-33.89,151.25,NSW,Bondi Junction,debit,authorized,a2f4c56e1f3c4806ac801598f957e15d,SALES-POS,30-40,2018,9,25,15,3,Tuesday,0 days,119081.90000000002
ACC-354106658,39,25.0,14952.37,,CUS-2376382098,2018-09-26,Christine,F,-33.80,151.04,,,,,,,debit,posted,9f91d03e37b949babea8ca53441bbd85,INTER BANK,30-40,2018,9,26,9,0,Wednesday,0 days,119081.90000000002
ACC-354106658,39,134.1,14818.27,0.0,CUS-2376382098,2018-09-26,Christine,F,-33.80,151.04,,70893c77-ef73-44d2-9914-a3797911b6a9,-33.89,151.2,NSW,Chippendale,debit,authorized,9604d71c0bae4abb9a402fb7a086411a,SALES-POS,30-40,2018,9,26,11,30,Wednesday,0 days,119081.90000000002
ACC-354106658,39,40.84,14777.43,1.0,CUS-2376382098,2018-09-26,Christine,F,-33.80,151.04,,b365d471-8591-49a5-8a11-5379cee7cb34,-33.7,151.1,NSW,Hornsby,debit,authorized,0a9e686a341c41f98e4b57d01a9bfbb4,POS,30-40,2018,9,26,23,38,Wednesday,0 days,119081.90000000002
ACC-354106658,39,55.34,14722.09,1.0,CUS-2376382098,2018-09-27,Christine,F,-33.80,151.04,,96da8d6a-6e81-4c00-9972-957ccae5be3d,-33.83,151.14,NSW,Hunters Hill,debit,authorized,5a8f66e2b6d148f5836885a051bc4897,POS,30-40,2018,9,27,15,43,Thursday,0 days,119081.90000000002
ACC-354106658,39,52.0,14670.09,,CUS-2376382098,2018-09-27,Christine,F,-33.80,151.04,,,,,,,debit,posted,1a8d9bbaea9a4a61a3f732867d4a9bed,PAYMENT,30-40,2018,9,27,23,0,Thursday,0 days,119081.90000000002
ACC-354106658,39,37.52,14632.57,1.0,CUS-2376382098,2018-09-28,Christine,F,-33.80,151.04,,98d92e0f-9e45-45a1-b280-37009854e60b,-33.79,151.29,NSW,Manly,debit,authorized,fac3303b6b7f45418a8bce0af8d4d22e,POS,30-40,2018,9,28,21,0,Friday,0 days,119081.90000000002
ACC-354106658,39,41.2,14591.37,1.0,CUS-2376382098,2018-09-29,Christine,F,-33.80,151.04,,7b9c1f66-a529-4c96-853f-f8bb71b192bd,-33.75,151.18,NSW,East Killara,debit,authorized,188b113692af49d2bb51fea3853b4889,POS,30-40,2018,9,29,16,40,Saturday,0 days,119081.90000000002
ACC-354106658,39,30.21,14561.16,1.0,CUS-2376382098,2018-10-01,Christine,F,-33.80,151.04,,268615ad-6188-49e6-87b9-9745897e6dad,-33.87,151.21,NSW,Sydney,debit,authorized,cbac1b4b1d314d63b3054277a3b949a7,POS,30-40,2018,10,1,12,13,Monday,0 days,119081.90000000002
ACC-354106658,39,21.0,14540.16,,CUS-2376382098,2018-10-02,Christine,F,-33.80,151.04,,,,,,,debit,posted,c032c6c9827b4633bd750f31e197a973,PAYMENT,30-40,2018,10,2,6,0,Tuesday,0 days,119081.90000000002
ACC-354106658,39,64.8,14475.36,1.0,CUS-2376382098,2018-10-02,Christine,F,-33.80,151.04,,75ff88ff-c3c1-483e-aa0f-44597f6258ed,-33.92,151.18,NSW,Mascot,debit,authorized,63b43823a5be421b82e9ba87e8ef5bfe,SALES-POS,30-40,2018,10,2,11,55,Tuesday,0 days,119081.90000000002
ACC-354106658,39,25.0,14450.36,,CUS-2376382098,2018-10-03,Christine,F,-33.80,151.04,,,,,,,debit,posted,487591b82a05490384d62b2b3a7fcf7c,INTER BANK,30-40,2018,10,3,9,0,Wednesday,0 days,119081.90000000002
ACC-354106658,39,33.72,14416.64,0.0,CUS-2376382098,2018-10-04,Christine,F,-33.80,151.04,,96828216-c471-47f3-b14b-e25f78f32c79,-33.96,151.08,NSW,Penshurst,debit,authorized,a1875742d141436eaf3b993ed8fb5a04,SALES-POS,30-40,2018,10,4,22,58,Thursday,0 days,119081.90000000002
ACC-354106658,39,52.0,14364.64,,CUS-2376382098,2018-10-04,Christine,F,-33.80,151.04,,,,,,,debit,posted,9ae9a1ccd3f44760a4b4daffaf5e02b3,PAYMENT,30-40,2018,10,4,23,0,Thursday,0 days,119081.90000000002
ACC-354106658,39,119.45,14245.19,1.0,CUS-2376382098,2018-10-07,Christine,F,-33.80,151.04,,c906b450-c9bc-4dd4-9539-ef5c86f6481b,-33.91,151.2,NSW,Alexandria,debit,authorized,339de160fb7640f3892715852e44221f,POS,30-40,2018,10,7,20,52,Sunday,0 days,119081.90000000002
ACC-354106658,39,20.55,14224.64,1.0,CUS-2376382098,2018-10-07,Christine,F,-33.80,151.04,,f70b258d-5e34-4611-b108-63f3abc50635,-33.92,151.08,NSW,Lakemba,debit,authorized,a958cfe5a60e4c9caa624b407081e69e,SALES-POS,30-40,2018,10,7,21,7,Sunday,0 days,119081.90000000002
ACC-354106658,39,21.0,14203.64,,CUS-2376382098,2018-10-09,Christine,F,-33.80,151.04,,,,,,,debit,posted,82288f75f02f4725b156592d0cae5ed7,PAYMENT,30-40,2018,10,9,6,0,Tuesday,0 days,119081.90000000002
ACC-354106658,39,25.0,14178.64,,CUS-2376382098,2018-10-10,Christine,F,-33.80,151.04,,,,,,,debit,posted,0037395f47aa45c6a432c906abe64934,INTER BANK,30-40,2018,10,10,9,0,Wednesday,0 days,119081.90000000002
ACC-354106658,39,10.13,14168.51,1.0,CUS-2376382098,2018-10-10,Christine,F,-33.80,151.04,,f4de8077-1282-4a9d-89ec-faf918885e57,-33.96,151.13,NSW,Kogarah,debit,authorized,47a5efc2847c4400acfc65a0c4c04ae7,POS,30-40,2018,10,10,11,45,Wednesday,0 days,119081.90000000002
ACC-354106658,39,52.0,14116.51,,CUS-2376382098,2018-10-11,Christine,F,-33.80,151.04,,,,,,,debit,posted,c093155e504d478fb71efbd751597431,PAYMENT,30-40,2018,10,11,23,0,Thursday,0 days,119081.90000000002
ACC-354106658,39,14.98,14101.53,0.0,CUS-2376382098,2018-10-12,Christine,F,-33.80,151.04,,18799c68-dbe9-48d1-a398-91faf098eecb,-33.87,151.21,NSW,Sydney,debit,authorized,c3ecbe53afad4585b99a3d3dcb984611,POS,30-40,2018,10,12,1,42,Friday,0 days,119081.90000000002
ACC-354106658,39,109.0,13992.53,,CUS-2376382098,2018-10-12,Christine,F,-33.80,151.04,,,,,,,debit,posted,e4425d6a9494418ca7e1f187bd164716,PAYMENT,30-40,2018,10,12,15,0,Friday,0 days,119081.90000000002
ACC-354106658,39,51.14,13941.39,0.0,CUS-2376382098,2018-10-14,Christine,F,-33.80,151.04,,26731ba8-e9ac-4898-9747-6374079c8510,-33.78,150.92,NSW,Blacktown,debit,authorized,5585690f6b6a4109b034da059a8a2956,SALES-POS,30-40,2018,10,14,12,46,Sunday,0 days,119081.90000000002
ACC-354106658,39,12.87,13928.52,1.0,CUS-2376382098,2018-10-14,Christine,F,-33.80,151.04,,b9f4c7ce-ecdb-431b-8328-a07c6f5b5cf4,-33.75,150.69,NSW,Penrith,debit,authorized,258e7829b85f4386a4376536e0c52627,POS,30-40,2018,10,14,15,41,Sunday,0 days,119081.90000000002
ACC-354106658,39,137.0,23998.54,,CUS-2376382098,2018-10-15,Christine,F,-33.80,151.04,,,,,,,debit,posted,2d30926c7bc944ed89beef9d0e2894d5,PAYMENT,30-40,2018,10,15,23,0,Monday,0 days,119081.90000000002
ACC-354106658,39,21.0,23977.54,,CUS-2376382098,2018-10-16,Christine,F,-33.80,151.04,,,,,,,debit,posted,c937d4089bac4440b572f353c0143063,PAYMENT,30-40,2018,10,16,6,0,Tuesday,0 days,119081.90000000002
ACC-354106658,39,25.0,23952.54,,CUS-2376382098,2018-10-17,Christine,F,-33.80,151.04,,,,,,,debit,posted,1c2201c45ed543018ee4726ee50076fe,INTER BANK,30-40,2018,10,17,9,0,Wednesday,0 days,119081.90000000002
ACC-354106658,39,177.0,23775.54,,CUS-2376382098,2018-10-17,Christine,F,-33.80,151.04,,,,,,,debit,posted,cc13dd8545bb49a8b1592cc912dd6231,PHONE BANK,30-40,2018,10,17,13,0,Wednesday,0 days,119081.90000000002
ACC-354106658,39,52.0,23723.54,,CUS-2376382098,2018-10-18,Christine,F,-33.80,151.04,,,,,,,debit,posted,62510e0ea18a4a8bab4842134c5c2cb6,PAYMENT,30-40,2018,10,18,23,0,Thursday,0 days,119081.90000000002
ACC-354106658,39,21.0,23702.54,,CUS-2376382098,2018-10-23,Christine,F,-33.80,151.04,,,,,,,debit,posted,db5ddda0322944c7b668897365a0a2ea,PAYMENT,30-40,2018,10,23,6,0,Tuesday,0 days,119081.90000000002
ACC-354106658,39,25.0,23677.54,,CUS-2376382098,2018-10-24,Christine,F,-33.80,151.04,,,,,,,debit,posted,e88189f5a90b4bdfbc699a9ac18ed7d1,INTER BANK,30-40,2018,10,24,9,0,Wednesday,0 days,119081.90000000002
ACC-354106658,39,32.02,23645.52,1.0,CUS-2376382098,2018-10-24,Christine,F,-33.80,151.04,,f31f4b14-2040-40ec-a120-b141bb274cbd,-33.93,151.19,NSW,Mascot,debit,authorized,733556a2f8e843bd8f2886cca9ae61bb,SALES-POS,30-40,2018,10,24,11,0,Wednesday,0 days,119081.90000000002
ACC-354106658,39,30.4,23615.12,1.0,CUS-2376382098,2018-10-24,Christine,F,-33.80,151.04,,abe64210-3df3-4615-83d7-5cc2c28964d6,-33.88,151.2,NSW,Ultimo,debit,authorized,cc4baf6591fe4b9da6b3daa2589e672d,SALES-POS,30-40,2018,10,24,17,16,Wednesday,0 days,119081.90000000002
ACC-354106658,39,16.36,23598.76,1.0,CUS-2376382098,2018-10-25,Christine,F,-33.80,151.04,,d119230c-f05a-44bd-a6dc-9ab0dc67e8c5,-33.89,151.19,NSW,Newtown,debit,authorized,147b428a95904d49a08463f366bef400,SALES-POS,30-40,2018,10,25,9,41,Thursday,0 days,119081.90000000002
ACC-354106658,39,40.38,23558.38,1.0,CUS-2376382098,2018-10-25,Christine,F,-33.80,151.04,,146cffd0-87c3-47e3-b0f3-815483a532b9,-33.96,137.71,SA,Kadina,debit,authorized,8767f89802144187834542f2414deb27,POS,30-40,2018,10,25,15,20,Thursday,0 days,119081.90000000002
ACC-354106658,39,52.0,23506.38,,CUS-2376382098,2018-10-25,Christine,F,-33.80,151.04,,,,,,,debit,posted,51ccef462b2440269a33d596264952ec,PAYMENT,30-40,2018,10,25,23,0,Thursday,0 days,119081.90000000002
ACC-354106658,39,46.29,23460.09,0.0,CUS-2376382098,2018-10-26,Christine,F,-33.80,151.04,,5b69624b-b549-4426-89c2-9d65f517e1b7,-33.85,150.9,NSW,Wetherill Park,debit,authorized,65c384e4df5041879410086ce2562d87,POS,30-40,2018,10,26,13,24,Friday,0 days,119081.90000000002
ACC-354106658,39,30.7,23429.39,1.0,CUS-2376382098,2018-10-26,Christine,F,-33.80,151.04,,03016710-5428-41ee-9ec7-75bfb3b8ea12,-33.88,151.22,NSW,Darlinghurst,debit,authorized,a8e4dc527b684a24a3fe644004fba8da,POS,30-40,2018,10,26,23,39,Friday,0 days,119081.90000000002
ACC-354106658,39,35.08,23394.31,1.0,CUS-2376382098,2018-10-27,Christine,F,-33.80,151.04,,f15c8c37-9fd9-47fc-a685-fdfb084311bb,-33.75,150.7,NSW,Penrith,debit,authorized,4bb118054daa4cd3987baf28a0a01410,SALES-POS,30-40,2018,10,27,8,13,Saturday,0 days,119081.90000000002
ACC-354106658,39,49.05,23345.26,1.0,CUS-2376382098,2018-10-27,Christine,F,-33.80,151.04,,d91b753b-1b0a-4426-b2d1-4b7c1fce0c06,-33.81,151.11,NSW,Ryde,debit,authorized,6197297c1255488ba8a93ba8ce8700f4,POS,30-40,2018,10,27,11,52,Saturday,0 days,119081.90000000002
ACC-354106658,39,12.3,23332.96,1.0,CUS-2376382098,2018-10-27,Christine,F,-33.80,151.04,,559bce8b-2c87-47c4-8a8e-b0cb3c5af835,-33.96,151.13,NSW,Kogarah,debit,authorized,cabd62376ac947a78349e4056582abea,POS,30-40,2018,10,27,13,32,Saturday,0 days,119081.90000000002
ACC-354106658,39,4.96,23328.0,1.0,CUS-2376382098,2018-10-27,Christine,F,-33.80,151.04,,7a6204b2-c42b-42a2-a432-2110027fb828,-33.83,138.61,SA,Clare,debit,authorized,62e1d751a2b14ccf8df27f5f5f304e3c,SALES-POS,30-40,2018,10,27,17,44,Saturday,0 days,119081.90000000002
ACC-354106658,39,31.65,23296.35,1.0,CUS-2376382098,2018-10-29,Christine,F,-33.80,151.04,,555ad3cd-5311-42fd-a3b1-efefab7d6498,-33.81,151.11,NSW,Ryde,debit,authorized,dfb17f8ac2ad4e32bfd3f58dcbaaccc4,SALES-POS,30-40,2018,10,29,21,8,Monday,0 days,119081.90000000002
ACC-354106658,39,21.0,23275.35,,CUS-2376382098,2018-10-30,Christine,F,-33.80,151.04,,,,,,,debit,posted,ea4adad63158491d99d1008ab0a0758a,PAYMENT,30-40,2018,10,30,6,0,Tuesday,0 days,119081.90000000002
ACC-354106658,39,25.0,23250.35,,CUS-2376382098,2018-10-31,Christine,F,-33.80,151.04,,,,,,,debit,posted,53175a8194b145f5a5459db79201687d,INTER BANK,30-40,2018,10,31,9,0,Wednesday,0 days,119081.90000000002
ACC-354106658,39,10.54,23239.81,1.0,CUS-2376382098,2018-10-31,Christine,F,-33.80,151.04,,cd46586a-4af6-40ce-9c93-de3a85dc5ebb,-33.8,151.18,NSW,Chatswood,debit,authorized,55a2930c7ae0489ebb5f268f5b9a25ae,POS,30-40,2018,10,31,14,24,Wednesday,0 days,119081.90000000002
ACC-1443681913,31,36.0,586.2,,CUS-3129499595,2018-08-01,Ryan,M,-33.77,150.92,,,,,,,debit,posted,2addbcee343d4406bfd5f17fb8d40dee,PAYMENT,30-40,2018,8,1,9,0,Wednesday,7 days,51946.8
ACC-1443681913,31,93.79,492.41,1.0,CUS-3129499595,2018-08-01,Ryan,M,-33.77,150.92,,c50f2e29-5fb5-4ac5-a2ea-1ae575443069,-33.88,151.21,NSW,Haymarket,debit,authorized,d60f5196641f43debf50a0c04de03c8c,SALES-POS,30-40,2018,8,1,17,38,Wednesday,7 days,51946.8
ACC-1443681913,31,123.0,369.41,,CUS-3129499595,2018-08-05,Ryan,M,-33.77,150.92,,,,,,,debit,posted,141d4ba53f534d0588673dbb40d8b3f7,PAYMENT,30-40,2018,8,5,9,0,Sunday,7 days,51946.8
ACC-1443681913,31,68.31,301.1,1.0,CUS-3129499595,2018-08-05,Ryan,M,-33.77,150.92,,ca81094e-ca7c-4d45-b6a6-bcd8fc0d5ac8,-33.75,151.24,NSW,Frenchs Forest,debit,authorized,22e2f09d38fb4851b83f99fc1619dbf3,POS,30-40,2018,8,5,20,1,Sunday,7 days,51946.8
ACC-1443681913,31,28.71,272.39,1.0,CUS-3129499595,2018-08-05,Ryan,M,-33.77,150.92,,560f44b3-d0db-47f7-b596-5721ff607087,-33.77,150.91,NSW,Blacktown,debit,authorized,458219961bc34497a73766f624dda687,SALES-POS,30-40,2018,8,5,20,28,Sunday,7 days,51946.8
ACC-1443681913,31,10.68,261.71,1.0,CUS-3129499595,2018-08-07,Ryan,M,-33.77,150.92,,35886395-d67b-48ab-9f4c-668eabb62e8c,-33.76,150.68,NSW,Penrith,debit,authorized,dcad491ff28146179f88c387508d45c4,POS,30-40,2018,8,7,3,59,Tuesday,7 days,51946.8
ACC-1443681913,31,21.85,239.86,1.0,CUS-3129499595,2018-08-07,Ryan,M,-33.77,150.92,,4c322c8a-4f66-42c9-8d01-57a41d96756c,-33.76,151.24,NSW,Allambie Heights,debit,authorized,4061712d2f9340b8a9bad7204ee08722,SALES-POS,30-40,2018,8,7,9,4,Tuesday,7 days,51946.8
ACC-1443681913,31,36.0,1200.1,,CUS-3129499595,2018-08-08,Ryan,M,-33.77,150.92,,,,,,,debit,posted,5bd4bb8396e34ce88ebfa26037ff047b,PAYMENT,30-40,2018,8,8,9,0,Wednesday,7 days,51946.8
ACC-1443681913,31,18.31,1181.79,0.0,CUS-3129499595,2018-08-09,Ryan,M,-33.77,150.92,,dafa1c3c-700e-4630-9f62-5b9860f94cfb,-31.1,150.94,NSW,Tamworth,debit,authorized,ef8c15b3f99a438ca5bb43e9c729ac32,POS,30-40,2018,8,9,9,46,Thursday,7 days,51946.8
ACC-1443681913,31,10.91,1170.88,1.0,CUS-3129499595,2018-08-09,Ryan,M,-33.77,150.92,,702f801d-f481-4dfd-8f01-e78a8a5fa9c4,-34.4,150.89,NSW,Fairy Meadow,debit,authorized,443fcf231c24419db2b04d069ef7cfb4,POS,30-40,2018,8,9,11,13,Thursday,7 days,51946.8
ACC-1443681913,31,74.0,1096.88,,CUS-3129499595,2018-08-10,Ryan,M,-33.77,150.92,,,,,,,debit,posted,30a0ce6ce5f4422da8d1c54f5db57dd2,PAYMENT,30-40,2018,8,10,14,0,Friday,7 days,51946.8
ACC-1443681913,31,127.0,969.88,,CUS-3129499595,2018-08-11,Ryan,M,-33.77,150.92,,,,,,,debit,posted,334724e784d54c6db0044ebc5c04b9df,PAYMENT,30-40,2018,8,11,5,0,Saturday,7 days,51946.8
ACC-1443681913,31,36.0,1930.12,,CUS-3129499595,2018-08-15,Ryan,M,-33.77,150.92,,,,,,,debit,posted,b7e326415a4d466ab285f14ee7b24ff5,PAYMENT,30-40,2018,8,15,9,0,Wednesday,7 days,51946.8
ACC-1443681913,31,113.0,1817.12,,CUS-3129499595,2018-08-19,Ryan,M,-33.77,150.92,,,,,,,debit,posted,1573c8f1a2774f2fadbcf23d8cc11fe2,PAYMENT,30-40,2018,8,19,16,0,Sunday,7 days,51946.8
ACC-1443681913,31,36.0,2777.36,,CUS-3129499595,2018-08-22,Ryan,M,-33.77,150.92,,,,,,,debit,posted,706e5325b84e4f3b9073bb789f0ae52f,PAYMENT,30-40,2018,8,22,9,0,Wednesday,7 days,51946.8
ACC-1443681913,31,12.34,2765.02,0.0,CUS-3129499595,2018-08-25,Ryan,M,-33.77,150.92,,6b7bc24c-90dc-449e-9e3a-77846113bfbd,-33.72,150.31,NSW,Katoomba,debit,authorized,b5fa1280bf6d4b8c9b113474b7373933,POS,30-40,2018,8,25,12,16,Saturday,7 days,51946.8
ACC-1443681913,31,496.76,2268.26,1.0,CUS-3129499595,2018-08-25,Ryan,M,-33.77,150.92,,ecbdb80d-3d5a-4649-8bb0-6d56b1526933,-33.8,151.27,NSW,Fairlight,debit,authorized,8a2a06b5a82a44cf991c70d2c9056b6c,POS,30-40,2018,8,25,14,46,Saturday,7 days,51946.8
ACC-1443681913,31,12.22,2256.04,1.0,CUS-3129499595,2018-08-27,Ryan,M,-33.77,150.92,,c46b0e50-9a81-422a-8a3d-e0392d96ea43,-33.78,151.11,NSW,Macquarie Park,debit,authorized,cd49bf0adf4b45f1944a0488cd7a1e4d,SALES-POS,30-40,2018,8,27,9,15,Monday,7 days,51946.8
ACC-1443681913,31,14.21,2241.83,1.0,CUS-3129499595,2018-08-27,Ryan,M,-33.77,150.92,,efefeb05-9ea1-4b28-ab11-eecdbeee8901,-33.82,151.19,NSW,Artarmon,debit,authorized,e53008171e5144cfb3eba04646e733f4,POS,30-40,2018,8,27,10,26,Monday,7 days,51946.8
ACC-1443681913,31,28.15,2213.68,1.0,CUS-3129499595,2018-08-27,Ryan,M,-33.77,150.92,,b7a01aea-e488-47b1-9067-d8fb32a49f0d,-33.78,151.29,NSW,Freshwater,debit,authorized,618e45235d154f358b6314a3b0a15559,SALES-POS,30-40,2018,8,27,12,27,Monday,7 days,51946.8
ACC-1443681913,31,13.6,2200.08,0.0,CUS-3129499595,2018-08-27,Ryan,M,-33.77,150.92,,bc260cad-0f4a-414f-beda-45e56027380b,-34.09,151.01,NSW,Heathcote,debit,authorized,64336f99c68747a9b3dd1ad5277292b8,SALES-POS,30-40,2018,8,27,21,35,Monday,7 days,51946.8
ACC-1443681913,31,12.38,2187.7,0.0,CUS-3129499595,2018-08-28,Ryan,M,-33.77,150.92,,63664ebd-b860-4f15-86d4-1c43abdcf61d,-34.48,150.42,NSW,Bowral,debit,authorized,1e403f24857c4eb7ad1c2053a63e17c3,SALES-POS,30-40,2018,8,28,13,31,Tuesday,7 days,51946.8
ACC-1443681913,31,28.63,3155.31,0.0,CUS-3129499595,2018-08-28,Ryan,M,-33.77,150.92,,700e9984-c27e-4277-9b21-db2ba02e64fb,-33.87,151.28,NSW,Rose Bay North,debit,authorized,f764658f09f545f2922e2b94e6fc0712,POS,30-40,2018,8,28,15,5,Tuesday,7 days,51946.8
ACC-1443681913,31,43.47,3111.84,1.0,CUS-3129499595,2018-08-28,Ryan,M,-33.77,150.92,,db000dad-7f99-4115-9149-de40200f0edc,-33.9,150.88,NSW,Green Valley,debit,authorized,b19c697bf8b84ac4a91f99cf6229adb8,POS,30-40,2018,8,28,16,36,Tuesday,7 days,51946.8
ACC-1443681913,31,36.0,3075.84,,CUS-3129499595,2018-08-29,Ryan,M,-33.77,150.92,,,,,,,debit,posted,e0c55b8678f64e12887426fecbdb3f70,PAYMENT,30-40,2018,8,29,9,0,Wednesday,7 days,51946.8
ACC-1443681913,31,10.93,3064.91,1.0,CUS-3129499595,2018-08-30,Ryan,M,-33.77,150.92,,0afff570-e732-4d08-9933-416d7a72cb62,-33.79,151.19,NSW,Chatswood,debit,authorized,25d712a3d92b44b986208653fe29fca6,SALES-POS,30-40,2018,8,30,19,28,Thursday,7 days,51946.8
ACC-1443681913,31,130.55,2934.36,0.0,CUS-3129499595,2018-08-31,Ryan,M,-33.77,150.92,,7b08b478-9639-4ec2-b389-c526887e5615,-33.93,151.18,NSW,Mascot,debit,authorized,d97147c71d23473087112c57b40961be,SALES-POS,30-40,2018,8,31,4,29,Friday,7 days,51946.8
ACC-1443681913,31,98.93,2835.43,1.0,CUS-3129499595,2018-08-31,Ryan,M,-33.77,150.92,,45a37c0b-7008-45ce-b6e0-449d3e91e293,-33.76,151.28,NSW,North Curl Curl,debit,authorized,68f0bbe85ab943a4922f113cfb3fa2e6,POS,30-40,2018,8,31,21,39,Friday,7 days,51946.8
ACC-1443681913,31,38.46,2796.97,1.0,CUS-3129499595,2018-09-01,Ryan,M,-33.77,150.92,,0bacf8a8-2ffe-4b09-b1de-e4004a9ea52d,-33.93,150.92,NSW,Liverpool,debit,authorized,94bafbf560974215ac97b2df99517548,POS,30-40,2018,9,1,9,56,Saturday,7 days,51946.8
ACC-1443681913,31,43.18,2753.79,0.0,CUS-3129499595,2018-09-01,Ryan,M,-33.77,150.92,,badad515-2c08-4896-b2f2-3d50a4505fe2,-33.85,150.99,NSW,Guildford,debit,authorized,9916bc8730984e648e20343e2882ad09,POS,30-40,2018,9,1,16,44,Saturday,7 days,51946.8
ACC-1443681913,31,8.89,2744.9,1.0,CUS-3129499595,2018-09-01,Ryan,M,-33.77,150.92,,a0a75540-9552-439d-a258-fdbe92d1f3de,-33.82,151.19,NSW,St Leonards,debit,authorized,3e16158609c74faba41acaddb60bdf15,POS,30-40,2018,9,1,20,40,Saturday,7 days,51946.8
ACC-1443681913,31,14.13,2730.77,0.0,CUS-3129499595,2018-09-02,Ryan,M,-33.77,150.92,,1b1140e3-9149-4738-9916-028e5527d1b1,-33.9,150.95,NSW,Lansvale,debit,authorized,4c7ccddb27b5425ea84b9f804d86723c,POS,30-40,2018,9,2,20,50,Sunday,7 days,51946.8
ACC-1443681913,31,34.78,2695.99,1.0,CUS-3129499595,2018-09-03,Ryan,M,-33.77,150.92,,08490e90-f0e5-4b39-84f8-7ae90b79f549,-33.87,151.22,NSW,Potts Point,debit,authorized,58ba3ebbb1334928882bffc091967ebe,POS,30-40,2018,9,3,16,36,Monday,7 days,51946.8
ACC-1443681913,31,13.93,2682.06,1.0,CUS-3129499595,2018-09-03,Ryan,M,-33.77,150.92,,a1f05263-9ae7-49ce-bd52-49f79ea54b5e,-33.82,151.21,NSW,Cammeray,debit,authorized,c170ab21ae204244b913f716c157e122,POS,30-40,2018,9,3,22,55,Monday,7 days,51946.8
ACC-1443681913,31,29.5,2652.56,0.0,CUS-3129499595,2018-09-04,Ryan,M,-33.77,150.92,,a798fba6-3835-448c-ac62-4c96deef1e68,-33.74,151.21,NSW,Belrose,debit,authorized,bef786627e1947e586806f1db38fa142,POS,30-40,2018,9,4,9,34,Tuesday,7 days,51946.8
ACC-1443681913,31,36.0,3612.8,,CUS-3129499595,2018-09-05,Ryan,M,-33.77,150.92,,,,,,,debit,posted,c94e164d0d6b4abb9506503aa0d5c5f2,PAYMENT,30-40,2018,9,5,9,0,Wednesday,7 days,51946.8
ACC-1443681913,31,123.0,3489.8,,CUS-3129499595,2018-09-05,Ryan,M,-33.77,150.92,,,,,,,debit,posted,c48fe6eb78b846adb9e73402569f0b30,PAYMENT,30-40,2018,9,5,9,0,Wednesday,7 days,51946.8
ACC-1443681913,31,32.44,3457.36,0.0,CUS-3129499595,2018-09-08,Ryan,M,-33.77,150.92,,0d05f6d3-b8cd-4c32-b997-22cf8eb5019b,-34.34,150.91,NSW,Bulli,debit,authorized,44cfc6409cbf44a4ab413db53763ca5d,POS,30-40,2018,9,8,8,51,Saturday,7 days,51946.8
ACC-1443681913,31,34.05,3423.31,1.0,CUS-3129499595,2018-09-08,Ryan,M,-33.77,150.92,,436ac4a2-c0fd-462e-b6b1-ac4267e0f225,-33.76,151.27,NSW,Brookvale,debit,authorized,0cbf86102db548ee8e6a74d154e79abf,SALES-POS,30-40,2018,9,8,10,18,Saturday,7 days,51946.8
ACC-1443681913,31,31.09,3392.22,1.0,CUS-3129499595,2018-09-08,Ryan,M,-33.77,150.92,,da3deefd-e453-4ba6-9d32-54edf2dfd93d,-37.82,144.95,VIC,Docklands,debit,authorized,96f003b359ce449f906e86f08c62bde8,SALES-POS,30-40,2018,9,8,14,50,Saturday,7 days,51946.8
ACC-1443681913,31,150.08,3242.14,1.0,CUS-3129499595,2018-09-08,Ryan,M,-33.77,150.92,,660292cf-7b01-4be6-b1be-9277e7ca4290,-33.87,151.2,NSW,Sydney,debit,authorized,55a9bce2a98b49e1bf7ffb0466ab23aa,SALES-POS,30-40,2018,9,8,20,14,Saturday,7 days,51946.8
ACC-1443681913,31,13.91,3228.23,1.0,CUS-3129499595,2018-09-08,Ryan,M,-33.77,150.92,,bdf96d63-a630-4367-b08d-5fa55358fcfc,-33.87,151.21,NSW,Sydney,debit,authorized,adbebb8314014b5ebf320af311dd5a5f,SALES-POS,30-40,2018,9,8,21,19,Saturday,7 days,51946.8
ACC-1443681913,31,30.43,3197.8,0.0,CUS-3129499595,2018-09-09,Ryan,M,-33.77,150.92,,3c794012-c383-4f54-9ecf-7bff64e564ce,-33.81,115.12,WA,Metricup,debit,authorized,e910de0e380547fe870eb8a386ecc6d7,SALES-POS,30-40,2018,9,9,11,9,Sunday,7 days,51946.8
ACC-1443681913,31,24.32,3173.48,1.0,CUS-3129499595,2018-09-09,Ryan,M,-33.77,150.92,,1d38be30-a337-4f3e-85db-fb9a265c0d2b,-33.87,151.2,NSW,Sydney,debit,authorized,45788538d8054385a5f62f0fd3ba8e7e,POS,30-40,2018,9,9,22,7,Sunday,7 days,51946.8
ACC-1443681913,31,19.79,3153.69,1.0,CUS-3129499595,2018-09-10,Ryan,M,-33.77,150.92,,ad8e3b9d-d9a8-4415-a278-a426122d17de,-37.82,144.96,VIC,Melbourne,debit,authorized,b7601900f970499b811141b596483a0d,SALES-POS,30-40,2018,9,10,0,53,Monday,7 days,51946.8
ACC-1443681913,31,63.53,3090.16,1.0,CUS-3129499595,2018-09-10,Ryan,M,-33.77,150.92,,fc64b389-93c7-4d15-abc8-f0ab7914b926,-33.9,151.2,NSW,Waterloo,debit,authorized,ba6c2ce7a7e34ee186f3afeb1228d64e,POS,30-40,2018,9,10,1,52,Monday,7 days,51946.8
ACC-1443681913,31,41.74,3048.42,0.0,CUS-3129499595,2018-09-10,Ryan,M,-33.77,150.92,,7c0fb9a6-2a80-4ba4-94c6-edcc4a4e4227,-33.79,151.27,NSW,Balgowlah,debit,authorized,ce4220a14fc946778cdf7f8e0e147497,SALES-POS,30-40,2018,9,10,9,19,Monday,7 days,51946.8
ACC-1443681913,31,113.27,2935.15,0.0,CUS-3129499595,2018-09-10,Ryan,M,-33.77,150.92,,bccc2aea-8c61-401e-9d1b-7c89f557c036,-33.81,151,NSW,Parramatta,debit,authorized,ec7b43d4a322454c96c453a7cb18e624,POS,30-40,2018,9,10,9,31,Monday,7 days,51946.8
ACC-1443681913,31,74.0,2861.15,,CUS-3129499595,2018-09-10,Ryan,M,-33.77,150.92,,,,,,,debit,posted,d0350cce31554b2cad550a9b46e4214f,PAYMENT,30-40,2018,9,10,14,0,Monday,7 days,51946.8
ACC-1443681913,31,127.0,2734.15,,CUS-3129499595,2018-09-11,Ryan,M,-33.77,150.92,,,,,,,debit,posted,7177128da1ff4e98b9639a17994209b2,PAYMENT,30-40,2018,9,11,5,0,Tuesday,7 days,51946.8
ACC-1443681913,31,36.0,3694.39,,CUS-3129499595,2018-09-12,Ryan,M,-33.77,150.92,,,,,,,debit,posted,fbaf691d05ba4e7fa43f120a5f9d6e01,PAYMENT,30-40,2018,9,12,9,0,Wednesday,7 days,51946.8
ACC-1443681913,31,50.86,3643.53,1.0,CUS-3129499595,2018-09-13,Ryan,M,-33.77,150.92,,c469fa1e-aace-404c-bf80-160bea139ea3,-33.85,151.21,NSW,Milsons Point,debit,authorized,866c1c7085904a7986ba80ea2d7f8d5f,SALES-POS,30-40,2018,9,13,11,18,Thursday,7 days,51946.8
ACC-1443681913,31,30.51,3613.02,1.0,CUS-3129499595,2018-09-14,Ryan,M,-33.77,150.92,,0e08d4cb-0910-4752-b6ed-10f4875e9d02,-33.9,151.21,NSW,Waterloo,debit,authorized,986763570939450f9f6959e5dbcacc2b,SALES-POS,30-40,2018,9,14,0,8,Friday,7 days,51946.8
ACC-1443681913,31,24.82,3588.2,0.0,CUS-3129499595,2018-09-14,Ryan,M,-33.77,150.92,,231b7102-a72c-4f0a-9596-0e65a5753038,-34.06,151.15,NSW,Cronulla,debit,authorized,f6ead8eb5db34c20b81cef197de90f4b,SALES-POS,30-40,2018,9,14,9,12,Friday,7 days,51946.8
ACC-1443681913,31,79.19,3509.01,0.0,CUS-3129499595,2018-09-14,Ryan,M,-33.77,150.92,,9690a753-fe1a-4bfd-be12-5b33652e8093,-33.75,150.69,NSW,Penrith,debit,authorized,2c5df5e0b34f4e548b6dc8365e352e91,POS,30-40,2018,9,14,11,36,Friday,7 days,51946.8
ACC-1443681913,31,10.13,3498.88,1.0,CUS-3129499595,2018-09-14,Ryan,M,-33.77,150.92,,993ba598-6469-49ce-8a04-452b460d783d,-33.66,115.31,WA,West Busselton,debit,authorized,b2903dfb657149a7a83bd61852845078,POS,30-40,2018,9,14,17,38,Friday,7 days,51946.8
ACC-1443681913,31,21.54,3477.34,0.0,CUS-3129499595,2018-09-14,Ryan,M,-33.77,150.92,,5296902a-a068-4c1d-a6d7-d06fe6f23962,-33.83,151.21,NSW,North Sydney,debit,authorized,b7553d314b284a77ba81cf7e5ca3b00b,POS,30-40,2018,9,14,22,20,Friday,7 days,51946.8
ACC-1443681913,31,39.28,4434.3,1.0,CUS-3129499595,2018-09-18,Ryan,M,-33.77,150.92,,855d0474-b763-4e85-9b3c-3b5ddf0e8dc2,-33.92,151.24,NSW,Randwick,debit,authorized,c9d77c21b7ee46e7b0d95b112303e0d6,SALES-POS,30-40,2018,9,18,14,57,Tuesday,7 days,51946.8
ACC-1443681913,31,7.06,4427.24,1.0,CUS-3129499595,2018-09-18,Ryan,M,-33.77,150.92,,0de914e5-d9d9-4dfa-aae8-6cae722a1c53,-33.9,151,NSW,Bass Hill,debit,authorized,70bba44dd4b04309b07d1e5b7b1176b5,POS,30-40,2018,9,18,19,19,Tuesday,7 days,51946.8
ACC-1443681913,31,36.0,4391.24,,CUS-3129499595,2018-09-19,Ryan,M,-33.77,150.92,,,,,,,debit,posted,35ca873384c2406d8467380c342dec1d,PAYMENT,30-40,2018,9,19,9,0,Wednesday,7 days,51946.8
ACC-1443681913,31,23.45,4367.79,1.0,CUS-3129499595,2018-09-19,Ryan,M,-33.77,150.92,,142d45ab-8d51-47d2-87ad-cb2bbf7e23fc,-33.95,115.07,WA,Margaret River,debit,authorized,d26abb53eaf642b6b4ca015bef62b797,SALES-POS,30-40,2018,9,19,14,13,Wednesday,7 days,51946.8
ACC-1443681913,31,113.0,4254.79,,CUS-3129499595,2018-09-19,Ryan,M,-33.77,150.92,,,,,,,debit,posted,8599e720eeea417a8f252917892defea,PAYMENT,30-40,2018,9,19,16,0,Wednesday,7 days,51946.8
ACC-1443681913,31,126.46,4128.33,1.0,CUS-3129499595,2018-09-20,Ryan,M,-33.77,150.92,,14fe61e3-382c-4857-a990-3cfec2f7f99b,-33.82,151,NSW,Parramatta,debit,authorized,882ebc2323f845d3893de59b9b72a1a2,SALES-POS,30-40,2018,9,20,9,8,Thursday,7 days,51946.8
ACC-1443681913,31,30.41,4097.92,1.0,CUS-3129499595,2018-09-20,Ryan,M,-33.77,150.92,,6f918ce9-bb34-4e2f-9df2-d8bef7233b2b,-33.67,150.91,NSW,Rouse Hill,debit,authorized,a6e38dc1e42d4e03ac8181e4dcb59967,POS,30-40,2018,9,20,9,23,Thursday,7 days,51946.8
ACC-1443681913,31,40.15,4057.77,1.0,CUS-3129499595,2018-09-20,Ryan,M,-33.77,150.92,,1c7c5189-a531-4ca5-9696-36b25253201a,-33.8,151.19,NSW,Chatswood,debit,authorized,42cb80660f8b4f7f95872e44b16e2649,SALES-POS,30-40,2018,9,20,9,37,Thursday,7 days,51946.8
ACC-1443681913,31,47.59,4010.18,1.0,CUS-3129499595,2018-09-20,Ryan,M,-33.77,150.92,,c6717cc7-5c1e-4779-b147-d59ecd7f3827,-33.82,151,NSW,Parramatta,debit,authorized,7a01b8ec213043ef950c517bad17f07b,POS,30-40,2018,9,20,11,28,Thursday,7 days,51946.8
ACC-1443681913,31,12.6,3997.58,1.0,CUS-3129499595,2018-09-20,Ryan,M,-33.77,150.92,,803c3de8-6590-42cc-b5f2-95d9d597750c,-33.85,151.07,NSW,Sydney Olympic Park,debit,authorized,ab4611af6d114d7d8ee463276db2735f,POS,30-40,2018,9,20,20,3,Thursday,7 days,51946.8
ACC-1443681913,31,29.79,3967.79,1.0,CUS-3129499595,2018-09-21,Ryan,M,-33.77,150.92,,cc86f6d6-f1ba-41cc-98f6-5f259a4feef3,-33.97,151.13,NSW,Carlton,debit,authorized,40f7e907133d406583527a53ce629081,POS,30-40,2018,9,21,2,45,Friday,7 days,51946.8
ACC-1443681913,31,34.23,3933.56,0.0,CUS-3129499595,2018-09-22,Ryan,M,-33.77,150.92,,50509899-e929-4d8e-bdd9-5e7faef2fa91,-33.89,151.21,NSW,Surry Hills,debit,authorized,c355724da0fb4d22960d81b1f1effc0c,POS,30-40,2018,9,22,6,37,Saturday,7 days,51946.8
ACC-1443681913,31,49.4,3884.16,0.0,CUS-3129499595,2018-09-22,Ryan,M,-33.77,150.92,,cdb5aa98-3008-4c5e-9ad9-8c6faada1788,-33.77,151.27,NSW,Brookvale,debit,authorized,f356c3447edb4cd5b8f2bf585106a960,SALES-POS,30-40,2018,9,22,11,53,Saturday,7 days,51946.8
ACC-1443681913,31,734.1,3150.06,1.0,CUS-3129499595,2018-09-22,Ryan,M,-33.77,150.92,,77b07bea-433a-458d-954a-1b38d057bb57,-33.83,151.13,NSW,Gladesville,debit,authorized,ff6d799d085141ca92078c2b4155ab12,SALES-POS,30-40,2018,9,22,22,54,Saturday,7 days,51946.8
ACC-1443681913,31,28.73,3121.33,1.0,CUS-3129499595,2018-09-23,Ryan,M,-33.77,150.92,,93a7a659-b071-4149-802e-2a851bcde8c0,-33.91,151.23,NSW,Randwick,debit,authorized,c2f3f6cba63a408d8b2ad1c804e5ad42,SALES-POS,30-40,2018,9,23,11,14,Sunday,7 days,51946.8
ACC-1443681913,31,8.48,3112.85,1.0,CUS-3129499595,2018-09-23,Ryan,M,-33.77,150.92,,de059016-7f69-46e4-9e5a-f7b2840f7bb2,-33.77,150.83,NSW,Mount Druitt,debit,authorized,02c3bb8ed30f4954ae7fe6bf59f33c3b,SALES-POS,30-40,2018,9,23,19,59,Sunday,7 days,51946.8
ACC-1443681913,31,36.0,4073.09,,CUS-3129499595,2018-09-26,Ryan,M,-33.77,150.92,,,,,,,debit,posted,37f22cffca804579b2d0c8214c3d230a,PAYMENT,30-40,2018,9,26,9,0,Wednesday,7 days,51946.8
ACC-1443681913,31,16.25,4056.84,0.0,CUS-3129499595,2018-09-29,Ryan,M,-33.77,150.92,,dcafc231-8643-4688-b1ca-2b84951771d3,-33.88,151.2,NSW,Chippendale,debit,authorized,3f055903faf54513b2d3a58963e27f97,SALES-POS,30-40,2018,9,29,14,21,Saturday,7 days,51946.8
ACC-1443681913,31,19.97,4036.87,1.0,CUS-3129499595,2018-09-29,Ryan,M,-33.77,150.92,,f048e864-da7f-4a57-9b20-2f679a06f899,-34.43,150.88,NSW,Wollongong,debit,authorized,3a576f8f142f4e728fbcf8d4988fb2ca,SALES-POS,30-40,2018,9,29,23,39,Saturday,7 days,51946.8
ACC-1443681913,31,36.0,4997.11,,CUS-3129499595,2018-10-03,Ryan,M,-33.77,150.92,,,,,,,debit,posted,ea6174c88014470aab532b788da76127,PAYMENT,30-40,2018,10,3,9,0,Wednesday,7 days,51946.8
ACC-1443681913,31,73.31,4923.8,1.0,CUS-3129499595,2018-10-04,Ryan,M,-33.77,150.92,,dbedbd4d-66c5-4869-9a78-04df37ceeef0,-33.78,151.11,NSW,North Ryde,debit,authorized,515fa6d4456e40a390c88370b74b0744,SALES-POS,30-40,2018,10,4,14,55,Thursday,7 days,51946.8
ACC-1443681913,31,123.0,4800.8,,CUS-3129499595,2018-10-05,Ryan,M,-33.77,150.92,,,,,,,debit,posted,318b9816064c42cb966bc18e397c2920,PAYMENT,30-40,2018,10,5,9,0,Friday,7 days,51946.8
ACC-1443681913,31,20.25,4780.55,1.0,CUS-3129499595,2018-10-06,Ryan,M,-33.77,150.92,,4a17692a-cce0-4bcb-986c-a8e8976b00ab,-33.72,150.43,NSW,Lawson,debit,authorized,2edf70583f974f259726b1bb54e9cef8,SALES-POS,30-40,2018,10,6,11,16,Saturday,7 days,51946.8
ACC-1443681913,31,19.31,4761.24,1.0,CUS-3129499595,2018-10-06,Ryan,M,-33.77,150.92,,18c8ce9c-128f-42ba-a8dd-a4f7c57ca18f,-33.73,151.16,NSW,Saint Ives,debit,authorized,de76694b3338472a8e25f67b6d61c182,POS,30-40,2018,10,6,12,19,Saturday,7 days,51946.8
ACC-1443681913,31,29.7,4731.54,1.0,CUS-3129499595,2018-10-06,Ryan,M,-33.77,150.92,,cf5c7992-56f1-470d-a133-7dcd5471e798,-33.96,150.89,NSW,Casula,debit,authorized,b25eed9d57b94c59bea6d1063e3f9381,SALES-POS,30-40,2018,10,6,15,33,Saturday,7 days,51946.8
ACC-1443681913,31,34.95,4696.59,1.0,CUS-3129499595,2018-10-06,Ryan,M,-33.77,150.92,,0b9370d0-c8d1-406d-8915-640ff9115c7c,-33.81,151.17,NSW,Lane Cove,debit,authorized,732a7a38a9304d8eb46e628953da8fb1,POS,30-40,2018,10,6,22,12,Saturday,7 days,51946.8
ACC-1443681913,31,36.0,5656.83,,CUS-3129499595,2018-10-10,Ryan,M,-33.77,150.92,,,,,,,debit,posted,48540a6cb409463b8d7f05ebd6d0c651,PAYMENT,30-40,2018,10,10,9,0,Wednesday,7 days,51946.8
ACC-1443681913,31,74.0,5582.83,,CUS-3129499595,2018-10-10,Ryan,M,-33.77,150.92,,,,,,,debit,posted,7675f55ca6d2470380bebff67d8f539e,PAYMENT,30-40,2018,10,10,14,0,Wednesday,7 days,51946.8
ACC-1443681913,31,127.0,5455.83,,CUS-3129499595,2018-10-11,Ryan,M,-33.77,150.92,,,,,,,debit,posted,8db322c9a16842b2ad51ef94850fa97a,PAYMENT,30-40,2018,10,11,5,0,Thursday,7 days,51946.8
ACC-1443681913,31,6.37,5449.46,1.0,CUS-3129499595,2018-10-12,Ryan,M,-33.77,150.92,,75af9468-b3e2-4959-b35b-9ea9845d92c6,-33.82,151.19,NSW,St Leonards,debit,authorized,3e989469207b4990a2c784f22d01c094,POS,30-40,2018,10,12,14,16,Friday,7 days,51946.8
ACC-1443681913,31,9.17,5440.29,1.0,CUS-3129499595,2018-10-13,Ryan,M,-33.77,150.92,,b3da314c-23c2-4218-9ab2-d88265311a10,-33.98,151.25,NSW,Little Bay,debit,authorized,5ca11c8f46dd444bbc6295a4840cefe7,POS,30-40,2018,10,13,21,6,Saturday,7 days,51946.8
ACC-1443681913,31,17.17,5423.12,1.0,CUS-3129499595,2018-10-13,Ryan,M,-33.77,150.92,,e2f1b9d5-38ab-42ae-a7e5-0fea756f62b8,-33.97,151.08,NSW,Mortdale,debit,authorized,3d4a542d73d54d4686882973d3e68436,SALES-POS,30-40,2018,10,13,21,53,Saturday,7 days,51946.8
ACC-1443681913,31,22.96,5400.16,1.0,CUS-3129499595,2018-10-14,Ryan,M,-33.77,150.92,,5aab531a-f596-4184-b229-f5b8ab29b51a,-33.98,151.08,NSW,Oatley,debit,authorized,516ed70bdd354ca9abec6de0309be787,SALES-POS,30-40,2018,10,14,17,13,Sunday,7 days,51946.8
ACC-1443681913,31,10.38,5389.78,1.0,CUS-3129499595,2018-10-15,Ryan,M,-33.77,150.92,,ad887c40-4ee9-433c-a5c9-355e106e5991,-33.78,150.92,NSW,Blacktown,debit,authorized,a2f2bf29021f475b945f2a38310eb103,SALES-POS,30-40,2018,10,15,9,46,Monday,7 days,51946.8
ACC-1443681913,31,1627.0,3762.78,,CUS-3129499595,2018-10-15,Ryan,M,-33.77,150.92,,,,,,,debit,posted,aed617d140c643429108181924a29950,INTER BANK,30-40,2018,10,15,12,0,Monday,7 days,51946.8
ACC-1443681913,31,24.08,3738.7,1.0,CUS-3129499595,2018-10-16,Ryan,M,-33.77,150.92,,a1393fa3-196b-4b47-bc66-91e287c25733,-33.84,151.21,NSW,North Sydney,debit,authorized,f9b1dd68094246a08a66118b7ae700df,POS,30-40,2018,10,16,11,36,Tuesday,7 days,51946.8
ACC-1443681913,31,21.49,4713.45,1.0,CUS-3129499595,2018-10-16,Ryan,M,-33.77,150.92,,debb3faa-5710-46cd-8b3f-a25cf698b0bb,-33.72,151.17,NSW,Saint Ives,debit,authorized,521117792c2945e8a10b77d8687002cd,SALES-POS,30-40,2018,10,16,21,41,Tuesday,7 days,51946.8
ACC-1443681913,31,36.0,4677.45,,CUS-3129499595,2018-10-17,Ryan,M,-33.77,150.92,,,,,,,debit,posted,433dc73bd79d44058f71ae40e12f9d50,PAYMENT,30-40,2018,10,17,9,0,Wednesday,7 days,51946.8
ACC-1443681913,31,16.5,4660.95,1.0,CUS-3129499595,2018-10-18,Ryan,M,-33.77,150.92,,c4b2ee62-fdd5-41aa-b8e5-ca4e70ac4d77,-33.77,150.82,NSW,Mount Druitt,debit,authorized,9f82839b16f84fd98086f63c43b91d30,POS,30-40,2018,10,18,9,46,Thursday,7 days,51946.8
ACC-1443681913,31,19.66,4641.29,1.0,CUS-3129499595,2018-10-18,Ryan,M,-33.77,150.92,,fd6e6be3-9a6e-4505-8235-42ad0ae571eb,-33.77,150.68,NSW,Penrith,debit,authorized,1ccf5d31cc854caa96d360529deb75de,SALES-POS,30-40,2018,10,18,17,10,Thursday,7 days,51946.8
ACC-1443681913,31,55.04,4586.25,1.0,CUS-3129499595,2018-10-19,Ryan,M,-33.77,150.92,,7273f476-4d39-48a6-835d-22704480b61a,-34.08,150.8,NSW,Campbelltown,debit,authorized,f160cfdf4e5e479d9e3e3d7e284a4506,SALES-POS,30-40,2018,10,19,11,7,Friday,7 days,51946.8
ACC-1443681913,31,113.0,4473.25,,CUS-3129499595,2018-10-19,Ryan,M,-33.77,150.92,,,,,,,debit,posted,bf9428e4741c47a492564187034ea45c,PAYMENT,30-40,2018,10,19,16,0,Friday,7 days,51946.8
ACC-1443681913,31,16.17,4457.08,1.0,CUS-3129499595,2018-10-19,Ryan,M,-33.77,150.92,,940afd8b-0802-41b8-b171-55dce1d15a18,-33.81,150.99,NSW,Westmead,debit,authorized,a49718c1d9f644beac8d75e29144f607,SALES-POS,30-40,2018,10,19,20,12,Friday,7 days,51946.8
ACC-1443681913,31,5.55,4451.53,0.0,CUS-3129499595,2018-10-20,Ryan,M,-33.77,150.92,,3f2b5da1-c3f3-4cab-a06e-21cd91403e68,-33.78,151.18,NSW,Roseville,debit,authorized,feaf09d2aea542819536c8777bd766a7,SALES-POS,30-40,2018,10,20,13,23,Saturday,7 days,51946.8
ACC-1443681913,31,18.46,4433.07,0.0,CUS-3129499595,2018-10-20,Ryan,M,-33.77,150.92,,ee99aae3-23d3-47c2-b895-e2901b0ae3d5,-33.81,151.18,NSW,Artarmon,debit,authorized,b0f253fd08af4f099bb24ecd94986290,SALES-POS,30-40,2018,10,20,16,53,Saturday,7 days,51946.8
ACC-1443681913,31,16.7,4416.37,1.0,CUS-3129499595,2018-10-20,Ryan,M,-33.77,150.92,,ade8836d-78d7-4d5c-860f-972e9c88d476,-33.8,150.96,NSW,Pendle Hill,debit,authorized,3eec7f7c57ac4755b5bd57b5b0feeb2d,SALES-POS,30-40,2018,10,20,20,17,Saturday,7 days,51946.8
ACC-1443681913,31,19.75,4396.62,1.0,CUS-3129499595,2018-10-21,Ryan,M,-33.77,150.92,,9ff63b41-279f-4da3-af7c-2eec227ccff5,-33.72,151.12,NSW,Wahroonga,debit,authorized,ad3c0d9f23d34ad08378a2e1d223b658,SALES-POS,30-40,2018,10,21,4,28,Sunday,7 days,51946.8
ACC-1443681913,31,66.93,4329.69,1.0,CUS-3129499595,2018-10-22,Ryan,M,-33.77,150.92,,a05dbb7f-df3c-441c-a427-66a43729bb0f,-33.88,151.21,NSW,Surry Hills,debit,authorized,c03766980bed407c8ba2ee5de775d861,POS,30-40,2018,10,22,18,41,Monday,7 days,51946.8
ACC-1443681913,31,26.25,4303.44,1.0,CUS-3129499595,2018-10-23,Ryan,M,-33.77,150.92,,9559ad81-51a1-4ead-ba0f-2cf2103a6615,-34.38,150.91,NSW,East Corrimal,debit,authorized,ecdee3f951904bcb98cdfdb8a8e209c9,SALES-POS,30-40,2018,10,23,9,8,Tuesday,7 days,51946.8
ACC-1443681913,31,28.26,5271.42,1.0,CUS-3129499595,2018-10-24,Ryan,M,-33.77,150.92,,a566e35d-eaba-41d7-a8d7-31d750fce2d3,-34.45,140.57,SA,Loxton,debit,authorized,f09b0f0aaa504ca6b34a766ea73e6dc6,SALES-POS,30-40,2018,10,24,8,11,Wednesday,7 days,51946.8
ACC-1443681913,31,36.0,5235.42,,CUS-3129499595,2018-10-24,Ryan,M,-33.77,150.92,,,,,,,debit,posted,c4cbf73973e3459a96f9b67ea0643b2d,PAYMENT,30-40,2018,10,24,9,0,Wednesday,7 days,51946.8
ACC-1443681913,31,6.76,5228.66,1.0,CUS-3129499595,2018-10-24,Ryan,M,-33.77,150.92,,4f1bd388-4717-4fa6-8c32-1090324e34b4,-33.83,151.19,NSW,Wollstonecraft,debit,authorized,dbea872440ed436faea8cab0c5e9cda5,SALES-POS,30-40,2018,10,24,17,3,Wednesday,7 days,51946.8
ACC-1443681913,31,12.76,5215.9,1.0,CUS-3129499595,2018-10-25,Ryan,M,-33.77,150.92,,0f28e5da-0266-480b-8c72-c6e743128a95,-33.8,151.18,NSW,Chatswood,debit,authorized,bd4ef86f5d354026ba60b3de39ac4daf,SALES-POS,30-40,2018,10,25,16,30,Thursday,7 days,51946.8
ACC-1443681913,31,24.04,5191.86,1.0,CUS-3129499595,2018-10-26,Ryan,M,-33.77,150.92,,18809615-6921-4f17-9cd5-ee10421047e8,-33.9,151.15,NSW,Petersham,debit,authorized,7641ad7c0ea349c182fdde522c92b4cd,SALES-POS,30-40,2018,10,26,12,47,Friday,7 days,51946.8
ACC-1443681913,31,17.66,5174.2,1.0,CUS-3129499595,2018-10-26,Ryan,M,-33.77,150.92,,33de11be-d1af-410c-a6ca-e7ff735253f2,-33.91,151.17,NSW,Marrickville,debit,authorized,37b1731d143d48ac8287f68ffa084bb0,SALES-POS,30-40,2018,10,26,17,15,Friday,7 days,51946.8
ACC-1443681913,31,24.44,5149.76,0.0,CUS-3129499595,2018-10-26,Ryan,M,-33.77,150.92,,7c7402cb-2c84-4f38-96ee-a148afdb49d1,-33.82,151.01,NSW,Harris Park,debit,authorized,edb6a98f15da4fdaa9eacb9d61bd796f,SALES-POS,30-40,2018,10,26,19,39,Friday,7 days,51946.8
ACC-1443681913,31,43.96,5105.8,1.0,CUS-3129499595,2018-10-27,Ryan,M,-33.77,150.92,,e3a8ba8a-df2f-4410-bf2c-a74b3a2c79f0,-33.71,151.1,NSW,Hornsby,debit,authorized,15d9b38a4f29453f8674093d22b3b00c,SALES-POS,30-40,2018,10,27,0,42,Saturday,7 days,51946.8
ACC-1443681913,31,29.06,5076.74,1.0,CUS-3129499595,2018-10-27,Ryan,M,-33.77,150.92,,6eebedde-fd5e-432e-8fd5-20b4b6b47103,-33.9,151.16,NSW,Petersham,debit,authorized,eca9f527702b47d1a59c7559c6d26ec5,POS,30-40,2018,10,27,16,20,Saturday,7 days,51946.8
ACC-1443681913,31,8.49,5068.25,0.0,CUS-3129499595,2018-10-27,Ryan,M,-33.77,150.92,,2113b19a-c85d-4553-8b32-c9a4eeb9d51a,-33.92,151.18,NSW,Mascot,debit,authorized,48bb024422564ee5853455edd8f3f464,SALES-POS,30-40,2018,10,27,17,54,Saturday,7 days,51946.8
ACC-1443681913,31,54.73,5013.52,1.0,CUS-3129499595,2018-10-28,Ryan,M,-33.77,150.92,,e957b3e1-e8d7-49a4-98a9-e5feba8b1a74,-33.89,151.25,NSW,Bondi Junction,debit,authorized,e9c2269a7c6949978dbb5e45e55c33e9,SALES-POS,30-40,2018,10,28,15,3,Sunday,7 days,51946.8
ACC-1443681913,31,20.71,4992.81,0.0,CUS-3129499595,2018-10-28,Ryan,M,-33.77,150.92,,216f1be9-780e-41c4-ac53-b460db8898e6,-33.85,151.03,NSW,Auburn,debit,authorized,3af41c4b9a12473594ab4e12e13672e5,POS,30-40,2018,10,28,20,1,Sunday,7 days,51946.8
ACC-1443681913,31,48.38,4944.43,1.0,CUS-3129499595,2018-10-28,Ryan,M,-33.77,150.92,,9e80ab72-b313-459a-8783-283550726f05,-33.74,150.92,NSW,Kings Langley,debit,authorized,70171d246f144199a8587cbdc30bf0ae,SALES-POS,30-40,2018,10,28,21,46,Sunday,7 days,51946.8
ACC-1443681913,31,58.99,4885.44,0.0,CUS-3129499595,2018-10-28,Ryan,M,-33.77,150.92,,b1e22450-945f-456f-84fa-d6582620873f,-33.75,151.3,NSW,Dee Why,debit,authorized,9cfa9bc3ea81494f8e15609fc07233d5,POS,30-40,2018,10,28,23,14,Sunday,7 days,51946.8
ACC-1443681913,31,36.0,5845.68,,CUS-3129499595,2018-10-31,Ryan,M,-33.77,150.92,,,,,,,debit,posted,799cd3520a994b558b188a0478c183ae,PAYMENT,30-40,2018,10,31,9,0,Wednesday,7 days,51946.8
ACC-1443681913,31,234.9,5610.78,1.0,CUS-3129499595,2018-10-31,Ryan,M,-33.77,150.92,,976e9595-fdf4-4662-aaf2-476681a0291f,-33.87,151.2,NSW,Sydney,debit,authorized,9b85bc8e0da848fab4ecbe176d6fabb0,SALES-POS,30-40,2018,10,31,21,40,Wednesday,7 days,51946.8
ACC-1443681913,31,70.51,5540.27,0.0,CUS-3129499595,2018-10-31,Ryan,M,-33.77,150.92,,6fcdc956-3548-40b2-a2ce-9dbc6cb64eb9,-33.91,151.17,NSW,Marrickville,debit,authorized,f82ed841f0404363b4a3782ce6118294,SALES-POS,30-40,2018,10,31,21,56,Wednesday,7 days,51946.8
ACC-1443681913,31,22.36,5517.91,1.0,CUS-3129499595,2018-10-31,Ryan,M,-33.77,150.92,,f31f4b14-2040-40ec-a120-b141bb274cbd,-33.93,151.19,NSW,Mascot,debit,authorized,6d5218e04e8040b9996850ce11a19426,SALES-POS,30-40,2018,10,31,23,59,Wednesday,7 days,51946.8
ACC-1710017148,19,17.96,1636.91,1.0,CUS-883482547,2018-08-01,Michelle,F,-34.01,150.82,,8a0fab50-4efb-41e2-a569-29346eb6c9de,-33.83,151,NSW,Granville,debit,authorized,455044b17a8648a2945d7c39e8274351,SALES-POS,<20,2018,8,1,9,2,Wednesday,14 days,103698.064
ACC-1710017148,19,11.57,1625.34,0.0,CUS-883482547,2018-08-01,Michelle,F,-34.01,150.82,,4af25042-a1a4-4688-90b5-240d790e5332,-33.92,151.19,NSW,Alexandria,debit,authorized,82acf03790844776b4587fd6e6f526c5,SALES-POS,<20,2018,8,1,9,11,Wednesday,14 days,103698.064
ACC-1710017148,19,16.18,1609.16,1.0,CUS-883482547,2018-08-01,Michelle,F,-34.01,150.82,,499b1c74-d767-43d6-a084-b20d00010c70,-33.77,150.91,NSW,Blacktown,debit,authorized,927d07bdbeb743ebab2865f86132cd99,POS,<20,2018,8,1,14,37,Wednesday,14 days,103698.064
ACC-1710017148,19,6.58,1602.58,1.0,CUS-883482547,2018-08-01,Michelle,F,-34.01,150.82,,31409513-c87e-497b-bcdb-4f91c51b5996,-33.97,151.1,NSW,Hurstville,debit,authorized,0b0be6179db945629804267253f52d4d,SALES-POS,<20,2018,8,1,15,8,Wednesday,14 days,103698.064
ACC-1710017148,19,33.0,1569.58,,CUS-883482547,2018-08-01,Michelle,F,-34.01,150.82,,,,,,,debit,posted,3252e03de44c4f0f98a7f52a21fe4972,PAYMENT,<20,2018,8,1,22,0,Wednesday,14 days,103698.064
ACC-1710017148,19,40.0,1529.58,,CUS-883482547,2018-08-03,Michelle,F,-34.01,150.82,,,,,,,debit,posted,54d2f45fdfff480b9ce12b3967df1c34,PAYMENT,<20,2018,8,3,4,0,Friday,14 days,103698.064
ACC-1710017148,19,8.63,1520.95,0.0,CUS-883482547,2018-08-04,Michelle,F,-34.01,150.82,,d104c46f-5796-49c9-a5cd-4086bf4b04b8,-33.97,151.1,NSW,Hurstville,debit,authorized,0d32ba19f2904a0288245193757a6791,SALES-POS,<20,2018,8,4,20,14,Saturday,14 days,103698.064
ACC-1710017148,19,27.68,1493.27,1.0,CUS-883482547,2018-08-05,Michelle,F,-34.01,150.82,,6c3b88a4-3876-4699-ad9d-58424bc073dc,-33.76,151.27,NSW,Brookvale,debit,authorized,80ce35066c08432a9b9ea75dca302d82,POS,<20,2018,8,5,0,44,Sunday,14 days,103698.064
ACC-1710017148,19,17.11,1476.16,0.0,CUS-883482547,2018-08-05,Michelle,F,-34.01,150.82,,809b43f0-8e5e-4230-b10f-23b8bfa1c861,-33.67,151.1,NSW,Hornsby Heights,debit,authorized,44f119b4df9a4f2d8b9f02025b074b2e,SALES-POS,<20,2018,8,5,9,9,Sunday,14 days,103698.064
ACC-1710017148,19,6.31,1469.85,1.0,CUS-883482547,2018-08-05,Michelle,F,-34.01,150.82,,803270e1-3d12-407e-9c00-70b7b6779495,-33.8,151.18,NSW,Chatswood,debit,authorized,bc3f9b21d04842ceaa735783f8d8d9d9,SALES-POS,<20,2018,8,5,21,35,Sunday,14 days,103698.064
ACC-1710017148,19,21.87,1447.98,1.0,CUS-883482547,2018-08-05,Michelle,F,-34.01,150.82,,5e7bb850-a7b6-4914-9b43-dea6bb3c7b00,-33.87,151.22,NSW,Potts Point,debit,authorized,8fbaa45d920943e8aee04ab0cbd73b03,SALES-POS,<20,2018,8,5,22,22,Sunday,14 days,103698.064
ACC-1710017148,19,5.46,1442.52,1.0,CUS-883482547,2018-08-05,Michelle,F,-34.01,150.82,,cc58adc3-19aa-4400-b3d1-58945c7b7a7a,-38.02,145.3,VIC,Narre Warren,debit,authorized,02427cb526d4445182c80ddabcdd681f,SALES-POS,<20,2018,8,5,22,39,Sunday,14 days,103698.064
ACC-1710017148,19,56.73,1385.79,1.0,CUS-883482547,2018-08-05,Michelle,F,-34.01,150.82,,f7c2a095-4198-46b8-ad74-5eeba70e6766,-33.87,151.21,NSW,Sydney,debit,authorized,043b1c6e6f8943089e0c6168f09c1c88,POS,<20,2018,8,5,23,39,Sunday,14 days,103698.064
ACC-1710017148,19,19.54,1366.25,1.0,CUS-883482547,2018-08-06,Michelle,F,-34.01,150.82,,89352a56-ae9c-437b-a90a-5906dbca6c99,-33.77,150.82,NSW,Mount Druitt,debit,authorized,e43cee32703848ec8eb36660192d4123,SALES-POS,<20,2018,8,6,9,10,Monday,14 days,103698.064
ACC-1710017148,19,29.54,1336.71,1.0,CUS-883482547,2018-08-06,Michelle,F,-34.01,150.82,,12bd9960-37f8-4485-ba9a-a312c4c9f4de,-33.97,151.11,NSW,Hurstville,debit,authorized,78a9d7ff1e564fe0b639942dc4d2b25f,POS,<20,2018,8,6,12,51,Monday,14 days,103698.064
ACC-1710017148,19,28.13,5286.04,1.0,CUS-883482547,2018-08-07,Michelle,F,-34.01,150.82,,f218ca8d-dc6f-43d3-b3fe-94971bb76fc4,-33.62,116.32,WA,Mcalinden,debit,authorized,307cf646157d47719b79d5ae6181044c,POS,<20,2018,8,7,0,59,Tuesday,14 days,103698.064
ACC-1710017148,19,54.0,5209.29,,CUS-883482547,2018-08-07,Michelle,F,-34.01,150.82,,,,,,,debit,posted,e60c658ed5224ab0b9c7bc2feed3eed6,PAYMENT,<20,2018,8,7,9,0,Tuesday,14 days,103698.064
ACC-1710017148,19,200.0,5009.29,,CUS-883482547,2018-08-07,Michelle,F,-34.01,150.82,,,,,,,debit,posted,7404f01d88a748a59b10806d9513f9a7,PAYMENT,<20,2018,8,7,9,0,Tuesday,14 days,103698.064
ACC-1710017148,19,22.75,5263.29,1.0,CUS-883482547,2018-08-07,Michelle,F,-34.01,150.82,,067e0c0b-7256-4c1b-a298-aa324f1f97b7,-23.13,150.74,QLD,Yeppoon,debit,authorized,a40b622f86974cda81ce049b1dba564e,SALES-POS,<20,2018,8,7,9,58,Tuesday,14 days,103698.064
ACC-1710017148,19,117.59,4891.7,1.0,CUS-883482547,2018-08-08,Michelle,F,-34.01,150.82,,33e2ced9-f864-4b39-9731-5de5f64bce83,-33.84,151.21,NSW,North Sydney,debit,authorized,74dbd1f478344acf816454c445667866,POS,<20,2018,8,8,7,19,Wednesday,14 days,103698.064
ACC-1710017148,19,22.44,4869.26,1.0,CUS-883482547,2018-08-08,Michelle,F,-34.01,150.82,,79eed392-31bb-4f6b-b876-b25f95241251,-34.04,151.12,NSW,Caringbah,debit,authorized,7cd4e853979d45729055f313be5e8daa,SALES-POS,<20,2018,8,8,15,31,Wednesday,14 days,103698.064
ACC-1710017148,19,69.64,4799.62,1.0,CUS-883482547,2018-08-08,Michelle,F,-34.01,150.82,,b8d3539f-ebde-46be-9577-7e18bd433af0,-34.04,151.12,NSW,Caringbah,debit,authorized,f448c8b384a34edd96a8e028c4068ca2,SALES-POS,<20,2018,8,8,17,40,Wednesday,14 days,103698.064
ACC-1710017148,19,258.96,4540.66,1.0,CUS-883482547,2018-08-08,Michelle,F,-34.01,150.82,,0432fdb9-b5ab-4603-af0e-0965f41ed3a9,-33.85,151.03,NSW,Auburn,debit,authorized,bc967915729641d6869d3e2e8566f73c,SALES-POS,<20,2018,8,8,17,51,Wednesday,14 days,103698.064
ACC-1710017148,19,33.0,4507.66,,CUS-883482547,2018-08-08,Michelle,F,-34.01,150.82,,,,,,,debit,posted,8dc5cbf4a07c49d3871e9e9e83bd72d6,PAYMENT,<20,2018,8,8,22,0,Wednesday,14 days,103698.064
ACC-1710017148,19,40.0,4467.66,,CUS-883482547,2018-08-10,Michelle,F,-34.01,150.82,,,,,,,debit,posted,3c72a5d874874cd6b68c514d0d7878d4,PAYMENT,<20,2018,8,10,4,0,Friday,14 days,103698.064
ACC-1710017148,19,256.0,4211.66,,CUS-883482547,2018-08-11,Michelle,F,-34.01,150.82,,,,,,,debit,posted,ac02a0b57adb413389cc1ad5795e9da3,PHONE BANK,<20,2018,8,11,10,0,Saturday,14 days,103698.064
ACC-1710017148,19,54.0,4157.66,,CUS-883482547,2018-08-14,Michelle,F,-34.01,150.82,,,,,,,debit,posted,c9ba1b6d62414daeb8b6c08d7e9f9f6b,PAYMENT,<20,2018,8,14,9,0,Tuesday,14 days,103698.064
ACC-1710017148,19,28.16,4129.5,1.0,CUS-883482547,2018-08-15,Michelle,F,-34.01,150.82,,50b966cd-5400-41dc-8dcd-dbc2fd97cc92,-33.95,115.08,WA,Margaret River,debit,authorized,89f0192499264cd795a1d7a3f47ba76f,SALES-POS,<20,2018,8,15,15,27,Wednesday,14 days,103698.064
ACC-1710017148,19,8.87,4120.63,1.0,CUS-883482547,2018-08-15,Michelle,F,-34.01,150.82,,5ef086e6-3b62-4a1e-967e-1d6c733b554b,-33.8,151.18,NSW,Chatswood,debit,authorized,d87b70ccd2634cb2871e76793a042bbd,SALES-POS,<20,2018,8,15,16,10,Wednesday,14 days,103698.064
ACC-1710017148,19,33.0,4087.63,,CUS-883482547,2018-08-15,Michelle,F,-34.01,150.82,,,,,,,debit,posted,1f4b41fdd74340619ec8b6ff3772ce80,PAYMENT,<20,2018,8,15,22,0,Wednesday,14 days,103698.064
ACC-1710017148,19,40.0,4047.63,,CUS-883482547,2018-08-17,Michelle,F,-34.01,150.82,,,,,,,debit,posted,234187365dc1446fb3fe9f0d3a2bea45,PAYMENT,<20,2018,8,17,4,0,Friday,14 days,103698.064
ACC-1710017148,19,23.15,4024.48,1.0,CUS-883482547,2018-08-19,Michelle,F,-34.01,150.82,,eff25fdb-a677-437b-bb87-f4e4b4614499,-33.92,151.04,NSW,Bankstown,debit,authorized,4ce3ab430b314676ae3b6f6f4216c057,SALES-POS,<20,2018,8,19,4,42,Sunday,14 days,103698.064
ACC-1710017148,19,12.33,4012.15,1.0,CUS-883482547,2018-08-19,Michelle,F,-34.01,150.82,,7bc1461a-78e8-4c17-9b59-db2dc97da571,-34.55,150.86,NSW,Warilla,debit,authorized,c03add4f493a4ca1a9a9176fc5adc84d,POS,<20,2018,8,19,14,33,Sunday,14 days,103698.064
ACC-1710017148,19,67.28,3944.87,1.0,CUS-883482547,2018-08-19,Michelle,F,-34.01,150.82,,c1468f3e-98a2-4758-bb44-c537d180b3ce,-33.75,151.22,NSW,Frenchs Forest,debit,authorized,664dc8446d6548b2a869779f20db1d79,SALES-POS,<20,2018,8,19,15,25,Sunday,14 days,103698.064
ACC-1710017148,19,26.81,3918.06,1.0,CUS-883482547,2018-08-19,Michelle,F,-34.01,150.82,,343d5adf-1119-419a-b6e8-655f4a29cca2,-33.9,151.18,NSW,Newtown,debit,authorized,8a73b73e0f2944c28ef94c4f1802230e,SALES-POS,<20,2018,8,19,22,10,Sunday,14 days,103698.064
ACC-1710017148,19,36.34,3881.72,1.0,CUS-883482547,2018-08-19,Michelle,F,-34.01,150.82,,b9382076-2e3e-4ec6-94f4-7074db478cdc,-33.97,151.1,NSW,Hurstville,debit,authorized,fcc3dfb935ca4ecbaa8572289bfb4684,SALES-POS,<20,2018,8,19,23,24,Sunday,14 days,103698.064
ACC-1710017148,19,27.58,3854.14,1.0,CUS-883482547,2018-08-20,Michelle,F,-34.01,150.82,,0359e1a0-5efd-4921-8c41-89f1f0783aa1,-33.86,151.2,NSW,Sydney,debit,authorized,329db0bcce2a450eb2d2f70392825f33,POS,<20,2018,8,20,9,36,Monday,14 days,103698.064
ACC-1710017148,19,15.31,3838.83,0.0,CUS-883482547,2018-08-20,Michelle,F,-34.01,150.82,,1fa3e73c-373f-4e32-b371-17e7ca515852,-33.75,150.69,NSW,Penrith,debit,authorized,c0672e5bf3ff495c8ffcfe2ae8aab651,POS,<20,2018,8,20,10,13,Monday,14 days,103698.064
ACC-1710017148,19,51.94,3786.89,0.0,CUS-883482547,2018-08-20,Michelle,F,-34.01,150.82,,530dc97b-35b4-4730-8872-f9b057552c86,-34.04,150.74,NSW,Narellan,debit,authorized,d87cecb30d7d41dd8e79ef7c7d9e2389,POS,<20,2018,8,20,10,22,Monday,14 days,103698.064
ACC-1710017148,19,54.0,7710.35,,CUS-883482547,2018-08-21,Michelle,F,-34.01,150.82,,,,,,,debit,posted,89bdf0e84435495fb2cd9b145b9b36af,PAYMENT,<20,2018,8,21,9,0,Tuesday,14 days,103698.064
ACC-1710017148,19,33.0,7677.35,,CUS-883482547,2018-08-22,Michelle,F,-34.01,150.82,,,,,,,debit,posted,b344c8a3440c4ecca1498bee056eaca2,PAYMENT,<20,2018,8,22,22,0,Wednesday,14 days,103698.064
ACC-1710017148,19,7.9,7669.45,1.0,CUS-883482547,2018-08-23,Michelle,F,-34.01,150.82,,a41ea38b-0b76-482e-86fc-9e2e48cd148d,-33.72,150.31,NSW,Katoomba,debit,authorized,7b037c50c7284fa4977f6e5b251b50dd,POS,<20,2018,8,23,16,49,Thursday,14 days,103698.064
ACC-1710017148,19,76.02,7593.43,1.0,CUS-883482547,2018-08-23,Michelle,F,-34.01,150.82,,591eb556-c5b4-4697-80ad-3c7fe42d49c2,-33.66,115.27,WA,Broadwater,debit,authorized,9361223316c14c4ba4c55c3f68b20dfd,POS,<20,2018,8,23,17,25,Thursday,14 days,103698.064
ACC-1710017148,19,179.0,7414.43,,CUS-883482547,2018-08-23,Michelle,F,-34.01,150.82,,,,,,,debit,posted,bdd52d8c6c2b435083e769f1cbd29693,PHONE BANK,<20,2018,8,23,19,0,Thursday,14 days,103698.064
ACC-1710017148,19,40.0,7374.43,,CUS-883482547,2018-08-24,Michelle,F,-34.01,150.82,,,,,,,debit,posted,4d0a2fcf909d422788b7fdeca3a038ae,PAYMENT,<20,2018,8,24,4,0,Friday,14 days,103698.064
ACC-1710017148,19,31.14,7343.29,1.0,CUS-883482547,2018-08-26,Michelle,F,-34.01,150.82,,5ed7139b-d0fd-4ea1-b47c-a7d60499cb0f,-33.87,151.27,NSW,Rose Bay,debit,authorized,488d20a9ab4e49528be5052c908549b8,SALES-POS,<20,2018,8,26,10,4,Sunday,14 days,103698.064
ACC-1710017148,19,24.17,7319.12,0.0,CUS-883482547,2018-08-26,Michelle,F,-34.01,150.82,,f3df7829-6792-43ca-8241-57a33bbf50fb,-33.72,150.84,NSW,Marsden Park,debit,authorized,2df8a6c271b041deb766c9e201107f51,SALES-POS,<20,2018,8,26,10,33,Sunday,14 days,103698.064
ACC-1710017148,19,37.24,7281.88,1.0,CUS-883482547,2018-08-26,Michelle,F,-34.01,150.82,,9fb2eaeb-afed-4640-acf1-82ccadfe390d,-33.76,150.99,NSW,Baulkham Hills,debit,authorized,45913f6e09f4426abab34a73f2d753b2,SALES-POS,<20,2018,8,26,11,3,Sunday,14 days,103698.064
ACC-1710017148,19,22.5,7259.38,0.0,CUS-883482547,2018-08-26,Michelle,F,-34.01,150.82,,abf31fa7-2b8d-421b-85ca-1c81a4a04b64,-33.87,151.2,NSW,Sydney,debit,authorized,249fe3fe5a174da7b28ade865a2a6303,POS,<20,2018,8,26,15,28,Sunday,14 days,103698.064
ACC-1710017148,19,75.52,7183.86,1.0,CUS-883482547,2018-08-26,Michelle,F,-34.01,150.82,,711b6911-6ed7-42c0-ae19-2714f3a18953,-34.06,151.12,NSW,Caringbah South,debit,authorized,76d7907305844d5399f2c08c6edb3cba,POS,<20,2018,8,26,21,57,Sunday,14 days,103698.064
ACC-1710017148,19,21.48,7162.38,1.0,CUS-883482547,2018-08-27,Michelle,F,-34.01,150.82,,3c2fdebb-595a-4706-80cb-95eca94ff4ed,-27.5,153.04,QLD,Woolloongabba,debit,authorized,eb90957c07734590800494ac68cd8956,SALES-POS,<20,2018,8,27,8,13,Monday,14 days,103698.064
ACC-1710017148,19,20.56,7141.82,0.0,CUS-883482547,2018-08-27,Michelle,F,-34.01,150.82,,da68404b-0d95-42e0-aa2e-0a8149d9efe9,-33.78,150.91,NSW,Blacktown,debit,authorized,0fe1f2a7c47049bdb2d2ec3dc956b8e7,POS,<20,2018,8,27,17,27,Monday,14 days,103698.064
ACC-1710017148,19,160.0,6981.82,,CUS-883482547,2018-08-28,Michelle,F,-34.01,150.82,,,,,,,debit,posted,f1635d975f154a09aadcb4533760dc75,PAYMENT,<20,2018,8,28,6,0,Tuesday,14 days,103698.064
ACC-1710017148,19,54.0,6927.82,,CUS-883482547,2018-08-28,Michelle,F,-34.01,150.82,,,,,,,debit,posted,74591bbbfb1c4b66b1cd5b23b48a159e,PAYMENT,<20,2018,8,28,9,0,Tuesday,14 days,103698.064
ACC-1710017148,19,31.36,6896.46,0.0,CUS-883482547,2018-08-28,Michelle,F,-34.01,150.82,,de57c45e-87e6-433d-a756-d3d76be32150,-33.84,150.99,NSW,Merrylands,debit,authorized,d7dc6ab8f3dc4cd68449e1ee25c6dfb6,SALES-POS,<20,2018,8,28,10,31,Tuesday,14 days,103698.064
ACC-1710017148,19,3.68,6892.78,1.0,CUS-883482547,2018-08-28,Michelle,F,-34.01,150.82,,155b0711-026f-464e-9640-d38da87add09,-33.75,150.7,NSW,Penrith,debit,authorized,3782509b9b7c4e7d87b7e6159b2afeea,SALES-POS,<20,2018,8,28,10,51,Tuesday,14 days,103698.064
ACC-1710017148,19,18.43,6874.35,1.0,CUS-883482547,2018-08-28,Michelle,F,-34.01,150.82,,dacaaef6-b43a-47b9-8873-30b83f7e7661,-34.49,150.8,NSW,Dapto,debit,authorized,9e8445b2ec844ae39186d79ba73d0ccc,POS,<20,2018,8,28,12,25,Tuesday,14 days,103698.064
ACC-1710017148,19,33.0,6841.35,,CUS-883482547,2018-08-29,Michelle,F,-34.01,150.82,,,,,,,debit,posted,ee6afa6837d643d5868c19aa4be55cfd,PAYMENT,<20,2018,8,29,22,0,Wednesday,14 days,103698.064
ACC-1710017148,19,40.0,6801.35,,CUS-883482547,2018-08-31,Michelle,F,-34.01,150.82,,,,,,,debit,posted,6f03a982d9c841a2b02c1a32a6c7941c,PAYMENT,<20,2018,8,31,4,0,Friday,14 days,103698.064
ACC-1710017148,19,94.22,6707.13,1.0,CUS-883482547,2018-09-01,Michelle,F,-34.01,150.82,,cc41785e-0e26-4e86-a5d0-40ca04413a35,-33.8,151.2,NSW,North Willoughby,debit,authorized,1a954ee6471e46759bd3548b1b414e4e,SALES-POS,<20,2018,9,1,21,39,Saturday,14 days,103698.064
ACC-1710017148,19,12.76,6694.37,1.0,CUS-883482547,2018-09-01,Michelle,F,-34.01,150.82,,8e46c116-18e7-442f-8863-88b6b79ed8bb,-33.91,151.12,NSW,Canterbury,debit,authorized,a172ca32eaeb436398b8b8708a617ab2,SALES-POS,<20,2018,9,1,21,57,Saturday,14 days,103698.064
ACC-1710017148,19,18.32,6676.05,1.0,CUS-883482547,2018-09-02,Michelle,F,-34.01,150.82,,d1eb59dc-1878-4f0c-ae70-99221c4389f4,-33.94,151.22,NSW,Eastgardens,debit,authorized,68a325d6eb5041e2aa72ec9c9779f011,POS,<20,2018,9,2,14,42,Sunday,14 days,103698.064
ACC-1710017148,19,11.6,6664.45,1.0,CUS-883482547,2018-09-02,Michelle,F,-34.01,150.82,,a86e898d-8740-452a-8d2d-59718c4e8b6c,-33.65,115.03,WA,Yallingup,debit,authorized,83df2c2c6e9b42109ea69eccd1b949b3,SALES-POS,<20,2018,9,2,23,59,Sunday,14 days,103698.064
ACC-1710017148,19,5.79,6658.66,1.0,CUS-883482547,2018-09-03,Michelle,F,-34.01,150.82,,85262d2a-9173-4d21-9de5-39fbc01a74fe,-33.9,151.18,NSW,Newtown,debit,authorized,41c8ab08a7484c54b513470a7c29be75,SALES-POS,<20,2018,9,3,9,0,Monday,14 days,103698.064
ACC-1710017148,19,1534.0,9102.12,,CUS-883482547,2018-09-04,Michelle,F,-34.01,150.82,,,,,,,debit,posted,0dba192c4ccb4f6d987efde549f71ede,PAYMENT,<20,2018,9,4,4,0,Tuesday,14 days,103698.064
ACC-1710017148,19,54.0,9048.12,,CUS-883482547,2018-09-04,Michelle,F,-34.01,150.82,,,,,,,debit,posted,25bc5078d9204e8cac0a742753a13381,PAYMENT,<20,2018,9,4,9,0,Tuesday,14 days,103698.064
ACC-1710017148,19,33.0,9015.12,,CUS-883482547,2018-09-05,Michelle,F,-34.01,150.82,,,,,,,debit,posted,479b1fe4e7f1408fa8c793b6a8a08f54,PAYMENT,<20,2018,9,5,22,0,Wednesday,14 days,103698.064
ACC-1710017148,19,40.0,8975.12,,CUS-883482547,2018-09-07,Michelle,F,-34.01,150.82,,,,,,,debit,posted,95fea6659926486bb9b7ac6a4b3471fb,PAYMENT,<20,2018,9,7,4,0,Friday,14 days,103698.064
ACC-1710017148,19,200.0,8775.12,,CUS-883482547,2018-09-07,Michelle,F,-34.01,150.82,,,,,,,debit,posted,4c6f227b09334f2a89c7cea09d3e4da0,PAYMENT,<20,2018,9,7,9,0,Friday,14 days,103698.064
ACC-1710017148,19,54.0,8721.12,,CUS-883482547,2018-09-11,Michelle,F,-34.01,150.82,,,,,,,debit,posted,82f4e80c50c54e109de9635cd75f56c1,PAYMENT,<20,2018,9,11,9,0,Tuesday,14 days,103698.064
ACC-1710017148,19,33.0,8688.12,,CUS-883482547,2018-09-12,Michelle,F,-34.01,150.82,,,,,,,debit,posted,6e78561f9c7b48719598bc0d24cc606a,PAYMENT,<20,2018,9,12,22,0,Wednesday,14 days,103698.064
ACC-1710017148,19,10.21,8677.91,1.0,CUS-883482547,2018-09-13,Michelle,F,-34.01,150.82,,a1ca1b7e-a737-4fc8-b070-3e606f52c0d6,-33.95,115.07,WA,Margaret River,debit,authorized,c80e5014e48b4c8999ec1e7bee34c3f1,SALES-POS,<20,2018,9,13,14,19,Thursday,14 days,103698.064
ACC-1710017148,19,49.5,8628.41,0.0,CUS-883482547,2018-09-13,Michelle,F,-34.01,150.82,,ffaffe7f-3d95-4429-a3dd-96a8d6088863,-37.85,145,VIC,Prahran,debit,authorized,153b6793b8434034b373721d9d0bc299,SALES-POS,<20,2018,9,13,22,42,Thursday,14 days,103698.064
ACC-1710017148,19,32.26,8596.15,0.0,CUS-883482547,2018-09-13,Michelle,F,-34.01,150.82,,3d0c1cfa-bdfd-4467-b3f0-42d4037326d0,-33.9,151.2,NSW,Alexandria,debit,authorized,c6c6cec25ce64a809d00eb111987527c,POS,<20,2018,9,13,23,15,Thursday,14 days,103698.064
ACC-1710017148,19,38.31,8557.84,1.0,CUS-883482547,2018-09-13,Michelle,F,-34.01,150.82,,8bdc1e1c-40eb-49f9-aa1c-33b6e8f8e13f,-34.05,150.76,NSW,Narellan,debit,authorized,57263d9a79034d95abd8b6c9c64bf7cc,SALES-POS,<20,2018,9,13,23,31,Thursday,14 days,103698.064
ACC-1710017148,19,40.0,8517.84,,CUS-883482547,2018-09-14,Michelle,F,-34.01,150.82,,,,,,,debit,posted,fb1fa75f61fb4cbfb218d0795edf723f,PAYMENT,<20,2018,9,14,4,0,Friday,14 days,103698.064
ACC-1710017148,19,4.62,8513.22,1.0,CUS-883482547,2018-09-14,Michelle,F,-34.01,150.82,,7361b6ab-2ee1-4cf4-8de6-cd2929b38bd8,-33.91,151.24,NSW,Randwick,debit,authorized,92cb5a1883304418900aaf6f82570c2c,SALES-POS,<20,2018,9,14,8,19,Friday,14 days,103698.064
ACC-1710017148,19,36.31,8476.91,0.0,CUS-883482547,2018-09-14,Michelle,F,-34.01,150.82,,a5aa5467-c49e-4dee-a612-7bc76aad9ab7,-33.99,150.78,NSW,Catherine Field,debit,authorized,33e61940a6254c8d9782efd1cefd0611,SALES-POS,<20,2018,9,14,9,30,Friday,14 days,103698.064
ACC-1710017148,19,49.86,8427.05,1.0,CUS-883482547,2018-09-14,Michelle,F,-34.01,150.82,,d855e456-8a39-4249-91ca-02ffdc7a708c,-33.65,115.35,WA,Busselton,debit,authorized,1e645def09ef4f748a0ff9c7d92c9744,POS,<20,2018,9,14,17,17,Friday,14 days,103698.064
ACC-1710017148,19,45.24,8381.81,1.0,CUS-883482547,2018-09-15,Michelle,F,-34.01,150.82,,ea715c50-57c6-4f2c-9353-079eda5e0385,-34.07,137.59,SA,Moonta,debit,authorized,0661163e21994eaa9b4b58f04f20012f,POS,<20,2018,9,15,21,19,Saturday,14 days,103698.064
ACC-1710017148,19,19.04,8362.77,1.0,CUS-883482547,2018-09-15,Michelle,F,-34.01,150.82,,bb15561f-2bfc-4ec6-91a5-a2880101318d,-34.45,147.53,NSW,Temora,debit,authorized,1e38acd644494e96b3256fd322296fc9,POS,<20,2018,9,15,23,13,Saturday,14 days,103698.064
ACC-1710017148,19,17.96,8344.81,1.0,CUS-883482547,2018-09-16,Michelle,F,-34.01,150.82,,601b9030-369f-4132-b0d5-27b2a8dcda38,-33.6,137.93,SA,Port Broughton,debit,authorized,af2ce34d8c75403c8bb192be02c59321,SALES-POS,<20,2018,9,16,10,6,Sunday,14 days,103698.064
ACC-1710017148,19,31.23,8313.58,1.0,CUS-883482547,2018-09-16,Michelle,F,-34.01,150.82,,790b423d-b52c-41de-b9f2-f86ad72e0cd6,-33.74,150.84,NSW,Plumpton,debit,authorized,e44734fe98604dc48cae66126e65539c,POS,<20,2018,9,16,10,33,Sunday,14 days,103698.064
ACC-1710017148,19,39.12,8274.46,1.0,CUS-883482547,2018-09-16,Michelle,F,-34.01,150.82,,8b905246-9f6b-436d-af70-fc2fd7c7ad06,-33.89,151.15,NSW,Leichhardt,debit,authorized,8de6ab75254e4547898da748428f8014,POS,<20,2018,9,16,11,7,Sunday,14 days,103698.064
ACC-1710017148,19,11.18,8263.28,1.0,CUS-883482547,2018-09-16,Michelle,F,-34.01,150.82,,f100251b-1046-4162-b7b8-14a327543351,-33.63,150.84,NSW,Vineyard,debit,authorized,16417da23a1e41ea819494b160aa6aa5,POS,<20,2018,9,16,11,42,Sunday,14 days,103698.064
ACC-1710017148,19,14.05,8249.23,1.0,CUS-883482547,2018-09-16,Michelle,F,-34.01,150.82,,f2a5c744-e3c5-4892-aea1-192d24c28acc,-33.96,150.95,NSW,Wattle Grove,debit,authorized,194bec6281dc4780a93eda1356f43952,SALES-POS,<20,2018,9,16,12,26,Sunday,14 days,103698.064
ACC-1710017148,19,10.72,8238.51,1.0,CUS-883482547,2018-09-17,Michelle,F,-34.01,150.82,,c83ad3ee-302d-462e-8de1-fd5e57972c86,-33.73,150.85,NSW,Colebee,debit,authorized,8eae5f9516464856ba9b1ea63879bf5e,SALES-POS,<20,2018,9,17,9,1,Monday,14 days,103698.064
ACC-1710017148,19,7.65,8230.86,0.0,CUS-883482547,2018-09-17,Michelle,F,-34.01,150.82,,b08294e6-fa5e-4361-9c25-623a2bb40bff,-33.9,151.18,NSW,Newtown,debit,authorized,a61aea45fa764395ae12ac1e022b6886,SALES-POS,<20,2018,9,17,9,31,Monday,14 days,103698.064
ACC-1710017148,19,12.32,8218.54,0.0,CUS-883482547,2018-09-17,Michelle,F,-34.01,150.82,,e47ee0df-3fee-42b3-b6d2-4a121700e678,-33.86,151.2,NSW,Barangaroo,debit,authorized,64a3ddbbcf9d473eab59442620227973,POS,<20,2018,9,17,11,32,Monday,14 days,103698.064
ACC-1710017148,19,245.96,7972.58,1.0,CUS-883482547,2018-09-17,Michelle,F,-34.01,150.82,,feda5c3b-b971-4d0f-bd4e-00910b13a027,-33.82,150.99,NSW,Parramatta,debit,authorized,46bc04ec6e9b49a681afddd96bcb1359,SALES-POS,<20,2018,9,17,12,11,Monday,14 days,103698.064
ACC-1710017148,19,36.15,7936.43,1.0,CUS-883482547,2018-09-17,Michelle,F,-34.01,150.82,,e073b046-7632-4b69-a46b-681be6baa67c,-33.77,151.26,NSW,Brookvale,debit,authorized,7b68a9488ae542e89f6a76acdf0bab77,SALES-POS,<20,2018,9,17,12,58,Monday,14 days,103698.064
ACC-1710017148,19,21.57,7914.86,1.0,CUS-883482547,2018-09-17,Michelle,F,-34.01,150.82,,6408684b-a117-4003-bb62-07b713b59a22,-33.94,151.07,NSW,Roselands,debit,authorized,7a18d3ce2f074206bf74a427dc2d229d,SALES-POS,<20,2018,9,17,14,10,Monday,14 days,103698.064
ACC-1710017148,19,41.54,7873.32,1.0,CUS-883482547,2018-09-17,Michelle,F,-34.01,150.82,,f632267a-1254-436b-a0ff-ddc8db2b287e,-33.75,151.23,NSW,Frenchs Forest,debit,authorized,177fbc07c00247d79aa92e2a791ffdff,POS,<20,2018,9,17,17,32,Monday,14 days,103698.064
ACC-1710017148,19,45.19,11805.59,1.0,CUS-883482547,2018-09-17,Michelle,F,-34.01,150.82,,ee12130c-8068-4bcc-b192-6d4ba9021977,-33.77,151.28,NSW,Freshwater,debit,authorized,12f985b46bcc4d5e8cf2102f55539d89,SALES-POS,<20,2018,9,17,18,39,Monday,14 days,103698.064
ACC-1710017148,19,26.68,11778.91,1.0,CUS-883482547,2018-09-18,Michelle,F,-34.01,150.82,,ac62ecb6-25a5-4f34-8f2a-38b989b57519,-33.91,151.24,NSW,Randwick,debit,authorized,becbb6609b584895a3fefc45d59cd83f,POS,<20,2018,9,18,0,32,Tuesday,14 days,103698.064
ACC-1710017148,19,6.0,11772.91,1.0,CUS-883482547,2018-09-18,Michelle,F,-34.01,150.82,,f6d24b03-5ca8-4cb3-83e2-73db22103a8a,-37.91,145.25,VIC,Rowville,debit,authorized,31b3b0dfe22b4b749fcbaebed70fd351,POS,<20,2018,9,18,8,40,Tuesday,14 days,103698.064
ACC-1710017148,19,54.0,11708.06,,CUS-883482547,2018-09-18,Michelle,F,-34.01,150.82,,,,,,,debit,posted,9beadf2f4d7f446bb57b29c1fae02f78,PAYMENT,<20,2018,9,18,9,0,Tuesday,14 days,103698.064
ACC-1710017148,19,10.85,11762.06,1.0,CUS-883482547,2018-09-18,Michelle,F,-34.01,150.82,,e1f4ce70-32f4-41b1-8715-a1274b8a0887,-33.74,150.85,NSW,Glendenning,debit,authorized,85dea4b9402b45ed90bcdbd0cf8abe26,SALES-POS,<20,2018,9,18,9,21,Tuesday,14 days,103698.064
ACC-1710017148,19,33.0,11675.06,,CUS-883482547,2018-09-19,Michelle,F,-34.01,150.82,,,,,,,debit,posted,9c25793eeac845cb98ca5cf50ffcd4af,PAYMENT,<20,2018,9,19,22,0,Wednesday,14 days,103698.064
ACC-1710017148,19,40.0,11635.06,,CUS-883482547,2018-09-21,Michelle,F,-34.01,150.82,,,,,,,debit,posted,c9d9ae279ffa4ad19506bbf3ffaa0543,PAYMENT,<20,2018,9,21,4,0,Friday,14 days,103698.064
ACC-1710017148,19,179.0,11456.06,,CUS-883482547,2018-09-23,Michelle,F,-34.01,150.82,,,,,,,debit,posted,a052645571b7475591bb5ffbfa0b7f86,PHONE BANK,<20,2018,9,23,19,0,Sunday,14 days,103698.064
ACC-1710017148,19,54.0,11402.06,,CUS-883482547,2018-09-25,Michelle,F,-34.01,150.82,,,,,,,debit,posted,af7f6b65be08433facf32a7d8d33f2fa,PAYMENT,<20,2018,9,25,9,0,Tuesday,14 days,103698.064
ACC-1710017148,19,19.76,11382.3,1.0,CUS-883482547,2018-09-26,Michelle,F,-34.01,150.82,,8392b7cd-e90e-4703-83ab-51769e20f02e,-33.75,151.11,NSW,South Turramurra,debit,authorized,96f3823d16d5449cb92a814915427a1d,POS,<20,2018,9,26,10,42,Wednesday,14 days,103698.064
ACC-1710017148,19,33.0,11349.3,,CUS-883482547,2018-09-26,Michelle,F,-34.01,150.82,,,,,,,debit,posted,3d3cb1651e504974ae3454b45f69b04f,PAYMENT,<20,2018,9,26,22,0,Wednesday,14 days,103698.064
ACC-1710017148,19,81.77,11267.53,1.0,CUS-883482547,2018-09-27,Michelle,F,-34.01,150.82,,b54a7f4e-74ac-4e5c-a784-013898ec4461,-37.82,144.97,VIC,Melbourne,debit,authorized,1a7a55dfe3f84f8fafdcc1da52dca4cb,SALES-POS,<20,2018,9,27,9,42,Thursday,14 days,103698.064
ACC-1710017148,19,11.62,11255.91,0.0,CUS-883482547,2018-09-27,Michelle,F,-34.01,150.82,,33ff13ea-0ed5-4c31-8f43-d30c9dbabb0d,-33.64,151.33,NSW,Avalon Beach,debit,authorized,fc57347ceb7f43ae8f7bde1e450ad7be,POS,<20,2018,9,27,9,50,Thursday,14 days,103698.064
ACC-1710017148,19,10.66,11245.25,1.0,CUS-883482547,2018-09-27,Michelle,F,-34.01,150.82,,f100251b-1046-4162-b7b8-14a327543351,-33.63,150.84,NSW,Vineyard,debit,authorized,7dbc2f8d0c5e4693a0dbfd4d27737dda,POS,<20,2018,9,27,10,40,Thursday,14 days,103698.064
ACC-1710017148,19,36.53,11208.72,1.0,CUS-883482547,2018-09-28,Michelle,F,-34.01,150.82,,3716e385-33dd-4645-bd4d-6a6e42dcf6eb,-33.65,115.35,WA,Busselton,debit,authorized,fb5de5fb1b244c0b883c0edf144714ee,SALES-POS,<20,2018,9,28,0,59,Friday,14 days,103698.064
ACC-1710017148,19,40.0,11168.72,,CUS-883482547,2018-09-28,Michelle,F,-34.01,150.82,,,,,,,debit,posted,9be2380c0b364995b339b8a269d4964b,PAYMENT,<20,2018,9,28,4,0,Friday,14 days,103698.064
ACC-1710017148,19,160.0,10988.14,,CUS-883482547,2018-09-28,Michelle,F,-34.01,150.82,,,,,,,debit,posted,8a0adf975494454db7d19c1e74c3665c,PAYMENT,<20,2018,9,28,6,0,Friday,14 days,103698.064
ACC-1710017148,19,20.58,11148.14,1.0,CUS-883482547,2018-09-28,Michelle,F,-34.01,150.82,,efba50c6-c0fc-4a6c-85bb-a93c33fd0443,-34.02,151.07,NSW,Jannali,debit,authorized,0cc5884f9a5643d3aeb44426b6c741f2,SALES-POS,<20,2018,9,28,6,3,Friday,14 days,103698.064
ACC-1710017148,19,16.49,10971.65,1.0,CUS-883482547,2018-09-28,Michelle,F,-34.01,150.82,,b82483f8-57c4-4f6f-92ff-4f7b680495d2,-33.65,115.34,WA,Busselton,debit,authorized,9bed300ba9334567aec02ec4e1d5c9b1,SALES-POS,<20,2018,9,28,7,41,Friday,14 days,103698.064
ACC-1710017148,19,15.66,10955.99,1.0,CUS-883482547,2018-09-28,Michelle,F,-34.01,150.82,,53f4150d-093a-458d-8339-581c9d233111,-33.72,151.04,NSW,Cherrybrook,debit,authorized,ce47478eddec44e79966e64e227b7e76,SALES-POS,<20,2018,9,28,15,50,Friday,14 days,103698.064
ACC-1710017148,19,52.92,10903.07,1.0,CUS-883482547,2018-09-28,Michelle,F,-34.01,150.82,,ed748fd9-0312-494a-a5dd-a6842c6a9430,-34.04,151.08,NSW,Gymea,debit,authorized,047326c6508041f7bb5ba7ccfef67fa5,POS,<20,2018,9,28,17,40,Friday,14 days,103698.064
ACC-1710017148,19,29.82,10873.25,1.0,CUS-883482547,2018-09-29,Michelle,F,-34.01,150.82,,031aaca7-415a-4191-b0c9-0bff464836d0,-34.07,150.8,NSW,Campbelltown,debit,authorized,7a435e1249494676a98295addccc3c45,POS,<20,2018,9,29,13,42,Saturday,14 days,103698.064
ACC-1710017148,19,54.0,14796.71,,CUS-883482547,2018-10-02,Michelle,F,-34.01,150.82,,,,,,,debit,posted,68c36c287901477eb2aa988953b9089f,PAYMENT,<20,2018,10,2,9,0,Tuesday,14 days,103698.064
ACC-1710017148,19,8.13,14788.58,0.0,CUS-883482547,2018-10-02,Michelle,F,-34.01,150.82,,29586199-863f-4b71-942b-39249e595c90,-33.97,151.13,NSW,Kogarah,debit,authorized,ea010b02e0a74fe58418d2b3d6d66fe3,POS,<20,2018,10,2,22,59,Tuesday,14 days,103698.064
ACC-1710017148,19,6.34,14782.24,0.0,CUS-883482547,2018-10-03,Michelle,F,-34.01,150.82,,9d7f67d2-d7c9-47b9-bcf6-81cb5ff65261,-33.84,151.21,NSW,North Sydney,debit,authorized,af24e744163f4ba9b6d6d802f1445ebb,POS,<20,2018,10,3,1,9,Wednesday,14 days,103698.064
ACC-1710017148,19,11.09,14771.15,1.0,CUS-883482547,2018-10-03,Michelle,F,-34.01,150.82,,67b82577-3155-4818-890f-6ec0ce126de7,-33.74,151.21,NSW,Belrose,debit,authorized,86baf4f7369841dcb3a201229a206ff9,SALES-POS,<20,2018,10,3,14,45,Wednesday,14 days,103698.064
ACC-1710017148,19,29.03,14742.12,1.0,CUS-883482547,2018-10-03,Michelle,F,-34.01,150.82,,90bcca1c-37b3-4e43-8320-e6886b13dc71,-33.95,150.95,NSW,Hammondville,debit,authorized,0bb593a103c44ed996b27a458374a33c,POS,<20,2018,10,3,15,47,Wednesday,14 days,103698.064
ACC-1710017148,19,11.14,14730.98,1.0,CUS-883482547,2018-10-03,Michelle,F,-34.01,150.82,,a86e898d-8740-452a-8d2d-59718c4e8b6c,-33.65,115.03,WA,Yallingup,debit,authorized,c2994ad40e294855a8f9b8ad34a7eec6,SALES-POS,<20,2018,10,3,16,17,Wednesday,14 days,103698.064
ACC-1710017148,19,33.0,14697.98,,CUS-883482547,2018-10-03,Michelle,F,-34.01,150.82,,,,,,,debit,posted,9d6c418c8f7a4790a845e546885cefb8,PAYMENT,<20,2018,10,3,22,0,Wednesday,14 days,103698.064
ACC-1710017148,19,42.5,14655.48,1.0,CUS-883482547,2018-10-04,Michelle,F,-34.01,150.82,,b03fb628-5059-48e4-b99c-a2381e260ee8,-33.92,151.08,NSW,Lakemba,debit,authorized,e1a3b045220b4ab7a7a8e1af838723c2,SALES-POS,<20,2018,10,4,11,23,Thursday,14 days,103698.064
ACC-1710017148,19,40.0,14615.48,,CUS-883482547,2018-10-05,Michelle,F,-34.01,150.82,,,,,,,debit,posted,8638b59d372444a3a9cf37313bbc2b4d,PAYMENT,<20,2018,10,5,4,0,Friday,14 days,103698.064
ACC-1710017148,19,32.59,14582.89,0.0,CUS-883482547,2018-10-05,Michelle,F,-34.01,150.82,,4f6fc082-0946-4aae-8c2b-0ab5b64b0dcf,-34.02,151.07,NSW,Jannali,debit,authorized,0ecd73b025e8461c9e077f54071e9e4f,SALES-POS,<20,2018,10,5,6,28,Friday,14 days,103698.064
ACC-1710017148,19,16.54,14566.35,1.0,CUS-883482547,2018-10-05,Michelle,F,-34.01,150.82,,9833296d-81dd-4baa-bc6c-8c9151e644bf,-33.91,151.2,NSW,Alexandria,debit,authorized,9d1d38a5578c48b5b9f6c0078624c444,SALES-POS,<20,2018,10,5,9,37,Friday,14 days,103698.064
ACC-1710017148,19,22.92,14543.43,1.0,CUS-883482547,2018-10-05,Michelle,F,-34.01,150.82,,428bea06-acf2-4fdf-b7d0-2f7ee36f3251,-34.5,150.79,NSW,Dapto,debit,authorized,4740b8b0fab747669d020a5d25c493ca,POS,<20,2018,10,5,13,47,Friday,14 days,103698.064
ACC-1710017148,19,200.0,14343.43,,CUS-883482547,2018-10-07,Michelle,F,-34.01,150.82,,,,,,,debit,posted,10b85f0e08fd4dffafb96fc26f63882b,PAYMENT,<20,2018,10,7,9,0,Sunday,14 days,103698.064
ACC-1710017148,19,54.0,14229.45,,CUS-883482547,2018-10-09,Michelle,F,-34.01,150.82,,,,,,,debit,posted,556fcc9942f94178b0641824e18e1989,PAYMENT,<20,2018,10,9,9,0,Tuesday,14 days,103698.064
ACC-1710017148,19,59.98,14283.45,1.0,CUS-883482547,2018-10-09,Michelle,F,-34.01,150.82,,3df82b4a-7300-4ebe-9660-0d810bb28410,-33.75,151.24,NSW,Frenchs Forest,debit,authorized,a5502bbb79d448a39cbbb25e7d5ea675,POS,<20,2018,10,9,9,45,Tuesday,14 days,103698.064
ACC-1710017148,19,35.71,14193.74,1.0,CUS-883482547,2018-10-09,Michelle,F,-34.01,150.82,,40bcf29f-51ae-48b0-9c99-aadccc325e10,-33.9,151.25,NSW,Bondi Junction,debit,authorized,0c75bea1a9b24793bfa3e0c721059393,SALES-POS,<20,2018,10,9,15,27,Tuesday,14 days,103698.064
ACC-1710017148,19,24.38,14169.36,1.0,CUS-883482547,2018-10-09,Michelle,F,-34.01,150.82,,4a343ec1-48cf-499e-99bf-6cbe7db9c538,-33.76,151.28,NSW,Dee Why,debit,authorized,9df5483bdf7e46198dd6462efc3e8d5d,POS,<20,2018,10,9,20,46,Tuesday,14 days,103698.064
ACC-1710017148,19,7.27,14162.09,1.0,CUS-883482547,2018-10-10,Michelle,F,-34.01,150.82,,ed323d3e-dff0-434d-be5b-b04855e3d9e9,-33.92,151.03,NSW,Bankstown,debit,authorized,a3ee4f3b31cc4b81b7d4a250d3b2d424,SALES-POS,<20,2018,10,10,11,57,Wednesday,14 days,103698.064
ACC-1710017148,19,16.34,14145.75,1.0,CUS-883482547,2018-10-10,Michelle,F,-34.01,150.82,,b9510d80-80d9-4fe5-b712-523881bfff75,-33.65,115.34,WA,Busselton,debit,authorized,586aa692fae54af4b897d55c99460de3,SALES-POS,<20,2018,10,10,13,49,Wednesday,14 days,103698.064
ACC-1710017148,19,39.87,14105.88,1.0,CUS-883482547,2018-10-10,Michelle,F,-34.01,150.82,,02d8f097-abb7-4545-8ffd-a0090fece10c,-33.89,150.91,NSW,Cabramatta West,debit,authorized,e4c851c484af44099c5885e2a1df02b5,POS,<20,2018,10,10,14,23,Wednesday,14 days,103698.064
ACC-1710017148,19,98.82,14007.06,1.0,CUS-883482547,2018-10-10,Michelle,F,-34.01,150.82,,922e5cd4-6a92-4398-9af8-88226fbae3c6,-33.94,151.06,NSW,Riverwood,debit,authorized,b11ba3c4f45a438ba19c58ff0e2b7789,POS,<20,2018,10,10,15,33,Wednesday,14 days,103698.064
ACC-1710017148,19,33.0,13974.06,,CUS-883482547,2018-10-10,Michelle,F,-34.01,150.82,,,,,,,debit,posted,5ea799ced8984800b518ca3d90abeaab,PAYMENT,<20,2018,10,10,22,0,Wednesday,14 days,103698.064
ACC-1710017148,19,54.39,13919.67,1.0,CUS-883482547,2018-10-11,Michelle,F,-34.01,150.82,,ebb9d59d-d959-4bd7-a773-92e9250c5be4,-33.83,151.22,NSW,Neutral Bay,debit,authorized,46c72c726de44379b71a685016fdebfc,SALES-POS,<20,2018,10,11,9,4,Thursday,14 days,103698.064
ACC-1710017148,19,36.35,13883.32,1.0,CUS-883482547,2018-10-11,Michelle,F,-34.01,150.82,,5fe95a04-b9de-4e74-a4f3-bdddc4715670,-33.85,151.05,NSW,Lidcombe,debit,authorized,1b34c17a25f44517b8a582cef90d5267,POS,<20,2018,10,11,9,9,Thursday,14 days,103698.064
ACC-1710017148,19,18.72,13864.6,1.0,CUS-883482547,2018-10-12,Michelle,F,-34.01,150.82,,edadc46b-f158-4c81-a040-7f615aaf9c4d,-33.73,151.01,NSW,Castle Hill,debit,authorized,4355047186334b129f33972c0fecf469,SALES-POS,<20,2018,10,12,0,17,Friday,14 days,103698.064
ACC-1710017148,19,40.0,13824.6,,CUS-883482547,2018-10-12,Michelle,F,-34.01,150.82,,,,,,,debit,posted,c0648d61d4204ad18cd5dce7ea62cf6b,PAYMENT,<20,2018,10,12,4,0,Friday,14 days,103698.064
ACC-1710017148,19,19.84,13804.76,1.0,CUS-883482547,2018-10-12,Michelle,F,-34.01,150.82,,743caa53-10ab-42e0-a96b-8b456efd5229,-33.76,151.21,NSW,Forestville,debit,authorized,5fae39b636cd4d7fadaa2bf23937c036,SALES-POS,<20,2018,10,12,8,45,Friday,14 days,103698.064
ACC-1710017148,19,11.71,13793.05,1.0,CUS-883482547,2018-10-12,Michelle,F,-34.01,150.82,,b0901e60-7922-4b56-ac83-0eb765364375,-33.89,151.24,NSW,Woollahra,debit,authorized,36ddfb25c42d4e0099aad9c06675abe9,POS,<20,2018,10,12,12,40,Friday,14 days,103698.064
ACC-1710017148,19,11.83,13781.22,1.0,CUS-883482547,2018-10-12,Michelle,F,-34.01,150.82,,3863eaa9-4a57-4a5d-b118-238c328524ee,-33.65,115.34,WA,Busselton,debit,authorized,6b1ca02f28a74c0483066cd799a9dbfe,SALES-POS,<20,2018,10,12,12,59,Friday,14 days,103698.064
ACC-1710017148,19,12.57,13768.65,0.0,CUS-883482547,2018-10-12,Michelle,F,-34.01,150.82,,c799c273-ce9b-4406-a55e-4b3279fbf2b9,-33.89,151.16,NSW,Leichhardt,debit,authorized,5b2d1c0fef1d4a489c05468d60d747e2,POS,<20,2018,10,12,16,8,Friday,14 days,103698.064
ACC-1710017148,19,17.65,13751.0,1.0,CUS-883482547,2018-10-12,Michelle,F,-34.01,150.82,,c8c5a63c-993b-4f10-9905-efc03c2be02c,-37.79,145.07,VIC,Balwyn North,debit,authorized,862c216278c54d03b322809065bd9e89,SALES-POS,<20,2018,10,12,21,14,Friday,14 days,103698.064
ACC-1710017148,19,13.13,13737.87,1.0,CUS-883482547,2018-10-14,Michelle,F,-34.01,150.82,,e7679f48-7159-44ac-bdac-34451fcd487d,-33.92,151.24,NSW,Randwick,debit,authorized,93976454b1a04eb3a86542574c105e70,POS,<20,2018,10,14,21,3,Sunday,14 days,103698.064
ACC-1710017148,19,12.55,13725.32,0.0,CUS-883482547,2018-10-15,Michelle,F,-34.01,150.82,,341b0dfd-632c-4ed8-a5d9-0814fbd69760,-33.61,150.82,NSW,Windsor,debit,authorized,7b2c7fff606b4a7dbda7868b10d3a547,POS,<20,2018,10,15,10,34,Monday,14 days,103698.064
ACC-1710017148,19,25.15,13700.17,0.0,CUS-883482547,2018-10-15,Michelle,F,-34.01,150.82,,585fdd2e-e514-4574-81b2-7ac234ccae2e,-33.76,138.44,SA,Hart,debit,authorized,76c26033f1ed41f8a07981e1e54779d6,SALES-POS,<20,2018,10,15,11,59,Monday,14 days,103698.064
ACC-1710017148,19,13.64,13686.53,1.0,CUS-883482547,2018-10-15,Michelle,F,-34.01,150.82,,fdc9d08a-37e3-494c-b4ec-d5fdcd3d3f5e,-33.64,150.29,NSW,Blackheath,debit,authorized,99e29d4a6f274b69b1cb361b981981c9,SALES-POS,<20,2018,10,15,14,34,Monday,14 days,103698.064
ACC-1710017148,19,54.0,17609.99,,CUS-883482547,2018-10-16,Michelle,F,-34.01,150.82,,,,,,,debit,posted,621198c486df433ca808037136aafe69,PAYMENT,<20,2018,10,16,9,0,Tuesday,14 days,103698.064
ACC-1710017148,19,35.44,17574.55,0.0,CUS-883482547,2018-10-17,Michelle,F,-34.01,150.82,,7c27c261-9d34-40e2-89d2-d32c5626712d,-27.42,153.03,QLD,Lutwyche,debit,authorized,9ddfc3e97f9f4e17915a415a27f933e2,SALES-POS,<20,2018,10,17,15,39,Wednesday,14 days,103698.064
ACC-1710017148,19,33.0,17541.55,,CUS-883482547,2018-10-17,Michelle,F,-34.01,150.82,,,,,,,debit,posted,a5ffb7234e6c4345a0b77d177b333462,PAYMENT,<20,2018,10,17,22,0,Wednesday,14 days,103698.064
ACC-1710017148,19,10.63,17530.92,1.0,CUS-883482547,2018-10-18,Michelle,F,-34.01,150.82,,fc91a397-3c10-418f-bc72-e29c9e31fd3d,-34.04,139.67,SA,Morgan,debit,authorized,81c4c812dcc040c48bdfd27b6f427924,SALES-POS,<20,2018,10,18,11,32,Thursday,14 days,103698.064
ACC-1710017148,19,40.0,17490.92,,CUS-883482547,2018-10-19,Michelle,F,-34.01,150.82,,,,,,,debit,posted,9f1ed67d032d4493bbbb0f96a6fba309,PAYMENT,<20,2018,10,19,4,0,Friday,14 days,103698.064
ACC-1710017148,19,26.34,17464.58,1.0,CUS-883482547,2018-10-20,Michelle,F,-34.01,150.82,,c69a4e96-466b-4819-9318-484b6ed92b96,-33.9,151.18,NSW,Newtown,debit,authorized,f685b6a9facd4f18a63f6d2c95cff5a9,POS,<20,2018,10,20,9,50,Saturday,14 days,103698.064
ACC-1710017148,19,54.0,17410.58,,CUS-883482547,2018-10-23,Michelle,F,-34.01,150.82,,,,,,,debit,posted,640dbb4497e24533922d88bc1b07dbc8,PAYMENT,<20,2018,10,23,9,0,Tuesday,14 days,103698.064
ACC-1710017148,19,179.0,17231.58,,CUS-883482547,2018-10-23,Michelle,F,-34.01,150.82,,,,,,,debit,posted,92af4e0ca14f4117bbf2128b3ef5492d,PHONE BANK,<20,2018,10,23,19,0,Tuesday,14 days,103698.064
ACC-1710017148,19,33.0,17198.58,,CUS-883482547,2018-10-24,Michelle,F,-34.01,150.82,,,,,,,debit,posted,a4bbe7cb57434440b4d8bcdf6fd71908,PAYMENT,<20,2018,10,24,22,0,Wednesday,14 days,103698.064
ACC-1710017148,19,40.0,17158.58,,CUS-883482547,2018-10-26,Michelle,F,-34.01,150.82,,,,,,,debit,posted,7fdc3c0551174a738613dac5f966575d,PAYMENT,<20,2018,10,26,4,0,Friday,14 days,103698.064
ACC-1710017148,19,6.46,17152.12,1.0,CUS-883482547,2018-10-27,Michelle,F,-34.01,150.82,,1aa43ff9-5593-4e72-9a78-f7ca2e859f3d,-33.87,151.21,NSW,Sydney,debit,authorized,e8608b3b231948e0912d8701465eedb9,POS,<20,2018,10,27,7,24,Saturday,14 days,103698.064
ACC-1710017148,19,24.99,17127.13,0.0,CUS-883482547,2018-10-27,Michelle,F,-34.01,150.82,,4933e854-a99f-4669-82c8-a29053a44765,-33.82,151.17,NSW,Lane Cove,debit,authorized,aa87c3ecc5b54f60871511294663b856,POS,<20,2018,10,27,12,55,Saturday,14 days,103698.064
ACC-1710017148,19,160.0,16967.13,,CUS-883482547,2018-10-28,Michelle,F,-34.01,150.82,,,,,,,debit,posted,053ff6f0b2274506ad6dc38b24268b59,PAYMENT,<20,2018,10,28,6,0,Sunday,14 days,103698.064
ACC-1710017148,19,47.03,16920.1,0.0,CUS-883482547,2018-10-28,Michelle,F,-34.01,150.82,,f656c191-9b37-4ca9-9b91-4f91ebed5cbe,-33.91,151.19,NSW,Alexandria,debit,authorized,b5c649edf595470580830e93d40c4c30,SALES-POS,<20,2018,10,28,7,49,Sunday,14 days,103698.064
ACC-1710017148,19,21.73,16898.37,1.0,CUS-883482547,2018-10-28,Michelle,F,-34.01,150.82,,abc95c52-7dc7-46d2-966b-efb49095ad99,-34.06,151.15,NSW,Cronulla,debit,authorized,08df57b7f96b4be3af24b2caa1ce0731,SALES-POS,<20,2018,10,28,9,33,Sunday,14 days,103698.064
ACC-1710017148,19,41.25,16857.12,1.0,CUS-883482547,2018-10-29,Michelle,F,-34.01,150.82,,de8527b5-475b-4607-8ce1-6bc04df87865,-33.61,150.82,NSW,Windsor,debit,authorized,e7e3a78b584f43a9afca2b3776e4242d,POS,<20,2018,10,29,10,15,Monday,14 days,103698.064
ACC-1710017148,19,10.7,16846.42,1.0,CUS-883482547,2018-10-29,Michelle,F,-34.01,150.82,,c50c3147-5b47-42c4-aa9a-e38b6fe72637,-33.8,151.18,NSW,Chatswood,debit,authorized,06046887d1ab4900a4d34919cc5b6bc1,SALES-POS,<20,2018,10,29,12,24,Monday,14 days,103698.064
ACC-1710017148,19,10.92,16835.5,0.0,CUS-883482547,2018-10-29,Michelle,F,-34.01,150.82,,94b58e22-eb53-4863-ae56-58baaa8dc5f2,-33.62,115.11,WA,Dunsborough,debit,authorized,96939f55e2074145b430cd96fd25cbf5,SALES-POS,<20,2018,10,29,12,46,Monday,14 days,103698.064
ACC-1710017148,19,26.06,20786.9,0.0,CUS-883482547,2018-10-29,Michelle,F,-34.01,150.82,,50ae3ae2-d9d6-40d5-8508-52ba91c86a0d,-33.87,151.17,NSW,Rozelle,debit,authorized,4e3f9f6ba9744cbaa4697cb025342a06,POS,<20,2018,10,29,20,24,Monday,14 days,103698.064
ACC-1710017148,19,54.0,20732.9,,CUS-883482547,2018-10-30,Michelle,F,-34.01,150.82,,,,,,,debit,posted,90b4eebb87e249d095110820307c7f81,PAYMENT,<20,2018,10,30,9,0,Tuesday,14 days,103698.064
ACC-1710017148,19,33.0,20699.9,,CUS-883482547,2018-10-31,Michelle,F,-34.01,150.82,,,,,,,debit,posted,96fe9c5dcda24b599e81b6f6d5bdcb66,PAYMENT,<20,2018,10,31,22,0,Wednesday,14 days,103698.064
ACC-2673069055,24,14.49,11525.54,1.0,CUS-51506836,2018-08-01,Richard,M,-27.49,152.99,,73b8eb5f-d6e6-43fb-896a-84faa162d544,-26.61,153.08,QLD,Pacific Paradise,debit,authorized,221c4f7dd53240a18ceab43e1b879a62,SALES-POS,20-30,2018,8,1,9,6,Wednesday,31 days,73297.96166666666
ACC-2673069055,24,87.03,11438.51,1.0,CUS-51506836,2018-08-01,Richard,M,-27.49,152.99,,30077f02-9082-4179-b287-3c927eed1be9,-27.51,153.05,QLD,Greenslopes,debit,authorized,e06884699c114da592c8dcde6d30cab3,SALES-POS,20-30,2018,8,1,9,47,Wednesday,31 days,73297.96166666666
ACC-2673069055,24,13.93,11424.58,0.0,CUS-51506836,2018-08-02,Richard,M,-27.49,152.99,,c251a571-814d-47fc-bfb5-928382086f12,-27.45,153.01,QLD,Kelvin Grove,debit,authorized,b1b18c288b0841da9693f211c566e958,POS,20-30,2018,8,2,18,56,Thursday,31 days,73297.96166666666
ACC-2673069055,24,57.75,11366.83,1.0,CUS-51506836,2018-08-02,Richard,M,-27.49,152.99,,f3b432d7-4224-4216-9f69-972559838cba,-33.87,151.21,NSW,Sydney,debit,authorized,70d5f6f3584e44be87c6aad04ca12275,POS,20-30,2018,8,2,20,48,Thursday,31 days,73297.96166666666
ACC-2673069055,24,43.0,11323.83,,CUS-51506836,2018-08-03,Richard,M,-27.49,152.99,,,,,,,debit,posted,25c5c51ba765437fb2d6781fe0cb74ce,PAYMENT,20-30,2018,8,3,3,0,Friday,31 days,73297.96166666666
ACC-2673069055,24,24.55,11299.28,1.0,CUS-51506836,2018-08-03,Richard,M,-27.49,152.99,,caf30f6a-3825-450b-ad8a-83a3355e048e,-27.53,153.06,QLD,Holland Park,debit,authorized,e460cee566ac416e9f9473ca481a69a2,POS,20-30,2018,8,3,10,10,Friday,31 days,73297.96166666666
ACC-2673069055,24,20.52,11278.76,1.0,CUS-51506836,2018-08-03,Richard,M,-27.49,152.99,,b86c9f6d-ccba-4188-abac-331af90c0f61,-26.73,153.06,QLD,Sippy Downs,debit,authorized,f1b6b3a13331409ba8ae36cce03bf88c,POS,20-30,2018,8,3,17,47,Friday,31 days,73297.96166666666
ACC-2673069055,24,128.0,11150.76,,CUS-51506836,2018-08-04,Richard,M,-27.49,152.99,,,,,,,debit,posted,e4714463490246729908241977ba8bbf,PAYMENT,20-30,2018,8,4,2,0,Saturday,31 days,73297.96166666666
ACC-2673069055,24,39.0,11111.76,,CUS-51506836,2018-08-06,Richard,M,-27.49,152.99,,,,,,,debit,posted,6c0a11b2380749b8b203917edfd00d31,INTER BANK,20-30,2018,8,6,9,0,Monday,31 days,73297.96166666666
ACC-2673069055,24,9.23,11102.53,1.0,CUS-51506836,2018-08-07,Richard,M,-27.49,152.99,,7644aebc-beec-40bd-aa31-28395d47d552,-31.45,152.89,NSW,Port Macquarie,debit,authorized,f8cba1674ed444e0a44091823bf55f8a,POS,20-30,2018,8,7,0,13,Tuesday,31 days,73297.96166666666
ACC-2673069055,24,97.97,17029.05,1.0,CUS-51506836,2018-08-07,Richard,M,-27.49,152.99,,ff61dd5e-938a-4acb-a1fd-03d1d2fbba4e,-33.87,151.21,NSW,Sydney,debit,authorized,05668e2dded141758fab7b864eb9fc92,POS,20-30,2018,8,7,19,31,Tuesday,31 days,73297.96166666666
ACC-2673069055,24,11.33,17017.72,1.0,CUS-51506836,2018-08-08,Richard,M,-27.49,152.99,,07de2417-faaa-43c8-8003-80b190764eb4,-27.7,153.04,QLD,Park Ridge,debit,authorized,78effef564a94615aeaa8b20fb8d7166,SALES-POS,20-30,2018,8,8,9,23,Wednesday,31 days,73297.96166666666
ACC-2673069055,24,5.22,17012.5,1.0,CUS-51506836,2018-08-08,Richard,M,-27.49,152.99,,bf2091e2-83f9-4ead-88c2-31cbd0e770b2,-27.56,152.28,QLD,Gatton,debit,authorized,80d75293194242af9c277e6d799fb041,POS,20-30,2018,8,8,9,59,Wednesday,31 days,73297.96166666666
ACC-2673069055,24,19.27,16993.23,1.0,CUS-51506836,2018-08-08,Richard,M,-27.49,152.99,,e7cebec6-f27d-443c-81eb-0ce04ffd9659,-27.74,152.98,QLD,Greenbank,debit,authorized,c6a58460ea334362ae053c0e4a11571c,POS,20-30,2018,8,8,14,43,Wednesday,31 days,73297.96166666666
ACC-2673069055,24,12.37,16980.86,1.0,CUS-51506836,2018-08-09,Richard,M,-27.49,152.99,,02e5bf74-cd2b-4b91-877e-eac5be9b0007,-27.08,152.95,QLD,Caboolture,debit,authorized,bd666a2e88ca4b3f8dc1e1d7dcef0fc2,SALES-POS,20-30,2018,8,9,15,1,Thursday,31 days,73297.96166666666
ACC-2673069055,24,11.51,16969.35,1.0,CUS-51506836,2018-08-09,Richard,M,-27.49,152.99,,8a98b3ba-f15c-43d6-b9a0-b7cc310e0dba,-27.49,153.17,QLD,Wakerley,debit,authorized,f4003a86bc90419e90c71214beff09a7,SALES-POS,20-30,2018,8,9,19,8,Thursday,31 days,73297.96166666666
ACC-2673069055,24,10.85,16958.5,1.0,CUS-51506836,2018-08-09,Richard,M,-27.49,152.99,,e7aa42db-d3e1-4bb8-9522-f05329c12e84,-27.54,151.93,QLD,Wilsonton,debit,authorized,cf5349cb375e4f42914d2e8bdaf4fdee,POS,20-30,2018,8,9,20,16,Thursday,31 days,73297.96166666666
ACC-2673069055,24,43.0,16915.5,,CUS-51506836,2018-08-10,Richard,M,-27.49,152.99,,,,,,,debit,posted,0ab9f2bfebea4d20b2956d4b62d80b45,PAYMENT,20-30,2018,8,10,3,0,Friday,31 days,73297.96166666666
ACC-2673069055,24,23.13,16892.37,1.0,CUS-51506836,2018-08-11,Richard,M,-27.49,152.99,,14f8c748-af9a-4332-8c45-6f39f4912968,-27.45,151.72,QLD,Oakey,debit,authorized,b39b163dabe542d9a88c5bcce78a4acd,POS,20-30,2018,8,11,11,40,Saturday,31 days,73297.96166666666
ACC-2673069055,24,13.36,16879.01,1.0,CUS-51506836,2018-08-12,Richard,M,-27.49,152.99,,2c947b40-d708-44b7-9ec0-1889e016aeac,-27.08,152.96,QLD,Caboolture,debit,authorized,9a36bb6e5d6347f6934853dc593e8799,POS,20-30,2018,8,12,7,26,Sunday,31 days,73297.96166666666
ACC-2673069055,24,9.43,16869.58,0.0,CUS-51506836,2018-08-12,Richard,M,-27.49,152.99,,7632200d-3c24-413d-b8b9-107a7bee6a4e,-27.5,153.1,QLD,Carindale,debit,authorized,165aaf2b300d4a5da7556b86f1877268,SALES-POS,20-30,2018,8,12,15,45,Sunday,31 days,73297.96166666666
ACC-2673069055,24,7.27,16862.31,1.0,CUS-51506836,2018-08-12,Richard,M,-27.49,152.99,,e3cf89c5-875e-4d51-a835-ef0e3ecce6dd,-31.43,152.91,NSW,Port Macquarie,debit,authorized,153e7390be0f4449b785df3ac19ef82f,POS,20-30,2018,8,12,17,18,Sunday,31 days,73297.96166666666
ACC-2673069055,24,14.41,16847.9,1.0,CUS-51506836,2018-08-12,Richard,M,-27.49,152.99,,7bd71991-b451-411e-8ec5-ab03fe2e4279,-27.53,152.98,QLD,Sherwood,debit,authorized,d3934005cca048479ad00cd35fcfc359,SALES-POS,20-30,2018,8,12,21,7,Sunday,31 days,73297.96166666666
ACC-2673069055,24,39.0,16808.9,,CUS-51506836,2018-08-13,Richard,M,-27.49,152.99,,,,,,,debit,posted,037f6182313f4f21af7033a8322a53ec,INTER BANK,20-30,2018,8,13,9,0,Monday,31 days,73297.96166666666
ACC-2673069055,24,22.07,16786.83,1.0,CUS-51506836,2018-08-13,Richard,M,-27.49,152.99,,2fd21fb5-17b0-44d5-9f15-1e7eb76f859b,-27.5,153.01,QLD,Saint Lucia,debit,authorized,bc7b121be11d40f7a9a44a9e5d697523,SALES-POS,20-30,2018,8,13,22,44,Monday,31 days,73297.96166666666
ACC-2673069055,24,20.44,16766.39,1.0,CUS-51506836,2018-08-15,Richard,M,-27.49,152.99,,3b4cef6e-7b92-41cb-92cb-2602d25486b6,-37.82,145.03,VIC,Hawthorn,debit,authorized,b842520fa506404684cc3b2fc4d5e9b0,SALES-POS,20-30,2018,8,15,9,1,Wednesday,31 days,73297.96166666666
ACC-2673069055,24,43.0,16707.14,,CUS-51506836,2018-08-17,Richard,M,-27.49,152.99,,,,,,,debit,posted,806fd6f7503d48e58c175c357f799439,PAYMENT,20-30,2018,8,17,3,0,Friday,31 days,73297.96166666666
ACC-2673069055,24,8.92,16698.22,1.0,CUS-51506836,2018-08-17,Richard,M,-27.49,152.99,,8f35974b-2a49-4519-9635-d9c716b1991d,-27.38,153.12,QLD,Brisbane Airport,debit,authorized,7b77512fa7a8420a8dd3a5ca48db3aee,SALES-POS,20-30,2018,8,17,4,25,Friday,31 days,73297.96166666666
ACC-2673069055,24,32.13,16666.09,1.0,CUS-51506836,2018-08-17,Richard,M,-27.49,152.99,,7a3a3af1-2664-4373-b806-a3e579e95194,-26.66,153.1,QLD,Maroochydore,debit,authorized,bcf08d63ec1444ad947926c1da114f63,POS,20-30,2018,8,17,11,46,Friday,31 days,73297.96166666666
ACC-2673069055,24,11.35,16654.74,0.0,CUS-51506836,2018-08-17,Richard,M,-27.49,152.99,,0c9a9567-20b6-4917-8e4e-df4b42940e3f,-27.55,151.93,QLD,Wilsonton,debit,authorized,4a17dd7872054a19bcd14f1bc9cde1d0,POS,20-30,2018,8,17,21,32,Friday,31 days,73297.96166666666
ACC-2673069055,24,12.94,16641.8,1.0,CUS-51506836,2018-08-17,Richard,M,-27.49,152.99,,dd0cc5ff-c82e-4ad9-adf5-b21d7a8b9ae6,-31.48,152.91,NSW,Port Macquarie,debit,authorized,7e35fb3d18b24c2fb825ed643e26666d,POS,20-30,2018,8,17,22,13,Friday,31 days,73297.96166666666
ACC-2673069055,24,5.79,16636.01,0.0,CUS-51506836,2018-08-18,Richard,M,-27.49,152.99,,ece151d2-3e52-4c95-b47c-38cc75b4a517,-33.84,151.21,NSW,North Sydney,debit,authorized,8b79d3b5000c4f53af4071ba66cb39aa,SALES-POS,20-30,2018,8,18,14,29,Saturday,31 days,73297.96166666666
ACC-2673069055,24,23.76,16612.25,1.0,CUS-51506836,2018-08-18,Richard,M,-27.49,152.99,,5a31025d-e6b2-46e6-87c0-6469d76af016,-27.41,153.08,QLD,Brisbane Airport,debit,authorized,559bf655d41e4d03acf93595daffd844,POS,20-30,2018,8,18,17,29,Saturday,31 days,73297.96166666666
ACC-2673069055,24,27.91,16584.34,1.0,CUS-51506836,2018-08-18,Richard,M,-27.49,152.99,,d01c02b1-32c1-4beb-960c-f51390b23d99,-27.42,152.98,QLD,Mitchelton,debit,authorized,f2d97e8ff7894f6399f70072cf74287f,POS,20-30,2018,8,18,20,28,Saturday,31 days,73297.96166666666
ACC-2673069055,24,212.1,16372.24,1.0,CUS-51506836,2018-08-18,Richard,M,-27.49,152.99,,b3e7d34c-43ca-4dfd-bbce-21f1066a1fa2,-27.44,153.07,QLD,Hamilton,debit,authorized,6349e8bfb6574cd0b56205ba46857869,SALES-POS,20-30,2018,8,18,21,52,Saturday,31 days,73297.96166666666
ACC-2673069055,24,14.66,16357.58,0.0,CUS-51506836,2018-08-19,Richard,M,-27.49,152.99,,25896704-b327-4f70-82c6-ea8ed111f509,-27.7,153.21,QLD,Eagleby,debit,authorized,289398df68f2450e8e1c4df9d0007ded,SALES-POS,20-30,2018,8,19,10,52,Sunday,31 days,73297.96166666666
ACC-2673069055,24,31.85,16325.73,0.0,CUS-51506836,2018-08-19,Richard,M,-27.49,152.99,,d8dc9fdd-2ab0-485b-9519-838cdd67649d,-29.72,152.93,NSW,South Grafton,debit,authorized,8066027f22504e9ead2716f5197ddbb4,POS,20-30,2018,8,19,20,26,Sunday,31 days,73297.96166666666
ACC-2673069055,24,19.82,16305.91,1.0,CUS-51506836,2018-08-20,Richard,M,-27.49,152.99,,55e8b3fc-f63b-4d5e-9ff4-2645ae08082d,-27.64,153.24,QLD,Mount Cotton,debit,authorized,d3fa819205b6473abf35fecf7597cc92,POS,20-30,2018,8,20,7,25,Monday,31 days,73297.96166666666
ACC-2673069055,24,39.0,16266.91,,CUS-51506836,2018-08-20,Richard,M,-27.49,152.99,,,,,,,debit,posted,91e8865c57c54ae2999fabb0e41e967e,INTER BANK,20-30,2018,8,20,9,0,Monday,31 days,73297.96166666666
ACC-2673069055,24,14.57,16252.34,1.0,CUS-51506836,2018-08-20,Richard,M,-27.49,152.99,,fa6b4381-10b8-4216-b091-82709cc037fc,-29.62,153.07,NSW,Calliope,debit,authorized,b0a4eb0aaf7f43369bd71679d3c5eae4,POS,20-30,2018,8,20,11,15,Monday,31 days,73297.96166666666
ACC-2673069055,24,14.68,16237.66,1.0,CUS-51506836,2018-08-21,Richard,M,-27.49,152.99,,bcf746b5-7bf5-44fc-934b-9c44540ed213,-27.53,153.27,QLD,Cleveland,debit,authorized,df4ef8af637642a3b18a90223dd02e8b,POS,20-30,2018,8,21,9,43,Tuesday,31 days,73297.96166666666
ACC-2673069055,24,20.77,16216.89,0.0,CUS-51506836,2018-08-22,Richard,M,-27.49,152.99,,424b56bb-e775-4cc4-b8bd-bc5105497b87,-27.5,153.1,QLD,Carindale,debit,authorized,53c1c21f349b47aa815b4d280283d016,POS,20-30,2018,8,22,1,14,Wednesday,31 days,73297.96166666666
ACC-2673069055,24,7.96,16208.93,1.0,CUS-51506836,2018-08-22,Richard,M,-27.49,152.99,,b0a75618-ae5c-4fd4-97af-66f328a0e01c,-27.64,153.13,QLD,Slacks Creek,debit,authorized,2cd4c0babc654533a4a39c4bb965f129,POS,20-30,2018,8,22,9,27,Wednesday,31 days,73297.96166666666
ACC-2673069055,24,3.64,16205.29,1.0,CUS-51506836,2018-08-22,Richard,M,-27.49,152.99,,8f3c4e8a-1ad0-4d1e-92fe-de82441d620d,-27.66,153.04,QLD,Browns Plains,debit,authorized,64d27c4f0b6f4f96a76f0ae392725f69,POS,20-30,2018,8,22,11,27,Wednesday,31 days,73297.96166666666
ACC-2673069055,24,22.89,16182.4,0.0,CUS-51506836,2018-08-22,Richard,M,-27.49,152.99,,86dde4fe-7852-4ea4-856e-46959a0d3796,-27.57,151.97,QLD,Toowoomba,debit,authorized,3f51c2d88785469fb412e40ba14ebd2c,POS,20-30,2018,8,22,12,46,Wednesday,31 days,73297.96166666666
ACC-2673069055,24,70.0,16112.4,,CUS-51506836,2018-08-22,Richard,M,-27.49,152.99,,,,,,,debit,posted,2d1fe5e67726433894d0d7f9c412553a,PAYMENT,20-30,2018,8,22,14,0,Wednesday,31 days,73297.96166666666
ACC-2673069055,24,20.4,16092.0,1.0,CUS-51506836,2018-08-22,Richard,M,-27.49,152.99,,55460e3b-6ab0-4986-bbf4-8077f7e34891,-27.47,153.13,QLD,Tingalpa,debit,authorized,a9b13794bc394ddf8669689531a0c275,POS,20-30,2018,8,22,17,19,Wednesday,31 days,73297.96166666666
ACC-2673069055,24,11.16,16080.84,1.0,CUS-51506836,2018-08-22,Richard,M,-27.49,152.99,,2e61fcfd-9986-4926-bc9e-3977bae5a41b,-27.53,151.96,QLD,Harlaxton,debit,authorized,1fa0a081c5914ce496cc8b481675c9ee,SALES-POS,20-30,2018,8,22,17,41,Wednesday,31 days,73297.96166666666
ACC-2673069055,24,16.02,16064.82,1.0,CUS-51506836,2018-08-22,Richard,M,-27.49,152.99,,a6a51af8-8bb2-44af-acdd-01bbec89e2a3,-27.5,153.04,QLD,Woolloongabba,debit,authorized,e4bd2b560cfd4862b33d41e217da4234,SALES-POS,20-30,2018,8,22,19,58,Wednesday,31 days,73297.96166666666
ACC-2673069055,24,9.63,16055.19,1.0,CUS-51506836,2018-08-23,Richard,M,-27.49,152.99,,95af8bd5-f70e-48de-ae95-311c9949b134,-26.42,153.05,QLD,Noosaville,debit,authorized,c86920edd3cc41a88ed30771342f14c0,POS,20-30,2018,8,23,11,56,Thursday,31 days,73297.96166666666
ACC-2673069055,24,17.09,16038.1,1.0,CUS-51506836,2018-08-23,Richard,M,-27.49,152.99,,00227be5-63f8-4aa3-9008-55d01f9aaec7,-27.72,150.37,QLD,Moonie,debit,authorized,18039854215a4ca3ab8c1f6fca699e60,SALES-POS,20-30,2018,8,23,13,27,Thursday,31 days,73297.96166666666
ACC-2673069055,24,30.41,16007.69,1.0,CUS-51506836,2018-08-23,Richard,M,-27.49,152.99,,37e9c950-5136-4f86-9e9b-1ded5c0c8d5c,-27.43,117.89,WA,Cue,debit,authorized,3e130a3a1b9f41349fbeac6ee1196396,POS,20-30,2018,8,23,17,47,Thursday,31 days,73297.96166666666
ACC-2673069055,24,43.0,15964.69,,CUS-51506836,2018-08-24,Richard,M,-27.49,152.99,,,,,,,debit,posted,fe0d759c8a7d41a7a693389a2c58de70,PAYMENT,20-30,2018,8,24,3,0,Friday,31 days,73297.96166666666
ACC-2673069055,24,19.4,15945.29,1.0,CUS-51506836,2018-08-24,Richard,M,-27.49,152.99,,9d88caf1-1e4b-44e7-a307-14b16c7495a0,-27.47,153.02,QLD,Brisbane City,debit,authorized,7b0bea0759cd445b96a4157ce6bf2743,POS,20-30,2018,8,24,9,45,Friday,31 days,73297.96166666666
ACC-2673069055,24,9.88,15935.41,1.0,CUS-51506836,2018-08-24,Richard,M,-27.49,152.99,,16f87b35-bf91-4632-83c5-b4d9041c7cbe,-27.53,151.93,QLD,Wilsonton Heights,debit,authorized,dee859f895e74331979550db6b8383bb,SALES-POS,20-30,2018,8,24,14,25,Friday,31 days,73297.96166666666
ACC-2673069055,24,10.0,15925.41,1.0,CUS-51506836,2018-08-24,Richard,M,-27.49,152.99,,a3a3d03d-4131-47a1-82ea-d875d9def6a9,-27.46,153.04,QLD,Fortitude Valley,debit,authorized,711be1c38b2e456b8a0fc498c70b79bd,SALES-POS,20-30,2018,8,24,14,52,Friday,31 days,73297.96166666666
ACC-2673069055,24,11.06,15914.35,1.0,CUS-51506836,2018-08-24,Richard,M,-27.49,152.99,,fb435e83-a1cf-417c-b400-3aab3867dbed,-27.56,151.93,QLD,Newtown,debit,authorized,46a98fd464c54f93988ae1851d15a357,POS,20-30,2018,8,24,15,55,Friday,31 days,73297.96166666666
ACC-2673069055,24,45.86,15868.49,0.0,CUS-51506836,2018-08-25,Richard,M,-27.49,152.99,,b099f24e-201c-4242-9016-2cb431c80125,-27.54,152.34,QLD,Gatton,debit,authorized,53135a12f6c7442084f70a300de00162,POS,20-30,2018,8,25,4,41,Saturday,31 days,73297.96166666666
ACC-2673069055,24,11.91,15856.58,1.0,CUS-51506836,2018-08-25,Richard,M,-27.49,152.99,,fb435e83-a1cf-417c-b400-3aab3867dbed,-27.56,151.93,QLD,Newtown,debit,authorized,162f6450d29345c7916ca6aaaaebc7c3,POS,20-30,2018,8,25,9,26,Saturday,31 days,73297.96166666666
ACC-2673069055,24,10.36,15846.22,1.0,CUS-51506836,2018-08-25,Richard,M,-27.49,152.99,,16f87b35-bf91-4632-83c5-b4d9041c7cbe,-27.53,151.93,QLD,Wilsonton Heights,debit,authorized,e92f2e90fa654b4a91ee79235ac7f9e8,POS,20-30,2018,8,25,11,44,Saturday,31 days,73297.96166666666
ACC-2673069055,24,34.18,15812.04,1.0,CUS-51506836,2018-08-25,Richard,M,-27.49,152.99,,617a670e-a706-400a-bbfa-09858d56a871,-26.72,153.06,QLD,Sippy Downs,debit,authorized,e753513ce7ef4a5f92080535face339e,SALES-POS,20-30,2018,8,25,11,52,Saturday,31 days,73297.96166666666
ACC-2673069055,24,18.29,15793.75,1.0,CUS-51506836,2018-08-25,Richard,M,-27.49,152.99,,7b5603a6-fe3d-4f52-8a99-e4e54fbb9da5,-27.5,152.97,QLD,Indooroopilly,debit,authorized,ae81e8dc478043fa8e91d937b17618bc,SALES-POS,20-30,2018,8,25,12,31,Saturday,31 days,73297.96166666666
ACC-2673069055,24,9.53,15784.22,1.0,CUS-51506836,2018-08-26,Richard,M,-27.49,152.99,,1bf290e1-ba37-4715-9f42-513fc26d155f,-27.39,153.04,QLD,Wavell Heights,debit,authorized,54728f593156433bbe9568ab418eb2eb,SALES-POS,20-30,2018,8,26,1,5,Sunday,31 days,73297.96166666666
ACC-2673069055,24,17.97,15766.25,1.0,CUS-51506836,2018-08-26,Richard,M,-27.49,152.99,,bffb6c3a-5dfa-4422-bb30-49c0f9d38c62,-27.41,152.99,QLD,Everton Park,debit,authorized,e3ceed52f26c49e88eca29df9ed33c83,SALES-POS,20-30,2018,8,26,7,45,Sunday,31 days,73297.96166666666
ACC-2673069055,24,39.0,15727.25,,CUS-51506836,2018-08-27,Richard,M,-27.49,152.99,,,,,,,debit,posted,35b6aa7bf552478b90d51d22a899927a,INTER BANK,20-30,2018,8,27,9,0,Monday,31 days,73297.96166666666
ACC-2673069055,24,14.15,15713.1,1.0,CUS-51506836,2018-08-27,Richard,M,-27.49,152.99,,cfa1bc70-2600-4842-bcd7-0443e30bfee4,-27.5,153.05,QLD,Coorparoo,debit,authorized,f4a88f0f663949acac450be29d91251f,POS,20-30,2018,8,27,18,33,Monday,31 days,73297.96166666666
ACC-2673069055,24,19.93,15693.17,1.0,CUS-51506836,2018-08-28,Richard,M,-27.49,152.99,,7cbc7858-b82d-4ba3-884f-be894d456fb2,-27.42,153.06,QLD,Clayfield,debit,authorized,7cd402be84bf449e960526dfe616cdcb,SALES-POS,20-30,2018,8,28,11,9,Tuesday,31 days,73297.96166666666
ACC-2673069055,24,9.28,15683.89,1.0,CUS-51506836,2018-08-28,Richard,M,-27.49,152.99,,0de8b8cd-30e0-4b7f-96e2-7120d692a587,-27.4,153.07,QLD,Nundah,debit,authorized,694992d1090e4416aa3e491fe1f3fcef,SALES-POS,20-30,2018,8,28,11,35,Tuesday,31 days,73297.96166666666
ACC-2673069055,24,11.04,15672.85,1.0,CUS-51506836,2018-08-30,Richard,M,-27.49,152.99,,3ce9c136-7b37-4255-91f2-bab26d1d4baf,-27.53,152.91,QLD,Pullenvale,debit,authorized,c5f522c1a4154a45a1e63136a46706c5,POS,20-30,2018,8,30,14,17,Thursday,31 days,73297.96166666666
ACC-2673069055,24,14.74,15658.11,1.0,CUS-51506836,2018-08-30,Richard,M,-27.49,152.99,,8a0fab50-4efb-41e2-a569-29346eb6c9de,-33.83,151,NSW,Granville,debit,authorized,1b102cbd7cf24d02a6dd19a97596ed2f,POS,20-30,2018,8,30,15,29,Thursday,31 days,73297.96166666666
ACC-2673069055,24,11.65,15646.46,1.0,CUS-51506836,2018-08-30,Richard,M,-27.49,152.99,,236861a5-af94-42a9-aefc-660f30e395fa,-31.44,152.89,NSW,Port Macquarie,debit,authorized,414a5beb42594d7ba711e4c281e48c51,SALES-POS,20-30,2018,8,30,15,55,Thursday,31 days,73297.96166666666
ACC-2673069055,24,131.3,15515.16,0.0,CUS-51506836,2018-08-30,Richard,M,-27.49,152.99,,88a0c51d-a601-4cef-afff-05a07a47343e,-27.55,152.82,QLD,Karana Downs,debit,authorized,25100684d9e44876b96032f4d36aee94,POS,20-30,2018,8,30,17,31,Thursday,31 days,73297.96166666666
ACC-2673069055,24,43.0,15472.16,,CUS-51506836,2018-08-31,Richard,M,-27.49,152.99,,,,,,,debit,posted,5b9b4b6b9aa44e138b0eae7853f38672,PAYMENT,20-30,2018,8,31,3,0,Friday,31 days,73297.96166666666
ACC-2673069055,24,39.0,15433.16,,CUS-51506836,2018-09-03,Richard,M,-27.49,152.99,,,,,,,debit,posted,8c73c21c038740e2b36d7189301963fb,INTER BANK,20-30,2018,9,3,9,0,Monday,31 days,73297.96166666666
ACC-2673069055,24,128.0,15305.16,,CUS-51506836,2018-09-04,Richard,M,-27.49,152.99,,,,,,,debit,posted,ed5457850d974a8bac45aea65ba60b3a,PAYMENT,20-30,2018,9,4,2,0,Tuesday,31 days,73297.96166666666
ACC-2673069055,24,16.03,15289.13,1.0,CUS-51506836,2018-09-04,Richard,M,-27.49,152.99,,2e51bfb2-6d5e-4334-b9ec-e9d878481e8c,-27.58,152.2,QLD,Grantham,debit,authorized,afbaa5d6ef8b4a42a5fbfcc8ea69bcbf,POS,20-30,2018,9,4,8,45,Tuesday,31 days,73297.96166666666
ACC-2673069055,24,21.74,15267.39,0.0,CUS-51506836,2018-09-05,Richard,M,-27.49,152.99,,541ca120-5600-48cd-adca-3e638d2baffb,-27.97,153.41,QLD,Southport,debit,authorized,b104297c85be4ec9909a0b47138e2ff4,POS,20-30,2018,9,5,7,24,Wednesday,31 days,73297.96166666666
ACC-2673069055,24,3.46,15263.93,1.0,CUS-51506836,2018-09-05,Richard,M,-27.49,152.99,,92e29a1f-f88e-4fcd-b89f-a612e66287ba,-27.44,153.15,QLD,Lindum,debit,authorized,6e25d17b4d9e4139a37c07a5d8209330,SALES-POS,20-30,2018,9,5,17,37,Wednesday,31 days,73297.96166666666
ACC-2673069055,24,7.37,15256.56,1.0,CUS-51506836,2018-09-05,Richard,M,-27.49,152.99,,c63ca943-1682-456d-96b4-b4d21a068cf6,-27.74,153.19,QLD,Windaroo,debit,authorized,0fe179dd96e14151b2d6b4693f87fa65,POS,20-30,2018,9,5,20,15,Wednesday,31 days,73297.96166666666
ACC-2673069055,24,14.34,15242.22,1.0,CUS-51506836,2018-09-06,Richard,M,-27.49,152.99,,d0df1c50-3e2d-4903-b195-af050fe93c20,-30.49,153.01,NSW,Urunga,debit,authorized,835650e6ab0d4d6f8475ece3833fff49,POS,20-30,2018,9,6,8,11,Thursday,31 days,73297.96166666666
ACC-2673069055,24,28.26,15213.96,1.0,CUS-51506836,2018-09-06,Richard,M,-27.49,152.99,,4f1edc4f-9913-4ea1-afeb-5fdb411d3f8b,-27.46,153.15,QLD,Wynnum West,debit,authorized,a183a126361b4d45a8568ac8fe19167a,POS,20-30,2018,9,6,19,35,Thursday,31 days,73297.96166666666
ACC-2673069055,24,3.88,15210.08,1.0,CUS-51506836,2018-09-06,Richard,M,-27.49,152.99,,a6174989-3e55-4ea6-99b7-1ccb9de26101,-27.52,152.98,QLD,Graceville,debit,authorized,df255b437cf7423887b51d2698dc643a,POS,20-30,2018,9,6,21,38,Thursday,31 days,73297.96166666666
ACC-2673069055,24,43.0,15167.08,,CUS-51506836,2018-09-07,Richard,M,-27.49,152.99,,,,,,,debit,posted,d818507c9af44d9ca3d15d3f97dd4b5a,PAYMENT,20-30,2018,9,7,3,0,Friday,31 days,73297.96166666666
ACC-2673069055,24,10.69,15156.39,0.0,CUS-51506836,2018-09-07,Richard,M,-27.49,152.99,,6ed40c89-5af3-44db-8a1f-a62ffa19e07b,-27.59,153.28,QLD,Victoria Point,debit,authorized,43fd8513abb84a6e9b2e1ec7d80d0662,SALES-POS,20-30,2018,9,7,4,4,Friday,31 days,73297.96166666666
ACC-2673069055,24,9.22,15147.17,0.0,CUS-51506836,2018-09-07,Richard,M,-27.49,152.99,,62febf9f-1112-46b5-b5f3-87a69dac25a5,-27.48,153.02,QLD,South Brisbane,debit,authorized,30b55cfd02ed4bf99c6815351d674fbe,POS,20-30,2018,9,7,10,6,Friday,31 days,73297.96166666666
ACC-2673069055,24,9.01,15138.16,1.0,CUS-51506836,2018-09-07,Richard,M,-27.49,152.99,,9a03ee73-65a0-4669-a9b0-b77c5a2cf3f7,-27.09,152.95,QLD,Caboolture,debit,authorized,327638409fe742919aaa72b077649460,SALES-POS,20-30,2018,9,7,12,23,Friday,31 days,73297.96166666666
ACC-2673069055,24,4.37,15133.79,1.0,CUS-51506836,2018-09-07,Richard,M,-27.49,152.99,,059be9cb-b858-4a1c-bb45-83bcbecc94a3,-27.5,153.06,QLD,Coorparoo,debit,authorized,eaa62fc3b0d84b819d9e0fd97bf4dd82,SALES-POS,20-30,2018,9,7,14,22,Friday,31 days,73297.96166666666
ACC-2673069055,24,15.11,21143.17,1.0,CUS-51506836,2018-09-07,Richard,M,-27.49,152.99,,d1b05476-e6b1-4e4d-8005-e3e9e7f2006b,-27.52,153.27,QLD,Cleveland,debit,authorized,d5aa88b1597e46b1b3f31d5023815efd,POS,20-30,2018,9,7,16,56,Friday,31 days,73297.96166666666
ACC-2673069055,24,17.42,21125.75,0.0,CUS-51506836,2018-09-07,Richard,M,-27.49,152.99,,52962314-3628-4865-b842-09a3dd1bd853,-27.64,153.15,QLD,Daisy Hill,debit,authorized,a485f1709a714a719e772bea67ddd6c2,POS,20-30,2018,9,7,23,14,Friday,31 days,73297.96166666666
ACC-2673069055,24,24.64,21101.11,1.0,CUS-51506836,2018-09-08,Richard,M,-27.49,152.99,,4c84abf9-fc4b-4246-a35d-7aed75a9547e,-27.61,153.06,QLD,Sunnybank Hills,debit,authorized,a1f2c8925abb4fd49396bbc015006aae,POS,20-30,2018,9,8,12,33,Saturday,31 days,73297.96166666666
ACC-2673069055,24,33.41,21067.7,0.0,CUS-51506836,2018-09-08,Richard,M,-27.49,152.99,,2c2fc391-9300-4fc4-907b-a30ed711f4c9,-27.66,153.05,QLD,Browns Plains,debit,authorized,f446c53b1ee643b8b45ebfb58358164b,SALES-POS,20-30,2018,9,8,15,9,Saturday,31 days,73297.96166666666
ACC-2673069055,24,18.59,21049.11,1.0,CUS-51506836,2018-09-08,Richard,M,-27.49,152.99,,7a57eefe-cbd1-4629-ac0e-722f9ee66fe9,-27.4,153.03,QLD,Kedron,debit,authorized,46b3ec5be964427aacb3a1d1d76c0673,POS,20-30,2018,9,8,21,5,Saturday,31 days,73297.96166666666
ACC-2673069055,24,16.5,21032.61,0.0,CUS-51506836,2018-09-09,Richard,M,-27.49,152.99,,cca1d03d-cafc-45fc-990c-8e800a331916,-27.56,153.08,QLD,Upper Mount Gravatt,debit,authorized,02420d82151a4bad81580afff3d49db8,POS,20-30,2018,9,9,17,43,Sunday,31 days,73297.96166666666
ACC-2673069055,24,11.2,21021.41,1.0,CUS-51506836,2018-09-09,Richard,M,-27.49,152.99,,862c9f46-f64d-4374-83e7-ccd4450a3915,-27.38,153.03,QLD,Chermside,debit,authorized,dd7069afc2f843e58c50b56d05970695,SALES-POS,20-30,2018,9,9,20,48,Sunday,31 days,73297.96166666666
ACC-2673069055,24,6.97,21014.44,1.0,CUS-51506836,2018-09-09,Richard,M,-27.49,152.99,,1abec525-0ba2-432c-a60e-82cb2a7bcb03,-27.57,151.97,QLD,Toowoomba City,debit,authorized,464693df2c724ab18ead59cb2139dae2,POS,20-30,2018,9,9,21,56,Sunday,31 days,73297.96166666666
ACC-2673069055,24,39.0,20975.44,,CUS-51506836,2018-09-10,Richard,M,-27.49,152.99,,,,,,,debit,posted,10b0d96a664442d9ac6b759cf016175e,INTER BANK,20-30,2018,9,10,9,0,Monday,31 days,73297.96166666666
ACC-2673069055,24,16.89,20958.55,0.0,CUS-51506836,2018-09-11,Richard,M,-27.49,152.99,,b0c21608-751b-4534-bf71-87d311a1ba4e,-27.62,152.97,QLD,Forest Lake,debit,authorized,5fe61170595c4a2d8bf471b9a495d9b4,POS,20-30,2018,9,11,0,12,Tuesday,31 days,73297.96166666666
ACC-2673069055,24,5.89,20952.66,1.0,CUS-51506836,2018-09-11,Richard,M,-27.49,152.99,,bf2091e2-83f9-4ead-88c2-31cbd0e770b2,-27.56,152.28,QLD,Gatton,debit,authorized,6f847eb158f24fc1b496de38c9eaac9b,SALES-POS,20-30,2018,9,11,15,19,Tuesday,31 days,73297.96166666666
ACC-2673069055,24,19.75,20932.91,1.0,CUS-51506836,2018-09-11,Richard,M,-27.49,152.99,,ca506b49-b1b7-43f2-b015-af1cf0462b54,-27.58,151.95,QLD,Toowoomba City,debit,authorized,50add58b42744c5ea9ddff57906087ee,POS,20-30,2018,9,11,15,28,Tuesday,31 days,73297.96166666666
ACC-2673069055,24,43.0,20889.91,,CUS-51506836,2018-09-14,Richard,M,-27.49,152.99,,,,,,,debit,posted,b9d87758fba14a0cba8f1612580117b8,PAYMENT,20-30,2018,9,14,3,0,Friday,31 days,73297.96166666666
ACC-2673069055,24,104.9,20785.01,1.0,CUS-51506836,2018-09-14,Richard,M,-27.49,152.99,,0b8fab23-d4fd-45e7-acac-555c96e0b1c7,-33.87,151.2,NSW,Sydney,debit,authorized,72841d9af46d418d941d197c986b426d,SALES-POS,20-30,2018,9,14,10,27,Friday,31 days,73297.96166666666
ACC-2673069055,24,49.94,20735.07,1.0,CUS-51506836,2018-09-14,Richard,M,-27.49,152.99,,6bcca105-4e3d-4ac7-adb3-0d1317a88abb,-37.69,144.88,VIC,Tullamarine,debit,authorized,3f6cc53773dd4b7bab645b3f485c0571,POS,20-30,2018,9,14,18,20,Friday,31 days,73297.96166666666
ACC-2673069055,24,11.45,20723.62,1.0,CUS-51506836,2018-09-14,Richard,M,-27.49,152.99,,76edd368-a120-406d-aac0-16b7e981450f,-27.59,152.92,QLD,Wacol,debit,authorized,8551de9c85334df49ac31c8c43395366,SALES-POS,20-30,2018,9,14,19,30,Friday,31 days,73297.96166666666
ACC-2673069055,24,10.69,20712.93,1.0,CUS-51506836,2018-09-15,Richard,M,-27.49,152.99,,33de11be-d1af-410c-a6ca-e7ff735253f2,-33.91,151.17,NSW,Marrickville,debit,authorized,4fe5ca6ce72542bfb94c4388f58f2308,POS,20-30,2018,9,15,1,30,Saturday,31 days,73297.96166666666
ACC-2673069055,24,50.86,20662.07,1.0,CUS-51506836,2018-09-15,Richard,M,-27.49,152.99,,b755a38f-b8d8-48a4-800a-63db88276e34,-27.55,135.45,SA,Oodnadatta,debit,authorized,67f74a820159459d880093f78f9fc201,POS,20-30,2018,9,15,20,50,Saturday,31 days,73297.96166666666
ACC-2673069055,24,13.81,20648.26,0.0,CUS-51506836,2018-09-16,Richard,M,-27.49,152.99,,a354b8ce-27c0-48c5-bbff-15e1fab5ffd5,-27.49,153.04,QLD,Woolloongabba,debit,authorized,2f8e21e170574f81b753d85d5db65047,POS,20-30,2018,9,16,1,33,Sunday,31 days,73297.96166666666
ACC-2673069055,24,7.31,20640.95,0.0,CUS-51506836,2018-09-16,Richard,M,-27.49,152.99,,d130e4ff-26ff-452c-9b15-e3bf30de9dec,-27.56,151.95,QLD,Toowoomba City,debit,authorized,42a118b1741a4cd3a0b5c24049cce9cc,SALES-POS,20-30,2018,9,16,3,48,Sunday,31 days,73297.96166666666
ACC-2673069055,24,25.15,20615.8,1.0,CUS-51506836,2018-09-16,Richard,M,-27.49,152.99,,c32e6115-9e1a-4bf5-9627-ffbbcc210e53,-27.54,151.95,QLD,Harlaxton,debit,authorized,e79d99e104fa49baabb7b7547bed26fb,SALES-POS,20-30,2018,9,16,12,45,Sunday,31 days,73297.96166666666
ACC-2673069055,24,26.06,20589.74,1.0,CUS-51506836,2018-09-16,Richard,M,-27.49,152.99,,22e0b7e5-bd9f-45c6-a7ad-6f3db34ed52b,-27.55,153.2,QLD,Capalaba,debit,authorized,218acff8316f4405b89abc7278f7d365,SALES-POS,20-30,2018,9,16,17,25,Sunday,31 days,73297.96166666666
ACC-2673069055,24,13.42,20576.32,1.0,CUS-51506836,2018-09-16,Richard,M,-27.49,152.99,,35091d81-268d-4a65-ab8d-9f239ce6eb14,-27.53,152.95,QLD,Jindalee,debit,authorized,8bfc04570db94c9ea8eac48e6a746303,POS,20-30,2018,9,16,18,51,Sunday,31 days,73297.96166666666
ACC-2673069055,24,12.12,20564.2,1.0,CUS-51506836,2018-09-16,Richard,M,-27.49,152.99,,23b2b0fc-6c7f-49f3-929d-a247ae09575b,-27.55,152.28,QLD,Gatton,debit,authorized,f7613d3d49f1432cba2ea9b1e749af5a,POS,20-30,2018,9,16,21,54,Sunday,31 days,73297.96166666666
ACC-2673069055,24,39.0,20525.2,,CUS-51506836,2018-09-17,Richard,M,-27.49,152.99,,,,,,,debit,posted,510e230cadfc4c47b0c4321b2601b2c7,INTER BANK,20-30,2018,9,17,9,0,Monday,31 days,73297.96166666666
ACC-2673069055,24,16.91,20508.29,1.0,CUS-51506836,2018-09-17,Richard,M,-27.49,152.99,,5ad21473-0dd2-400d-a915-1971c1c828d6,-26.4,153.09,QLD,Noosa Heads,debit,authorized,8895d6a773814de18083e436462a192b,POS,20-30,2018,9,17,10,42,Monday,31 days,73297.96166666666
ACC-2673069055,24,6.89,20501.4,1.0,CUS-51506836,2018-09-17,Richard,M,-27.49,152.99,,08026e5f-d940-4773-b670-8c08f26bddd9,-27.74,153.22,QLD,Yatala,debit,authorized,7255881f2700406f8811b102fdd55747,SALES-POS,20-30,2018,9,17,19,17,Monday,31 days,73297.96166666666
ACC-2673069055,24,39.59,20461.81,1.0,CUS-51506836,2018-09-18,Richard,M,-27.49,152.99,,7e4c128c-110a-45ad-b13d-e8a18b81eef3,-27.41,153.08,QLD,Brisbane Airport,debit,authorized,3c62a73061e942beaa3a3f3fd415a713,SALES-POS,20-30,2018,9,18,15,41,Tuesday,31 days,73297.96166666666
ACC-2673069055,24,1910.0,18540.0,,CUS-51506836,2018-09-18,Richard,M,-27.49,152.99,,,,,,,debit,posted,dd001442f6fc4d86a411222e9f447b5a,INTER BANK,20-30,2018,9,18,20,0,Tuesday,31 days,73297.96166666666
ACC-2673069055,24,11.81,20450.0,0.0,CUS-51506836,2018-09-18,Richard,M,-27.49,152.99,,a6709743-af53-4d35-a5ae-d529b9ad399d,-33.86,151.21,NSW,Sydney,debit,authorized,3e20eaab52454754abe577a127e8927e,SALES-POS,20-30,2018,9,18,20,21,Tuesday,31 days,73297.96166666666
ACC-2673069055,24,8.93,18531.07,1.0,CUS-51506836,2018-09-19,Richard,M,-27.49,152.99,,206e9f71-0576-48fd-8b88-0cd72191ef67,-27.48,153.02,QLD,South Brisbane,debit,authorized,c1fa47ab94e1459099f56df50fb5f2ab,SALES-POS,20-30,2018,9,19,1,15,Wednesday,31 days,73297.96166666666
ACC-2673069055,24,16.8,18514.27,1.0,CUS-51506836,2018-09-19,Richard,M,-27.49,152.99,,b0367e17-47cc-4360-a8ca-62f8eb43fa8b,-27.51,152.94,QLD,Kenmore,debit,authorized,f05807d65fdd476a95cfca10ac4d73f2,SALES-POS,20-30,2018,9,19,11,8,Wednesday,31 days,73297.96166666666
ACC-2673069055,24,15.57,18498.7,1.0,CUS-51506836,2018-09-19,Richard,M,-27.49,152.99,,7ddd2b1f-49e4-47db-a51a-63fc7ac38817,-27.59,153.06,QLD,Sunnybank Hills,debit,authorized,3594dcbf6a2a446b8525096c1fd01e89,POS,20-30,2018,9,19,13,48,Wednesday,31 days,73297.96166666666
ACC-2673069055,24,5.52,18493.18,1.0,CUS-51506836,2018-09-19,Richard,M,-27.49,152.99,,c6e24dac-a68f-4db8-9c3c-33d2ebd86f22,-27.42,153.04,QLD,Kedron,debit,authorized,87869539cb4e40998af6e5fb022a17b3,SALES-POS,20-30,2018,9,19,14,43,Wednesday,31 days,73297.96166666666
ACC-2673069055,24,9.01,18484.17,1.0,CUS-51506836,2018-09-19,Richard,M,-27.49,152.99,,1bb56657-3576-4e98-bd10-203c737f1e3b,-27.57,151.96,QLD,Toowoomba City,debit,authorized,b74d1af71cfb4c329238b1c577374f8e,POS,20-30,2018,9,19,15,42,Wednesday,31 days,73297.96166666666
ACC-2673069055,24,34.81,18449.36,1.0,CUS-51506836,2018-09-19,Richard,M,-27.49,152.99,,15d424a4-9e07-4397-9b44-5e51cf7f0445,-33.92,151.19,NSW,Alexandria,debit,authorized,d42c314a1ad44da78231517d37342e77,SALES-POS,20-30,2018,9,19,17,9,Wednesday,31 days,73297.96166666666
ACC-2673069055,24,123.74,18325.62,1.0,CUS-51506836,2018-09-20,Richard,M,-27.49,152.99,,5375b001-92ed-4d0d-880d-e1703ca3bb05,-27.54,153.01,QLD,Rocklea,debit,authorized,d1597b33b08e4affbc4d7d3edec7253e,SALES-POS,20-30,2018,9,20,0,8,Thursday,31 days,73297.96166666666
ACC-2673069055,24,43.0,18282.62,,CUS-51506836,2018-09-21,Richard,M,-27.49,152.99,,,,,,,debit,posted,96236c206813457fa9dc486b7f107e39,PAYMENT,20-30,2018,9,21,3,0,Friday,31 days,73297.96166666666
ACC-2673069055,24,17.07,18265.55,1.0,CUS-51506836,2018-09-21,Richard,M,-27.49,152.99,,9f373ff3-b14b-4b51-ade4-c361bcd5499d,-26.39,153.09,QLD,Noosa Heads,debit,authorized,9dcabf179d964a4ca6d397633749b884,SALES-POS,20-30,2018,9,21,22,41,Friday,31 days,73297.96166666666
ACC-2673069055,24,23.5,18242.05,1.0,CUS-51506836,2018-09-22,Richard,M,-27.49,152.99,,51e6a9c9-fd75-49fb-b774-2ce12042bbdc,-27.59,153.28,QLD,Victoria Point,debit,authorized,574809a14a8f4d05b8aab45d54fe639c,SALES-POS,20-30,2018,9,22,9,36,Saturday,31 days,73297.96166666666
ACC-2673069055,24,23.02,18219.03,1.0,CUS-51506836,2018-09-22,Richard,M,-27.49,152.99,,3537d391-1906-4e29-ac70-130997ca8438,-30.32,153.09,NSW,Coffs Harbour,debit,authorized,358c1da36f2a41ba9df9bbaa889e54ea,SALES-POS,20-30,2018,9,22,10,28,Saturday,31 days,73297.96166666666
ACC-2673069055,24,5.48,18213.55,1.0,CUS-51506836,2018-09-22,Richard,M,-27.49,152.99,,b0a6a7f9-b9c9-45b3-ac1b-eaf2e65a141c,-27.71,114.17,WA,Kalbarri,debit,authorized,0b453e29a3a94d8bb6e61bfea4fdf4da,POS,20-30,2018,9,22,10,50,Saturday,31 days,73297.96166666666
ACC-2673069055,24,6.08,18207.47,1.0,CUS-51506836,2018-09-22,Richard,M,-27.49,152.99,,6e17103e-29c5-454a-b437-ef36efb7afda,-27.46,153.03,QLD,Brisbane,debit,authorized,c8b182d8db704d47834e94222828c9a8,SALES-POS,20-30,2018,9,22,11,31,Saturday,31 days,73297.96166666666
ACC-2673069055,24,70.0,18137.47,,CUS-51506836,2018-09-22,Richard,M,-27.49,152.99,,,,,,,debit,posted,59280990c3e8490bbbf712c8c5f932d2,PAYMENT,20-30,2018,9,22,14,0,Saturday,31 days,73297.96166666666
ACC-2673069055,24,18.74,18118.73,0.0,CUS-51506836,2018-09-22,Richard,M,-27.49,152.99,,f39e8c3c-b44b-4879-8087-ca556de62378,-27.68,153.18,QLD,Tanah Merah,debit,authorized,6a11325e862c4f9ab14fe8a5d93bad87,POS,20-30,2018,9,22,20,30,Saturday,31 days,73297.96166666666
ACC-2673069055,24,29.57,18089.16,0.0,CUS-51506836,2018-09-22,Richard,M,-27.49,152.99,,84b99c77-74ea-4ca7-862c-127b2c813493,-27.63,153.03,QLD,Parkinson,debit,authorized,81745882ded14074a263cb32ab5a5eab,POS,20-30,2018,9,22,23,12,Saturday,31 days,73297.96166666666
ACC-2673069055,24,6.53,18082.63,1.0,CUS-51506836,2018-09-23,Richard,M,-27.49,152.99,,bd4a986f-fe5b-4cf2-8a2c-df8d0b1b86dc,-27.69,152.65,QLD,Willowbank,debit,authorized,3220f2688d72483fa3f61ee609f2b99b,POS,20-30,2018,9,23,9,30,Sunday,31 days,73297.96166666666
ACC-2673069055,24,27.26,18055.37,1.0,CUS-51506836,2018-09-23,Richard,M,-27.49,152.99,,b197bdf9-bdde-4297-bffa-199eca0733f0,-27.56,151.93,QLD,Newtown,debit,authorized,e3be18bf297845c0ba7e1ea869e34593,SALES-POS,20-30,2018,9,23,11,3,Sunday,31 days,73297.96166666666
ACC-2673069055,24,18.17,18037.2,0.0,CUS-51506836,2018-09-23,Richard,M,-27.49,152.99,,b84df009-03e4-413e-9368-f02a72a2d757,-27.41,152.97,QLD,Mitchelton,debit,authorized,31f26e0616364c9ab941d129e18cb120,POS,20-30,2018,9,23,20,18,Sunday,31 days,73297.96166666666
ACC-2673069055,24,19.5,18017.7,1.0,CUS-51506836,2018-09-23,Richard,M,-27.49,152.99,,7cbc7858-b82d-4ba3-884f-be894d456fb2,-27.42,153.06,QLD,Clayfield,debit,authorized,109fbddca1f54320b212446fb7866c1e,POS,20-30,2018,9,23,22,27,Sunday,31 days,73297.96166666666
ACC-2673069055,24,39.0,17978.7,,CUS-51506836,2018-09-24,Richard,M,-27.49,152.99,,,,,,,debit,posted,8e8d08c4ab49417ea0a8b416585e51f0,INTER BANK,20-30,2018,9,24,9,0,Monday,31 days,73297.96166666666
ACC-2673069055,24,5.54,17973.16,1.0,CUS-51506836,2018-09-24,Richard,M,-27.49,152.99,,309da780-04f7-4354-8d93-bc5a9831c506,-27.47,153.02,QLD,Brisbane City,debit,authorized,ad10f19b929f4266b61be29b6443c245,POS,20-30,2018,9,24,10,23,Monday,31 days,73297.96166666666
ACC-2673069055,24,16.03,17957.13,1.0,CUS-51506836,2018-09-24,Richard,M,-27.49,152.99,,b61c0a70-e9d7-4424-b5c3-af399a1e0147,-27.66,153.04,QLD,Browns Plains,debit,authorized,8bbbcc5d05364090b1c6e132e6e01448,POS,20-30,2018,9,24,13,3,Monday,31 days,73297.96166666666
ACC-2673069055,24,17.56,17939.57,1.0,CUS-51506836,2018-09-26,Richard,M,-27.49,152.99,,b2446f5c-2219-470c-a5df-e1ec9a898941,-33.9,151.1,NSW,Croydon Park,debit,authorized,4c9f480dc73949269e91e11dd529a89d,POS,20-30,2018,9,26,4,22,Wednesday,31 days,73297.96166666666
ACC-2673069055,24,12.39,17927.18,1.0,CUS-51506836,2018-09-26,Richard,M,-27.49,152.99,,11eb61c3-16bc-41c3-a082-866f774d5e57,-27.38,153.02,QLD,Chermside,debit,authorized,df490567341b422bbd2a266e5399c0e1,POS,20-30,2018,9,26,9,46,Wednesday,31 days,73297.96166666666
ACC-2673069055,24,14.25,17912.93,0.0,CUS-51506836,2018-09-26,Richard,M,-27.49,152.99,,417c3cbc-7467-44a8-a6d1-0abd6f4f9472,-27.4,153.03,QLD,Kedron,debit,authorized,8c2a40df9a794a33a8e0d5335774c736,POS,20-30,2018,9,26,17,52,Wednesday,31 days,73297.96166666666
ACC-2673069055,24,79.66,17833.27,1.0,CUS-51506836,2018-09-26,Richard,M,-27.49,152.99,,0101c0d9-6a4b-4dbd-9f59-91e376d584bb,-31.87,115.82,WA,Balcatta,debit,authorized,cf88b25982bf4b69912b20b49bdd9923,POS,20-30,2018,9,26,19,26,Wednesday,31 days,73297.96166666666
ACC-2673069055,24,7.71,17825.56,1.0,CUS-51506836,2018-09-27,Richard,M,-27.49,152.99,,df271e23-5dfa-4d26-9a47-ed2441cdee3a,-27.56,151.95,QLD,Toowoomba City,debit,authorized,fd1fba2ee85f4971a06425050365335f,SALES-POS,20-30,2018,9,27,16,21,Thursday,31 days,73297.96166666666
ACC-2673069055,24,43.0,17782.56,,CUS-51506836,2018-09-28,Richard,M,-27.49,152.99,,,,,,,debit,posted,7f26be210bb5438f86b8c05736a20588,PAYMENT,20-30,2018,9,28,3,0,Friday,31 days,73297.96166666666
ACC-2673069055,24,107.15,17675.41,1.0,CUS-51506836,2018-09-29,Richard,M,-27.49,152.99,,f82e6e6e-13a2-42e4-9b36-ee31e951e54e,-33.76,151.26,NSW,Brookvale,debit,authorized,8d95cb2dff8b4fd2b11caf2d08482986,POS,20-30,2018,9,29,17,25,Saturday,31 days,73297.96166666666
ACC-2673069055,24,20.39,17655.02,1.0,CUS-51506836,2018-09-30,Richard,M,-27.49,152.99,,85f205ca-dc6b-43f4-b081-859a27457643,-31.86,115.81,WA,Balcatta,debit,authorized,2ab2f6caaf274f8e864bcc37fa7ddaa4,SALES-POS,20-30,2018,9,30,2,20,Sunday,31 days,73297.96166666666
ACC-2673069055,24,17.12,17637.9,1.0,CUS-51506836,2018-09-30,Richard,M,-27.49,152.99,,18411a26-e323-46a4-ae87-3434a1983f5e,-27.79,153.25,QLD,Ormeau,debit,authorized,9342c84c62d244b48f7b13cf97979459,SALES-POS,20-30,2018,9,30,10,42,Sunday,31 days,73297.96166666666
ACC-2673069055,24,39.0,17598.9,,CUS-51506836,2018-10-01,Richard,M,-27.49,152.99,,,,,,,debit,posted,ea39d3ea66f54e6f8ae2c64d46358f80,INTER BANK,20-30,2018,10,1,9,0,Monday,31 days,73297.96166666666
ACC-2673069055,24,31.12,17567.78,1.0,CUS-51506836,2018-10-01,Richard,M,-27.49,152.99,,8661f284-7bee-4946-9299-653adcae8c09,-27.48,153.02,QLD,South Brisbane,debit,authorized,d48c3dbbe8a14286a150b7e5f152e5dc,SALES-POS,20-30,2018,10,1,10,40,Monday,31 days,73297.96166666666
ACC-2673069055,24,17.35,17550.43,1.0,CUS-51506836,2018-10-01,Richard,M,-27.49,152.99,,9f1d4304-e450-4d61-a214-0ed98ea70355,-27.66,153.05,QLD,Browns Plains,debit,authorized,cc47c4b329ae4a9ba13803455530a096,SALES-POS,20-30,2018,10,1,14,43,Monday,31 days,73297.96166666666
ACC-2673069055,24,8.9,17541.53,0.0,CUS-51506836,2018-10-02,Richard,M,-27.49,152.99,,6d74b491-0d92-43aa-af11-8b28388c9f40,-27.55,153.09,QLD,Upper Mount Gravatt,debit,authorized,99122a823e38416eb719f373bb975a1e,SALES-POS,20-30,2018,10,2,2,37,Tuesday,31 days,73297.96166666666
ACC-2673069055,24,10.77,17530.76,0.0,CUS-51506836,2018-10-02,Richard,M,-27.49,152.99,,43608856-b248-4100-9582-db1c1d48aa32,-27.56,153.08,QLD,Upper Mount Gravatt,debit,authorized,6e18e27bab474c92ba3f16465d487884,POS,20-30,2018,10,2,9,17,Tuesday,31 days,73297.96166666666
ACC-2673069055,24,9.78,17520.98,0.0,CUS-51506836,2018-10-02,Richard,M,-27.49,152.99,,c4fbec1e-bff1-430a-af2c-f0b8b95df036,-27.47,153.02,QLD,South Brisbane,debit,authorized,b1c6c15970934788848ff309d97c02c9,SALES-POS,20-30,2018,10,2,9,35,Tuesday,31 days,73297.96166666666
ACC-2673069055,24,36.35,17484.63,1.0,CUS-51506836,2018-10-02,Richard,M,-27.49,152.99,,680180ca-5735-4548-a19b-82f068a578b8,-27.47,153.01,QLD,Milton,debit,authorized,bc459913370b4456a73b29846f371595,SALES-POS,20-30,2018,10,2,11,29,Tuesday,31 days,73297.96166666666
ACC-2673069055,24,17.69,17466.94,1.0,CUS-51506836,2018-10-02,Richard,M,-27.49,152.99,,8db6dde0-a3d6-4d6a-87bb-7425b26197c9,-27.65,153.11,QLD,Kingston,debit,authorized,1a4f58f185c346e0935a36a80596ceb2,POS,20-30,2018,10,2,15,33,Tuesday,31 days,73297.96166666666
ACC-2673069055,24,24.4,17442.54,1.0,CUS-51506836,2018-10-03,Richard,M,-27.49,152.99,,37fa12f2-a913-46c0-9946-c3e40636d1d9,-27.6,153.12,QLD,Rochedale,debit,authorized,16b4f2c3afb048fe9266268036cba6b1,SALES-POS,20-30,2018,10,3,6,9,Wednesday,31 days,73297.96166666666
ACC-2673069055,24,5.81,17436.73,1.0,CUS-51506836,2018-10-03,Richard,M,-27.49,152.99,,732f50f3-d5c4-403a-89d1-6d819eb258e2,-27.46,153.07,QLD,Morningside,debit,authorized,eca954be31594013b8ec55b88cdb38ef,SALES-POS,20-30,2018,10,3,9,31,Wednesday,31 days,73297.96166666666
ACC-2673069055,24,12.8,17423.93,0.0,CUS-51506836,2018-10-03,Richard,M,-27.49,152.99,,6cceaaa5-2cb2-4f71-95af-9aea4fbce0b5,-27.48,152.99,QLD,Toowong,debit,authorized,b1747528cc004d73a636b13d48793e68,POS,20-30,2018,10,3,19,58,Wednesday,31 days,73297.96166666666
ACC-2673069055,24,128.0,17295.93,,CUS-51506836,2018-10-04,Richard,M,-27.49,152.99,,,,,,,debit,posted,4e3e3a8b02194348a33f8e96de320891,PAYMENT,20-30,2018,10,4,2,0,Thursday,31 days,73297.96166666666
ACC-2673069055,24,31.35,17264.58,1.0,CUS-51506836,2018-10-04,Richard,M,-27.49,152.99,,7607258f-b7da-4d2b-ad62-7ae67fedef28,-27.62,153.12,QLD,Slacks Creek,debit,authorized,cd1a8a0a607e4acc95360f0fdea685ca,SALES-POS,20-30,2018,10,4,9,22,Thursday,31 days,73297.96166666666
ACC-2673069055,24,43.0,17221.58,,CUS-51506836,2018-10-05,Richard,M,-27.49,152.99,,,,,,,debit,posted,c8a5fd20f4ef459e922bd9bafe30c424,PAYMENT,20-30,2018,10,5,3,0,Friday,31 days,73297.96166666666
ACC-2673069055,24,12.13,17209.45,1.0,CUS-51506836,2018-10-05,Richard,M,-27.49,152.99,,d5291717-d6fe-438f-be37-7bc8a98d06c4,-27.72,153.2,QLD,Beenleigh,debit,authorized,1034f69cf93c4fd385201825e3e90b86,POS,20-30,2018,10,5,17,23,Friday,31 days,73297.96166666666
ACC-2673069055,24,25.24,17184.21,1.0,CUS-51506836,2018-10-05,Richard,M,-27.49,152.99,,5f4a814a-7e39-42da-9f2b-8bd8ec4a8368,-27.54,151.95,QLD,Harlaxton,debit,authorized,ccf80bd5fa8c415a989bbc28cc451003,SALES-POS,20-30,2018,10,5,23,18,Friday,31 days,73297.96166666666
ACC-2673069055,24,12.74,17171.47,0.0,CUS-51506836,2018-10-06,Richard,M,-27.49,152.99,,beedd5f7-1c68-42f7-9b18-1363b6a893fd,-27.66,153.17,QLD,Loganholme,debit,authorized,6d4abc17b5cf4de2976ded5a7cbd9305,SALES-POS,20-30,2018,10,6,4,13,Saturday,31 days,73297.96166666666
ACC-2673069055,24,40.64,17130.83,1.0,CUS-51506836,2018-10-06,Richard,M,-27.49,152.99,,51c48fe8-7f8d-4b1d-9c51-a76202af058f,-27.56,151.95,QLD,Toowoomba City,debit,authorized,f7dc00036fb440749701e3b7859d1751,SALES-POS,20-30,2018,10,6,11,53,Saturday,31 days,73297.96166666666
ACC-2673069055,24,20.61,17110.22,1.0,CUS-51506836,2018-10-06,Richard,M,-27.49,152.99,,105dadbb-cfaa-4e9d-a7e3-2466be9f3fcd,-27.51,152.95,QLD,Kenmore,debit,authorized,a44f83a2cd094d54b74bcf70305fbe25,SALES-POS,20-30,2018,10,6,14,18,Saturday,31 days,73297.96166666666
ACC-2673069055,24,21.0,17089.22,1.0,CUS-51506836,2018-10-06,Richard,M,-27.49,152.99,,323277c2-a17f-4c88-97a5-5c120e3e07fd,-27.4,152.96,QLD,Arana Hills,debit,authorized,3d537b64388d4243956058531571977b,SALES-POS,20-30,2018,10,6,14,43,Saturday,31 days,73297.96166666666
ACC-2673069055,24,1142.25,15946.97,1.0,CUS-51506836,2018-10-06,Richard,M,-27.49,152.99,,04c60c34-c302-4a70-83a7-cf3a70d8a106,-27.53,153.07,QLD,Mount Gravatt,debit,authorized,c1c6cf3a95ae48a6b512a1f646b40b15,POS,20-30,2018,10,6,15,45,Saturday,31 days,73297.96166666666
ACC-2673069055,24,84.82,15862.15,1.0,CUS-51506836,2018-10-06,Richard,M,-27.49,152.99,,8fa7c1a9-28e3-4b02-92ef-58510a010425,-27.46,153.04,QLD,Fortitude Valley,debit,authorized,546257e7215c4402b5896e62d7ce7225,SALES-POS,20-30,2018,10,6,16,29,Saturday,31 days,73297.96166666666
ACC-2673069055,24,21.24,15840.91,1.0,CUS-51506836,2018-10-07,Richard,M,-27.49,152.99,,55460e3b-6ab0-4986-bbf4-8077f7e34891,-27.47,153.13,QLD,Tingalpa,debit,authorized,f9a0a8aa35b540dc871c6ea036e9edac,POS,20-30,2018,10,7,2,51,Sunday,31 days,73297.96166666666
ACC-2673069055,24,5.87,15835.04,1.0,CUS-51506836,2018-10-07,Richard,M,-27.49,152.99,,4c71f1fb-c2fc-433b-a67c-59a60b308f28,-27.56,153.08,QLD,Upper Mount Gravatt,debit,authorized,d1639482f42444f38856bcff5e921078,POS,20-30,2018,10,7,9,55,Sunday,31 days,73297.96166666666
ACC-2673069055,24,58.8,15776.24,1.0,CUS-51506836,2018-10-07,Richard,M,-27.49,152.99,,52fbd408-cc03-440b-80cd-cb859ad092a3,-37.82,144.91,VIC,Port Melbourne,debit,authorized,4337ae2817ba409a90a93154eef05c7c,SALES-POS,20-30,2018,10,7,10,24,Sunday,31 days,73297.96166666666
ACC-2673069055,24,76.39,15699.85,1.0,CUS-51506836,2018-10-07,Richard,M,-27.49,152.99,,bcc8035c-6300-4953-b19d-ca2ec063162b,-37.84,144.96,VIC,South Melbourne,debit,authorized,98ea3292f6164cfe92ec75f4691896c6,SALES-POS,20-30,2018,10,7,17,43,Sunday,31 days,73297.96166666666
ACC-2673069055,24,39.0,15660.85,,CUS-51506836,2018-10-08,Richard,M,-27.49,152.99,,,,,,,debit,posted,9d782849ec3c490c938e8a7efd225ebc,INTER BANK,20-30,2018,10,8,9,0,Monday,31 days,73297.96166666666
ACC-2673069055,24,21.18,15639.67,1.0,CUS-51506836,2018-10-08,Richard,M,-27.49,152.99,,870eac62-f333-4db6-9c4d-97d6fc06af9c,-26.26,152.88,QLD,Kin Kin,debit,authorized,214b408cd77140e590713959212f2e01,SALES-POS,20-30,2018,10,8,22,37,Monday,31 days,73297.96166666666
ACC-2673069055,24,25.48,15614.19,1.0,CUS-51506836,2018-10-09,Richard,M,-27.49,152.99,,22e0b7e5-bd9f-45c6-a7ad-6f3db34ed52b,-27.55,153.2,QLD,Capalaba,debit,authorized,db4b578231e04b4c807d08d4e4054544,POS,20-30,2018,10,9,7,27,Tuesday,31 days,73297.96166666666
ACC-2673069055,24,33.56,15580.63,1.0,CUS-51506836,2018-10-09,Richard,M,-27.49,152.99,,165ae310-aa9e-43b6-b875-f996db6586bd,-27.47,153.03,QLD,Brisbane City,debit,authorized,feca4eaa555246ca9bb3ccb2537cae50,POS,20-30,2018,10,9,18,24,Tuesday,31 days,73297.96166666666
ACC-2673069055,24,25.91,15554.72,1.0,CUS-51506836,2018-10-10,Richard,M,-27.49,152.99,,1c3901a3-31c3-4bd4-b15c-5538a75ee589,-27.67,153.03,QLD,Regents Park,debit,authorized,52b24667659949008c41a4aa083c9cf9,SALES-POS,20-30,2018,10,10,9,45,Wednesday,31 days,73297.96166666666
ACC-2673069055,24,5.71,15549.01,1.0,CUS-51506836,2018-10-11,Richard,M,-27.49,152.99,,6a5cfd5a-8ae2-432f-a9f3-01a36b12db62,-27.46,153.01,QLD,Milton,debit,authorized,a69b13a920eb46baabeb735476b41b59,SALES-POS,20-30,2018,10,11,15,46,Thursday,31 days,73297.96166666666
ACC-2673069055,24,43.0,15506.01,,CUS-51506836,2018-10-12,Richard,M,-27.49,152.99,,,,,,,debit,posted,4de99956579d467fad8f9d94f1482329,PAYMENT,20-30,2018,10,12,3,0,Friday,31 days,73297.96166666666
ACC-2673069055,24,19.27,15486.74,1.0,CUS-51506836,2018-10-12,Richard,M,-27.49,152.99,,79ff0b27-1f9a-4111-9f78-76d9d86609ab,-27.45,151.94,QLD,Highfields,debit,authorized,19da4ac959004658a33b727fda5211b3,POS,20-30,2018,10,12,5,27,Friday,31 days,73297.96166666666
ACC-2673069055,24,10.96,15475.78,1.0,CUS-51506836,2018-10-12,Richard,M,-27.49,152.99,,a29bb976-b297-4ddd-9f2c-2283fa4a4e3c,-27.56,152.28,QLD,Gatton,debit,authorized,3e474136d4b54340a494e0500db40278,SALES-POS,20-30,2018,10,12,11,53,Friday,31 days,73297.96166666666
ACC-2673069055,24,31.95,15443.83,1.0,CUS-51506836,2018-10-13,Richard,M,-27.49,152.99,,2c2fc391-9300-4fc4-907b-a30ed711f4c9,-27.66,153.05,QLD,Browns Plains,debit,authorized,746af3cbaff44fb59509f47134491de0,SALES-POS,20-30,2018,10,13,8,54,Saturday,31 days,73297.96166666666
ACC-2673069055,24,35.73,15408.1,1.0,CUS-51506836,2018-10-13,Richard,M,-27.49,152.99,,e4e8d16b-e81c-48c5-8164-d6aa85aa746d,-27.19,153.03,QLD,Deception Bay,debit,authorized,192fd0cdaeb24ca6a993bb75a055795e,SALES-POS,20-30,2018,10,13,15,21,Saturday,31 days,73297.96166666666
ACC-2673069055,24,8.82,15399.28,1.0,CUS-51506836,2018-10-13,Richard,M,-27.49,152.99,,9b9d10fe-0f09-45c3-9369-6c41ef328689,-27.49,153.01,QLD,West End,debit,authorized,094fa2c8b80845e598d7df930cc67f78,SALES-POS,20-30,2018,10,13,21,23,Saturday,31 days,73297.96166666666
ACC-2673069055,24,13.25,15386.03,1.0,CUS-51506836,2018-10-14,Richard,M,-27.49,152.99,,ac40cd87-00ca-438f-ac36-14401d17aedb,-27.26,153.08,QLD,Clontarf,debit,authorized,e1b818a69f904e4d90e1ae3c57abe187,POS,20-30,2018,10,14,1,40,Sunday,31 days,73297.96166666666
ACC-2673069055,24,15.19,15370.84,0.0,CUS-51506836,2018-10-14,Richard,M,-27.49,152.99,,e5728470-bf30-4467-86cf-33bf03578de1,-27.56,152.28,QLD,Gatton,debit,authorized,9fbed680bd7c4b5998fa7028aea221dc,SALES-POS,20-30,2018,10,14,20,9,Sunday,31 days,73297.96166666666
ACC-2673069055,24,39.0,15331.84,,CUS-51506836,2018-10-15,Richard,M,-27.49,152.99,,,,,,,debit,posted,383eb821916e440ebc017740551ec564,INTER BANK,20-30,2018,10,15,9,0,Monday,31 days,73297.96166666666
ACC-2673069055,24,47.26,15284.58,0.0,CUS-51506836,2018-10-16,Richard,M,-27.49,152.99,,2d3f9099-eb95-48d7-8e34-ef4c4f1e492b,-37.83,144.99,VIC,Cremorne,debit,authorized,4a6fe2bb644e4b79ba21900cc6f7a68b,SALES-POS,20-30,2018,10,16,9,16,Tuesday,31 days,73297.96166666666
ACC-2673069055,24,44.18,15240.4,1.0,CUS-51506836,2018-10-16,Richard,M,-27.49,152.99,,d5a06bfa-b121-4870-a904-4693e09b6c8a,-31.46,152.92,NSW,Port Macquarie,debit,authorized,4e0056ab1d304d238ae5086e72ba170b,SALES-POS,20-30,2018,10,16,10,52,Tuesday,31 days,73297.96166666666
ACC-2673069055,24,16.7,15223.7,1.0,CUS-51506836,2018-10-17,Richard,M,-27.49,152.99,,509e8d7a-013c-41ec-a2a9-06b5bc7bb487,-27.58,152.98,QLD,Oxley,debit,authorized,71056574727a45e1854a92e70ce34427,POS,20-30,2018,10,17,9,18,Wednesday,31 days,73297.96166666666
ACC-2673069055,24,10.08,15213.62,1.0,CUS-51506836,2018-10-17,Richard,M,-27.49,152.99,,8a98b3ba-f15c-43d6-b9a0-b7cc310e0dba,-27.49,153.17,QLD,Wakerley,debit,authorized,a973e495d5104115b82ea4a371e294e3,POS,20-30,2018,10,17,11,16,Wednesday,31 days,73297.96166666666
ACC-2673069055,24,26.58,15187.04,1.0,CUS-51506836,2018-10-17,Richard,M,-27.49,152.99,,2b36e3f1-d074-41a3-999d-cc85dc51e204,-27.56,151.96,QLD,Toowoomba City,debit,authorized,61b8515db4e644cbb32b3d8c18db6525,SALES-POS,20-30,2018,10,17,17,51,Wednesday,31 days,73297.96166666666
ACC-2673069055,24,5.71,15181.33,1.0,CUS-51506836,2018-10-17,Richard,M,-27.49,152.99,,6019efb6-f6a7-402c-9ea1-b398ef4d98d1,-27.57,153.21,QLD,Sheldon,debit,authorized,906ef075b2d141c4accd32d8bade80a9,SALES-POS,20-30,2018,10,17,19,14,Wednesday,31 days,73297.96166666666
ACC-2673069055,24,8.81,15172.52,1.0,CUS-51506836,2018-10-17,Richard,M,-27.49,152.99,,3570d574-09fc-4fbf-a9c3-83e5c1324b0a,-27.66,153.04,QLD,Browns Plains,debit,authorized,5108618578e04ac687fb27deffc0db63,SALES-POS,20-30,2018,10,17,21,1,Wednesday,31 days,73297.96166666666
ACC-2673069055,24,15.19,15157.33,1.0,CUS-51506836,2018-10-18,Richard,M,-27.49,152.99,,2a8e2076-2601-4655-9e6e-3f2c53b88756,-26.69,152.96,QLD,Palmwoods,debit,authorized,d69c469c2af740db96b04947c0c6a7d5,POS,20-30,2018,10,18,10,0,Thursday,31 days,73297.96166666666
ACC-2673069055,24,34.66,15122.67,1.0,CUS-51506836,2018-10-18,Richard,M,-27.49,152.99,,86c9064d-0486-4ca1-93d2-66d62243c1d0,-33.85,151.07,NSW,Sydney Olympic Park,debit,authorized,3de4371c359e43fa9321cf44d588adc2,SALES-POS,20-30,2018,10,18,11,59,Thursday,31 days,73297.96166666666
ACC-2673069055,24,58.26,15064.41,0.0,CUS-51506836,2018-10-18,Richard,M,-27.49,152.99,,444c1cf8-2e39-4b9f-9aec-d151c246e899,-27.61,152.76,QLD,Ipswich,debit,authorized,f078f097600f4c50a4793dd826310678,POS,20-30,2018,10,18,16,56,Thursday,31 days,73297.96166666666
ACC-2673069055,24,12.83,15051.58,1.0,CUS-51506836,2018-10-19,Richard,M,-27.49,152.99,,04a8798a-5e53-4baa-bebe-23f3415ad780,-27.56,153.08,QLD,Upper Mount Gravatt,debit,authorized,15d9ddc44b6745ab8d719a8a4a09b35f,SALES-POS,20-30,2018,10,19,1,48,Friday,31 days,73297.96166666666
ACC-2673069055,24,43.0,15008.58,,CUS-51506836,2018-10-19,Richard,M,-27.49,152.99,,,,,,,debit,posted,edb31e620ae548ab9686bb0986438679,PAYMENT,20-30,2018,10,19,3,0,Friday,31 days,73297.96166666666
ACC-2673069055,24,22.67,14985.91,1.0,CUS-51506836,2018-10-19,Richard,M,-27.49,152.99,,e8fbfa42-204a-4b7b-b9e1-518544981fdb,-27.46,153.06,QLD,Hawthorne,debit,authorized,2f8428f8a6c842f28a80e5f1bbb2d554,SALES-POS,20-30,2018,10,19,4,26,Friday,31 days,73297.96166666666
ACC-2673069055,24,9.03,14976.88,1.0,CUS-51506836,2018-10-19,Richard,M,-27.49,152.99,,d3ba1df4-47bc-4064-8ded-b0c1b4063950,-27.47,153.03,QLD,Brisbane City,debit,authorized,3574f1b09a684b629cd1863222560436,POS,20-30,2018,10,19,8,57,Friday,31 days,73297.96166666666
ACC-2673069055,24,5.21,14971.67,1.0,CUS-51506836,2018-10-19,Richard,M,-27.49,152.99,,67e5bcbe-a2ad-400c-9b57-c539e50838e3,-37.82,144.96,VIC,Melbourne,debit,authorized,bf8cffb32f4f4e5e8e92ed2b72aef40d,POS,20-30,2018,10,19,10,11,Friday,31 days,73297.96166666666
ACC-2673069055,24,14.87,14956.8,1.0,CUS-51506836,2018-10-19,Richard,M,-27.49,152.99,,4169a179-5de6-4982-908b-8bd1469f9eef,-27.41,153.05,QLD,Wooloowin,debit,authorized,ed170490e2804f84bb6ce0d4f19e1659,POS,20-30,2018,10,19,13,29,Friday,31 days,73297.96166666666
ACC-2673069055,24,20.42,14936.38,1.0,CUS-51506836,2018-10-19,Richard,M,-27.49,152.99,,c0fb68c6-935b-47ae-8594-e3da036d0f94,-28,153.36,QLD,Gold Coast,debit,authorized,e91f065cc70b4d629bee91794a919db4,POS,20-30,2018,10,19,18,57,Friday,31 days,73297.96166666666
ACC-2673069055,24,50.48,14885.9,1.0,CUS-51506836,2018-10-20,Richard,M,-27.49,152.99,,cdad3e1b-8102-48e1-9834-318789a2e49b,-27.12,152.95,QLD,Morayfield,debit,authorized,921e2f2e6a1f465eac637b0f0575cec0,POS,20-30,2018,10,20,8,0,Saturday,31 days,73297.96166666666
ACC-2673069055,24,19.09,14866.81,1.0,CUS-51506836,2018-10-20,Richard,M,-27.49,152.99,,60145aef-57a3-41b5-b5b2-1fbc2276d247,-27.54,152.94,QLD,Jindalee,debit,authorized,02f640953ff84d8a82fee6afb1764221,POS,20-30,2018,10,20,12,47,Saturday,31 days,73297.96166666666
ACC-2673069055,24,17.64,14849.17,0.0,CUS-51506836,2018-10-21,Richard,M,-27.49,152.99,,941e4ce3-dc1e-45af-8e77-1b3c809a879c,-27.64,153.15,QLD,Daisy Hill,debit,authorized,e017e000e18b4ba495eef35307460f69,POS,20-30,2018,10,21,7,20,Sunday,31 days,73297.96166666666
ACC-2673069055,24,38.74,14810.43,1.0,CUS-51506836,2018-10-21,Richard,M,-27.49,152.99,,028bc621-f7ce-4c0f-88e1-116a536b34f5,-33.86,151.05,NSW,Lidcombe,debit,authorized,9c583bdf37d0424a8d24e08fc8d8bbc0,POS,20-30,2018,10,21,20,53,Sunday,31 days,73297.96166666666
ACC-2673069055,24,26.29,14784.14,1.0,CUS-51506836,2018-10-21,Richard,M,-27.49,152.99,,1b21994f-95ad-43f1-9837-6937fff1d688,-27.71,153.2,QLD,Beenleigh,debit,authorized,f6ed1d6da59140788115b001adb432ff,POS,20-30,2018,10,21,21,37,Sunday,31 days,73297.96166666666
ACC-2673069055,24,8.9,14775.24,1.0,CUS-51506836,2018-10-21,Richard,M,-27.49,152.99,,3822c5bf-f1b6-4cfa-be2b-765be53cb95c,-27.55,153.08,QLD,Upper Mount Gravatt,debit,authorized,2f1cf4ab1dab404da2929deba63a94f5,SALES-POS,20-30,2018,10,21,22,19,Sunday,31 days,73297.96166666666
ACC-2673069055,24,39.0,14733.7,,CUS-51506836,2018-10-22,Richard,M,-27.49,152.99,,,,,,,debit,posted,bb36f892208f468695a6ea6f4af62f23,INTER BANK,20-30,2018,10,22,9,0,Monday,31 days,73297.96166666666
ACC-2673069055,24,2.54,14772.7,1.0,CUS-51506836,2018-10-22,Richard,M,-27.49,152.99,,7a293d4b-3c01-4f5d-8610-d18dbcaf5c7b,-26.66,152.97,QLD,Woombye,debit,authorized,2d2367391a22443d9f232a72e41204c9,POS,20-30,2018,10,22,9,47,Monday,31 days,73297.96166666666
ACC-2673069055,24,70.0,14663.7,,CUS-51506836,2018-10-22,Richard,M,-27.49,152.99,,,,,,,debit,posted,ddf5de75ee344bb39f11454029aa58db,PAYMENT,20-30,2018,10,22,14,0,Monday,31 days,73297.96166666666
ACC-2673069055,24,6.18,14657.52,1.0,CUS-51506836,2018-10-22,Richard,M,-27.49,152.99,,94a687cc-6a8a-4129-b2d2-f55e494bd74c,-27.47,153.02,QLD,Brisbane City,debit,authorized,28075625036747d5a624c3eff594f58f,POS,20-30,2018,10,22,21,12,Monday,31 days,73297.96166666666
ACC-2673069055,24,13.0,14644.52,1.0,CUS-51506836,2018-10-22,Richard,M,-27.49,152.99,,d0000853-c09a-4c7d-a17c-b8d2ef4ec535,-27.52,153.2,QLD,Capalaba,debit,authorized,3b29ad82516c4d09abbedcc77b39b9dc,SALES-POS,20-30,2018,10,22,22,16,Monday,31 days,73297.96166666666
ACC-2673069055,24,18.74,14625.78,1.0,CUS-51506836,2018-10-23,Richard,M,-27.49,152.99,,56c12657-9a47-4bec-8e3e-fdef6095f510,-27.46,152.58,QLD,Lowood,debit,authorized,c447fe9bd6a34e208982d1c7c8c821c9,SALES-POS,20-30,2018,10,23,13,28,Tuesday,31 days,73297.96166666666
ACC-2673069055,24,1385.0,13240.78,,CUS-51506836,2018-10-24,Richard,M,-27.49,152.99,,,,,,,debit,posted,e2436775113d466f96d53a591f017849,PAYMENT,20-30,2018,10,24,3,0,Wednesday,31 days,73297.96166666666
ACC-2673069055,24,43.0,13197.78,,CUS-51506836,2018-10-26,Richard,M,-27.49,152.99,,,,,,,debit,posted,64eb54fff74248beb22b4cc0d9049f44,PAYMENT,20-30,2018,10,26,3,0,Friday,31 days,73297.96166666666
ACC-2673069055,24,22.58,13175.2,1.0,CUS-51506836,2018-10-26,Richard,M,-27.49,152.99,,bc2f4c89-efaf-46ec-991f-105d77119ab7,-27.38,153.03,QLD,Chermside,debit,authorized,6e11f9bcb66d4f078915bbe59b10d90b,SALES-POS,20-30,2018,10,26,17,36,Friday,31 days,73297.96166666666
ACC-2673069055,24,7.52,13167.68,1.0,CUS-51506836,2018-10-26,Richard,M,-27.49,152.99,,e3dde7d3-6a86-452f-b1f4-413110cf1b97,-27.56,151.96,QLD,Toowoomba,debit,authorized,ba2181fad5c24d32a138335889ae02f1,POS,20-30,2018,10,26,20,51,Friday,31 days,73297.96166666666
ACC-2673069055,24,1377.0,11790.68,,CUS-51506836,2018-10-27,Richard,M,-27.49,152.99,,,,,,,debit,posted,a341c06498614366baf7a3728a371cc5,INTER BANK,20-30,2018,10,27,3,0,Saturday,31 days,73297.96166666666
ACC-2673069055,24,32.75,11757.93,1.0,CUS-51506836,2018-10-27,Richard,M,-27.49,152.99,,eb4af8a0-c7e4-4e63-b2a3-201ca918321d,-27.66,153.17,QLD,Shailer Park,debit,authorized,08bceb2c6a214c5eac3af916cadcabfd,SALES-POS,20-30,2018,10,27,9,35,Saturday,31 days,73297.96166666666
ACC-2673069055,24,12.86,11745.07,1.0,CUS-51506836,2018-10-27,Richard,M,-27.49,152.99,,bcf746b5-7bf5-44fc-934b-9c44540ed213,-27.53,153.27,QLD,Cleveland,debit,authorized,67193412f6a342cdbddd3f1111d4f412,POS,20-30,2018,10,27,14,4,Saturday,31 days,73297.96166666666
ACC-2673069055,24,27.69,11717.38,1.0,CUS-51506836,2018-10-27,Richard,M,-27.49,152.99,,b197bdf9-bdde-4297-bffa-199eca0733f0,-27.56,151.93,QLD,Newtown,debit,authorized,02e63b5d11094f84bd03b33aaae1d025,SALES-POS,20-30,2018,10,27,14,21,Saturday,31 days,73297.96166666666
ACC-2673069055,24,11.96,11705.42,1.0,CUS-51506836,2018-10-27,Richard,M,-27.49,152.99,,96c988fa-90f9-4a9f-bba6-33a335326711,-27.56,151.95,QLD,Toowoomba City,debit,authorized,e6d4cb4a481d4afe8f07c66205a42393,POS,20-30,2018,10,27,15,28,Saturday,31 days,73297.96166666666
ACC-2673069055,24,13.71,11691.71,1.0,CUS-51506836,2018-10-27,Richard,M,-27.49,152.99,,61720158-6db6-438d-9e12-b8316b17f31f,-27.52,153.22,QLD,Alexandra Hills,debit,authorized,843cd5f1b9b6484796a1352e867ac1e2,POS,20-30,2018,10,27,21,51,Saturday,31 days,73297.96166666666
ACC-2673069055,24,11.72,11679.99,1.0,CUS-51506836,2018-10-28,Richard,M,-27.49,152.99,,249bab0f-a79e-418e-9662-4bb28a3e5951,-27.61,152.86,QLD,Collingwood,debit,authorized,1c0853fc2ec64d578e3b0f02a7e6c00b,POS,20-30,2018,10,28,10,7,Sunday,31 days,73297.96166666666
ACC-2673069055,24,14.31,11665.68,0.0,CUS-51506836,2018-10-28,Richard,M,-27.49,152.99,,120e98c5-0602-4a58-bc7d-e5fb8a6e8495,-27.54,153.2,QLD,Capalaba,debit,authorized,21b3b6206e4d4a29bbef064e5cc1245e,POS,20-30,2018,10,28,10,48,Sunday,31 days,73297.96166666666
ACC-2673069055,24,8.77,11656.91,1.0,CUS-51506836,2018-10-28,Richard,M,-27.49,152.99,,af914cdf-e2bf-404d-924c-d2e4de0b9400,-27.67,152.92,QLD,Springfield Lakes,debit,authorized,64687e620a4a4d9687db236945bf80d4,SALES-POS,20-30,2018,10,28,15,14,Sunday,31 days,73297.96166666666
ACC-2673069055,24,24.12,11632.79,1.0,CUS-51506836,2018-10-28,Richard,M,-27.49,152.99,,47914b27-cb1b-40b2-87c0-14a614c023cb,-37.87,145.24,VIC,Wantirna South,debit,authorized,4e5b5ed63e0b46f281d5de5156541b80,SALES-POS,20-30,2018,10,28,17,28,Sunday,31 days,73297.96166666666
ACC-2673069055,24,45.24,11587.55,1.0,CUS-51506836,2018-10-28,Richard,M,-27.49,152.99,,d18327ac-3957-4c69-981e-5d892c0714c7,-27.52,153.2,QLD,Capalaba,debit,authorized,52be0d707d1f49ef88a6e550fbd24535,SALES-POS,20-30,2018,10,28,21,37,Sunday,31 days,73297.96166666666
ACC-2673069055,24,39.0,11527.97,,CUS-51506836,2018-10-29,Richard,M,-27.49,152.99,,,,,,,debit,posted,b6fea835108842b2bc1a162c84344a1f,INTER BANK,20-30,2018,10,29,9,0,Monday,31 days,73297.96166666666
ACC-2673069055,24,20.58,11566.97,1.0,CUS-51506836,2018-10-29,Richard,M,-27.49,152.99,,7f6b7665-317f-44f8-9f1b-569a7ff4bc83,-27.5,152.97,QLD,Indooroopilly,debit,authorized,f47e4c14f335426eb92919e49a5698cc,SALES-POS,20-30,2018,10,29,9,58,Monday,31 days,73297.96166666666
ACC-2673069055,24,6.98,11520.99,1.0,CUS-51506836,2018-10-29,Richard,M,-27.49,152.99,,f3c57977-0cb3-4919-99b5-8acc6412cd16,-27.57,151.97,QLD,East Toowoomba,debit,authorized,2c361694b1ce4278b6eba63c48376a6b,SALES-POS,20-30,2018,10,29,18,54,Monday,31 days,73297.96166666666
ACC-3485804958,34,33.89,12529.59,0.0,CUS-1196156254,2018-08-01,Jessica,F,-35.01,138.52,,a08935a2-99a8-49f0-b73a-f8de51ca0abd,-34.9,138.53,SA,Findon,debit,authorized,89050ee5c5aa4e79b03e717518236bf9,POS,30-40,2018,8,1,9,19,Wednesday,14 days,101775.818
ACC-3485804958,34,11.54,16421.78,1.0,CUS-1196156254,2018-08-01,Jessica,F,-35.01,138.52,,5a3c0cad-eb95-43f2-9d62-c55f9d325ce9,-35.1,147.38,NSW,North Wagga Wagga,debit,authorized,d08a764ae0a5487b85cd08cf1d1e7378,POS,30-40,2018,8,1,19,23,Wednesday,14 days,101775.818
ACC-3485804958,34,27.0,16394.78,,CUS-1196156254,2018-08-02,Jessica,F,-35.01,138.52,,,,,,,debit,posted,7000019867204e318697a67ea1d8ac7b,PAYMENT,30-40,2018,8,2,9,0,Thursday,14 days,101775.818
ACC-3485804958,34,21.42,16373.36,1.0,CUS-1196156254,2018-08-02,Jessica,F,-35.01,138.52,,a2d499f3-f376-4a70-8162-6117289e268e,-34.95,138.61,SA,Unley,debit,authorized,914ec16cce474b61966558b9bf4aa4bb,POS,30-40,2018,8,2,11,0,Thursday,14 days,101775.818
ACC-3485804958,34,16.0,16357.36,,CUS-1196156254,2018-08-03,Jessica,F,-35.01,138.52,,,,,,,debit,posted,13291b582fbe4f4aab93f5ff79cae353,PAYMENT,30-40,2018,8,3,12,0,Friday,14 days,101775.818
ACC-3485804958,34,63.0,16294.36,,CUS-1196156254,2018-08-03,Jessica,F,-35.01,138.52,,,,,,,debit,posted,a95204a92a804888a3d7602ec3193635,PAYMENT,30-40,2018,8,3,19,0,Friday,14 days,101775.818
ACC-3485804958,34,41.6,16252.76,1.0,CUS-1196156254,2018-08-03,Jessica,F,-35.01,138.52,,617a670e-a706-400a-bbfa-09858d56a871,-26.72,153.06,QLD,Sippy Downs,debit,authorized,49d13d68b6b6423d8c486922af9a87a6,SALES-POS,30-40,2018,8,3,20,20,Friday,14 days,101775.818
ACC-3485804958,34,29.55,16223.21,1.0,CUS-1196156254,2018-08-04,Jessica,F,-35.01,138.52,,7d696bdc-85a1-4d60-bedc-55babcf767cb,-35.12,147.37,NSW,Wagga Wagga,debit,authorized,a76f4857075e4c2f9f27b5c2ed0f3a71,SALES-POS,30-40,2018,8,4,16,20,Saturday,14 days,101775.818
ACC-3485804958,34,31.0,16192.21,,CUS-1196156254,2018-08-05,Jessica,F,-35.01,138.52,,,,,,,debit,posted,24827e7c6a594938a7e16589d4dee314,PAYMENT,30-40,2018,8,5,5,0,Sunday,14 days,101775.818
ACC-3485804958,34,11.68,16180.53,1.0,CUS-1196156254,2018-08-05,Jessica,F,-35.01,138.52,,7c378eee-b2d4-4dea-967e-b06b3fdbbe04,-35.01,138.54,SA,Oaklands Park,debit,authorized,a850909636564e08ada099084f60b1f1,POS,30-40,2018,8,5,16,24,Sunday,14 days,101775.818
ACC-3485804958,34,18.6,16161.93,1.0,CUS-1196156254,2018-08-06,Jessica,F,-35.01,138.52,,f1e6d4a0-87a2-4d0c-a39f-7fcbe685c491,-34.98,138.57,SA,Edwardstown,debit,authorized,b4c3220e9d814cd09f0384c4eb92f662,SALES-POS,30-40,2018,8,6,8,0,Monday,14 days,101775.818
ACC-3485804958,34,7.99,16153.94,1.0,CUS-1196156254,2018-08-06,Jessica,F,-35.01,138.52,,36038911-5791-4b2a-aadc-438e4ad075ea,-35.3,149.13,ACT,Parkes,debit,authorized,bb3676ae6dba4dfd88e3a4141974accc,SALES-POS,30-40,2018,8,6,9,32,Monday,14 days,101775.818
ACC-3485804958,34,13.39,16140.55,0.0,CUS-1196156254,2018-08-06,Jessica,F,-35.01,138.52,,7dc2fa2c-0738-40fc-8f45-46b6cc140b2f,-35.14,138.5,SA,Noarlunga Centre,debit,authorized,ca57511831494b008e94092be29f2adc,SALES-POS,30-40,2018,8,6,9,50,Monday,14 days,101775.818
ACC-3485804958,34,24.93,16115.62,1.0,CUS-1196156254,2018-08-07,Jessica,F,-35.01,138.52,,46b730a2-810c-4bf8-849b-ef1dc10d4ec5,-35.18,149.13,ACT,Gungahlin,debit,authorized,8158542166664e32a563408a01f5ee1b,SALES-POS,30-40,2018,8,7,9,12,Tuesday,14 days,101775.818
ACC-3485804958,34,39.0,16076.62,,CUS-1196156254,2018-08-07,Jessica,F,-35.01,138.52,,,,,,,debit,posted,5408be71626d451ebe2c19de024d3d7a,PAYMENT,30-40,2018,8,7,14,0,Tuesday,14 days,101775.818
ACC-3485804958,34,92.75,15983.87,0.0,CUS-1196156254,2018-08-07,Jessica,F,-35.01,138.52,,b3fe6666-bfd0-4156-ac85-d275fd646c05,-34.94,138.52,SA,Adelaide Airport,debit,authorized,7fe687b092494af0ab75e28dba5d44ac,POS,30-40,2018,8,7,22,59,Tuesday,14 days,101775.818
ACC-3485804958,34,68.56,15915.31,0.0,CUS-1196156254,2018-08-08,Jessica,F,-35.01,138.52,,f3b432d7-4224-4216-9f69-972559838cba,-33.87,151.21,NSW,Sydney,debit,authorized,33886e75e1434f929686ef6c5a343a1c,POS,30-40,2018,8,8,9,19,Wednesday,14 days,101775.818
ACC-3485804958,34,27.0,15888.31,,CUS-1196156254,2018-08-09,Jessica,F,-35.01,138.52,,,,,,,debit,posted,6366ee504c524fa7a2f0246f9204ddaa,PAYMENT,30-40,2018,8,9,9,0,Thursday,14 days,101775.818
ACC-3485804958,34,66.55,15821.76,1.0,CUS-1196156254,2018-08-09,Jessica,F,-35.01,138.52,,42c81e8a-c3ce-4c8d-956f-b88dcb40dbe8,-35.02,117.89,WA,Mira Mar,debit,authorized,5b32aed826db4ad4b92c0a04237687c5,SALES-POS,30-40,2018,8,9,17,8,Thursday,14 days,101775.818
ACC-3485804958,34,169.0,15652.76,,CUS-1196156254,2018-08-10,Jessica,F,-35.01,138.52,,,,,,,debit,posted,442e727b552e4eff840375f571393db8,INTER BANK,30-40,2018,8,10,3,0,Friday,14 days,101775.818
ACC-3485804958,34,16.0,15636.76,,CUS-1196156254,2018-08-10,Jessica,F,-35.01,138.52,,,,,,,debit,posted,000de828c5ad48c9a129bd090b23d632,PAYMENT,30-40,2018,8,10,12,0,Friday,14 days,101775.818
ACC-3485804958,34,63.0,15573.76,,CUS-1196156254,2018-08-10,Jessica,F,-35.01,138.52,,,,,,,debit,posted,7468a310039c4eddbab8e94cff3d7d85,PAYMENT,30-40,2018,8,10,19,0,Friday,14 days,101775.818
ACC-3485804958,34,11.3,15562.46,1.0,CUS-1196156254,2018-08-10,Jessica,F,-35.01,138.52,,5a3c0cad-eb95-43f2-9d62-c55f9d325ce9,-35.1,147.38,NSW,North Wagga Wagga,debit,authorized,edbae8ff638c48c6ab17fea3ed23a3d5,POS,30-40,2018,8,10,21,35,Friday,14 days,101775.818
ACC-3485804958,34,21.84,15540.62,1.0,CUS-1196156254,2018-08-10,Jessica,F,-35.01,138.52,,37212bce-18ec-4012-9e07-dee0c160e5c5,-35.01,138.72,SA,Stirling,debit,authorized,7e24e58193ec4d60a215c637e97792f6,SALES-POS,30-40,2018,8,10,23,58,Friday,14 days,101775.818
ACC-3485804958,34,52.62,15488.0,1.0,CUS-1196156254,2018-08-12,Jessica,F,-35.01,138.52,,b106312e-39bf-48fb-bdd6-f0398e1a5b5f,-34.94,138.64,SA,Toorak Gardens,debit,authorized,1f46ff17b2774ab28b805d13509197d4,POS,30-40,2018,8,12,0,43,Sunday,14 days,101775.818
ACC-3485804958,34,31.0,15457.0,,CUS-1196156254,2018-08-12,Jessica,F,-35.01,138.52,,,,,,,debit,posted,5f2c2a52ef444678a54842917ff28a12,PAYMENT,30-40,2018,8,12,5,0,Sunday,14 days,101775.818
ACC-3485804958,34,51.23,15405.77,1.0,CUS-1196156254,2018-08-12,Jessica,F,-35.01,138.52,,d47efc0a-2443-47d0-ad6b-4379779d2e3e,-35.03,117.89,WA,Albany,debit,authorized,96e0017b64ce4a0a821ddf979056100a,SALES-POS,30-40,2018,8,12,9,28,Sunday,14 days,101775.818
ACC-3485804958,34,13.78,15391.99,1.0,CUS-1196156254,2018-08-12,Jessica,F,-35.01,138.52,,3e111141-2bd3-4035-b228-64c2e2092109,-35.02,117.88,WA,Albany,debit,authorized,a97375b16c194e418f7f2d73b4259de5,SALES-POS,30-40,2018,8,12,20,35,Sunday,14 days,101775.818
ACC-3485804958,34,28.85,15363.14,0.0,CUS-1196156254,2018-08-13,Jessica,F,-35.01,138.52,,5a72f2e6-6ec1-49bf-be27-c9efd7eeb027,-35.1,138.54,SA,Reynella,debit,authorized,e2fab73e20194b66aa2a7cfa6505d16c,SALES-POS,30-40,2018,8,13,18,44,Monday,14 days,101775.818
ACC-3485804958,34,39.0,15315.74,,CUS-1196156254,2018-08-14,Jessica,F,-35.01,138.52,,,,,,,debit,posted,ae717a5d5e2a4cb189d4ec6412c15701,PAYMENT,30-40,2018,8,14,14,0,Tuesday,14 days,101775.818
ACC-3485804958,34,8.4,15354.74,1.0,CUS-1196156254,2018-08-14,Jessica,F,-35.01,138.52,,f70e3d19-b8b3-44d1-8367-61ebb2453125,-34.93,138.6,SA,Adelaide,debit,authorized,e1ff784816d84a7eb62d2f9f54057426,SALES-POS,30-40,2018,8,14,14,11,Tuesday,14 days,101775.818
ACC-3485804958,34,19.62,15296.12,1.0,CUS-1196156254,2018-08-14,Jessica,F,-35.01,138.52,,d5e0135b-d063-45f0-9696-81ece6091c26,-35.03,117.91,WA,Mount Clarence,debit,authorized,f041c3f8802f4ee4b5c8736c4d0a5b2c,POS,30-40,2018,8,14,15,51,Tuesday,14 days,101775.818
ACC-3485804958,34,12.49,18921.91,1.0,CUS-1196156254,2018-08-17,Jessica,F,-35.01,138.52,,5a3c0cad-eb95-43f2-9d62-c55f9d325ce9,-35.1,147.38,NSW,North Wagga Wagga,debit,authorized,da06d2fe483147b7a8e2f12cef1e9963,POS,30-40,2018,8,17,4,1,Friday,14 days,101775.818
ACC-3485804958,34,3.66,18918.25,1.0,CUS-1196156254,2018-08-17,Jessica,F,-35.01,138.52,,a27c7ed1-6b31-438f-a536-6e18852c7dbf,-35.02,138.54,SA,Oaklands Park,debit,authorized,fe1b74201be7420c8193a47498f312e0,POS,30-40,2018,8,17,9,49,Friday,14 days,101775.818
ACC-3485804958,34,16.0,18902.25,,CUS-1196156254,2018-08-17,Jessica,F,-35.01,138.52,,,,,,,debit,posted,282a9645c6c74f5b9a0583ae1e43b0d6,PAYMENT,30-40,2018,8,17,12,0,Friday,14 days,101775.818
ACC-3485804958,34,16.51,18885.74,1.0,CUS-1196156254,2018-08-17,Jessica,F,-35.01,138.52,,2a87bd94-e8d2-4e41-9e05-d0d99505d414,-35.02,117.88,WA,Albany,debit,authorized,d4a2de315bc444fea13cb363e52a1bbb,SALES-POS,30-40,2018,8,17,13,29,Friday,14 days,101775.818
ACC-3485804958,34,63.0,18805.43,,CUS-1196156254,2018-08-17,Jessica,F,-35.01,138.52,,,,,,,debit,posted,5e2760a1629b4b7db6d7d14ddf39567b,PAYMENT,30-40,2018,8,17,19,0,Friday,14 days,101775.818
ACC-3485804958,34,17.31,18868.43,1.0,CUS-1196156254,2018-08-17,Jessica,F,-35.01,138.52,,86cd6e04-59b1-4604-8a73-3dcd291edc0a,-34.99,138.58,SA,Melrose Park,debit,authorized,d6d40d8256c746aea47d9e400bc7cff5,POS,30-40,2018,8,17,19,48,Friday,14 days,101775.818
ACC-3485804958,34,49.94,18755.49,1.0,CUS-1196156254,2018-08-18,Jessica,F,-35.01,138.52,,d47efc0a-2443-47d0-ad6b-4379779d2e3e,-35.03,117.89,WA,Albany,debit,authorized,030c457de08043f187b3e1c43452e8fe,POS,30-40,2018,8,18,0,28,Saturday,14 days,101775.818
ACC-3485804958,34,20.47,18735.02,0.0,CUS-1196156254,2018-08-18,Jessica,F,-35.01,138.52,,efa26eca-2cde-4d14-8557-65d69e245397,-34.78,150.7,NSW,Berry,debit,authorized,dbbe8edbe0fc481c8cb2305b6741e10a,SALES-POS,30-40,2018,8,18,1,1,Saturday,14 days,101775.818
ACC-3485804958,34,75.0,18660.02,,CUS-1196156254,2018-08-18,Jessica,F,-35.01,138.52,,,,,,,debit,posted,31b1432df81440f6982a25276d1ec109,PAYMENT,30-40,2018,8,18,11,0,Saturday,14 days,101775.818
ACC-3485804958,34,31.0,18629.02,,CUS-1196156254,2018-08-19,Jessica,F,-35.01,138.52,,,,,,,debit,posted,6f823766c67f412e83a661d05eedbc89,PAYMENT,30-40,2018,8,19,5,0,Sunday,14 days,101775.818
ACC-3485804958,34,20.02,18609.0,1.0,CUS-1196156254,2018-08-19,Jessica,F,-35.01,138.52,,8f0ef063-4950-4175-895d-2df580d755fc,-34.88,150.6,NSW,Nowra,debit,authorized,aa78c28d430240d49bfed5aa4a8bb42f,SALES-POS,30-40,2018,8,19,20,9,Sunday,14 days,101775.818
ACC-3485804958,34,39.0,18542.65,,CUS-1196156254,2018-08-21,Jessica,F,-35.01,138.52,,,,,,,debit,posted,c75fef86f522497f97c383951eb5e208,PAYMENT,30-40,2018,8,21,14,0,Tuesday,14 days,101775.818
ACC-3485804958,34,27.35,18581.65,1.0,CUS-1196156254,2018-08-21,Jessica,F,-35.01,138.52,,7b0d0000-8913-45d7-aec4-152287c53850,-34.92,138.63,SA,Norwood,debit,authorized,3b0ce0942ccf488f85a3232835774a4f,SALES-POS,30-40,2018,8,21,14,12,Tuesday,14 days,101775.818
ACC-3485804958,34,15.14,18527.51,1.0,CUS-1196156254,2018-08-22,Jessica,F,-35.01,138.52,,f48b868b-9816-4b47-aef8-d53e28a33bbd,-35.08,150.66,NSW,Vincentia,debit,authorized,8fde4af544e840ca90fb08dab34a2a7d,SALES-POS,30-40,2018,8,22,0,36,Wednesday,14 days,101775.818
ACC-3485804958,34,6.05,18521.46,0.0,CUS-1196156254,2018-08-22,Jessica,F,-35.01,138.52,,a1e5ae86-8fbd-4527-9064-284db0d393e5,-34.93,138.5,SA,Henley Beach,debit,authorized,e333ad04aa67417891d0a4881456d4bf,POS,30-40,2018,8,22,4,7,Wednesday,14 days,101775.818
ACC-3485804958,34,29.49,18491.97,1.0,CUS-1196156254,2018-08-22,Jessica,F,-35.01,138.52,,af436251-02a4-45d4-bcde-267b5cf1a562,-34.91,150.6,NSW,South Nowra,debit,authorized,c777826a0ebf4421a3e2679b03ed4336,POS,30-40,2018,8,22,8,47,Wednesday,14 days,101775.818
ACC-3485804958,34,44.26,18447.71,1.0,CUS-1196156254,2018-08-22,Jessica,F,-35.01,138.52,,170e5de7-7f8e-4990-bdff-01c72108a46a,-34.93,138.61,SA,Adelaide,debit,authorized,4c0ee542b37148748193cd01906bce4c,SALES-POS,30-40,2018,8,22,9,53,Wednesday,14 days,101775.818
ACC-3485804958,34,7.34,18440.37,1.0,CUS-1196156254,2018-08-22,Jessica,F,-35.01,138.52,,b51c5167-4500-430e-b4f1-8b2877529495,-35.24,149.08,ACT,Bruce,debit,authorized,ca076130141d4960bba753946d80d64c,SALES-POS,30-40,2018,8,22,14,2,Wednesday,14 days,101775.818
ACC-3485804958,34,25.27,18415.1,1.0,CUS-1196156254,2018-08-22,Jessica,F,-35.01,138.52,,03bbaee4-1663-48e2-8abe-487eb9eb52d2,-34.86,138.65,SA,Hillcrest,debit,authorized,ddf66fafea9249c2891b31665e9c7f38,POS,30-40,2018,8,22,15,55,Wednesday,14 days,101775.818
ACC-3485804958,34,27.0,18388.1,,CUS-1196156254,2018-08-23,Jessica,F,-35.01,138.52,,,,,,,debit,posted,ed71b0b4d53140a0a2b8dcaf2d842e4e,PAYMENT,30-40,2018,8,23,9,0,Thursday,14 days,101775.818
ACC-3485804958,34,16.0,18372.1,,CUS-1196156254,2018-08-24,Jessica,F,-35.01,138.52,,,,,,,debit,posted,f4a7a821c981453db078f2eea738a019,PAYMENT,30-40,2018,8,24,12,0,Friday,14 days,101775.818
ACC-3485804958,34,9.05,18363.05,0.0,CUS-1196156254,2018-08-24,Jessica,F,-35.01,138.52,,417301c4-1576-4b54-885d-2d557ac2e554,-34.93,138.59,SA,Adelaide,debit,authorized,7f377ba50bc146c7b6e790b89e6ad733,POS,30-40,2018,8,24,15,10,Friday,14 days,101775.818
ACC-3485804958,34,63.0,18300.05,,CUS-1196156254,2018-08-24,Jessica,F,-35.01,138.52,,,,,,,debit,posted,aedf221643344e9dbb9e5d529ad49569,PAYMENT,30-40,2018,8,24,19,0,Friday,14 days,101775.818
ACC-3485804958,34,18.76,18281.29,1.0,CUS-1196156254,2018-08-24,Jessica,F,-35.01,138.52,,9e9825b8-b6bf-447a-8187-2b66a86e6688,-34.91,138.51,SA,Fulham Gardens,debit,authorized,04eeacea964147fa9d9a7257941d7af5,SALES-POS,30-40,2018,8,24,21,2,Friday,14 days,101775.818
ACC-3485804958,34,12.76,18268.53,1.0,CUS-1196156254,2018-08-24,Jessica,F,-35.01,138.52,,67b1bd4a-a94e-4fcb-816c-b5264733d8d5,-34.93,138.59,SA,Adelaide,debit,authorized,d5635ccbe5e84e63b28fbb1d2133e81f,SALES-POS,30-40,2018,8,24,23,35,Friday,14 days,101775.818
ACC-3485804958,34,23.77,18244.76,0.0,CUS-1196156254,2018-08-26,Jessica,F,-35.01,138.52,,9d25e263-200f-42a4-98b2-aa84ad6e5034,-32.02,115.83,WA,Applecross,debit,authorized,fe2fb3e7925c41009d1b36346c5cd80f,POS,30-40,2018,8,26,3,57,Sunday,14 days,101775.818
ACC-3485804958,34,31.0,18213.76,,CUS-1196156254,2018-08-26,Jessica,F,-35.01,138.52,,,,,,,debit,posted,bf0a0cd7281e4e8cbf9c67fc8f32f4eb,PAYMENT,30-40,2018,8,26,5,0,Sunday,14 days,101775.818
ACC-3485804958,34,43.15,18170.61,0.0,CUS-1196156254,2018-08-26,Jessica,F,-35.01,138.52,,2adfb016-d492-4baf-9cc8-566355cacea7,-34.95,138.52,SA,Adelaide Airport,debit,authorized,f493cb2bc0364d1e805e7fba7b70f7cd,POS,30-40,2018,8,26,12,44,Sunday,14 days,101775.818
ACC-3485804958,34,20.93,18149.68,1.0,CUS-1196156254,2018-08-26,Jessica,F,-35.01,138.52,,8f0ef063-4950-4175-895d-2df580d755fc,-34.88,150.6,NSW,Nowra,debit,authorized,a128fadd5d1e422098b535e98dbaa1e9,POS,30-40,2018,8,26,21,50,Sunday,14 days,101775.818
ACC-3485804958,34,18.78,18130.9,1.0,CUS-1196156254,2018-08-27,Jessica,F,-35.01,138.52,,3f6d4985-d5eb-4fcf-8ff5-4bf543f64106,-35.07,150.66,NSW,Vincentia,debit,authorized,6891aa8e5b284304a9a19a7c878fea5d,POS,30-40,2018,8,27,9,32,Monday,14 days,101775.818
ACC-3485804958,34,20.17,18110.73,1.0,CUS-1196156254,2018-08-27,Jessica,F,-35.01,138.52,,78ab2b76-4131-40df-89f1-aba4574144db,-35.3,149.13,ACT,Parkes,debit,authorized,10939e5eda504eb6b83cfab3afcc7809,SALES-POS,30-40,2018,8,27,9,53,Monday,14 days,101775.818
ACC-3485804958,34,177.0,17933.73,,CUS-1196156254,2018-08-28,Jessica,F,-35.01,138.52,,,,,,,debit,posted,9b50f359275c457d82c06125f0472f6e,PAYMENT,30-40,2018,8,28,8,0,Tuesday,14 days,101775.818
ACC-3485804958,34,15.1,17918.63,1.0,CUS-1196156254,2018-08-28,Jessica,F,-35.01,138.52,,3e111141-2bd3-4035-b228-64c2e2092109,-35.02,117.88,WA,Albany,debit,authorized,2add260978f44da485e19052e63aa070,SALES-POS,30-40,2018,8,28,10,41,Tuesday,14 days,101775.818
ACC-3485804958,34,39.0,17879.63,,CUS-1196156254,2018-08-28,Jessica,F,-35.01,138.52,,,,,,,debit,posted,6cd7e75bcabf42e69e16ccaaffc34553,PAYMENT,30-40,2018,8,28,14,0,Tuesday,14 days,101775.818
ACC-3485804958,34,22.29,17857.34,1.0,CUS-1196156254,2018-08-29,Jessica,F,-35.01,138.52,,fa38d743-985d-4138-b7cd-09ff48b3742d,-27.46,153.02,QLD,Brisbane City,debit,authorized,d2baac2666984e29b70dfaa3bdd677db,POS,30-40,2018,8,29,16,3,Wednesday,14 days,101775.818
ACC-3485804958,34,10.46,21750.61,1.0,CUS-1196156254,2018-08-30,Jessica,F,-35.01,138.52,,36038911-5791-4b2a-aadc-438e4ad075ea,-35.3,149.13,ACT,Parkes,debit,authorized,17e0c34bb14d4ee58406ef64bd8a5203,SALES-POS,30-40,2018,8,30,4,31,Thursday,14 days,101775.818
ACC-3485804958,34,59.0,21691.61,1.0,CUS-1196156254,2018-08-30,Jessica,F,-35.01,138.52,,30dd6f5a-4a03-4d90-ac48-cdc92136900b,-34.78,150.7,NSW,Berry,debit,authorized,eafaa8d46cff495393a8601ebcc92c6e,POS,30-40,2018,8,30,8,58,Thursday,14 days,101775.818
ACC-3485804958,34,27.0,21664.61,,CUS-1196156254,2018-08-30,Jessica,F,-35.01,138.52,,,,,,,debit,posted,fd7a14ad17874901b6224d22544d913b,PAYMENT,30-40,2018,8,30,9,0,Thursday,14 days,101775.818
ACC-3485804958,34,13.03,21651.58,1.0,CUS-1196156254,2018-08-30,Jessica,F,-35.01,138.52,,5a3c0cad-eb95-43f2-9d62-c55f9d325ce9,-35.1,147.38,NSW,North Wagga Wagga,debit,authorized,5bd478d164744a59a5d567b8358944b8,POS,30-40,2018,8,30,10,0,Thursday,14 days,101775.818
ACC-3485804958,34,7.41,21644.17,1.0,CUS-1196156254,2018-08-30,Jessica,F,-35.01,138.52,,5b939344-c418-4b64-ace2-2087565e4dd2,-34.85,138.53,SA,Rosewater,debit,authorized,741e37ebed4e4d38b0a0d01b06132269,SALES-POS,30-40,2018,8,30,15,18,Thursday,14 days,101775.818
ACC-3485804958,34,82.06,21562.11,1.0,CUS-1196156254,2018-08-30,Jessica,F,-35.01,138.52,,c5e7e0b4-e42b-49fc-a869-4e36bb42bf7c,-34.95,138.6,SA,Goodwood,debit,authorized,3b095425ae864c998e372e3c0357582f,POS,30-40,2018,8,30,22,30,Thursday,14 days,101775.818
ACC-3485804958,34,10.91,21551.2,1.0,CUS-1196156254,2018-08-31,Jessica,F,-35.01,138.52,,310dc575-0166-4af8-b8c6-a62dab9426e1,-35.31,149.14,ACT,Kingston,debit,authorized,20841ba46da14c61b5a44b6e8f6791ba,SALES-POS,30-40,2018,8,31,4,52,Friday,14 days,101775.818
ACC-3485804958,34,25.59,21525.61,1.0,CUS-1196156254,2018-08-31,Jessica,F,-35.01,138.52,,0b971b7b-6fd6-4abe-819a-9fab9bf75293,-35.34,149.15,ACT,Narrabundah,debit,authorized,5638ff6ffad545708830f8533821f2c7,POS,30-40,2018,8,31,9,39,Friday,14 days,101775.818
ACC-3485804958,34,16.0,21509.61,,CUS-1196156254,2018-08-31,Jessica,F,-35.01,138.52,,,,,,,debit,posted,365f179e1e75445598aae0b78dab60c5,PAYMENT,30-40,2018,8,31,12,0,Friday,14 days,101775.818
ACC-3485804958,34,31.26,21478.35,1.0,CUS-1196156254,2018-08-31,Jessica,F,-35.01,138.52,,56155437-b395-47cc-827c-fd7009450bd3,-34.93,138.6,SA,Adelaide,debit,authorized,6f894ecc33ee4708932b7256d1874a17,SALES-POS,30-40,2018,8,31,15,43,Friday,14 days,101775.818
ACC-3485804958,34,63.0,21415.35,,CUS-1196156254,2018-08-31,Jessica,F,-35.01,138.52,,,,,,,debit,posted,b5c2f8871c624e818e33c621812c326e,PAYMENT,30-40,2018,8,31,19,0,Friday,14 days,101775.818
ACC-3485804958,34,390.67,21024.68,1.0,CUS-1196156254,2018-08-31,Jessica,F,-35.01,138.52,,cec6c173-d338-458d-8de3-0268e91dfcd6,-35.06,117.53,WA,Lowlands,debit,authorized,a8997bb6e0824fb3b3dbcb61cbe74d6e,SALES-POS,30-40,2018,8,31,21,59,Friday,14 days,101775.818
ACC-3485804958,34,89.91,20934.77,0.0,CUS-1196156254,2018-09-01,Jessica,F,-35.01,138.52,,9148f42a-c5b8-487d-8f5a-a38264d30552,-37.82,144.97,VIC,Melbourne,debit,authorized,75ecde03039f4288856bfe27d1d7cfe8,POS,30-40,2018,9,1,10,58,Saturday,14 days,101775.818
ACC-3485804958,34,16.87,20917.9,1.0,CUS-1196156254,2018-09-01,Jessica,F,-35.01,138.52,,f2f0934b-a448-4e8f-b742-46c66073aee8,-35.03,138.53,SA,Seacliff Park,debit,authorized,11f2281ba261424588471e639ba64001,SALES-POS,30-40,2018,9,1,12,6,Saturday,14 days,101775.818
ACC-3485804958,34,31.0,20886.9,,CUS-1196156254,2018-09-02,Jessica,F,-35.01,138.52,,,,,,,debit,posted,35664ffb488d43a88772e15ef5893353,PAYMENT,30-40,2018,9,2,5,0,Sunday,14 days,101775.818
ACC-3485804958,34,8.22,20878.68,0.0,CUS-1196156254,2018-09-02,Jessica,F,-35.01,138.52,,33be4fb6-9e56-4bc3-a6a9-ec95ab6e55e0,-34.92,138.6,SA,Adelaide,debit,authorized,0417b1feb77a43fb86c9e36a74cbbc33,SALES-POS,30-40,2018,9,2,11,3,Sunday,14 days,101775.818
ACC-3485804958,34,42.78,20835.9,1.0,CUS-1196156254,2018-09-02,Jessica,F,-35.01,138.52,,d6688d4c-9653-4051-8623-16233df27cde,-35.3,148.22,NSW,Tumut,debit,authorized,5ffcce791bfb4485927f4b7ff70de363,POS,30-40,2018,9,2,19,43,Sunday,14 days,101775.818
ACC-3485804958,34,19.73,20816.17,0.0,CUS-1196156254,2018-09-03,Jessica,F,-35.01,138.52,,7dbb70bb-832e-4d68-ab1b-d882a2a8a7cc,-35.11,147.37,NSW,Wagga Wagga,debit,authorized,4fa9bc7000844058be43359e604ea8a6,SALES-POS,30-40,2018,9,3,9,5,Monday,14 days,101775.818
ACC-3485804958,34,29.35,20786.82,1.0,CUS-1196156254,2018-09-03,Jessica,F,-35.01,138.52,,88ea1229-f823-4600-811d-c39ee5270e8c,-35.06,148.1,NSW,Gundagai,debit,authorized,f62aafb43a844b19820fc0679c330f48,POS,30-40,2018,9,3,9,32,Monday,14 days,101775.818
ACC-3485804958,34,9.3,20777.52,1.0,CUS-1196156254,2018-09-03,Jessica,F,-35.01,138.52,,abf377ce-3e2a-4f49-adff-d52bc3e93488,-35.08,147.36,NSW,North Wagga Wagga,debit,authorized,3884bf0d793b480e885b13097ee6e64d,SALES-POS,30-40,2018,9,3,16,8,Monday,14 days,101775.818
ACC-3485804958,34,43.11,20734.41,0.0,CUS-1196156254,2018-09-03,Jessica,F,-35.01,138.52,,415d5a26-26fb-480f-9321-13169d4e1b1b,-34.93,138.6,SA,Adelaide,debit,authorized,c290182201df43a088ec8722bb976a60,SALES-POS,30-40,2018,9,3,20,15,Monday,14 days,101775.818
ACC-3485804958,34,26.65,20707.76,1.0,CUS-1196156254,2018-09-04,Jessica,F,-35.01,138.52,,f26401e1-93c1-4dc9-92e2-79cd25e902e2,-33.77,151.26,NSW,Brookvale,debit,authorized,6b38b57e26da4a7590f13d9b3d81d86d,SALES-POS,30-40,2018,9,4,7,33,Tuesday,14 days,101775.818
ACC-3485804958,34,31.26,20676.5,1.0,CUS-1196156254,2018-09-04,Jessica,F,-35.01,138.52,,7d696bdc-85a1-4d60-bedc-55babcf767cb,-35.12,147.37,NSW,Wagga Wagga,debit,authorized,7481a1071050490fa1cbc92b0673afa0,SALES-POS,30-40,2018,9,4,11,5,Tuesday,14 days,101775.818
ACC-3485804958,34,39.0,20637.5,,CUS-1196156254,2018-09-04,Jessica,F,-35.01,138.52,,,,,,,debit,posted,7bee54d42ab9427eb495d1a1efda52f9,PAYMENT,30-40,2018,9,4,14,0,Tuesday,14 days,101775.818
ACC-3485804958,34,20.96,20616.54,1.0,CUS-1196156254,2018-09-05,Jessica,F,-35.01,138.52,,386cc895-bcda-4fe4-94d9-47fa6c01c73c,-35.24,149.06,ACT,Belconnen,debit,authorized,0c56b3b04d7f4f26b2c71d95957c5b13,SALES-POS,30-40,2018,9,5,11,30,Wednesday,14 days,101775.818
ACC-3485804958,34,24.48,20592.06,1.0,CUS-1196156254,2018-09-05,Jessica,F,-35.01,138.52,,8b27d913-3fc4-4ae7-abf1-a6325a819d19,-34.92,138.6,SA,Adelaide,debit,authorized,1e1c5aae6cbe474ca0c34e86bd055916,SALES-POS,30-40,2018,9,5,15,20,Wednesday,14 days,101775.818
ACC-3485804958,34,19.71,20572.35,1.0,CUS-1196156254,2018-09-05,Jessica,F,-35.01,138.52,,d83e60cf-5899-48fb-a944-fff565eec79c,-34.95,138.6,SA,Hyde Park,debit,authorized,75e2ae0441014f23b755fe844b345c78,POS,30-40,2018,9,5,17,24,Wednesday,14 days,101775.818
ACC-3485804958,34,28.29,20544.06,1.0,CUS-1196156254,2018-09-05,Jessica,F,-35.01,138.52,,01eff92f-bd8a-4a13-9de6-9d49fb552110,-27.47,153.03,QLD,Brisbane,debit,authorized,a7b9429cc6e147d89f893c505af39107,SALES-POS,30-40,2018,9,5,19,12,Wednesday,14 days,101775.818
ACC-3485804958,34,27.0,20517.06,,CUS-1196156254,2018-09-06,Jessica,F,-35.01,138.52,,,,,,,debit,posted,dced6cb5efd34a36a14fb7171a75d891,PAYMENT,30-40,2018,9,6,9,0,Thursday,14 days,101775.818
ACC-3485804958,34,29.31,20487.75,1.0,CUS-1196156254,2018-09-06,Jessica,F,-35.01,138.52,,60e25947-c418-4213-afd2-e6c00ebf6a87,-35.02,117.89,WA,Centennial Park,debit,authorized,3b8b7cd4fec448c393224215782f49f6,SALES-POS,30-40,2018,9,6,11,15,Thursday,14 days,101775.818
ACC-3485804958,34,46.64,20441.11,0.0,CUS-1196156254,2018-09-07,Jessica,F,-35.01,138.52,,ea247b5c-61ee-4106-988f-84c3036ce5e0,-34.92,150.6,NSW,South Nowra,debit,authorized,ef9f4cebb7a44597a376a600f968d71e,POS,30-40,2018,9,7,9,38,Friday,14 days,101775.818
ACC-3485804958,34,16.0,20425.11,,CUS-1196156254,2018-09-07,Jessica,F,-35.01,138.52,,,,,,,debit,posted,1e214d202b0c4962be959045e42b3356,PAYMENT,30-40,2018,9,7,12,0,Friday,14 days,101775.818
ACC-3485804958,34,63.0,20362.11,,CUS-1196156254,2018-09-07,Jessica,F,-35.01,138.52,,,,,,,debit,posted,daa055c6081d464a9223ab6e6323df53,PAYMENT,30-40,2018,9,7,19,0,Friday,14 days,101775.818
ACC-3485804958,34,25.99,20336.12,1.0,CUS-1196156254,2018-09-08,Jessica,F,-35.01,138.52,,02cb9aab-54b3-489e-9189-e7750e0879aa,-34.88,150.61,NSW,Nowra,debit,authorized,b723007edd1b4c7aaa8fe57055cf91ea,SALES-POS,30-40,2018,9,8,14,17,Saturday,14 days,101775.818
ACC-3485804958,34,18.81,20317.31,1.0,CUS-1196156254,2018-09-08,Jessica,F,-35.01,138.52,,d5e0135b-d063-45f0-9696-81ece6091c26,-35.03,117.91,WA,Mount Clarence,debit,authorized,dab5e25e486b40b384a3343225e67c3a,SALES-POS,30-40,2018,9,8,21,47,Saturday,14 days,101775.818
ACC-3485804958,34,31.0,20286.31,,CUS-1196156254,2018-09-09,Jessica,F,-35.01,138.52,,,,,,,debit,posted,20371ea91f2141f0bb26536680f419f5,PAYMENT,30-40,2018,9,9,5,0,Sunday,14 days,101775.818
ACC-3485804958,34,31.23,20255.08,1.0,CUS-1196156254,2018-09-09,Jessica,F,-35.01,138.52,,1d1a5361-c41c-45fa-aba5-645f3b147e28,-34.93,150.76,NSW,Culburra Beach,debit,authorized,955e9d04368f4509ab749147f5d9c061,SALES-POS,30-40,2018,9,9,10,19,Sunday,14 days,101775.818
ACC-3485804958,34,9.08,20246.0,1.0,CUS-1196156254,2018-09-09,Jessica,F,-35.01,138.52,,fcf4fe27-9b25-47cd-9d79-5107b1d6e526,-34.85,150.74,NSW,Shoalhaven Heads,debit,authorized,55efad5b7651460a800e6e8dd20614e1,SALES-POS,30-40,2018,9,9,15,49,Sunday,14 days,101775.818
ACC-3485804958,34,169.0,20077.0,,CUS-1196156254,2018-09-10,Jessica,F,-35.01,138.52,,,,,,,debit,posted,529d95b87a6c4600ac73e021e8606d2a,INTER BANK,30-40,2018,9,10,3,0,Monday,14 days,101775.818
ACC-3485804958,34,102.89,19974.11,1.0,CUS-1196156254,2018-09-10,Jessica,F,-35.01,138.52,,20440fb7-e48f-46cf-afc6-a71e50c433a3,-35.32,149.1,ACT,Deakin,debit,authorized,2725e77e31de44bc816bfb9c9ec9d13b,POS,30-40,2018,9,10,9,49,Monday,14 days,101775.818
ACC-3485804958,34,31.31,19942.8,1.0,CUS-1196156254,2018-09-10,Jessica,F,-35.01,138.52,,a1265af0-d718-4285-99ce-6eb528f8527c,-35.05,147.49,NSW,Harefield,debit,authorized,0517b97bbf824237a75684063e83cd57,POS,30-40,2018,9,10,10,13,Monday,14 days,101775.818
ACC-3485804958,34,17.35,19925.45,0.0,CUS-1196156254,2018-09-10,Jessica,F,-35.01,138.52,,d27e703a-643d-4198-beb5-20e3a78b8fe9,-34.96,138.63,SA,Fullarton,debit,authorized,b444f1bcc5f44f628abafa7285e09cce,SALES-POS,30-40,2018,9,10,14,37,Monday,14 days,101775.818
ACC-3485804958,34,33.98,19891.47,0.0,CUS-1196156254,2018-09-10,Jessica,F,-35.01,138.52,,56e19732-2944-4521-94f3-c4a4595e84d0,-34.93,150.76,NSW,Culburra Beach,debit,authorized,7d72355b68ec4b1baf231414790e018d,SALES-POS,30-40,2018,9,10,17,39,Monday,14 days,101775.818
ACC-3485804958,34,12.95,19878.52,1.0,CUS-1196156254,2018-09-11,Jessica,F,-35.01,138.52,,9a112a54-f370-4115-b75f-800ca9687176,-34.75,149.72,NSW,Goulburn,debit,authorized,1e5fe66b3d5244aebe69688370e1a552,SALES-POS,30-40,2018,9,11,1,10,Tuesday,14 days,101775.818
ACC-3485804958,34,44.6,19833.92,0.0,CUS-1196156254,2018-09-11,Jessica,F,-35.01,138.52,,818e50ea-c183-40ce-80ca-16a721104f8d,-34.94,138.62,SA,Parkside,debit,authorized,3524a71a7cf5450b9a3fb7133571cd6e,POS,30-40,2018,9,11,9,4,Tuesday,14 days,101775.818
ACC-3485804958,34,39.0,19794.92,,CUS-1196156254,2018-09-11,Jessica,F,-35.01,138.52,,,,,,,debit,posted,45ef4a2b32a741f4861326deb876a960,PAYMENT,30-40,2018,9,11,14,0,Tuesday,14 days,101775.818
ACC-3485804958,34,11.31,19783.61,1.0,CUS-1196156254,2018-09-12,Jessica,F,-35.01,138.52,,93fa42e9-8c46-4fd3-b042-efba48fda9f9,-35.08,138.6,SA,Aberfoyle Park,debit,authorized,f4bb83251b954feb91a6fcfdcc6766e3,POS,30-40,2018,9,12,14,13,Wednesday,14 days,101775.818
ACC-3485804958,34,9.78,23677.56,1.0,CUS-1196156254,2018-09-12,Jessica,F,-35.01,138.52,,5db857fb-118c-4757-ab48-337ea3710e01,-35.12,147.42,NSW,Wagga Wagga,debit,authorized,068bc56f0b274778b2141cbd969ef8a9,SALES-POS,30-40,2018,9,12,19,26,Wednesday,14 days,101775.818
ACC-3485804958,34,9.35,23668.21,1.0,CUS-1196156254,2018-09-12,Jessica,F,-35.01,138.52,,5db857fb-118c-4757-ab48-337ea3710e01,-35.12,147.42,NSW,Wagga Wagga,debit,authorized,b716035d3b294a0992f8dba6ea963da6,POS,30-40,2018,9,12,20,34,Wednesday,14 days,101775.818
ACC-3485804958,34,27.0,23641.21,,CUS-1196156254,2018-09-13,Jessica,F,-35.01,138.52,,,,,,,debit,posted,d8e41adf3b9d43f9a598d88d623fd6f3,PAYMENT,30-40,2018,9,13,9,0,Thursday,14 days,101775.818
ACC-3485804958,34,16.0,23625.21,,CUS-1196156254,2018-09-14,Jessica,F,-35.01,138.52,,,,,,,debit,posted,f419d9d7f2324b04ba70a28021a6ad51,PAYMENT,30-40,2018,9,14,12,0,Friday,14 days,101775.818
ACC-3485804958,34,63.0,23562.21,,CUS-1196156254,2018-09-14,Jessica,F,-35.01,138.52,,,,,,,debit,posted,3f4639ad7a3a411d9559f75824226da3,PAYMENT,30-40,2018,9,14,19,0,Friday,14 days,101775.818
ACC-3485804958,34,7.51,23554.7,1.0,CUS-1196156254,2018-09-14,Jessica,F,-35.01,138.52,,21b61d81-d7af-47f3-8831-2b134cd1ec99,-35.02,117.92,WA,Middleton Beach,debit,authorized,7fd8df9ade684e1ca54ee39fe2e4272e,POS,30-40,2018,9,14,20,28,Friday,14 days,101775.818
ACC-3485804958,34,49.75,23504.95,1.0,CUS-1196156254,2018-09-15,Jessica,F,-35.01,138.52,,d47efc0a-2443-47d0-ad6b-4379779d2e3e,-35.03,117.89,WA,Albany,debit,authorized,55fa9a0cd66f46e1a79e30e01f6520a0,POS,30-40,2018,9,15,4,22,Saturday,14 days,101775.818
ACC-3485804958,34,27.62,23477.33,1.0,CUS-1196156254,2018-09-15,Jessica,F,-35.01,138.52,,c7c3f0d7-5cac-48ff-bec3-59dadb194279,-34.9,138.64,SA,Marden,debit,authorized,005b7ca511bb4aa2b74681c5c8249e44,SALES-POS,30-40,2018,9,15,12,48,Saturday,14 days,101775.818
ACC-3485804958,34,24.36,23452.97,1.0,CUS-1196156254,2018-09-16,Jessica,F,-35.01,138.52,,1a99ba7a-42b7-40ce-ac39-d878c15e1b16,-35.34,143.56,VIC,Swan Hill,debit,authorized,9d20cf161dfd466fb82fff992c365354,POS,30-40,2018,9,16,4,32,Sunday,14 days,101775.818
ACC-3485804958,34,31.0,23421.97,,CUS-1196156254,2018-09-16,Jessica,F,-35.01,138.52,,,,,,,debit,posted,21a070d8c9d748ef893a40dc79acd866,PAYMENT,30-40,2018,9,16,5,0,Sunday,14 days,101775.818
ACC-3485804958,34,14.09,23407.88,1.0,CUS-1196156254,2018-09-16,Jessica,F,-35.01,138.52,,75447b29-3ce1-466b-bf1d-4b3004f2c02d,-34.92,138.6,SA,Adelaide,debit,authorized,2bc46594e11243ffbe469390410efd3a,POS,30-40,2018,9,16,10,39,Sunday,14 days,101775.818
ACC-3485804958,34,34.69,23373.19,1.0,CUS-1196156254,2018-09-16,Jessica,F,-35.01,138.52,,ab523591-340e-4293-ae1e-da2cb9d08dd4,-35.02,117.89,WA,Mira Mar,debit,authorized,a29d4c6b6255457d854e2ee0265360bf,SALES-POS,30-40,2018,9,16,15,34,Sunday,14 days,101775.818
ACC-3485804958,34,130.0,23243.19,,CUS-1196156254,2018-09-16,Jessica,F,-35.01,138.52,,,,,,,debit,posted,f68d52eaca444ecbad2b96a60f065b13,INTER BANK,30-40,2018,9,16,23,0,Sunday,14 days,101775.818
ACC-3485804958,34,11.47,23231.72,1.0,CUS-1196156254,2018-09-17,Jessica,F,-35.01,138.52,,9ed79227-3a16-4aad-94fd-6542f61450a8,-35.28,149.13,ACT,Canberra,debit,authorized,9170583a6b5a49869e7d3b8d13a62cac,SALES-POS,30-40,2018,9,17,8,44,Monday,14 days,101775.818
ACC-3485804958,34,28.33,23203.39,1.0,CUS-1196156254,2018-09-17,Jessica,F,-35.01,138.52,,0a0b9723-63c1-4ac5-b679-7299fa3758bb,-35.03,117.88,WA,Albany,debit,authorized,5fb7bd2ed54d4ab7bee5299a6494ef5e,SALES-POS,30-40,2018,9,17,9,39,Monday,14 days,101775.818
ACC-3485804958,34,75.0,23128.39,,CUS-1196156254,2018-09-18,Jessica,F,-35.01,138.52,,,,,,,debit,posted,b6aa7d82626d4f0797e701d8fe119648,PAYMENT,30-40,2018,9,18,11,0,Tuesday,14 days,101775.818
ACC-3485804958,34,39.0,23089.39,,CUS-1196156254,2018-09-18,Jessica,F,-35.01,138.52,,,,,,,debit,posted,3c22f374b6b5474796bab05606869555,PAYMENT,30-40,2018,9,18,14,0,Tuesday,14 days,101775.818
ACC-3485804958,34,11.55,23077.84,1.0,CUS-1196156254,2018-09-19,Jessica,F,-35.01,138.52,,13b56cec-9433-473e-a12f-5c81d27a24ae,-35.02,117.88,WA,Albany,debit,authorized,805baa0e19014190b6e3c7b0e607865f,POS,30-40,2018,9,19,15,36,Wednesday,14 days,101775.818
ACC-3485804958,34,14.11,23063.73,1.0,CUS-1196156254,2018-09-19,Jessica,F,-35.01,138.52,,c9a7d15f-11e9-40e7-a480-33b22a4c5f1a,-34.92,138.59,SA,Adelaide,debit,authorized,7440e4ab101840759a1f1b9241aa0715,SALES-POS,30-40,2018,9,19,19,44,Wednesday,14 days,101775.818
ACC-3485804958,34,35.79,23027.94,1.0,CUS-1196156254,2018-09-20,Jessica,F,-35.01,138.52,,745e87e1-2454-4028-bec9-ee97ff30f8c0,-35.02,117.88,WA,Albany,debit,authorized,b6ba2148e0c245978442aa0083cab405,SALES-POS,30-40,2018,9,20,7,29,Thursday,14 days,101775.818
ACC-3485804958,34,27.0,23000.94,,CUS-1196156254,2018-09-20,Jessica,F,-35.01,138.52,,,,,,,debit,posted,9ad67a4601aa4a8ba5531006db9ca7fc,PAYMENT,30-40,2018,9,20,9,0,Thursday,14 days,101775.818
ACC-3485804958,34,22.22,22978.72,1.0,CUS-1196156254,2018-09-20,Jessica,F,-35.01,138.52,,d7b8f51e-1832-4609-8d34-3e2de4445823,-35.12,147.36,NSW,Wagga Wagga,debit,authorized,0ebfbeea414a4f1d879ab0fca41f3bd7,SALES-POS,30-40,2018,9,20,17,32,Thursday,14 days,101775.818
ACC-3485804958,34,49.01,22929.71,1.0,CUS-1196156254,2018-09-20,Jessica,F,-35.01,138.52,,96d8c93f-1d3a-4853-b08f-84d87ca73475,-35.35,149.09,ACT,Phillip,debit,authorized,2b20becf8e534f78897bf7ecbf0df658,POS,30-40,2018,9,20,19,8,Thursday,14 days,101775.818
ACC-3485804958,34,10.3,22919.41,1.0,CUS-1196156254,2018-09-21,Jessica,F,-35.01,138.52,,eafe401d-dcda-483c-97f1-469d4482d417,-34.75,150.83,NSW,Gerringong,debit,authorized,01e3ff3a9bde42e1b0128ead6a772c2e,SALES-POS,30-40,2018,9,21,0,44,Friday,14 days,101775.818
ACC-3485804958,34,16.0,22903.41,,CUS-1196156254,2018-09-21,Jessica,F,-35.01,138.52,,,,,,,debit,posted,45459f2391ab40b2ab1716b70e8e51e4,PAYMENT,30-40,2018,9,21,12,0,Friday,14 days,101775.818
ACC-3485804958,34,37.0,22866.41,0.0,CUS-1196156254,2018-09-21,Jessica,F,-35.01,138.52,,03b7047b-72fa-41ba-9b20-e8c2c8312bf0,-35.35,149.08,ACT,Phillip,debit,authorized,dfbd27c7c2724f3a9972532315fecb5a,POS,30-40,2018,9,21,13,38,Friday,14 days,101775.818
ACC-3485804958,34,25.71,22840.7,1.0,CUS-1196156254,2018-09-21,Jessica,F,-35.01,138.52,,cd6b9ee2-6660-41f0-807e-e403063257fd,-34.9,138.87,SA,Lobethal,debit,authorized,22c6713b19094ca5a4ca24e1408ff494,SALES-POS,30-40,2018,9,21,17,19,Friday,14 days,101775.818
ACC-3485804958,34,24.72,22815.98,0.0,CUS-1196156254,2018-09-21,Jessica,F,-35.01,138.52,,1c968353-0209-4d4a-8fec-1388cfc4e900,-34.93,138.6,SA,Adelaide,debit,authorized,93dce30a109049ecbbeacadd875d46b8,POS,30-40,2018,9,21,17,45,Friday,14 days,101775.818
ACC-3485804958,34,63.0,22752.98,,CUS-1196156254,2018-09-21,Jessica,F,-35.01,138.52,,,,,,,debit,posted,5b619d1b0801448ab8e343506f3d79fb,PAYMENT,30-40,2018,9,21,19,0,Friday,14 days,101775.818
ACC-3485804958,34,13.76,22739.22,0.0,CUS-1196156254,2018-09-21,Jessica,F,-35.01,138.52,,25b0fa43-750c-4c0c-b4ec-0c858600bc6d,-34.78,150.7,NSW,Berry,debit,authorized,5deb51eb35a44d9cb3c72ea6236e7dc3,SALES-POS,30-40,2018,9,21,21,26,Friday,14 days,101775.818
ACC-3485804958,34,11.12,22728.1,1.0,CUS-1196156254,2018-09-22,Jessica,F,-35.01,138.52,,35e00b7c-1d21-4926-a645-2df4694163e8,-35.1,138.5,SA,Lonsdale,debit,authorized,4ed9926509cb47d1a7f386334c0815ec,POS,30-40,2018,9,22,0,54,Saturday,14 days,101775.818
ACC-3485804958,34,11.84,22716.26,1.0,CUS-1196156254,2018-09-22,Jessica,F,-35.01,138.52,,a3adc59f-5e58-4d80-afb2-f00d23c324d9,-34.93,138.6,SA,Adelaide,debit,authorized,188ba51880cb41159cbb4d38ba9de79e,POS,30-40,2018,9,22,9,1,Saturday,14 days,101775.818
ACC-3485804958,34,118.51,22597.75,1.0,CUS-1196156254,2018-09-22,Jessica,F,-35.01,138.52,,b8009e6e-dfdd-448e-bf3c-97064a9bbf57,-34.93,138.59,SA,Adelaide,debit,authorized,f23e65ff46dc4dddb0412be326422778,POS,30-40,2018,9,22,22,19,Saturday,14 days,101775.818
ACC-3485804958,34,12.68,22585.07,0.0,CUS-1196156254,2018-09-22,Jessica,F,-35.01,138.52,,57454818-9f5a-438f-b493-8bb5bc0d7e67,-34.99,117.85,WA,Mckail,debit,authorized,2627d31f4a3f494d8e4002d8da2ce93a,POS,30-40,2018,9,22,22,48,Saturday,14 days,101775.818
ACC-3485804958,34,49.76,22535.31,0.0,CUS-1196156254,2018-09-23,Jessica,F,-35.01,138.52,,d47efc0a-2443-47d0-ad6b-4379779d2e3e,-35.03,117.89,WA,Albany,debit,authorized,1f495b802dae407fb75c610080dd9850,POS,30-40,2018,9,23,1,12,Sunday,14 days,101775.818
ACC-3485804958,34,31.0,22504.31,,CUS-1196156254,2018-09-23,Jessica,F,-35.01,138.52,,,,,,,debit,posted,958d8e35a3fc4e94b6ad9c1b5a2c20d2,PAYMENT,30-40,2018,9,23,5,0,Sunday,14 days,101775.818
ACC-3485804958,34,25.14,22479.17,1.0,CUS-1196156254,2018-09-23,Jessica,F,-35.01,138.52,,cb631cac-0d21-4ee3-9293-bb5bf6ac5569,-35.35,149.09,ACT,Phillip,debit,authorized,9f727cbbd5364f0d81cf2725db48926c,SALES-POS,30-40,2018,9,23,9,35,Sunday,14 days,101775.818
ACC-3485804958,34,25.51,22453.66,0.0,CUS-1196156254,2018-09-23,Jessica,F,-35.01,138.52,,8d505855-d938-41b3-9ee0-7063c5abf848,-34.95,138.61,SA,Unley,debit,authorized,370ec026568e456ab1a65038fa5101cb,POS,30-40,2018,9,23,15,17,Sunday,14 days,101775.818
ACC-3485804958,34,25.23,22428.43,0.0,CUS-1196156254,2018-09-23,Jessica,F,-35.01,138.52,,8b27d913-3fc4-4ae7-abf1-a6325a819d19,-34.92,138.6,SA,Adelaide,debit,authorized,4342300a53474dc08117cb0ce8923408,POS,30-40,2018,9,23,19,42,Sunday,14 days,101775.818
ACC-3485804958,34,15.51,22412.92,1.0,CUS-1196156254,2018-09-24,Jessica,F,-35.01,138.52,,4b18f2e9-aca8-408a-8c9e-7ef285fc06d1,-35.24,149.07,ACT,Belconnen,debit,authorized,92e87a49e8614f4ca49cc7ab08acfb3b,SALES-POS,30-40,2018,9,24,8,13,Monday,14 days,101775.818
ACC-3485804958,34,10.05,22402.87,0.0,CUS-1196156254,2018-09-25,Jessica,F,-35.01,138.52,,70c84b85-fd0f-4d7a-a09c-c11599ba16a5,-35.34,149.03,ACT,Duffy,debit,authorized,be2a6fadb23944d591fe5b4652080b59,SALES-POS,30-40,2018,9,25,8,15,Tuesday,14 days,101775.818
ACC-3485804958,34,81.36,22321.51,1.0,CUS-1196156254,2018-09-25,Jessica,F,-35.01,138.52,,fedbbadf-3ae8-43e7-9501-e568effeebec,-34.92,138.64,SA,Norwood,debit,authorized,f2f1322b37c74819bc89bdb19fe8ffe2,SALES-POS,30-40,2018,9,25,9,15,Tuesday,14 days,101775.818
ACC-3485804958,34,8.75,22312.76,1.0,CUS-1196156254,2018-09-25,Jessica,F,-35.01,138.52,,5db857fb-118c-4757-ab48-337ea3710e01,-35.12,147.42,NSW,Wagga Wagga,debit,authorized,95d8db0f264b4472b4ab766ba1993420,SALES-POS,30-40,2018,9,25,10,11,Tuesday,14 days,101775.818
ACC-3485804958,34,12.23,22300.53,0.0,CUS-1196156254,2018-09-25,Jessica,F,-35.01,138.52,,5a3c0cad-eb95-43f2-9d62-c55f9d325ce9,-35.1,147.38,NSW,North Wagga Wagga,debit,authorized,b6a42f87f3234b3ab36fc536252caea4,POS,30-40,2018,9,25,11,59,Tuesday,14 days,101775.818
ACC-3485804958,34,39.0,22261.53,,CUS-1196156254,2018-09-25,Jessica,F,-35.01,138.52,,,,,,,debit,posted,c4b85f54970646a0b8c3064f6f4109c8,PAYMENT,30-40,2018,9,25,14,0,Tuesday,14 days,101775.818
ACC-3485804958,34,22.34,22239.19,1.0,CUS-1196156254,2018-09-26,Jessica,F,-35.01,138.52,,defbfdb1-32de-47dd-8156-508f664ef87e,-34.77,149.69,NSW,Goulburn,debit,authorized,c856f0719a884d63a1bfd2b9e0464e1b,POS,30-40,2018,9,26,1,49,Wednesday,14 days,101775.818
ACC-3485804958,34,27.4,22211.79,1.0,CUS-1196156254,2018-09-26,Jessica,F,-35.01,138.52,,6b7baa9c-f976-4c44-b40c-2793dc794569,-34.99,138.54,SA,Glengowrie,debit,authorized,4238ddba1a404196a3417b31c8b1ec6c,SALES-POS,30-40,2018,9,26,4,46,Wednesday,14 days,101775.818
ACC-3485804958,34,156.68,22055.11,1.0,CUS-1196156254,2018-09-26,Jessica,F,-35.01,138.52,,cd00f1ea-a82d-4cae-88c4-590a9f77c638,-35.28,149.13,ACT,Canberra,debit,authorized,aa10995dd3ed428faa7fa477f331aff3,SALES-POS,30-40,2018,9,26,9,19,Wednesday,14 days,101775.818
ACC-3485804958,34,27.0,25917.66,,CUS-1196156254,2018-09-27,Jessica,F,-35.01,138.52,,,,,,,debit,posted,c53a068075c6411fad04c84297c31d9f,PAYMENT,30-40,2018,9,27,9,0,Thursday,14 days,101775.818
ACC-3485804958,34,14.18,25944.66,1.0,CUS-1196156254,2018-09-27,Jessica,F,-35.01,138.52,,e6dd1c40-9574-4d2f-a6ce-9f7528b339d0,-35.11,147.36,NSW,Wagga Wagga,debit,authorized,ab7e902a7f404ea8a29ce481ad8b8692,POS,30-40,2018,9,27,9,14,Thursday,14 days,101775.818
ACC-3485804958,34,18.7,25898.96,1.0,CUS-1196156254,2018-09-27,Jessica,F,-35.01,138.52,,b944f633-31bb-46ee-9bde-ca97ccaf3e18,-35.01,117.72,WA,Elleker,debit,authorized,b7e1176313934fb1a13b572eac19df1c,POS,30-40,2018,9,27,17,30,Thursday,14 days,101775.818
ACC-3485804958,34,15.32,25883.64,1.0,CUS-1196156254,2018-09-27,Jessica,F,-35.01,138.52,,6cf8968f-11f3-4599-ab02-f264bdb2e671,-34.83,138.5,SA,Peterhead,debit,authorized,7ab82290ef8a482d8bb8509fc911f53c,SALES-POS,30-40,2018,9,27,21,17,Thursday,14 days,101775.818
ACC-3485804958,34,7.86,25875.78,1.0,CUS-1196156254,2018-09-28,Jessica,F,-35.01,138.52,,37a25201-df58-4243-bb29-09895061ec33,-35.3,149.19,ACT,Majura Park,debit,authorized,bc3367e5ede64cbba011a1ca8f1e6661,SALES-POS,30-40,2018,9,28,2,27,Friday,14 days,101775.818
ACC-3485804958,34,177.0,25681.82,,CUS-1196156254,2018-09-28,Jessica,F,-35.01,138.52,,,,,,,debit,posted,b689730c2c2b4756bd6674d97b0cb96a,PAYMENT,30-40,2018,9,28,8,0,Friday,14 days,101775.818
ACC-3485804958,34,16.96,25858.82,0.0,CUS-1196156254,2018-09-28,Jessica,F,-35.01,138.52,,2a87bd94-e8d2-4e41-9e05-d0d99505d414,-35.02,117.88,WA,Albany,debit,authorized,bb5a7190a4c24e8b9fcfea60050474d8,SALES-POS,30-40,2018,9,28,8,53,Friday,14 days,101775.818
ACC-3485804958,34,16.0,25665.82,,CUS-1196156254,2018-09-28,Jessica,F,-35.01,138.52,,,,,,,debit,posted,01b29f3d22944045961d2245dc80ba9b,PAYMENT,30-40,2018,9,28,12,0,Friday,14 days,101775.818
ACC-3485804958,34,13.1,25652.72,0.0,CUS-1196156254,2018-09-28,Jessica,F,-35.01,138.52,,9501a84e-7d76-474f-9d50-522a355e10e3,-35.01,117.9,WA,Spencer Park,debit,authorized,bbb560c02f494bb190b7fe83a5ba1185,POS,30-40,2018,9,28,16,49,Friday,14 days,101775.818
ACC-3485804958,34,29.31,25623.41,1.0,CUS-1196156254,2018-09-28,Jessica,F,-35.01,138.52,,0a0b9723-63c1-4ac5-b679-7299fa3758bb,-35.03,117.88,WA,Albany,debit,authorized,dfa3940f86ac4da09b268560db12407f,SALES-POS,30-40,2018,9,28,17,31,Friday,14 days,101775.818
ACC-3485804958,34,63.0,25545.89,,CUS-1196156254,2018-09-28,Jessica,F,-35.01,138.52,,,,,,,debit,posted,e2cdec4c66a341a3961389bb636bff0f,PAYMENT,30-40,2018,9,28,19,0,Friday,14 days,101775.818
ACC-3485804958,34,14.52,25608.89,1.0,CUS-1196156254,2018-09-28,Jessica,F,-35.01,138.52,,b6cb6ab5-e6fe-4a64-9247-c808b9ea22c8,-34.95,138.52,SA,Adelaide Airport,debit,authorized,02b5a3ee70d14fb191a473a686c730ac,SALES-POS,30-40,2018,9,28,19,28,Friday,14 days,101775.818
ACC-3485804958,34,31.0,25514.89,,CUS-1196156254,2018-09-30,Jessica,F,-35.01,138.52,,,,,,,debit,posted,20857c79191942f2a5148334e8ce778e,PAYMENT,30-40,2018,9,30,5,0,Sunday,14 days,101775.818
ACC-3485804958,34,16.85,25498.04,1.0,CUS-1196156254,2018-10-01,Jessica,F,-35.01,138.52,,91349a57-c0c6-4868-9eec-a27f0f65df7f,-34.95,138.58,SA,Everard Park,debit,authorized,3e487c99b8994ead93ff02643220679f,SALES-POS,30-40,2018,10,1,10,7,Monday,14 days,101775.818
ACC-3485804958,34,103.06,25394.98,0.0,CUS-1196156254,2018-10-01,Jessica,F,-35.01,138.52,,7eedce4e-a959-4b13-b9ab-314071f88f3a,-35.35,149.11,ACT,O'Malley,debit,authorized,ac300efb115943338d644611a164c168,SALES-POS,30-40,2018,10,1,15,9,Monday,14 days,101775.818
ACC-3485804958,34,39.0,25355.98,,CUS-1196156254,2018-10-02,Jessica,F,-35.01,138.52,,,,,,,debit,posted,a547185c637d43719d2adc48bd05817f,PAYMENT,30-40,2018,10,2,14,0,Tuesday,14 days,101775.818
ACC-3485804958,34,27.0,25323.28,,CUS-1196156254,2018-10-04,Jessica,F,-35.01,138.52,,,,,,,debit,posted,2aa82f2f7d484a758d744d7012e50127,PAYMENT,30-40,2018,10,4,9,0,Thursday,14 days,101775.818
ACC-3485804958,34,5.7,25350.28,0.0,CUS-1196156254,2018-10-04,Jessica,F,-35.01,138.52,,3b891da7-8910-4ca0-bd80-70c7d49b24d5,-34.87,150.6,NSW,Nowra,debit,authorized,16bc091c58ea4766af30ee15499d5ee9,POS,30-40,2018,10,4,9,42,Thursday,14 days,101775.818
ACC-3485804958,34,65.92,25257.36,1.0,CUS-1196156254,2018-10-04,Jessica,F,-35.01,138.52,,c4ebb892-da25-40b7-80b8-482f51968b68,-37.82,144.98,VIC,East Melbourne,debit,authorized,71fc4792dcb649fd8f88f8f908fb47c5,POS,30-40,2018,10,4,15,16,Thursday,14 days,101775.818
ACC-3485804958,34,34.39,25222.97,1.0,CUS-1196156254,2018-10-04,Jessica,F,-35.01,138.52,,b2bfeb0c-0b50-493e-a1e4-bd6c571b22a6,-37.81,144.97,VIC,Melbourne,debit,authorized,d98088053d9040dfa2a5554eb7698643,SALES-POS,30-40,2018,10,4,22,6,Thursday,14 days,101775.818
ACC-3485804958,34,16.78,25206.19,1.0,CUS-1196156254,2018-10-05,Jessica,F,-35.01,138.52,,6714d0be-9a69-4d2c-8d45-c8fc84df9eaa,-37.82,144.97,VIC,Melbourne,debit,authorized,2f98210228074af6b69cef63ac66fac6,POS,30-40,2018,10,5,3,52,Friday,14 days,101775.818
ACC-3485804958,34,16.0,25190.19,,CUS-1196156254,2018-10-05,Jessica,F,-35.01,138.52,,,,,,,debit,posted,6e79242893c44386b0a4f7c1c7dd5b7a,PAYMENT,30-40,2018,10,5,12,0,Friday,14 days,101775.818
ACC-3485804958,34,63.0,25127.19,,CUS-1196156254,2018-10-05,Jessica,F,-35.01,138.52,,,,,,,debit,posted,772356e481e44f90be1fe49810d9333b,PAYMENT,30-40,2018,10,5,19,0,Friday,14 days,101775.818
ACC-3485804958,34,31.0,25096.19,,CUS-1196156254,2018-10-07,Jessica,F,-35.01,138.52,,,,,,,debit,posted,27c557e6882d4f3a9c5b53c8870fe50d,PAYMENT,30-40,2018,10,7,5,0,Sunday,14 days,101775.818
ACC-3485804958,34,5.6,25090.59,1.0,CUS-1196156254,2018-10-07,Jessica,F,-35.01,138.52,,9d8cbcd5-8f3a-42b6-b4c0-a978a0dd0daa,-35.12,139.27,SA,Murray Bridge,debit,authorized,d15ad25bf9204ed685bd88686d1d9dd3,POS,30-40,2018,10,7,21,33,Sunday,14 days,101775.818
ACC-3485804958,34,23.16,25067.43,1.0,CUS-1196156254,2018-10-07,Jessica,F,-35.01,138.52,,9b9d1085-87e7-4d4b-99ab-b7156c690019,-35.31,149.11,ACT,Deakin,debit,authorized,64dc5d60fa1e466bacca993ee6e638a2,SALES-POS,30-40,2018,10,7,22,47,Sunday,14 days,101775.818
ACC-3485804958,34,12.82,25054.61,0.0,CUS-1196156254,2018-10-08,Jessica,F,-35.01,138.52,,5a3c0cad-eb95-43f2-9d62-c55f9d325ce9,-35.1,147.38,NSW,North Wagga Wagga,debit,authorized,f8c61a44a6a3473bb71ec79537d1db20,SALES-POS,30-40,2018,10,8,14,49,Monday,14 days,101775.818
ACC-3485804958,34,16.0,25038.61,1.0,CUS-1196156254,2018-10-09,Jessica,F,-35.01,138.52,,00dd8b3e-72dc-4965-b8e3-9acf0289405d,-35.02,117.88,WA,Albany,debit,authorized,c9d8dc0a1212412cbba28e886a7596b5,POS,30-40,2018,10,9,10,27,Tuesday,14 days,101775.818
ACC-3485804958,34,12.96,25025.65,1.0,CUS-1196156254,2018-10-09,Jessica,F,-35.01,138.52,,3e111141-2bd3-4035-b228-64c2e2092109,-35.02,117.88,WA,Albany,debit,authorized,5ddd96e025a0402db0e9380888306683,POS,30-40,2018,10,9,11,57,Tuesday,14 days,101775.818
ACC-3485804958,34,39.0,24972.1,,CUS-1196156254,2018-10-09,Jessica,F,-35.01,138.52,,,,,,,debit,posted,6e289cb6b0ee4d6095d0f940097fc2fe,PAYMENT,30-40,2018,10,9,14,0,Tuesday,14 days,101775.818
ACC-3485804958,34,14.55,25011.1,1.0,CUS-1196156254,2018-10-09,Jessica,F,-35.01,138.52,,d425e815-9a0a-4a4a-b9b7-9394dc05f22c,-35.03,117.88,WA,Albany,debit,authorized,cb2829df239a41a9bb243c4cb427e3e0,POS,30-40,2018,10,9,14,47,Tuesday,14 days,101775.818
ACC-3485804958,34,22.22,24949.88,1.0,CUS-1196156254,2018-10-09,Jessica,F,-35.01,138.52,,d5e0135b-d063-45f0-9696-81ece6091c26,-35.03,117.91,WA,Mount Clarence,debit,authorized,85590e7b0b504118929bffd624144299,SALES-POS,30-40,2018,10,9,16,12,Tuesday,14 days,101775.818
ACC-3485804958,34,123.7,24826.18,1.0,CUS-1196156254,2018-10-09,Jessica,F,-35.01,138.52,,0bb9a68e-ba79-4ca9-adea-b92d1768eb5e,-31.95,115.86,WA,Perth,debit,authorized,ad087949f0ce4d92a7a04a1d87ef58a0,SALES-POS,30-40,2018,10,9,21,29,Tuesday,14 days,101775.818
ACC-3485804958,34,169.0,24657.18,,CUS-1196156254,2018-10-10,Jessica,F,-35.01,138.52,,,,,,,debit,posted,1435f9cbb6b44f868d201c9bf17663ec,INTER BANK,30-40,2018,10,10,3,0,Wednesday,14 days,101775.818
ACC-3485804958,34,6.33,24650.85,1.0,CUS-1196156254,2018-10-10,Jessica,F,-35.01,138.52,,158e9021-caa1-45ce-ab1e-5e5ec4605eba,-34.85,138.5,SA,Port Adelaide,debit,authorized,a0464832665a46ff98ddb414fcef3f5e,SALES-POS,30-40,2018,10,10,9,36,Wednesday,14 days,101775.818
ACC-3485804958,34,25.48,24625.37,1.0,CUS-1196156254,2018-10-10,Jessica,F,-35.01,138.52,,ad7ccfd9-0fb2-47bb-905f-6e1d97945c8c,-34.91,150.6,NSW,South Nowra,debit,authorized,a201085db7ed4064a24827d3011885f9,SALES-POS,30-40,2018,10,10,15,14,Wednesday,14 days,101775.818
ACC-3485804958,34,7.73,28521.37,1.0,CUS-1196156254,2018-10-10,Jessica,F,-35.01,138.52,,3bd1ce17-8073-4bfd-bd80-3aefe676638e,-34.93,138.6,SA,Adelaide,debit,authorized,d614f637303b4e7092851c821b9ba489,SALES-POS,30-40,2018,10,10,20,44,Wednesday,14 days,101775.818
ACC-3485804958,34,6.09,28515.28,0.0,CUS-1196156254,2018-10-11,Jessica,F,-35.01,138.52,,4d4e80af-5875-433e-aae3-dddbcbb731fb,-34.91,138.66,SA,Firle,debit,authorized,bb8ecef7fef0418ebdc10c86a2939977,SALES-POS,30-40,2018,10,11,8,59,Thursday,14 days,101775.818
ACC-3485804958,34,27.0,28488.28,,CUS-1196156254,2018-10-11,Jessica,F,-35.01,138.52,,,,,,,debit,posted,bb1445d8a6ac40f8bad1e8874877d4c1,PAYMENT,30-40,2018,10,11,9,0,Thursday,14 days,101775.818
ACC-3485804958,34,21.62,28466.66,1.0,CUS-1196156254,2018-10-11,Jessica,F,-35.01,138.52,,d5e0135b-d063-45f0-9696-81ece6091c26,-35.03,117.91,WA,Mount Clarence,debit,authorized,a5c338e79bf7446f82b16bb438351c0f,POS,30-40,2018,10,11,23,27,Thursday,14 days,101775.818
ACC-3485804958,34,19.55,28447.11,1.0,CUS-1196156254,2018-10-12,Jessica,F,-35.01,138.52,,c164d8f2-c4bf-45c4-bfab-123a83c02d18,-34.77,149.69,NSW,Goulburn,debit,authorized,ddbfa8348bfe41859f26d64f11d0d7e6,SALES-POS,30-40,2018,10,12,11,11,Friday,14 days,101775.818
ACC-3485804958,34,16.0,28431.11,,CUS-1196156254,2018-10-12,Jessica,F,-35.01,138.52,,,,,,,debit,posted,e59422458a814ebfa4b2afd96bc93497,PAYMENT,30-40,2018,10,12,12,0,Friday,14 days,101775.818
ACC-3485804958,34,36.51,28394.6,1.0,CUS-1196156254,2018-10-12,Jessica,F,-35.01,138.52,,0686236f-a990-4dc3-8667-f717542465e1,-34.95,138.52,SA,West Beach,debit,authorized,7a9164b31f1c45b9ab7e74a838ac1950,SALES-POS,30-40,2018,10,12,15,25,Friday,14 days,101775.818
ACC-3485804958,34,13.37,28381.23,1.0,CUS-1196156254,2018-10-12,Jessica,F,-35.01,138.52,,834d0c36-2c53-4706-a864-db338ddcc31a,-35.34,149.15,ACT,Narrabundah,debit,authorized,541f60d53ad24b26b1c8f2158b07f3bd,SALES-POS,30-40,2018,10,12,15,55,Friday,14 days,101775.818
ACC-3485804958,34,63.0,28318.23,,CUS-1196156254,2018-10-12,Jessica,F,-35.01,138.52,,,,,,,debit,posted,65cf813f53554b6e9cff1573792d48fc,PAYMENT,30-40,2018,10,12,19,0,Friday,14 days,101775.818
ACC-3485804958,34,29.26,28288.97,1.0,CUS-1196156254,2018-10-12,Jessica,F,-35.01,138.52,,22d331b1-9ed2-4b15-adc2-97000f6143e5,-34.91,139.3,SA,Mannum,debit,authorized,71c0124865414c37ad1f2cf276648fcf,POS,30-40,2018,10,12,21,36,Friday,14 days,101775.818
ACC-3485804958,34,17.08,28271.89,1.0,CUS-1196156254,2018-10-13,Jessica,F,-35.01,138.52,,d27e703a-643d-4198-beb5-20e3a78b8fe9,-34.96,138.63,SA,Fullarton,debit,authorized,d806f96b3408404bb319a8ce253c06ae,POS,30-40,2018,10,13,1,14,Saturday,14 days,101775.818
ACC-3485804958,34,18.23,28253.66,1.0,CUS-1196156254,2018-10-13,Jessica,F,-35.01,138.52,,9618e4cc-51ea-4f62-ad61-44da07772d73,-34.93,138.61,SA,Adelaide,debit,authorized,401dd90f4cc34d00b968f2dbb454ac09,POS,30-40,2018,10,13,14,45,Saturday,14 days,101775.818
ACC-3485804958,34,59.22,28194.44,0.0,CUS-1196156254,2018-10-13,Jessica,F,-35.01,138.52,,2d3f9099-eb95-48d7-8e34-ef4c4f1e492b,-37.83,144.99,VIC,Cremorne,debit,authorized,39befb3e34e946ab80dc2371c0111672,POS,30-40,2018,10,13,17,13,Saturday,14 days,101775.818
ACC-3485804958,34,84.57,28109.87,1.0,CUS-1196156254,2018-10-14,Jessica,F,-35.01,138.52,,c3c59d36-40bc-4aab-99cd-473c5711f05a,-34.88,150.6,NSW,Nowra,debit,authorized,944b9f8b6d234f0bbd03812eb827de48,POS,30-40,2018,10,14,1,58,Sunday,14 days,101775.818
ACC-3485804958,34,31.0,28078.87,,CUS-1196156254,2018-10-14,Jessica,F,-35.01,138.52,,,,,,,debit,posted,6932a9ef8af34a96b4a114bf5df7de76,PAYMENT,30-40,2018,10,14,5,0,Sunday,14 days,101775.818
ACC-3485804958,34,30.32,28048.55,1.0,CUS-1196156254,2018-10-14,Jessica,F,-35.01,138.52,,2c63709e-b73e-4e47-8d45-898cb136ec42,-35.24,149.07,ACT,Belconnen,debit,authorized,53f2280217b845bc82874e679c4ad598,SALES-POS,30-40,2018,10,14,10,51,Sunday,14 days,101775.818
ACC-3485804958,34,79.16,27969.39,1.0,CUS-1196156254,2018-10-14,Jessica,F,-35.01,138.52,,1215ed67-7b95-4d36-8344-9b9e16724acc,-34.92,138.62,SA,Norwood,debit,authorized,142aed2999284adfaa67f4307c91c5e0,POS,30-40,2018,10,14,17,45,Sunday,14 days,101775.818
ACC-3485804958,34,30.94,27938.45,1.0,CUS-1196156254,2018-10-14,Jessica,F,-35.01,138.52,,675bfbd2-4886-453a-8991-ab9f514bb5de,-34.94,138.63,SA,Glenside,debit,authorized,4e9912806ca549d48d13038ff11b012b,POS,30-40,2018,10,14,19,42,Sunday,14 days,101775.818
ACC-3485804958,34,14.41,27924.04,1.0,CUS-1196156254,2018-10-14,Jessica,F,-35.01,138.52,,45cd10b2-8c0c-48fe-8b11-4df5eebab8a9,-34.75,149.72,NSW,Goulburn,debit,authorized,7082dba1cf6846c786e0bc5260fd8681,POS,30-40,2018,10,14,20,2,Sunday,14 days,101775.818
ACC-3485804958,34,23.38,27900.66,1.0,CUS-1196156254,2018-10-16,Jessica,F,-35.01,138.52,,4b65c92b-c330-4dae-9c64-e8b53a8030f4,-34.79,138.69,SA,Golden Grove,debit,authorized,1672a7953f8f4fb48fc8d27c75e8fdd8,SALES-POS,30-40,2018,10,16,12,5,Tuesday,14 days,101775.818
ACC-3485804958,34,39.0,27827.77,,CUS-1196156254,2018-10-16,Jessica,F,-35.01,138.52,,,,,,,debit,posted,7f9078cf815b477996434647d94c60f8,PAYMENT,30-40,2018,10,16,14,0,Tuesday,14 days,101775.818
ACC-3485804958,34,33.89,27866.77,1.0,CUS-1196156254,2018-10-16,Jessica,F,-35.01,138.52,,19888e96-b5ce-4fdc-af64-60accbb64263,-33.86,151.06,NSW,Lidcombe,debit,authorized,3964021a8ab844c98ec671f767bc4b9d,SALES-POS,30-40,2018,10,16,14,21,Tuesday,14 days,101775.818
ACC-3485804958,34,130.0,27697.77,,CUS-1196156254,2018-10-16,Jessica,F,-35.01,138.52,,,,,,,debit,posted,cf2dcc84aae54d2aa0a7cbd6e56deb92,INTER BANK,30-40,2018,10,16,23,0,Tuesday,14 days,101775.818
ACC-3485804958,34,27.0,27670.77,,CUS-1196156254,2018-10-18,Jessica,F,-35.01,138.52,,,,,,,debit,posted,36c5efa6aa8a466a8cb19288d43f978f,PAYMENT,30-40,2018,10,18,9,0,Thursday,14 days,101775.818
ACC-3485804958,34,75.0,27595.77,,CUS-1196156254,2018-10-18,Jessica,F,-35.01,138.52,,,,,,,debit,posted,b92480d9330e4a33b8beea9b179a592b,PAYMENT,30-40,2018,10,18,11,0,Thursday,14 days,101775.818
ACC-3485804958,34,16.0,27579.77,,CUS-1196156254,2018-10-19,Jessica,F,-35.01,138.52,,,,,,,debit,posted,5c2183392dc64d3db7ac0addb4cc6280,PAYMENT,30-40,2018,10,19,12,0,Friday,14 days,101775.818
ACC-3485804958,34,63.0,27516.77,,CUS-1196156254,2018-10-19,Jessica,F,-35.01,138.52,,,,,,,debit,posted,427d6ea7107e493ab06a734246588195,PAYMENT,30-40,2018,10,19,19,0,Friday,14 days,101775.818
ACC-3485804958,34,31.0,27485.77,,CUS-1196156254,2018-10-21,Jessica,F,-35.01,138.52,,,,,,,debit,posted,225f9fe696074d9b92299a820134d036,PAYMENT,30-40,2018,10,21,5,0,Sunday,14 days,101775.818
ACC-3485804958,34,39.0,27446.77,,CUS-1196156254,2018-10-23,Jessica,F,-35.01,138.52,,,,,,,debit,posted,62785c5b034f436cb194d509552f4d30,PAYMENT,30-40,2018,10,23,14,0,Tuesday,14 days,101775.818
ACC-3485804958,34,27.0,31323.5,,CUS-1196156254,2018-10-25,Jessica,F,-35.01,138.52,,,,,,,debit,posted,3b43174736fc408b8088a2834b49b506,PAYMENT,30-40,2018,10,25,9,0,Thursday,14 days,101775.818
ACC-3485804958,34,16.0,31307.5,,CUS-1196156254,2018-10-26,Jessica,F,-35.01,138.52,,,,,,,debit,posted,a474dea83dec4735a6d3b6ae637bcb7e,PAYMENT,30-40,2018,10,26,12,0,Friday,14 days,101775.818
ACC-3485804958,34,63.0,31244.5,,CUS-1196156254,2018-10-26,Jessica,F,-35.01,138.52,,,,,,,debit,posted,b82bea93bd6b4b15a84d4ca9493a92b0,PAYMENT,30-40,2018,10,26,19,0,Friday,14 days,101775.818
ACC-3485804958,34,31.0,31213.5,,CUS-1196156254,2018-10-28,Jessica,F,-35.01,138.52,,,,,,,debit,posted,9b194a0d310c4d75bc31b6ae1fda1e22,PAYMENT,30-40,2018,10,28,5,0,Sunday,14 days,101775.818
ACC-3485804958,34,177.0,31036.5,,CUS-1196156254,2018-10-28,Jessica,F,-35.01,138.52,,,,,,,debit,posted,091fce1d6dbd449d98d72470a7ea026e,PAYMENT,30-40,2018,10,28,8,0,Sunday,14 days,101775.818
ACC-3485804958,34,17.19,31019.31,1.0,CUS-1196156254,2018-10-30,Jessica,F,-35.01,138.52,,2a87bd94-e8d2-4e41-9e05-d0d99505d414,-35.02,117.88,WA,Albany,debit,authorized,0c37ddd026f8406b983a536fff3bea6d,SALES-POS,30-40,2018,10,30,8,49,Tuesday,14 days,101775.818
ACC-3485804958,34,39.0,30980.31,,CUS-1196156254,2018-10-30,Jessica,F,-35.01,138.52,,,,,,,debit,posted,c96d793ab23f4df2a13b0d131f57cbf0,PAYMENT,30-40,2018,10,30,14,0,Tuesday,14 days,101775.818
ACC-3485804958,34,4.73,30975.58,1.0,CUS-1196156254,2018-10-30,Jessica,F,-35.01,138.52,,5bb68e2a-3272-41b7-a12e-7f42f0a2839c,-35.28,149.13,ACT,Canberra,debit,authorized,0a02d843ca9c4770b9b0ad441b39e1a7,SALES-POS,30-40,2018,10,30,16,48,Tuesday,14 days,101775.818
ACC-3485804958,34,19.92,30955.66,1.0,CUS-1196156254,2018-10-30,Jessica,F,-35.01,138.52,,dad0776a-38e4-4773-af4a-86a0925179c0,-35.12,138.52,SA,Morphett Vale,debit,authorized,2bdab529a9dd4e5d8fff5a396db9d606,POS,30-40,2018,10,30,17,22,Tuesday,14 days,101775.818
ACC-3485804958,34,27.45,30928.21,1.0,CUS-1196156254,2018-10-31,Jessica,F,-35.01,138.52,,b0466a3f-910d-4669-b1eb-a355cf2f2245,-34.92,138.57,SA,Mile End,debit,authorized,8bbc8ce90f56445dab26794edda0d29f,POS,30-40,2018,10,31,8,51,Wednesday,14 days,101775.818
ACC-3485804958,34,28.68,30899.53,0.0,CUS-1196156254,2018-10-31,Jessica,F,-35.01,138.52,,7bdae5fa-0014-4c59-9264-6dd609b71780,-35.31,149.1,ACT,Yarralumla,debit,authorized,8678a1477d2c44e48effb9a6d6578209,SALES-POS,30-40,2018,10,31,10,7,Wednesday,14 days,101775.818
ACC-3100725361,25,4.38,2086.31,1.0,CUS-2178051368,2018-08-01,Ronald,M,-17.03,145.73,,7a368a0e-c231-4458-a4e0-43a3f6953954,-16.81,145.7,QLD,Smithfield,debit,authorized,7c855689bafb457084fbe8e42824a36e,POS,20-30,2018,8,1,9,27,Wednesday,30 days,74304.632
ACC-3100725361,25,27.39,2058.92,0.0,CUS-2178051368,2018-08-01,Ronald,M,-17.03,145.73,,cd28c099-0971-41a5-a9cc-d44477c350df,-35.92,145.65,VIC,Cobram,debit,authorized,646333af54b7418db2ffddf4466e027d,POS,20-30,2018,8,1,11,52,Wednesday,30 days,74304.632
ACC-3100725361,25,26.0,2032.92,,CUS-2178051368,2018-08-01,Ronald,M,-17.03,145.73,,,,,,,debit,posted,77254bed4aed4a66b6870c77297cef71,INTER BANK,20-30,2018,8,1,13,0,Wednesday,30 days,74304.632
ACC-3100725361,25,30.99,2001.93,1.0,CUS-2178051368,2018-08-04,Ronald,M,-17.03,145.73,,d5b4b0fe-b691-4681-9998-a0442ae08fea,-37.81,144.97,VIC,Melbourne,debit,authorized,484307b376ca421e8fdae3697df041f0,POS,20-30,2018,8,4,9,10,Saturday,30 days,74304.632
ACC-3100725361,25,28.45,1973.48,1.0,CUS-2178051368,2018-08-04,Ronald,M,-17.03,145.73,,ceffdb95-20cb-44ac-a651-8d3f14da18a1,-16.93,145.77,QLD,Cairns City,debit,authorized,731786cad5c54688a0bf426aa44ea683,SALES-POS,20-30,2018,8,4,11,42,Saturday,30 days,74304.632
ACC-3100725361,25,21.46,1952.02,0.0,CUS-2178051368,2018-08-04,Ronald,M,-17.03,145.73,,7d06d8a4-d6ce-4dd2-b4d7-dde94d1ff630,-41.05,145.91,TAS,Burnie,debit,authorized,0015431694b1425a807107c872c11f01,SALES-POS,20-30,2018,8,4,21,25,Saturday,30 days,74304.632
ACC-3100725361,25,37.15,1914.87,1.0,CUS-2178051368,2018-08-05,Ronald,M,-17.03,145.73,,75b47942-0fb3-40c5-aab3-a15f60f53e61,-34.95,138.57,SA,Keswick,debit,authorized,887c576cab20456abac841d0c5547989,POS,20-30,2018,8,5,22,4,Sunday,30 days,74304.632
ACC-3100725361,25,5.01,1909.86,0.0,CUS-2178051368,2018-08-05,Ronald,M,-17.03,145.73,,e66ffcab-8b3d-4bfe-9786-6f6e062f3812,-38.13,145.84,VIC,Drouin,debit,authorized,ab33eb04af1646ef91626f6c3bf7f665,SALES-POS,20-30,2018,8,5,23,18,Sunday,30 days,74304.632
ACC-3100725361,25,7.09,1902.77,1.0,CUS-2178051368,2018-08-06,Ronald,M,-17.03,145.73,,814b74ef-67a5-472d-82f0-6c1dace99cf3,-31.5,145.84,NSW,Cobar,debit,authorized,742de3947b55488c825561368b923c6f,POS,20-30,2018,8,6,22,53,Monday,30 days,74304.632
ACC-3100725361,25,99.0,1803.77,,CUS-2178051368,2018-08-07,Ronald,M,-17.03,145.73,,,,,,,debit,posted,12a68aada202471880aa4efd60e9ab42,PAYMENT,20-30,2018,8,7,14,0,Tuesday,30 days,74304.632
ACC-3100725361,25,26.84,1776.93,1.0,CUS-2178051368,2018-08-07,Ronald,M,-17.03,145.73,,a0e99864-5db3-4b56-9ce2-80c427467f98,-38.14,145.86,VIC,Drouin,debit,authorized,b3e2fa90e4be43dba5b3b7656647f356,POS,20-30,2018,8,7,23,39,Tuesday,30 days,74304.632
ACC-3100725361,25,9.51,1767.42,0.0,CUS-2178051368,2018-08-08,Ronald,M,-17.03,145.73,,cdbb3cb3-c8fd-43dd-8bbf-e66b9dfe9ecc,-16.99,145.74,QLD,Mount Sheridan,debit,authorized,8742f1a6b7ab4fc0af28b48ab282a5cc,POS,20-30,2018,8,8,9,39,Wednesday,30 days,74304.632
ACC-3100725361,25,24.69,1742.73,1.0,CUS-2178051368,2018-08-08,Ronald,M,-17.03,145.73,,e475c328-f4bb-4542-b036-e7ee08661afc,-41.08,145.79,TAS,Elliott,debit,authorized,7fe42cf1a40e4e2195175cf37946c755,POS,20-30,2018,8,8,11,52,Wednesday,30 days,74304.632
ACC-3100725361,25,26.0,1716.73,,CUS-2178051368,2018-08-08,Ronald,M,-17.03,145.73,,,,,,,debit,posted,f9057eeceb894057a92671a3355fcfc1,INTER BANK,20-30,2018,8,8,13,0,Wednesday,30 days,74304.632
ACC-3100725361,25,74.66,1642.07,1.0,CUS-2178051368,2018-08-09,Ronald,M,-17.03,145.73,,d2152b22-0e11-4f3c-ac81-4d2051b6d0f2,-30.49,151.64,NSW,Armidale,debit,authorized,34d2e86a1141415cac41ba46986db83f,POS,20-30,2018,8,9,21,6,Thursday,30 days,74304.632
ACC-3100725361,25,161.0,1481.07,,CUS-2178051368,2018-08-10,Ronald,M,-17.03,145.73,,,,,,,debit,posted,dfc4447867014f16a7323583b0a1a7a8,INTER BANK,20-30,2018,8,10,13,0,Friday,30 days,74304.632
ACC-3100725361,25,33.28,1447.79,1.0,CUS-2178051368,2018-08-11,Ronald,M,-17.03,145.73,,907956c3-283d-4f7e-80f9-d944b5735c30,-33.88,151.02,NSW,Regents Park,debit,authorized,5f9e3dd67be64b31bc2b9c8dc0f2a0b4,POS,20-30,2018,8,11,23,29,Saturday,30 days,74304.632
ACC-3100725361,25,144.0,1303.79,,CUS-2178051368,2018-08-12,Ronald,M,-17.03,145.73,,,,,,,debit,posted,aa8a924204de4137868e60be384a652e,PAYMENT,20-30,2018,8,12,6,0,Sunday,30 days,74304.632
ACC-3100725361,25,6.45,1297.34,0.0,CUS-2178051368,2018-08-12,Ronald,M,-17.03,145.73,,37cd09c5-f238-4d32-8a60-03755b38b744,-27.53,153.1,QLD,Mansfield,debit,authorized,128bab997d3544e9922662cb81752071,POS,20-30,2018,8,12,14,28,Sunday,30 days,74304.632
ACC-3100725361,25,14.49,1282.85,1.0,CUS-2178051368,2018-08-12,Ronald,M,-17.03,145.73,,6f591854-1a34-48e3-b2a2-d17ff3019f5c,-16.88,145.75,QLD,Cairns City,debit,authorized,c82b5467d52047798cc8df5563e25ccc,SALES-POS,20-30,2018,8,12,20,18,Sunday,30 days,74304.632
ACC-3100725361,25,9.18,1273.67,1.0,CUS-2178051368,2018-08-12,Ronald,M,-17.03,145.73,,a908bd17-47ad-499e-aedd-5129077ec30f,-37.26,145.8,VIC,Thornton,debit,authorized,ca5df87d75b4495ea0bf62d9c7a24d9d,POS,20-30,2018,8,12,21,52,Sunday,30 days,74304.632
ACC-3100725361,25,7.85,1265.82,1.0,CUS-2178051368,2018-08-13,Ronald,M,-17.03,145.73,,814b74ef-67a5-472d-82f0-6c1dace99cf3,-31.5,145.84,NSW,Cobar,debit,authorized,9071980e300d4164a5831d8d55094c92,SALES-POS,20-30,2018,8,13,9,54,Monday,30 days,74304.632
ACC-3100725361,25,15.14,1250.68,1.0,CUS-2178051368,2018-08-13,Ronald,M,-17.03,145.73,,f1741d09-69b2-4f5f-b1bd-6282476ef072,-17.01,145.43,QLD,Mareeba,debit,authorized,4c220aecc57c4222a09dbff69e394d3f,SALES-POS,20-30,2018,8,13,12,58,Monday,30 days,74304.632
ACC-3100725361,25,17.72,1232.96,0.0,CUS-2178051368,2018-08-13,Ronald,M,-17.03,145.73,,635f3dfb-bead-4f60-9a01-0acc24dc4f46,-33.29,149.1,NSW,Orange,debit,authorized,0ee4338f2b784f0abd905fb282c6d318,SALES-POS,20-30,2018,8,13,16,34,Monday,30 days,74304.632
ACC-3100725361,25,26.0,1206.96,,CUS-2178051368,2018-08-15,Ronald,M,-17.03,145.73,,,,,,,debit,posted,b37be6bf4ec54779944e1012440136a2,INTER BANK,20-30,2018,8,15,13,0,Wednesday,30 days,74304.632
ACC-3100725361,25,63.51,1143.45,0.0,CUS-2178051368,2018-08-15,Ronald,M,-17.03,145.73,,5b53791d-fd26-4b42-88a7-efe061595618,-37.82,144.96,VIC,Melbourne,debit,authorized,118dcfae8d0749358558d0be432fdc81,POS,20-30,2018,8,15,15,2,Wednesday,30 days,74304.632
ACC-3100725361,25,6.4,1096.33,1.0,CUS-2178051368,2018-08-17,Ronald,M,-17.03,145.73,,690cc41c-767b-485d-86cd-eb79f4020a03,-16.9,145.76,QLD,Cairns North,debit,authorized,fe2a66e0896448a0be8b4076b4351891,POS,20-30,2018,8,17,14,35,Friday,30 days,74304.632
ACC-3100725361,25,26.06,1070.27,1.0,CUS-2178051368,2018-08-18,Ronald,M,-17.03,145.73,,07a1c4d0-e3da-4e6d-a882-d11211619bc9,-16.93,145.76,QLD,Westcourt,debit,authorized,26413b79897c4ec4a16f27ec8eeb4d0f,SALES-POS,20-30,2018,8,18,1,27,Saturday,30 days,74304.632
ACC-3100725361,25,20.03,1050.24,1.0,CUS-2178051368,2018-08-18,Ronald,M,-17.03,145.73,,c59efbe6-e282-49dd-8fa7-84313c84d46f,-37.77,145.01,VIC,Northcote,debit,authorized,eec312ee6ba04a39b87bdba226887e79,SALES-POS,20-30,2018,8,18,8,3,Saturday,30 days,74304.632
ACC-3100725361,25,16.1,1034.14,1.0,CUS-2178051368,2018-08-18,Ronald,M,-17.03,145.73,,4841e92a-0a02-44bf-9b7d-e274ff1a4d65,-16.8,145.7,QLD,Trinity Park,debit,authorized,e1770bab3e46421f9cef588399bd9222,SALES-POS,20-30,2018,8,18,10,22,Saturday,30 days,74304.632
ACC-3100725361,25,8.81,1025.33,0.0,CUS-2178051368,2018-08-18,Ronald,M,-17.03,145.73,,57c15e44-3bc5-4104-9470-f692191dbb74,-16.98,122.67,WA,Dampier Peninsula,debit,authorized,0ef99551c3f345f8a6efe79d8028563d,POS,20-30,2018,8,18,17,50,Saturday,30 days,74304.632
ACC-3100725361,25,27.63,997.7,1.0,CUS-2178051368,2018-08-18,Ronald,M,-17.03,145.73,,01ce15de-64fc-47a5-ac39-46e0b57cb684,-33.87,151.21,NSW,Sydney,debit,authorized,d09ac481f28e4ed883735eec67ab41e4,POS,20-30,2018,8,18,21,37,Saturday,30 days,74304.632
ACC-3100725361,25,6.43,991.27,0.0,CUS-2178051368,2018-08-20,Ronald,M,-17.03,145.73,,7c9748a0-a134-4b7b-be8c-17725f9df6c9,-37.71,144.97,VIC,Fawkner,debit,authorized,9dbbd8f717814be4929172faa1230a65,SALES-POS,20-30,2018,8,20,9,19,Monday,30 days,74304.632
ACC-3100725361,25,25.24,966.03,1.0,CUS-2178051368,2018-08-22,Ronald,M,-17.03,145.73,,e475c328-f4bb-4542-b036-e7ee08661afc,-41.08,145.79,TAS,Elliott,debit,authorized,70e1e943ca744708b9b36aee54d743bc,SALES-POS,20-30,2018,8,22,8,39,Wednesday,30 days,74304.632
ACC-3100725361,25,26.0,940.03,,CUS-2178051368,2018-08-22,Ronald,M,-17.03,145.73,,,,,,,debit,posted,631f30e2e8a04f7ab88659a919278e03,INTER BANK,20-30,2018,8,22,13,0,Wednesday,30 days,74304.632
ACC-3100725361,25,16.22,923.81,1.0,CUS-2178051368,2018-08-22,Ronald,M,-17.03,145.73,,a42d4595-dcd9-41ca-95e4-946b8243355b,-35.66,145.81,NSW,Berrigan,debit,authorized,c3023ec7526246df91366c6a9277c01b,POS,20-30,2018,8,22,16,56,Wednesday,30 days,74304.632
ACC-3100725361,25,144.16,779.65,1.0,CUS-2178051368,2018-08-23,Ronald,M,-17.03,145.73,,c51ef0f5-d6ef-4b80-8217-cd059aee74e1,-33.87,151.2,NSW,Sydney,debit,authorized,2261758026c842c5a2811afc0db0a819,POS,20-30,2018,8,23,0,14,Thursday,30 days,74304.632
ACC-3100725361,25,12.25,767.4,1.0,CUS-2178051368,2018-08-23,Ronald,M,-17.03,145.73,,12a4bfd6-b652-4a98-a5ba-28b905b614e9,-16.82,145.69,QLD,Smithfield,debit,authorized,a3f7530241cf45549da5ec2b2fde445a,POS,20-30,2018,8,23,7,11,Thursday,30 days,74304.632
ACC-3100725361,25,9.84,757.56,0.0,CUS-2178051368,2018-08-23,Ronald,M,-17.03,145.73,,342f081b-3399-40e6-bc04-7d064f6eb0e4,-16.99,145.42,QLD,Mareeba,debit,authorized,373dc81d5c4347d8a8a4f2e81e41b7b8,POS,20-30,2018,8,23,8,37,Thursday,30 days,74304.632
ACC-3100725361,25,14.85,742.71,1.0,CUS-2178051368,2018-08-23,Ronald,M,-17.03,145.73,,81e0744e-281c-43de-b088-286740dc1e97,-37.51,145.75,VIC,Marysville,debit,authorized,83b6627563394fb1851d1af530284264,SALES-POS,20-30,2018,8,23,9,7,Thursday,30 days,74304.632
ACC-3100725361,25,17.89,724.82,1.0,CUS-2178051368,2018-08-23,Ronald,M,-17.03,145.73,,5c967c03-49d7-45dd-abf5-87c6e937a534,-16.92,145.77,QLD,Cairns City,debit,authorized,3b05c3eda467422881abba46ced435e7,POS,20-30,2018,8,23,9,34,Thursday,30 days,74304.632
ACC-3100725361,25,28.16,696.66,1.0,CUS-2178051368,2018-08-24,Ronald,M,-17.03,145.73,,00a5bc50-0146-48d7-91ee-966e8be89c0b,-37.65,145.54,VIC,Healesville,debit,authorized,ce7232c4291e49b7ade5af5e311f31f4,POS,20-30,2018,8,24,8,43,Friday,30 days,74304.632
ACC-3100725361,25,8.81,687.85,0.0,CUS-2178051368,2018-08-24,Ronald,M,-17.03,145.73,,e98a15b4-b1e2-4dec-baf0-b54030469763,-37.82,144.96,VIC,Melbourne,debit,authorized,ca287b449dd94010a93cfcbd8ddccfce,POS,20-30,2018,8,24,9,52,Friday,30 days,74304.632
ACC-3100725361,25,14.42,673.43,0.0,CUS-2178051368,2018-08-24,Ronald,M,-17.03,145.73,,469cd883-7db8-4e55-903a-12c6f509f400,-37.9,145.23,VIC,Scoresby,debit,authorized,6465feed36114c3890fb8ad260e95c53,POS,20-30,2018,8,24,14,34,Friday,30 days,74304.632
ACC-3100725361,25,20.34,653.09,1.0,CUS-2178051368,2018-08-24,Ronald,M,-17.03,145.73,,abf814cc-5f46-4652-a768-39865adf4319,-32.08,115.81,WA,Coolbellup,debit,authorized,33266701f6be4eb1a1ffe2b5e93e158b,POS,20-30,2018,8,24,15,37,Friday,30 days,74304.632
ACC-3100725361,25,10.78,642.31,1.0,CUS-2178051368,2018-08-24,Ronald,M,-17.03,145.73,,c72f5ec0-d8f8-4db0-9425-87e98de8d82f,-37.64,144.81,VIC,Bulla,debit,authorized,b3079f79379e41f6a3a21c6963c647a9,POS,20-30,2018,8,24,20,34,Friday,30 days,74304.632
ACC-3100725361,25,34.16,608.15,1.0,CUS-2178051368,2018-08-24,Ronald,M,-17.03,145.73,,fdcae63c-afb4-4ec9-84bc-910959f5a724,-41.06,145.91,TAS,South Burnie,debit,authorized,63435819388f4a8884c4b5db3156925c,POS,20-30,2018,8,24,22,26,Friday,30 days,74304.632
ACC-3100725361,25,21.13,587.02,1.0,CUS-2178051368,2018-08-25,Ronald,M,-17.03,145.73,,438425eb-d3bb-4942-8d5a-65ca88f63191,-37.19,145.72,VIC,Alexandra,debit,authorized,76b82ee78f73442d837dd33efdd91471,SALES-POS,20-30,2018,8,25,17,47,Saturday,30 days,74304.632
ACC-3100725361,25,11.66,575.36,1.0,CUS-2178051368,2018-08-25,Ronald,M,-17.03,145.73,,8e83c95f-f8d1-44c1-8cc1-a06fc34b5482,-27.5,153.03,QLD,Annerley,debit,authorized,0d7f8c85b4104f7cb05622b88941a92f,POS,20-30,2018,8,25,21,9,Saturday,30 days,74304.632
ACC-3100725361,25,21.63,553.73,1.0,CUS-2178051368,2018-08-25,Ronald,M,-17.03,145.73,,fc133bc5-2c4a-4261-ba1e-6c6339a8363f,-33.87,151.21,NSW,Sydney,debit,authorized,9a7aa59f571d460c9d587743626b2e3a,SALES-POS,20-30,2018,8,25,21,58,Saturday,30 days,74304.632
ACC-3100725361,25,14.06,539.67,1.0,CUS-2178051368,2018-08-26,Ronald,M,-17.03,145.73,,4e380e66-5d03-4bd0-afe4-a27c6c4f0f74,-38.14,145.86,VIC,Drouin,debit,authorized,8012c620ab2d4fa98a5add3bd5d1444f,POS,20-30,2018,8,26,9,7,Sunday,30 days,74304.632
ACC-3100725361,25,11.48,528.19,1.0,CUS-2178051368,2018-08-26,Ronald,M,-17.03,145.73,,1447e914-f668-4de2-a33a-d3d550410df8,-16.91,145.74,QLD,Manoora,debit,authorized,617e587d8953428d86ea9252eb438749,SALES-POS,20-30,2018,8,26,11,27,Sunday,30 days,74304.632
ACC-3100725361,25,60.99,467.2,1.0,CUS-2178051368,2018-08-26,Ronald,M,-17.03,145.73,,a79490f1-8469-4eec-9ad0-0a4726f48781,-33.88,151.21,NSW,Haymarket,debit,authorized,311eb9d25aa54042a4a045d218ababa1,POS,20-30,2018,8,26,15,15,Sunday,30 days,74304.632
ACC-3100725361,25,5.8,461.4,1.0,CUS-2178051368,2018-08-26,Ronald,M,-17.03,145.73,,1eca2901-6392-4097-88d8-e41915133abe,-37.78,145.61,VIC,Yarra Junction,debit,authorized,d96afdd1fa834a0e930058159944e3b7,POS,20-30,2018,8,26,20,44,Sunday,30 days,74304.632
ACC-3100725361,25,28.94,432.46,1.0,CUS-2178051368,2018-08-27,Ronald,M,-17.03,145.73,,71cbf835-a5d9-44d8-8d58-d425865171b5,-37.83,144.89,VIC,Spotswood,debit,authorized,72b02373738344c0a42c05108ae24e1a,SALES-POS,20-30,2018,8,27,10,57,Monday,30 days,74304.632
ACC-3100725361,25,28.77,403.69,1.0,CUS-2178051368,2018-08-27,Ronald,M,-17.03,145.73,,12a1e4a6-4d48-4984-9afe-c16a4c1f623d,-35.92,145.64,VIC,Cobram,debit,authorized,1fd95d0490f74d08bb103c7d4dba48dd,SALES-POS,20-30,2018,8,27,14,29,Monday,30 days,74304.632
ACC-3100725361,25,17.96,385.73,0.0,CUS-2178051368,2018-08-28,Ronald,M,-17.03,145.73,,df955769-9e51-4c5f-995d-70b40b0dacd4,-37.88,145.13,VIC,Mount Waverley,debit,authorized,8a55563ef01d4be9a4c82c58270007ec,SALES-POS,20-30,2018,8,28,9,24,Tuesday,30 days,74304.632
ACC-3100725361,25,26.0,359.73,,CUS-2178051368,2018-08-29,Ronald,M,-17.03,145.73,,,,,,,debit,posted,eeed6df93b3a4c84b933f5e3410f992c,INTER BANK,20-30,2018,8,29,13,0,Wednesday,30 days,74304.632
ACC-3100725361,25,7.9,351.83,1.0,CUS-2178051368,2018-08-29,Ronald,M,-17.03,145.73,,d102321d-9e76-4322-8933-7d22a3a3764b,-38.13,145.86,VIC,Drouin,debit,authorized,a975bd92c258478bae5c0d70ed6ed0b5,POS,20-30,2018,8,29,16,16,Wednesday,30 days,74304.632
ACC-3100725361,25,23.1,328.73,0.0,CUS-2178051368,2018-08-31,Ronald,M,-17.03,145.73,,b8649567-81b9-465e-938b-393ddd20104d,-41.07,145.9,TAS,Upper Burnie,debit,authorized,01b413aede9543d0958f88045ff30feb,SALES-POS,20-30,2018,8,31,10,29,Friday,30 days,74304.632
ACC-3100725361,25,82.19,246.54,1.0,CUS-2178051368,2018-08-31,Ronald,M,-17.03,145.73,,7aa35faa-c607-489f-b7ea-226b095b16ee,-37.82,144.96,VIC,Melbourne,debit,authorized,1e2edf532f1c438aa947dd515e5f47ba,SALES-POS,20-30,2018,8,31,12,14,Friday,30 days,74304.632
ACC-3100725361,25,9.49,237.05,1.0,CUS-2178051368,2018-08-31,Ronald,M,-17.03,145.73,,0fc4e975-d30b-4bfe-ba2e-47268890a7d0,-17.93,145.92,QLD,Tully,debit,authorized,acd93e8a942d45cb9e5ebb5b2b0d9518,SALES-POS,20-30,2018,8,31,19,56,Friday,30 days,74304.632
ACC-3100725361,25,22.35,214.7,1.0,CUS-2178051368,2018-09-01,Ronald,M,-17.03,145.73,,43f4b696-fd6a-4236-a6bf-00fb26ea9c75,-41.04,145.83,TAS,Somerset,debit,authorized,3e4b2c4d5d1e455dbc42e7e2a967386b,POS,20-30,2018,9,1,2,7,Saturday,30 days,74304.632
ACC-3100725361,25,13.69,201.01,1.0,CUS-2178051368,2018-09-01,Ronald,M,-17.03,145.73,,f1741d09-69b2-4f5f-b1bd-6282476ef072,-17.01,145.43,QLD,Mareeba,debit,authorized,dfc6ed6e855548e9a77b675a363467e4,SALES-POS,20-30,2018,9,1,3,56,Saturday,30 days,74304.632
ACC-3100725361,25,6.44,194.57,1.0,CUS-2178051368,2018-09-01,Ronald,M,-17.03,145.73,,814b74ef-67a5-472d-82f0-6c1dace99cf3,-31.5,145.84,NSW,Cobar,debit,authorized,d593cd36e1e94bccaa302ffd092f8895,SALES-POS,20-30,2018,9,1,9,18,Saturday,30 days,74304.632
ACC-3100725361,25,6.83,187.74,1.0,CUS-2178051368,2018-09-01,Ronald,M,-17.03,145.73,,dbbe8885-57f9-4724-b6f5-c3e34e1030b8,-38.63,145.73,VIC,Inverloch,debit,authorized,22965534d23f4cf2ac068b082c1449bd,SALES-POS,20-30,2018,9,1,17,48,Saturday,30 days,74304.632
ACC-3100725361,25,15.39,172.35,1.0,CUS-2178051368,2018-09-01,Ronald,M,-17.03,145.73,,a42d4595-dcd9-41ca-95e4-946b8243355b,-35.66,145.81,NSW,Berrigan,debit,authorized,c08f370d2658426bbf1e9548cfb02781,POS,20-30,2018,9,1,21,4,Saturday,30 days,74304.632
ACC-3100725361,25,21.01,151.34,1.0,CUS-2178051368,2018-09-01,Ronald,M,-17.03,145.73,,017fe51b-2e55-4adc-bf20-6d1f9973fb2f,-41.05,145.9,TAS,Burnie,debit,authorized,13ae080f6e244d619d3a66751e819685,SALES-POS,20-30,2018,9,1,22,27,Saturday,30 days,74304.632
ACC-3100725361,25,24.54,126.8,0.0,CUS-2178051368,2018-09-02,Ronald,M,-17.03,145.73,,e475c328-f4bb-4542-b036-e7ee08661afc,-41.08,145.79,TAS,Elliott,debit,authorized,a65173159e1440a18f75fa3c0998ce02,SALES-POS,20-30,2018,9,2,0,34,Sunday,30 days,74304.632
ACC-3100725361,25,15.78,111.02,1.0,CUS-2178051368,2018-09-02,Ronald,M,-17.03,145.73,,a42d4595-dcd9-41ca-95e4-946b8243355b,-35.66,145.81,NSW,Berrigan,debit,authorized,eb5f86aa95044496821449eb0507010d,SALES-POS,20-30,2018,9,2,1,59,Sunday,30 days,74304.632
ACC-3100725361,25,11.86,99.16,1.0,CUS-2178051368,2018-09-02,Ronald,M,-17.03,145.73,,bcfecba6-8652-4413-bfd6-4e9f6e51cfdf,-37.77,144.89,VIC,Maribyrnong,debit,authorized,2a7a869af44e44ff814282cd5c7a92e1,POS,20-30,2018,9,2,8,34,Sunday,30 days,74304.632
ACC-3100725361,25,6.5,92.66,1.0,CUS-2178051368,2018-09-02,Ronald,M,-17.03,145.73,,e66ffcab-8b3d-4bfe-9786-6f6e062f3812,-38.13,145.84,VIC,Drouin,debit,authorized,ac9997182b114e3185407e7bdbb52e50,POS,20-30,2018,9,2,10,49,Sunday,30 days,74304.632
ACC-3100725361,25,5.6,87.06,1.0,CUS-2178051368,2018-09-02,Ronald,M,-17.03,145.73,,1eca2901-6392-4097-88d8-e41915133abe,-37.78,145.61,VIC,Yarra Junction,debit,authorized,93f927911a3146868188646c3628f140,POS,20-30,2018,9,2,14,16,Sunday,30 days,74304.632
ACC-3100725361,25,23.54,63.52,1.0,CUS-2178051368,2018-09-05,Ronald,M,-17.03,145.73,,b8649567-81b9-465e-938b-393ddd20104d,-41.07,145.9,TAS,Upper Burnie,debit,authorized,5b51665d618944bf9480692e4eb92d56,SALES-POS,20-30,2018,9,5,10,54,Wednesday,30 days,74304.632
ACC-3100725361,25,26.0,37.52,,CUS-2178051368,2018-09-05,Ronald,M,-17.03,145.73,,,,,,,debit,posted,51266622d4f544fcaa6c7dfa35ecdd3c,INTER BANK,20-30,2018,9,5,13,0,Wednesday,30 days,74304.632
ACC-3100725361,25,20.85,16.67,1.0,CUS-2178051368,2018-09-06,Ronald,M,-17.03,145.73,,aa8af5d1-53d4-448b-a612-6acd4b5bb310,-33.66,151.31,NSW,Newport,debit,authorized,0e17e4013ac44b649fb3966acab90e87,SALES-POS,20-30,2018,9,6,15,32,Thursday,30 days,74304.632
ACC-3100725361,25,12.33,4.34,1.0,CUS-2178051368,2018-09-06,Ronald,M,-17.03,145.73,,50fccc48-f815-454f-ae55-ac054158f7dd,-41.04,145.83,TAS,Somerset,debit,authorized,b86b46a324814042b2533f1c5d5c39e5,SALES-POS,20-30,2018,9,6,21,26,Thursday,30 days,74304.632
ACC-3100725361,25,11.85,6099.72,0.0,CUS-2178051368,2018-09-27,Ronald,M,-17.03,145.73,,253b63e9-4644-4eff-bfb2-12b5edb999ae,-33.93,151.17,NSW,Mascot,debit,authorized,1afcc9213b144ee8bec4b90b4eb69a3b,SALES-POS,20-30,2018,9,27,9,34,Thursday,30 days,74304.632
ACC-3100725361,25,7.31,6092.41,0.0,CUS-2178051368,2018-09-27,Ronald,M,-17.03,145.73,,6f011cc2-81ac-40f1-a8ed-2d2b127385a7,-37.74,144.8,VIC,Saint Albans,debit,authorized,1d99982883eb4f5e912f251e9d819793,SALES-POS,20-30,2018,9,27,14,2,Thursday,30 days,74304.632
ACC-3100725361,25,14.65,6077.76,1.0,CUS-2178051368,2018-09-28,Ronald,M,-17.03,145.73,,42cee44c-17c1-4d18-b32a-6a51e441a4c4,-35.36,145.73,NSW,Jerilderie,debit,authorized,044b12f218474f4a86642ed2e03616ea,SALES-POS,20-30,2018,9,28,11,17,Friday,30 days,74304.632
ACC-3100725361,25,14.04,6063.72,1.0,CUS-2178051368,2018-09-28,Ronald,M,-17.03,145.73,,393f08c4-f806-4415-b14f-bdb9030423d4,-16.93,145.77,QLD,Cairns City,debit,authorized,925b9f55a30f44d3b52bbd06ff2fbed7,POS,20-30,2018,9,28,15,10,Friday,30 days,74304.632
ACC-3100725361,25,6.5,6057.22,1.0,CUS-2178051368,2018-09-28,Ronald,M,-17.03,145.73,,8ce60d6d-32fe-46a8-bfc3-9f6d2363e73e,-38.43,145.83,VIC,Korumburra,debit,authorized,62ebbdbc988f40a7be3c88c8a5b56587,POS,20-30,2018,9,28,17,22,Friday,30 days,74304.632
ACC-3100725361,25,21.14,6036.08,1.0,CUS-2178051368,2018-09-29,Ronald,M,-17.03,145.73,,0cb93a9c-d9a8-4043-88f4-d1aea4b6e5bd,-16.99,145.42,QLD,Mareeba,debit,authorized,00b2b68d960942bb826dbdaa1fd7e319,POS,20-30,2018,9,29,10,25,Saturday,30 days,74304.632
ACC-3100725361,25,15.11,6020.97,1.0,CUS-2178051368,2018-09-29,Ronald,M,-17.03,145.73,,7106a8f5-aa44-4451-9798-628ea7fb1531,-17.02,145.75,QLD,Edmonton,debit,authorized,86d813f29c9a4ef8bfcf46e12a05a4f9,SALES-POS,20-30,2018,9,29,11,10,Saturday,30 days,74304.632
ACC-3100725361,25,16.59,6004.38,0.0,CUS-2178051368,2018-09-29,Ronald,M,-17.03,145.73,,4ae59658-8b43-48dc-9ee2-1d2154551bb1,-37.74,144.8,VIC,Saint Albans,debit,authorized,72aac9d436ed4e3c8e5bdee225c492b4,POS,20-30,2018,9,29,13,9,Saturday,30 days,74304.632
ACC-3100725361,25,7.35,5997.03,1.0,CUS-2178051368,2018-09-29,Ronald,M,-17.03,145.73,,99530045-46bc-48b3-a938-24aa02cecdf7,-41.04,145.87,TAS,Cooee,debit,authorized,f9d3026654494db4906f5808e141a6f7,SALES-POS,20-30,2018,9,29,14,13,Saturday,30 days,74304.632
ACC-3100725361,25,65.17,5931.86,1.0,CUS-2178051368,2018-09-30,Ronald,M,-17.03,145.73,,47c08650-7b78-42a6-a2e8-e5fb0fa00c63,-37.75,145.03,VIC,Preston,debit,authorized,5e657a89b47444389bbbb6402dc4d6ba,SALES-POS,20-30,2018,9,30,9,45,Sunday,30 days,74304.632
ACC-3100725361,25,28.01,5903.85,1.0,CUS-2178051368,2018-09-30,Ronald,M,-17.03,145.73,,a0e99864-5db3-4b56-9ce2-80c427467f98,-38.14,145.86,VIC,Drouin,debit,authorized,5859e470490443dc994f6e1efc503746,SALES-POS,20-30,2018,9,30,11,13,Sunday,30 days,74304.632
ACC-3100725361,25,27.96,5875.89,1.0,CUS-2178051368,2018-09-30,Ronald,M,-17.03,145.73,,07a1c4d0-e3da-4e6d-a882-d11211619bc9,-16.93,145.76,QLD,Westcourt,debit,authorized,10723cbac6a040fe86008fad2261a47b,SALES-POS,20-30,2018,9,30,11,56,Sunday,30 days,74304.632
ACC-3100725361,25,50.68,5825.21,0.0,CUS-2178051368,2018-10-01,Ronald,M,-17.03,145.73,,4486cfb1-b6f7-466b-9473-561db42f46d5,-33.9,151.2,NSW,Alexandria,debit,authorized,263f940796e241c5bf3ec01c7f221a33,SALES-POS,20-30,2018,10,1,9,51,Monday,30 days,74304.632
ACC-3100725361,25,50.1,5775.11,1.0,CUS-2178051368,2018-10-01,Ronald,M,-17.03,145.73,,ca81094e-ca7c-4d45-b6a6-bcd8fc0d5ac8,-33.75,151.24,NSW,Frenchs Forest,debit,authorized,27c48402eadd4df99d2cb2f2c3424a49,SALES-POS,20-30,2018,10,1,11,50,Monday,30 days,74304.632
ACC-3100725361,25,7.52,5767.59,1.0,CUS-2178051368,2018-10-02,Ronald,M,-17.03,145.73,,e66ffcab-8b3d-4bfe-9786-6f6e062f3812,-38.13,145.84,VIC,Drouin,debit,authorized,6bd498682e5d4b47a077032cc1792733,POS,20-30,2018,10,2,10,44,Tuesday,30 days,74304.632
ACC-3100725361,25,26.0,5741.59,,CUS-2178051368,2018-10-03,Ronald,M,-17.03,145.73,,,,,,,debit,posted,eb14047330a5453cbfdd77af71790176,INTER BANK,20-30,2018,10,3,13,0,Wednesday,30 days,74304.632
ACC-3100725361,25,8.66,5732.93,1.0,CUS-2178051368,2018-10-04,Ronald,M,-17.03,145.73,,662fe7ee-874d-467f-a5b9-43821b506cca,-16.93,145.76,QLD,Parramatta Park,debit,authorized,43e884daf03a4ff0b013c19bfb93502f,SALES-POS,20-30,2018,10,4,19,15,Thursday,30 days,74304.632
ACC-3100725361,25,6.09,5726.84,1.0,CUS-2178051368,2018-10-04,Ronald,M,-17.03,145.73,,c50d61f9-83b4-4b60-94c4-d6244b77345f,-35.36,145.73,NSW,Jerilderie,debit,authorized,ed2c1770f37d442183a8330ba390b4c4,SALES-POS,20-30,2018,10,4,21,9,Thursday,30 days,74304.632
ACC-3100725361,25,7.88,5718.96,0.0,CUS-2178051368,2018-10-05,Ronald,M,-17.03,145.73,,99530045-46bc-48b3-a938-24aa02cecdf7,-41.04,145.87,TAS,Cooee,debit,authorized,88df4ffe48414fdd846a4893d07022e0,SALES-POS,20-30,2018,10,5,21,32,Friday,30 days,74304.632
ACC-3100725361,25,23.21,5695.75,1.0,CUS-2178051368,2018-10-06,Ronald,M,-17.03,145.73,,eb1a69e3-7c1a-40ca-8e3c-c85364f2c17e,-38.63,145.73,VIC,Inverloch,debit,authorized,f737d0fa8c2a46b49fdc1c748bfafb3a,SALES-POS,20-30,2018,10,6,4,33,Saturday,30 days,74304.632
ACC-3100725361,25,99.0,5596.75,,CUS-2178051368,2018-10-07,Ronald,M,-17.03,145.73,,,,,,,debit,posted,f237642edabc44b793c6d0aac85a9e78,PAYMENT,20-30,2018,10,7,14,0,Sunday,30 days,74304.632
ACC-3100725361,25,26.01,5570.74,1.0,CUS-2178051368,2018-10-07,Ronald,M,-17.03,145.73,,b8649567-81b9-465e-938b-393ddd20104d,-41.07,145.9,TAS,Upper Burnie,debit,authorized,e93b057387ef4d70b2dfaed9a7e8115f,SALES-POS,20-30,2018,10,7,21,1,Sunday,30 days,74304.632
ACC-3100725361,25,12.04,5558.7,0.0,CUS-2178051368,2018-10-09,Ronald,M,-17.03,145.73,,0cd4b13e-0508-4cd6-8b65-20955b51e629,-37.83,144.98,VIC,Melbourne,debit,authorized,79508a251b5043479e86fb1a70421a7a,SALES-POS,20-30,2018,10,9,14,3,Tuesday,30 days,74304.632
ACC-3100725361,25,9.77,5548.93,0.0,CUS-2178051368,2018-10-10,Ronald,M,-17.03,145.73,,4a96e67d-db1c-4a08-a9f4-1e4610bb7727,-16.92,145.78,QLD,Cairns City,debit,authorized,e2ef669444b243f59497652b24b4da3d,SALES-POS,20-30,2018,10,10,9,14,Wednesday,30 days,74304.632
ACC-3100725361,25,9.71,5539.22,1.0,CUS-2178051368,2018-10-10,Ronald,M,-17.03,145.73,,95d58f16-a978-4a77-8227-f719712da960,-41,145.72,TAS,Wynyard,debit,authorized,5b700492b5294f898433163ff50601ab,SALES-POS,20-30,2018,10,10,11,32,Wednesday,30 days,74304.632
ACC-3100725361,25,26.0,5513.22,,CUS-2178051368,2018-10-10,Ronald,M,-17.03,145.73,,,,,,,debit,posted,ec757a6f8d754e73b9d9f6f77c95724f,INTER BANK,20-30,2018,10,10,13,0,Wednesday,30 days,74304.632
ACC-3100725361,25,161.0,5352.22,,CUS-2178051368,2018-10-10,Ronald,M,-17.03,145.73,,,,,,,debit,posted,828c0c95ca4c41f1bbee0caff9a7f2ca,INTER BANK,20-30,2018,10,10,13,0,Wednesday,30 days,74304.632
ACC-3100725361,25,8.69,5343.53,1.0,CUS-2178051368,2018-10-10,Ronald,M,-17.03,145.73,,57c15e44-3bc5-4104-9470-f692191dbb74,-16.98,122.67,WA,Dampier Peninsula,debit,authorized,23b3eec7e9734b2e9376371bb1509314,SALES-POS,20-30,2018,10,10,16,31,Wednesday,30 days,74304.632
ACC-3100725361,25,16.4,5327.13,1.0,CUS-2178051368,2018-10-10,Ronald,M,-17.03,145.73,,f1741d09-69b2-4f5f-b1bd-6282476ef072,-17.01,145.43,QLD,Mareeba,debit,authorized,54c7f107e7b64e0084173a8d9a235151,SALES-POS,20-30,2018,10,10,23,13,Wednesday,30 days,74304.632
ACC-3100725361,25,144.0,5183.13,,CUS-2178051368,2018-10-12,Ronald,M,-17.03,145.73,,,,,,,debit,posted,e519b8635fc7466eb950aae2eef98a32,PAYMENT,20-30,2018,10,12,6,0,Friday,30 days,74304.632
ACC-3100725361,25,39.75,5143.38,0.0,CUS-2178051368,2018-10-13,Ronald,M,-17.03,145.73,,9ffd3b45-7307-455d-a4a2-b9a3052f4b4e,-33.81,151.19,NSW,Artarmon,debit,authorized,b9737e8f6e20427199bb343635f4d8a2,POS,20-30,2018,10,13,1,38,Saturday,30 days,74304.632
ACC-3100725361,25,22.81,5120.57,1.0,CUS-2178051368,2018-10-13,Ronald,M,-17.03,145.73,,2feea8be-52d3-474f-84ea-413303995b49,-37.86,145.07,VIC,Glen Iris,debit,authorized,31cea425b9e34221b6f657f10bb078cb,POS,20-30,2018,10,13,20,28,Saturday,30 days,74304.632
ACC-3100725361,25,10.52,5110.05,1.0,CUS-2178051368,2018-10-14,Ronald,M,-17.03,145.73,,a990f275-7350-4c47-818f-cbf1aa71bf84,-16.88,145.75,QLD,Cairns City,debit,authorized,565a95a01c724b6bafeaea5406712d58,SALES-POS,20-30,2018,10,14,13,3,Sunday,30 days,74304.632
ACC-3100725361,25,37.87,5072.18,1.0,CUS-2178051368,2018-10-17,Ronald,M,-17.03,145.73,,31720751-95ab-4d30-b2ee-5a9c3b96b036,-17.02,145.75,QLD,Edmonton,debit,authorized,e98f4380ac754d5fab3ea74e28be743d,SALES-POS,20-30,2018,10,17,4,7,Wednesday,30 days,74304.632
ACC-3100725361,25,26.0,5046.18,,CUS-2178051368,2018-10-17,Ronald,M,-17.03,145.73,,,,,,,debit,posted,dae3e208bc5c42a78222a05bda11701d,INTER BANK,20-30,2018,10,17,13,0,Wednesday,30 days,74304.632
ACC-3100725361,25,13.89,5032.29,1.0,CUS-2178051368,2018-10-17,Ronald,M,-17.03,145.73,,667f5118-8085-4805-b4df-593a691e0abd,-16.95,145.74,QLD,Earlville,debit,authorized,b73dc88e425b4357825bc18496d80765,SALES-POS,20-30,2018,10,17,22,37,Wednesday,30 days,74304.632
ACC-3100725361,25,26.54,5005.75,1.0,CUS-2178051368,2018-10-18,Ronald,M,-17.03,145.73,,cf184d23-d5c6-4740-bfe6-5b429f829d88,-40.99,145.73,TAS,Wynyard,debit,authorized,d4127142402f419da6eb33b75c20a7c8,POS,20-30,2018,10,18,1,37,Thursday,30 days,74304.632
ACC-3100725361,25,22.85,4982.9,1.0,CUS-2178051368,2018-10-18,Ronald,M,-17.03,145.73,,7d06d8a4-d6ce-4dd2-b4d7-dde94d1ff630,-41.05,145.91,TAS,Burnie,debit,authorized,9309642794ed492ba51cd9abf68d2052,POS,20-30,2018,10,18,8,24,Thursday,30 days,74304.632
ACC-3100725361,25,15.33,4967.57,1.0,CUS-2178051368,2018-10-18,Ronald,M,-17.03,145.73,,81e0744e-281c-43de-b088-286740dc1e97,-37.51,145.75,VIC,Marysville,debit,authorized,0a1f5b4226964b94b6b363b7a107b013,POS,20-30,2018,10,18,9,0,Thursday,30 days,74304.632
ACC-3100725361,25,14.85,4952.72,0.0,CUS-2178051368,2018-10-18,Ronald,M,-17.03,145.73,,ca8ebe61-469f-4731-8fdc-559fe5dfbde3,-17.02,145.73,QLD,Edmonton,debit,authorized,8883d70a6dad42d88a5914d99acc6d21,SALES-POS,20-30,2018,10,18,10,18,Thursday,30 days,74304.632
ACC-3100725361,25,17.55,4935.17,1.0,CUS-2178051368,2018-10-18,Ronald,M,-17.03,145.73,,49c35605-04d0-4fec-993d-de6bce1e4871,-37.79,145.16,VIC,Doncaster East,debit,authorized,37b842133a9048f4b8f47acc258732d0,POS,20-30,2018,10,18,14,43,Thursday,30 days,74304.632
ACC-3100725361,25,9.49,4925.68,1.0,CUS-2178051368,2018-10-18,Ronald,M,-17.03,145.73,,57c15e44-3bc5-4104-9470-f692191dbb74,-16.98,122.67,WA,Dampier Peninsula,debit,authorized,e10736a60ee84c1c90c74ada85e58fe4,POS,20-30,2018,10,18,22,3,Thursday,30 days,74304.632
ACC-3100725361,25,14.01,4911.67,1.0,CUS-2178051368,2018-10-22,Ronald,M,-17.03,145.73,,b35c25d1-84f3-43d0-bfd6-f0763b1e17fa,-16.92,145.78,QLD,Cairns City,debit,authorized,dd819e1b3ae04d2a824a01440084959e,POS,20-30,2018,10,22,9,5,Monday,30 days,74304.632
ACC-3100725361,25,19.12,4892.55,1.0,CUS-2178051368,2018-10-22,Ronald,M,-17.03,145.73,,b12ca92c-cb07-4af7-92ef-891c05ec4af2,-37.19,145.71,VIC,Alexandra,debit,authorized,1debe35412dd44c2832380ba730dabbe,POS,20-30,2018,10,22,11,13,Monday,30 days,74304.632
ACC-3100725361,25,10.21,4882.34,1.0,CUS-2178051368,2018-10-22,Ronald,M,-17.03,145.73,,ebfe5260-d925-4a3f-84a9-9a1612a0c818,-41.05,145.88,TAS,Park Grove,debit,authorized,fdbf12267c584fd299daedfd6b899df0,SALES-POS,20-30,2018,10,22,17,6,Monday,30 days,74304.632
ACC-3100725361,25,86.19,4796.15,1.0,CUS-2178051368,2018-10-22,Ronald,M,-17.03,145.73,,660f5b62-2cd1-44d1-93b3-5934909c059a,-38.14,145.12,VIC,Frankston,debit,authorized,c815c2a4208440fa9c374e405062e197,SALES-POS,20-30,2018,10,22,19,53,Monday,30 days,74304.632
ACC-3100725361,25,11.77,4784.38,1.0,CUS-2178051368,2018-10-24,Ronald,M,-17.03,145.73,,efa3eb4e-376f-45d3-b1e8-ad3b03a66dbb,-37.7,144.8,VIC,Taylors Lakes,debit,authorized,acc8300c08424d319761f220925d150b,SALES-POS,20-30,2018,10,24,10,39,Wednesday,30 days,74304.632
ACC-3100725361,25,32.12,4752.26,1.0,CUS-2178051368,2018-10-24,Ronald,M,-17.03,145.73,,165ae310-aa9e-43b6-b875-f996db6586bd,-27.47,153.03,QLD,Brisbane City,debit,authorized,84f3c375caf240419d799f419e2a9eac,SALES-POS,20-30,2018,10,24,11,17,Wednesday,30 days,74304.632
ACC-3100725361,25,26.0,4726.26,,CUS-2178051368,2018-10-24,Ronald,M,-17.03,145.73,,,,,,,debit,posted,bc81e9f8957e4ea681ba3deaec8b3fb1,INTER BANK,20-30,2018,10,24,13,0,Wednesday,30 days,74304.632
ACC-3100725361,25,15.94,4710.32,1.0,CUS-2178051368,2018-10-24,Ronald,M,-17.03,145.73,,bfbb283f-f5a2-4b5b-b1e3-9e5edc057ae3,-33.8,151.18,NSW,Chatswood,debit,authorized,43e364c68a9a4110b85e7cf1df7134f1,SALES-POS,20-30,2018,10,24,14,1,Wednesday,30 days,74304.632
ACC-3100725361,25,13.91,4696.41,1.0,CUS-2178051368,2018-10-25,Ronald,M,-17.03,145.73,,9b396220-0ff3-473d-8ad3-a169f8b37757,-37.9,145.13,VIC,Notting Hill,debit,authorized,18f7fff51e224845af64ec2808f69a75,POS,20-30,2018,10,25,23,1,Thursday,30 days,74304.632
ACC-3100725361,25,21.57,4674.84,1.0,CUS-2178051368,2018-10-26,Ronald,M,-17.03,145.73,,0cb93a9c-d9a8-4043-88f4-d1aea4b6e5bd,-16.99,145.42,QLD,Mareeba,debit,authorized,afacf793d33c4125a0121c2b423d9ff6,SALES-POS,20-30,2018,10,26,0,22,Friday,30 days,74304.632
ACC-3100725361,25,29.05,4645.79,1.0,CUS-2178051368,2018-10-26,Ronald,M,-17.03,145.73,,12a1e4a6-4d48-4984-9afe-c16a4c1f623d,-35.92,145.64,VIC,Cobram,debit,authorized,d54538c8143840e29f53e54bf82b8779,SALES-POS,20-30,2018,10,26,8,17,Friday,30 days,74304.632
ACC-3100725361,25,15.32,10737.7,1.0,CUS-2178051368,2018-10-26,Ronald,M,-17.03,145.73,,37fe8e9e-8581-4972-9348-26f890f02bee,-37.88,145,VIC,Ripponlea,debit,authorized,6b3aa0e6ef83431b977a8a3302dfe001,POS,20-30,2018,10,26,16,34,Friday,30 days,74304.632
ACC-3100725361,25,11.37,10726.33,1.0,CUS-2178051368,2018-10-27,Ronald,M,-17.03,145.73,,b7b9227a-1d56-4b89-a045-1dc6d98ddb4a,-16.92,145.78,QLD,Cairns City,debit,authorized,a42ca5c9aee64099ac172dbd9f4bb143,POS,20-30,2018,10,27,4,10,Saturday,30 days,74304.632
ACC-3100725361,25,36.06,10690.27,0.0,CUS-2178051368,2018-10-28,Ronald,M,-17.03,145.73,,31d151fc-b49c-4cdb-af62-2ec97f55ba9d,-35.36,145.73,NSW,Jerilderie,debit,authorized,1d8e150abcb84faea11d60b1837eaf65,POS,20-30,2018,10,28,9,58,Sunday,30 days,74304.632
ACC-3100725361,25,7.49,10682.78,1.0,CUS-2178051368,2018-10-28,Ronald,M,-17.03,145.73,,aa589ec8-1a7f-4009-923f-92639bcaed62,-37.23,145.91,VIC,Eildon,debit,authorized,6fa0fce2a1924f9c83d9120251cf1765,SALES-POS,20-30,2018,10,28,21,32,Sunday,30 days,74304.632
ACC-3100725361,25,10.3,10672.48,1.0,CUS-2178051368,2018-10-29,Ronald,M,-17.03,145.73,,2b81d172-bc5e-42fb-8569-098eaff5063d,-37.75,145.69,VIC,Warburton,debit,authorized,733e7f753fbe4da0af2d3668ad8d7d74,POS,20-30,2018,10,29,1,8,Monday,30 days,74304.632
ACC-3100725361,25,19.27,10653.21,1.0,CUS-2178051368,2018-10-29,Ronald,M,-17.03,145.73,,1c802d52-f75e-4dbf-8343-b4772e3b6dfe,-16.99,145.74,QLD,Mount Sheridan,debit,authorized,7266b9fce82144ca89339b60b1f83712,POS,20-30,2018,10,29,10,48,Monday,30 days,74304.632
ACC-3100725361,25,8.01,10645.2,1.0,CUS-2178051368,2018-10-29,Ronald,M,-17.03,145.73,,1eca2901-6392-4097-88d8-e41915133abe,-37.78,145.61,VIC,Yarra Junction,debit,authorized,659f12f503c04d04aea9679fa2357939,POS,20-30,2018,10,29,18,21,Monday,30 days,74304.632
ACC-3100725361,25,48.88,10596.32,1.0,CUS-2178051368,2018-10-30,Ronald,M,-17.03,145.73,,f3e1f057-7924-4195-aa29-a7706688c4e1,-27.46,153.03,QLD,Spring Hill,debit,authorized,f40c0e9bf4f44e0593bc6653c13d1e26,SALES-POS,20-30,2018,10,30,8,26,Tuesday,30 days,74304.632
ACC-3100725361,25,10.33,10585.99,1.0,CUS-2178051368,2018-10-30,Ronald,M,-17.03,145.73,,a990f275-7350-4c47-818f-cbf1aa71bf84,-16.88,145.75,QLD,Cairns City,debit,authorized,ca4ed0acb2bf4edc987f261f95a4f32c,SALES-POS,20-30,2018,10,30,10,9,Tuesday,30 days,74304.632
ACC-3100725361,25,9.79,10576.2,1.0,CUS-2178051368,2018-10-30,Ronald,M,-17.03,145.73,,57c15e44-3bc5-4104-9470-f692191dbb74,-16.98,122.67,WA,Dampier Peninsula,debit,authorized,4df0229de1824c96a3dee7e668424388,SALES-POS,20-30,2018,10,30,18,34,Tuesday,30 days,74304.632
ACC-3100725361,25,19.31,10556.89,1.0,CUS-2178051368,2018-10-30,Ronald,M,-17.03,145.73,,fe87d8f6-9502-418a-8ce7-851b86b8f819,-37.82,145.22,VIC,Ringwood,debit,authorized,2a62f54a84a34fc7b8409ed06c132a85,POS,20-30,2018,10,30,23,39,Tuesday,30 days,74304.632
ACC-3100725361,25,26.0,10530.89,,CUS-2178051368,2018-10-31,Ronald,M,-17.03,145.73,,,,,,,debit,posted,dd8314056cce459596226942ac33bf79,INTER BANK,20-30,2018,10,31,13,0,Wednesday,30 days,74304.632
ACC-3100725361,25,16.08,10514.81,1.0,CUS-2178051368,2018-10-31,Ronald,M,-17.03,145.73,,0e767127-e5b6-48cd-9d50-f80c8932f9e8,-16.92,145.77,QLD,Cairns City,debit,authorized,38adb2818ba343f891fb0e9fab8f5195,SALES-POS,20-30,2018,10,31,14,51,Wednesday,30 days,74304.632
ACC-3100725361,25,8.52,10506.29,1.0,CUS-2178051368,2018-10-31,Ronald,M,-17.03,145.73,,1eca2901-6392-4097-88d8-e41915133abe,-37.78,145.61,VIC,Yarra Junction,debit,authorized,8cb807adda7d46a882f6a873440e425b,POS,20-30,2018,10,31,16,2,Wednesday,30 days,74304.632
ACC-3100725361,25,34.31,10471.98,1.0,CUS-2178051368,2018-10-31,Ronald,M,-17.03,145.73,,3d5cd451-fdd7-4eae-9494-d9866e8cdedf,-16.81,145.7,QLD,Smithfield,debit,authorized,c43b9e087328441ea2ddac6056ce5e96,POS,20-30,2018,10,31,19,44,Wednesday,30 days,74304.632
ACC-3100725361,25,26.59,10445.39,1.0,CUS-2178051368,2018-10-31,Ronald,M,-17.03,145.73,,f17a5cbd-fa5d-47db-8235-c7f449597dd0,-16.84,145.69,QLD,Smithfield,debit,authorized,593930fd0e1640398b5638f74b7dee14,SALES-POS,20-30,2018,10,31,22,22,Wednesday,30 days,74304.632
ACC-1990648130,21,28.49,1689.89,1.0,CUS-809013380,2018-08-01,Kaitlyn,F,-28.80,114.62,,0898833a-fca8-40b5-a738-8e1d4aa98322,-28.84,153.44,NSW,Alstonville,debit,authorized,4c299aa143c94a03bee6fba9db884567,POS,20-30,2018,8,1,9,39,Wednesday,7 days,54075.793
ACC-1990648130,21,14.43,1675.46,1.0,CUS-809013380,2018-08-01,Kaitlyn,F,-28.80,114.62,,55800aa3-486e-43f1-a0a3-1130709e4c0f,-28.9,121.33,WA,Leonora,debit,authorized,e25a2c80035844a4846625adb43d893a,POS,20-30,2018,8,1,9,43,Wednesday,7 days,54075.793
ACC-1990648130,21,135.0,1540.46,,CUS-809013380,2018-08-02,Kaitlyn,F,-28.80,114.62,,,,,,,debit,posted,31a0f2882f734b8786517374465b7a76,PAYMENT,20-30,2018,8,2,18,0,Thursday,7 days,54075.793
ACC-1990648130,21,28.0,1512.46,,CUS-809013380,2018-08-03,Kaitlyn,F,-28.80,114.62,,,,,,,debit,posted,3144f4a7aaa441f1ac5483ad75e71f7d,PAYMENT,20-30,2018,8,3,6,0,Friday,7 days,54075.793
ACC-1990648130,21,36.06,1476.4,1.0,CUS-809013380,2018-08-04,Kaitlyn,F,-28.80,114.62,,ade44fed-cf6d-4c45-8141-790dadb96d8b,-33.87,151.21,NSW,Sydney,debit,authorized,1684813ec10e41b9a3c0211d842c4ccd,SALES-POS,20-30,2018,8,4,18,4,Saturday,7 days,54075.793
ACC-1990648130,21,5.51,1470.89,1.0,CUS-809013380,2018-08-04,Kaitlyn,F,-28.80,114.62,,ca76c244-2b13-4760-8832-3d02d0ef8bae,-33.88,151.21,NSW,Surry Hills,debit,authorized,b193cf10686d495b8b003cce1cf73c79,SALES-POS,20-30,2018,8,4,19,5,Saturday,7 days,54075.793
ACC-1990648130,21,19.63,2488.33,1.0,CUS-809013380,2018-08-07,Kaitlyn,F,-28.80,114.62,,a3b4ecda-8a9f-44fd-8ca5-e3a111ead890,-28.85,153.56,NSW,Ballina,debit,authorized,c54b6f10360948998e80d7c66b3a3fae,SALES-POS,20-30,2018,8,7,17,46,Tuesday,7 days,54075.793
ACC-1990648130,21,20.02,2468.31,0.0,CUS-809013380,2018-08-07,Kaitlyn,F,-28.80,114.62,,e38bfe8c-f1e6-4f72-9c59-beb19860a8b3,-28.88,121.33,WA,Leonora,debit,authorized,4dc23e8c109b48c9a772e8b5019685b4,SALES-POS,20-30,2018,8,7,19,52,Tuesday,7 days,54075.793
ACC-1990648130,21,9.53,2458.78,1.0,CUS-809013380,2018-08-07,Kaitlyn,F,-28.80,114.62,,a18ccfc9-fc63-45a7-b359-715d1732b712,-28.87,153.04,NSW,Casino,debit,authorized,b1c8ca09d2f84966bc6d34300921c474,POS,20-30,2018,8,7,22,22,Tuesday,7 days,54075.793
ACC-1990648130,21,23.02,2435.76,1.0,CUS-809013380,2018-08-08,Kaitlyn,F,-28.80,114.62,,94748d82-dcbf-48a1-b2b9-a27d41e4075b,-28.77,114.61,WA,Geraldton,debit,authorized,ce36b29be1cd4e8b8fdd750854610eed,POS,20-30,2018,8,8,2,14,Wednesday,7 days,54075.793
ACC-1990648130,21,28.05,2407.71,1.0,CUS-809013380,2018-08-08,Kaitlyn,F,-28.80,114.62,,7233bf62-03fc-4889-861e-83c4bb3aff13,-28.86,153.04,NSW,Casino,debit,authorized,890298448b2244cd8b587b7aca623d63,SALES-POS,20-30,2018,8,8,6,2,Wednesday,7 days,54075.793
ACC-1990648130,21,19.93,2387.78,0.0,CUS-809013380,2018-08-08,Kaitlyn,F,-28.80,114.62,,e38bfe8c-f1e6-4f72-9c59-beb19860a8b3,-28.88,121.33,WA,Leonora,debit,authorized,6038dbf1af64457181a3b9ff647b0240,POS,20-30,2018,8,8,17,8,Wednesday,7 days,54075.793
ACC-1990648130,21,20.68,2367.1,1.0,CUS-809013380,2018-08-08,Kaitlyn,F,-28.80,114.62,,82bd7507-7481-4aad-9ec0-5071d5ba1bf0,-28.79,114.7,WA,Moonyoonooka,debit,authorized,31426f9d925a4c5e88ffcff9964987d3,SALES-POS,20-30,2018,8,8,22,58,Wednesday,7 days,54075.793
ACC-1990648130,21,14.26,2352.84,1.0,CUS-809013380,2018-08-09,Kaitlyn,F,-28.80,114.62,,c27e22fe-1781-4596-b7f0-9d57e2538fb8,-28.78,114.61,WA,Geraldton,debit,authorized,c7c35df6589440be8b8863fe52380d80,SALES-POS,20-30,2018,8,9,9,13,Thursday,7 days,54075.793
ACC-1990648130,21,28.0,2324.84,,CUS-809013380,2018-08-10,Kaitlyn,F,-28.80,114.62,,,,,,,debit,posted,f41afeef18d34325ae6a963c782e8924,PAYMENT,20-30,2018,8,10,6,0,Friday,7 days,54075.793
ACC-1990648130,21,4.3,2320.54,1.0,CUS-809013380,2018-08-14,Kaitlyn,F,-28.80,114.62,,ad13c1e4-8623-4c29-90b1-c7a885c9e19c,-28.85,153.55,NSW,Ballina,debit,authorized,62eda5518b844ee892fa093561d4ef00,SALES-POS,20-30,2018,8,14,14,40,Tuesday,7 days,54075.793
ACC-1990648130,21,19.46,3338.15,1.0,CUS-809013380,2018-08-14,Kaitlyn,F,-28.80,114.62,,d3c9f487-ef5b-43c8-83cf-4887f26f3a40,-28.8,153.28,NSW,Lismore,debit,authorized,3b127a35b8b2494bbc433395a84d3583,POS,20-30,2018,8,14,15,33,Tuesday,7 days,54075.793
ACC-1990648130,21,20.6,3317.55,1.0,CUS-809013380,2018-08-14,Kaitlyn,F,-28.80,114.62,,e38bfe8c-f1e6-4f72-9c59-beb19860a8b3,-28.88,121.33,WA,Leonora,debit,authorized,977ab812574a44a09f3bdac6b20ab34d,SALES-POS,20-30,2018,8,14,15,42,Tuesday,7 days,54075.793
ACC-1990648130,21,28.0,3289.55,,CUS-809013380,2018-08-17,Kaitlyn,F,-28.80,114.62,,,,,,,debit,posted,8b8925b743dc4768a6465bf8ffaede2d,PAYMENT,20-30,2018,8,17,6,0,Friday,7 days,54075.793
ACC-1990648130,21,8.06,3281.49,1.0,CUS-809013380,2018-08-17,Kaitlyn,F,-28.80,114.62,,9d225e05-23d6-4e29-acc8-8c09e251c22c,-28.82,153.33,NSW,Goonellabah,debit,authorized,76736b797b5142c5913eb26de5099fb1,POS,20-30,2018,8,17,12,3,Friday,7 days,54075.793
ACC-1990648130,21,7.28,3274.21,1.0,CUS-809013380,2018-08-17,Kaitlyn,F,-28.80,114.62,,20f49fac-03e1-43fb-a497-d2463bc779a5,-28.76,122.05,WA,Laverton,debit,authorized,1a4f3d8ed901455093bd4894be5ff562,POS,20-30,2018,8,17,12,36,Friday,7 days,54075.793
ACC-1990648130,21,6.37,3267.84,1.0,CUS-809013380,2018-08-17,Kaitlyn,F,-28.80,114.62,,20f49fac-03e1-43fb-a497-d2463bc779a5,-28.76,122.05,WA,Laverton,debit,authorized,3cd1a0c06eab4216bca9dbc47cefaa49,POS,20-30,2018,8,17,14,2,Friday,7 days,54075.793
ACC-1990648130,21,18.34,3249.5,1.0,CUS-809013380,2018-08-17,Kaitlyn,F,-28.80,114.62,,d3c9f487-ef5b-43c8-83cf-4887f26f3a40,-28.8,153.28,NSW,Lismore,debit,authorized,780448634a1541ec84aee7a847054c82,POS,20-30,2018,8,17,17,39,Friday,7 days,54075.793
ACC-1990648130,21,10.47,3239.03,0.0,CUS-809013380,2018-08-18,Kaitlyn,F,-28.80,114.62,,71d6ad22-eff0-4ab8-b771-72bcc0385c75,-28.78,114.59,WA,West End,debit,authorized,55236ee8451b4fa89c8b32e16aced7e4,POS,20-30,2018,8,18,23,29,Saturday,7 days,54075.793
ACC-1990648130,21,45.95,3193.08,1.0,CUS-809013380,2018-08-19,Kaitlyn,F,-28.80,114.62,,411776f7-814b-4227-93fb-1c0a6047a4d9,-26.7,114.57,WA,Meadow,debit,authorized,105099489e5f44a292455e52530becc8,SALES-POS,20-30,2018,8,19,10,10,Sunday,7 days,54075.793
ACC-1990648130,21,12.89,3180.19,0.0,CUS-809013380,2018-08-19,Kaitlyn,F,-28.80,114.62,,bac5f1e6-9678-4ae1-9c08-7a2f5842235a,-28.81,153.28,NSW,Lismore,debit,authorized,cb59581c0a1542fb91a4c23a827fdcaf,SALES-POS,20-30,2018,8,19,10,35,Sunday,7 days,54075.793
ACC-1990648130,21,7.75,3172.44,1.0,CUS-809013380,2018-08-19,Kaitlyn,F,-28.80,114.62,,20f49fac-03e1-43fb-a497-d2463bc779a5,-28.76,122.05,WA,Laverton,debit,authorized,323cb687b5a543788c3175740aeca24c,POS,20-30,2018,8,19,17,44,Sunday,7 days,54075.793
ACC-1990648130,21,16.03,3156.41,1.0,CUS-809013380,2018-08-21,Kaitlyn,F,-28.80,114.62,,cc3b1321-8dbb-45cc-98e1-ba891d87ad78,-28.73,153.41,NSW,Clunes,debit,authorized,40e568ef4ae243e1914ca8f69e4d4957,POS,20-30,2018,8,21,11,56,Tuesday,7 days,54075.793
ACC-1990648130,21,8.72,4184.76,0.0,CUS-809013380,2018-08-21,Kaitlyn,F,-28.80,114.62,,a18ccfc9-fc63-45a7-b359-715d1732b712,-28.87,153.04,NSW,Casino,debit,authorized,dfae6b4e694c47a3b75cdca6b7f249e2,SALES-POS,20-30,2018,8,21,15,28,Tuesday,7 days,54075.793
ACC-1990648130,21,8.51,4176.25,1.0,CUS-809013380,2018-08-21,Kaitlyn,F,-28.80,114.62,,20f49fac-03e1-43fb-a497-d2463bc779a5,-28.76,122.05,WA,Laverton,debit,authorized,38012624e37b4ea99b3768261e87e92c,POS,20-30,2018,8,21,15,54,Tuesday,7 days,54075.793
ACC-1990648130,21,13.94,4162.31,1.0,CUS-809013380,2018-08-21,Kaitlyn,F,-28.80,114.62,,357ed478-5937-4843-b53b-c3c68cfa26c4,-28.72,153.53,NSW,Newrybar,debit,authorized,b1e6fdc9624d43689988df4ead59d8a5,SALES-POS,20-30,2018,8,21,17,30,Tuesday,7 days,54075.793
ACC-1990648130,21,78.0,4084.31,,CUS-809013380,2018-08-21,Kaitlyn,F,-28.80,114.62,,,,,,,debit,posted,9e22c5a46ac847abb8eb9ca208abc784,PAYMENT,20-30,2018,8,21,19,0,Tuesday,7 days,54075.793
ACC-1990648130,21,1383.0,2701.31,,CUS-809013380,2018-08-22,Kaitlyn,F,-28.80,114.62,,,,,,,debit,posted,300447db7412413aaf0ea60f26714dd7,INTER BANK,20-30,2018,8,22,8,0,Wednesday,7 days,54075.793
ACC-1990648130,21,26.68,2674.63,1.0,CUS-809013380,2018-08-22,Kaitlyn,F,-28.80,114.62,,8a6de350-2d81-4eeb-b4ba-f68892eda39c,-28.81,153.28,NSW,Lismore,debit,authorized,957405c8cd0c42bab035b9248515efe8,SALES-POS,20-30,2018,8,22,22,56,Wednesday,7 days,54075.793
ACC-1990648130,21,28.0,2646.63,,CUS-809013380,2018-08-24,Kaitlyn,F,-28.80,114.62,,,,,,,debit,posted,a09ccb2f11f04a008a7a26536ff18cd0,PAYMENT,20-30,2018,8,24,6,0,Friday,7 days,54075.793
ACC-1990648130,21,8.18,2638.45,1.0,CUS-809013380,2018-08-24,Kaitlyn,F,-28.80,114.62,,20f49fac-03e1-43fb-a497-d2463bc779a5,-28.76,122.05,WA,Laverton,debit,authorized,b4143e81fe0247c093ca5dadd283971c,POS,20-30,2018,8,24,9,22,Friday,7 days,54075.793
ACC-1990648130,21,14.13,2624.32,1.0,CUS-809013380,2018-08-24,Kaitlyn,F,-28.80,114.62,,f75cba91-43f5-48cb-83ac-c4c2254e0028,-28.85,153.45,NSW,Alstonville,debit,authorized,9426cd7b65b9429192e7cad258f0efd9,SALES-POS,20-30,2018,8,24,13,3,Friday,7 days,54075.793
ACC-1990648130,21,7.54,2616.78,1.0,CUS-809013380,2018-08-24,Kaitlyn,F,-28.80,114.62,,995651b2-6592-49fe-8f54-1ac6753f67ea,-28.75,153.23,NSW,Goolmangar,debit,authorized,d5ef8b4f646d42c68af31678b2a6210c,SALES-POS,20-30,2018,8,24,13,58,Friday,7 days,54075.793
ACC-1990648130,21,22.3,2594.48,1.0,CUS-809013380,2018-08-25,Kaitlyn,F,-28.80,114.62,,32c03c46-713f-4603-8a67-14293e5090a7,-28.86,153.05,NSW,Casino,debit,authorized,f0cd019f68604f3089e5c93e62a86926,POS,20-30,2018,8,25,21,53,Saturday,7 days,54075.793
ACC-1990648130,21,68.17,2526.31,1.0,CUS-809013380,2018-08-25,Kaitlyn,F,-28.80,114.62,,b3dfd002-5a12-4da0-9a8c-7ae7178d4160,-33.75,151.24,NSW,Frenchs Forest,debit,authorized,fe8984cb90e344f782d1d58b4d56421f,POS,20-30,2018,8,25,23,6,Saturday,7 days,54075.793
ACC-1990648130,21,8.02,2518.29,1.0,CUS-809013380,2018-08-26,Kaitlyn,F,-28.80,114.62,,20f49fac-03e1-43fb-a497-d2463bc779a5,-28.76,122.05,WA,Laverton,debit,authorized,6ac4fdd334f44b7898bcd658f196b240,POS,20-30,2018,8,26,9,30,Sunday,7 days,54075.793
ACC-1990648130,21,12.55,2505.74,1.0,CUS-809013380,2018-08-26,Kaitlyn,F,-28.80,114.62,,97f098ef-0fd9-4cb1-94d2-a68d8446ca6c,-28.87,153.56,NSW,Ballina,debit,authorized,30f9906ab3264310ba8fa37f5ff95b9c,POS,20-30,2018,8,26,9,52,Sunday,7 days,54075.793
ACC-1990648130,21,38.42,2467.32,1.0,CUS-809013380,2018-08-26,Kaitlyn,F,-28.80,114.62,,907956c3-283d-4f7e-80f9-d944b5735c30,-33.88,151.02,NSW,Regents Park,debit,authorized,0c8677c5d51341159e64e5a67b7ebab1,SALES-POS,20-30,2018,8,26,10,54,Sunday,7 days,54075.793
ACC-1990648130,21,7.79,2459.53,1.0,CUS-809013380,2018-08-26,Kaitlyn,F,-28.80,114.62,,995651b2-6592-49fe-8f54-1ac6753f67ea,-28.75,153.23,NSW,Goolmangar,debit,authorized,27d292d9eb0f4be5888496b363dca497,SALES-POS,20-30,2018,8,26,11,15,Sunday,7 days,54075.793
ACC-1990648130,21,7.36,2452.17,1.0,CUS-809013380,2018-08-26,Kaitlyn,F,-28.80,114.62,,9d225e05-23d6-4e29-acc8-8c09e251c22c,-28.82,153.33,NSW,Goonellabah,debit,authorized,efcbc17e71a241709d529abe74adaaf6,POS,20-30,2018,8,26,17,12,Sunday,7 days,54075.793
ACC-1990648130,21,38.5,2413.67,1.0,CUS-809013380,2018-08-26,Kaitlyn,F,-28.80,114.62,,e3956228-a9fc-4fae-b2ef-9cab5926c660,-37.75,145.02,VIC,Preston,debit,authorized,79e15669bd2d46aab7959a1032de3c15,POS,20-30,2018,8,26,21,4,Sunday,7 days,54075.793
ACC-1990648130,21,57.65,2356.02,1.0,CUS-809013380,2018-08-27,Kaitlyn,F,-28.80,114.62,,b53f4984-e11f-40e1-9b1d-e342e4350ca4,-28.86,153.56,NSW,Ballina,debit,authorized,48895772e4c24a4dbf41687e8fd235fe,POS,20-30,2018,8,27,0,51,Monday,7 days,54075.793
ACC-1990648130,21,180.0,2176.02,,CUS-809013380,2018-08-27,Kaitlyn,F,-28.80,114.62,,,,,,,debit,posted,e8f147417be14ac8b269ce3a13065cfb,PAYMENT,20-30,2018,8,27,3,0,Monday,7 days,54075.793
ACC-1990648130,21,13.87,2162.15,1.0,CUS-809013380,2018-08-27,Kaitlyn,F,-28.80,114.62,,6894f899-b3f7-4f2c-8b53-a7792cf628fe,-28.85,153.56,NSW,Ballina,debit,authorized,12a441ed9c524c318589351ac61a18b0,SALES-POS,20-30,2018,8,27,9,40,Monday,7 days,54075.793
ACC-1990648130,21,13.41,2148.74,1.0,CUS-809013380,2018-08-27,Kaitlyn,F,-28.80,114.62,,357ed478-5937-4843-b53b-c3c68cfa26c4,-28.72,153.53,NSW,Newrybar,debit,authorized,4948d5a689aa471582cc1af58165e738,POS,20-30,2018,8,27,13,15,Monday,7 days,54075.793
ACC-1990648130,21,28.73,2120.01,1.0,CUS-809013380,2018-08-27,Kaitlyn,F,-28.80,114.62,,7233bf62-03fc-4889-861e-83c4bb3aff13,-28.86,153.04,NSW,Casino,debit,authorized,9f2fe4276c2b43a58f8605a775bc5a82,SALES-POS,20-30,2018,8,27,21,48,Monday,7 days,54075.793
ACC-1990648130,21,9.62,2110.39,0.0,CUS-809013380,2018-08-28,Kaitlyn,F,-28.80,114.62,,60268e27-530a-4d30-bb9d-9b01072f1cf9,-28.84,153.44,NSW,Alstonville,debit,authorized,4701e10d62484c729dfd466c50eb1054,POS,20-30,2018,8,28,1,1,Tuesday,7 days,54075.793
ACC-1990648130,21,8.26,2102.13,1.0,CUS-809013380,2018-08-28,Kaitlyn,F,-28.80,114.62,,37cd09c5-f238-4d32-8a60-03755b38b744,-27.53,153.1,QLD,Mansfield,debit,authorized,87a1af56f67f453883cb40119230fb9a,SALES-POS,20-30,2018,8,28,9,0,Tuesday,7 days,54075.793
ACC-1990648130,21,30.85,3108.35,1.0,CUS-809013380,2018-08-29,Kaitlyn,F,-28.80,114.62,,047e675b-ba97-4fd2-973f-bf14fa17f431,-28.78,114.61,WA,Geraldton,debit,authorized,8541ad5e363843f48c58443971ea6ebf,POS,20-30,2018,8,29,17,37,Wednesday,7 days,54075.793
ACC-1990648130,21,24.8,3083.55,0.0,CUS-809013380,2018-08-29,Kaitlyn,F,-28.80,114.62,,bde60467-effb-4a93-bdf3-6e84ef38156b,-28.82,153.33,NSW,Goonellabah,debit,authorized,f586c711a72240188d3d7167e3dbce6b,POS,20-30,2018,8,29,21,32,Wednesday,7 days,54075.793
ACC-1990648130,21,28.0,3055.55,,CUS-809013380,2018-08-31,Kaitlyn,F,-28.80,114.62,,,,,,,debit,posted,a27972a6807140568a60445f2a381789,PAYMENT,20-30,2018,8,31,6,0,Friday,7 days,54075.793
ACC-1990648130,21,8.78,3046.77,1.0,CUS-809013380,2018-08-31,Kaitlyn,F,-28.80,114.62,,a18ccfc9-fc63-45a7-b359-715d1732b712,-28.87,153.04,NSW,Casino,debit,authorized,2ac134a8e581450da7fef6e0ec4d1bf1,POS,20-30,2018,8,31,7,51,Friday,7 days,54075.793
ACC-1990648130,21,11.36,3035.41,1.0,CUS-809013380,2018-08-31,Kaitlyn,F,-28.80,114.62,,d4a36b62-4e26-461b-a18a-bbdb7800b004,-31.96,115.86,WA,Perth,debit,authorized,0f0448d8015a40c085266a0ca4c6834d,SALES-POS,20-30,2018,8,31,11,27,Friday,7 days,54075.793
ACC-1990648130,21,77.63,2957.78,1.0,CUS-809013380,2018-08-31,Kaitlyn,F,-28.80,114.62,,ff1f7f98-6258-48d5-9b2c-0b45d9d01e9d,-28.8,151.9,QLD,Ballandean,debit,authorized,98f425fde1a54b8d91ada96d67624f1c,SALES-POS,20-30,2018,8,31,14,0,Friday,7 days,54075.793
ACC-1990648130,21,20.76,2937.02,0.0,CUS-809013380,2018-08-31,Kaitlyn,F,-28.80,114.62,,efaf871e-5d3e-40a2-8990-218c13e5a78e,-28.89,152.57,NSW,Tabulam,debit,authorized,03203d58b53a4e5faa15483e92700103,POS,20-30,2018,8,31,15,1,Friday,7 days,54075.793
ACC-1990648130,21,23.42,2913.6,1.0,CUS-809013380,2018-08-31,Kaitlyn,F,-28.80,114.62,,ce4dfff9-2a03-43b3-96c6-4cfd104bce00,-28.81,153.27,NSW,South Lismore,debit,authorized,58a39f6cdc3444799cec1fc93bd6fc06,POS,20-30,2018,8,31,17,45,Friday,7 days,54075.793
ACC-1990648130,21,30.59,2883.01,1.0,CUS-809013380,2018-08-31,Kaitlyn,F,-28.80,114.62,,c19c0f54-5006-441a-9bd2-1055cb84084c,-28.81,153.29,NSW,Lismore,debit,authorized,880d948900604c71a0804ff20a4dd486,POS,20-30,2018,8,31,20,59,Friday,7 days,54075.793
ACC-1990648130,21,25.41,2857.6,1.0,CUS-809013380,2018-08-31,Kaitlyn,F,-28.80,114.62,,122883a5-9d03-4192-bfd2-927eb4800e55,-28.82,153.34,NSW,Goonellabah,debit,authorized,2e8da146e84449888d1ccb080bb570e3,POS,20-30,2018,8,31,21,14,Friday,7 days,54075.793
ACC-1990648130,21,8.87,2848.73,0.0,CUS-809013380,2018-08-31,Kaitlyn,F,-28.80,114.62,,6078b36f-b7a8-4171-806e-813ae73bf628,-28.86,153.56,NSW,Ballina,debit,authorized,05a2f78ecced44fe86ff46a45d432218,SALES-POS,20-30,2018,8,31,21,24,Friday,7 days,54075.793
ACC-1990648130,21,45.17,2803.56,0.0,CUS-809013380,2018-09-01,Kaitlyn,F,-28.80,114.62,,86f6f266-ca2e-4a5e-b563-2a40bda8d2e0,-37.82,144.96,VIC,Melbourne,debit,authorized,2649c5bdfe1a4e8c9138c2a49d1ab14b,POS,20-30,2018,9,1,16,13,Saturday,7 days,54075.793
ACC-1990648130,21,6.38,2797.18,1.0,CUS-809013380,2018-09-01,Kaitlyn,F,-28.80,114.62,,ca76c244-2b13-4760-8832-3d02d0ef8bae,-33.88,151.21,NSW,Surry Hills,debit,authorized,d8b7c28afac942bf81c816483c78d90f,POS,20-30,2018,9,1,17,0,Saturday,7 days,54075.793
ACC-1990648130,21,12.85,2784.33,0.0,CUS-809013380,2018-09-01,Kaitlyn,F,-28.80,114.62,,f75cba91-43f5-48cb-83ac-c4c2254e0028,-28.85,153.45,NSW,Alstonville,debit,authorized,82bfdd4b89514327bd0d51f3ef254460,POS,20-30,2018,9,1,17,16,Saturday,7 days,54075.793
ACC-1990648130,21,37.79,2746.54,1.0,CUS-809013380,2018-09-01,Kaitlyn,F,-28.80,114.62,,6a71cdc2-672a-4f84-b4bd-13eaaef07d9e,-28.86,153.56,NSW,Ballina,debit,authorized,4693f04d0c764b82b2a9df78faa24538,POS,20-30,2018,9,1,20,6,Saturday,7 days,54075.793
ACC-1990648130,21,11.6,2734.94,1.0,CUS-809013380,2018-09-01,Kaitlyn,F,-28.80,114.62,,3a12af3d-a155-4e6f-aaf0-24d4ad71a57d,-28.82,153.3,NSW,East Lismore,debit,authorized,25023deb7ccf44ffa528aea5bb909a81,POS,20-30,2018,9,1,20,27,Saturday,7 days,54075.793
ACC-1990648130,21,6.18,2728.76,0.0,CUS-809013380,2018-09-02,Kaitlyn,F,-28.80,114.62,,8c17f994-bf4e-4045-ad13-7cbf4173eea4,-28.77,114.61,WA,Geraldton,debit,authorized,4ea93df2e24e4c238c1580c705b7dff0,POS,20-30,2018,9,2,11,47,Sunday,7 days,54075.793
ACC-1990648130,21,12.35,2716.41,1.0,CUS-809013380,2018-09-02,Kaitlyn,F,-28.80,114.62,,97f098ef-0fd9-4cb1-94d2-a68d8446ca6c,-28.87,153.56,NSW,Ballina,debit,authorized,fd9538c030d7458da20afa3067e9dca6,SALES-POS,20-30,2018,9,2,11,56,Sunday,7 days,54075.793
ACC-1990648130,21,56.35,2660.06,1.0,CUS-809013380,2018-09-02,Kaitlyn,F,-28.80,114.62,,5c011d61-fbbe-437f-9ffa-3d9910cd2c7a,-37.83,145.15,VIC,Blackburn,debit,authorized,0cc49c6e4d02467ab9d946a1d5bc4e15,SALES-POS,20-30,2018,9,2,14,25,Sunday,7 days,54075.793
ACC-1990648130,21,47.33,2612.73,1.0,CUS-809013380,2018-09-02,Kaitlyn,F,-28.80,114.62,,f4b6a8b6-df07-4da7-9a9d-b46f3aff014b,-28.86,153.56,NSW,Ballina,debit,authorized,1649678e940b4d2a8c48c96f810bf322,POS,20-30,2018,9,2,14,34,Sunday,7 days,54075.793
ACC-1990648130,21,135.0,2477.73,,CUS-809013380,2018-09-02,Kaitlyn,F,-28.80,114.62,,,,,,,debit,posted,de0fc5a562b240d092552306edc5d521,PAYMENT,20-30,2018,9,2,18,0,Sunday,7 days,54075.793
ACC-1990648130,21,26.5,2451.23,1.0,CUS-809013380,2018-09-03,Kaitlyn,F,-28.80,114.62,,122883a5-9d03-4192-bfd2-927eb4800e55,-28.82,153.34,NSW,Goonellabah,debit,authorized,04932da035ab4b56a373e85d0cd566be,SALES-POS,20-30,2018,9,3,3,9,Monday,7 days,54075.793
ACC-1990648130,21,58.32,2392.91,0.0,CUS-809013380,2018-09-03,Kaitlyn,F,-28.80,114.62,,b53f4984-e11f-40e1-9b1d-e342e4350ca4,-28.86,153.56,NSW,Ballina,debit,authorized,61006d5f87114721be70aefabb466e6d,SALES-POS,20-30,2018,9,3,12,45,Monday,7 days,54075.793
ACC-1990648130,21,30.04,2362.87,1.0,CUS-809013380,2018-09-03,Kaitlyn,F,-28.80,114.62,,047e675b-ba97-4fd2-973f-bf14fa17f431,-28.78,114.61,WA,Geraldton,debit,authorized,ae4afbc66c664088a7b068efc91aa5aa,POS,20-30,2018,9,3,13,8,Monday,7 days,54075.793
ACC-1990648130,21,28.0,3371.94,,CUS-809013380,2018-09-07,Kaitlyn,F,-28.80,114.62,,,,,,,debit,posted,131a6d569e8244629ff287cd5b3973f6,PAYMENT,20-30,2018,9,7,6,0,Friday,7 days,54075.793
ACC-1990648130,21,18.53,3353.41,1.0,CUS-809013380,2018-09-08,Kaitlyn,F,-28.80,114.62,,654f2746-6db1-4620-99fe-a16cff87db6e,-33.8,151.18,NSW,Chatswood West,debit,authorized,84f258d9db2e40e19d931ba848ccb2fd,POS,20-30,2018,9,8,8,4,Saturday,7 days,54075.793
ACC-1990648130,21,17.48,3335.93,0.0,CUS-809013380,2018-09-08,Kaitlyn,F,-28.80,114.62,,2e4529be-02ba-44b9-b740-b3914eb04c0a,-28.82,153.33,NSW,Goonellabah,debit,authorized,7be0a7616f144c3d97ed373bdf9bf650,POS,20-30,2018,9,8,10,8,Saturday,7 days,54075.793
ACC-1990648130,21,22.96,3312.97,1.0,CUS-809013380,2018-09-08,Kaitlyn,F,-28.80,114.62,,efaf871e-5d3e-40a2-8990-218c13e5a78e,-28.89,152.57,NSW,Tabulam,debit,authorized,63d40967f06746e9a5b3435e3646f535,POS,20-30,2018,9,8,12,16,Saturday,7 days,54075.793
ACC-1990648130,21,10.77,3302.2,1.0,CUS-809013380,2018-09-08,Kaitlyn,F,-28.80,114.62,,354b6030-848a-4a1c-be4d-9df2ded3ec6c,-28.76,114.63,WA,Wonthella,debit,authorized,b4d52b1bebb6446b8fd03ed0e9d52697,SALES-POS,20-30,2018,9,8,14,8,Saturday,7 days,54075.793
ACC-1990648130,21,10.65,3291.55,0.0,CUS-809013380,2018-09-11,Kaitlyn,F,-28.80,114.62,,72001733-2028-44be-92b8-2d7e25512d3e,-28.88,121.33,WA,Leonora,debit,authorized,da20f395f49e46bd9694139f427993c6,POS,20-30,2018,9,11,10,29,Tuesday,7 days,54075.793
ACC-1990648130,21,13.34,4315.28,0.0,CUS-809013380,2018-09-11,Kaitlyn,F,-28.80,114.62,,810b95a9-3abc-42de-86c6-837e0abb58fc,-28.81,153.29,NSW,Lismore,debit,authorized,54056c124cc6492f99f46dfa25bdb850,SALES-POS,20-30,2018,9,11,21,27,Tuesday,7 days,54075.793
ACC-1990648130,21,28.0,4287.28,,CUS-809013380,2018-09-14,Kaitlyn,F,-28.80,114.62,,,,,,,debit,posted,7fbcb27e46144719a1c145ce0bf86218,PAYMENT,20-30,2018,9,14,6,0,Friday,7 days,54075.793
ACC-1990648130,21,15.66,5308.69,1.0,CUS-809013380,2018-09-20,Kaitlyn,F,-28.80,114.62,,55800aa3-486e-43f1-a0a3-1130709e4c0f,-28.9,121.33,WA,Leonora,debit,authorized,4c9cc84c50a04d239862be8e5a39c914,POS,20-30,2018,9,20,9,47,Thursday,7 days,54075.793
ACC-1990648130,21,7.3,5301.39,0.0,CUS-809013380,2018-09-20,Kaitlyn,F,-28.80,114.62,,20f49fac-03e1-43fb-a497-d2463bc779a5,-28.76,122.05,WA,Laverton,debit,authorized,8c965333811543c29224d806362daec3,POS,20-30,2018,9,20,22,37,Thursday,7 days,54075.793
ACC-1990648130,21,377.79,4923.6,1.0,CUS-809013380,2018-09-21,Kaitlyn,F,-28.80,114.62,,16749edf-3f58-4cd1-98c5-b1fb8a5e6cdb,-37.85,145.08,VIC,Camberwell,debit,authorized,8b05a21be1c1490583b5adecf2a395d2,SALES-POS,20-30,2018,9,21,2,16,Friday,7 days,54075.793
ACC-1990648130,21,28.0,4895.6,,CUS-809013380,2018-09-21,Kaitlyn,F,-28.80,114.62,,,,,,,debit,posted,3d3cfd4fe2aa44f8bfa7a3910e193672,PAYMENT,20-30,2018,9,21,6,0,Friday,7 days,54075.793
ACC-1990648130,21,67.54,4828.06,1.0,CUS-809013380,2018-09-21,Kaitlyn,F,-28.80,114.62,,2923fb5b-08fe-468c-8c95-e8529b75f52c,-28.87,153.56,NSW,Ballina,debit,authorized,7bcd1e051fb84512b23193bbea6c2497,SALES-POS,20-30,2018,9,21,11,5,Friday,7 days,54075.793
ACC-1990648130,21,14.39,4813.67,1.0,CUS-809013380,2018-09-21,Kaitlyn,F,-28.80,114.62,,f75cba91-43f5-48cb-83ac-c4c2254e0028,-28.85,153.45,NSW,Alstonville,debit,authorized,58146d3568bd493283fc4243ad0ed3a7,POS,20-30,2018,9,21,11,20,Friday,7 days,54075.793
ACC-1990648130,21,78.0,4735.67,,CUS-809013380,2018-09-21,Kaitlyn,F,-28.80,114.62,,,,,,,debit,posted,dc72a293b9c0490e9787ffc1672fcefd,PAYMENT,20-30,2018,9,21,19,0,Friday,7 days,54075.793
ACC-1990648130,21,180.0,5592.74,,CUS-809013380,2018-09-27,Kaitlyn,F,-28.80,114.62,,,,,,,debit,posted,2aa1e5bc36e64a06a4299137128482e7,PAYMENT,20-30,2018,9,27,3,0,Thursday,7 days,54075.793
ACC-1990648130,21,28.0,5564.74,,CUS-809013380,2018-09-28,Kaitlyn,F,-28.80,114.62,,,,,,,debit,posted,7b70ece323bd4e609dae191c336b5e3e,PAYMENT,20-30,2018,9,28,6,0,Friday,7 days,54075.793
ACC-1990648130,21,7.75,5556.99,1.0,CUS-809013380,2018-09-29,Kaitlyn,F,-28.80,114.62,,20f49fac-03e1-43fb-a497-d2463bc779a5,-28.76,122.05,WA,Laverton,debit,authorized,d1fedcb706af4e3397aac70781e5e40f,SALES-POS,20-30,2018,9,29,9,30,Saturday,7 days,54075.793
ACC-1990648130,21,26.98,5530.01,1.0,CUS-809013380,2018-09-29,Kaitlyn,F,-28.80,114.62,,0898833a-fca8-40b5-a738-8e1d4aa98322,-28.84,153.44,NSW,Alstonville,debit,authorized,0e9f81ef9422439dbf73bed4d207578f,SALES-POS,20-30,2018,9,29,10,4,Saturday,7 days,54075.793
ACC-1990648130,21,13.95,5516.06,0.0,CUS-809013380,2018-09-29,Kaitlyn,F,-28.80,114.62,,f75cba91-43f5-48cb-83ac-c4c2254e0028,-28.85,153.45,NSW,Alstonville,debit,authorized,a13d3cc6ffdd4cc0a4b5af63222bda0f,POS,20-30,2018,9,29,20,17,Saturday,7 days,54075.793
ACC-1990648130,21,28.28,5487.78,1.0,CUS-809013380,2018-09-29,Kaitlyn,F,-28.80,114.62,,0898833a-fca8-40b5-a738-8e1d4aa98322,-28.84,153.44,NSW,Alstonville,debit,authorized,aa7ed22c647d45d08b79e646e44da922,POS,20-30,2018,9,29,21,1,Saturday,7 days,54075.793
ACC-1990648130,21,78.14,5409.64,1.0,CUS-809013380,2018-09-29,Kaitlyn,F,-28.80,114.62,,a79490f1-8469-4eec-9ad0-0a4726f48781,-33.88,151.21,NSW,Haymarket,debit,authorized,6864be9c0fd140c6a689188740f9a864,SALES-POS,20-30,2018,9,29,21,18,Saturday,7 days,54075.793
ACC-1990648130,21,12.36,5397.28,1.0,CUS-809013380,2018-09-29,Kaitlyn,F,-28.80,114.62,,72001733-2028-44be-92b8-2d7e25512d3e,-28.88,121.33,WA,Leonora,debit,authorized,39e7345da5b54fdcb817d5b2637bd6b1,SALES-POS,20-30,2018,9,29,21,51,Saturday,7 days,54075.793
ACC-1990648130,21,73.19,5324.09,1.0,CUS-809013380,2018-09-29,Kaitlyn,F,-28.80,114.62,,b35c0649-12ba-428b-a82d-09ad6bb11bdb,-31.78,115.97,WA,Ellenbrook,debit,authorized,bc0f62853d0e4339bfe14172f4e53d24,POS,20-30,2018,9,29,22,44,Saturday,7 days,54075.793
ACC-1990648130,21,60.93,5263.16,1.0,CUS-809013380,2018-09-30,Kaitlyn,F,-28.80,114.62,,fc01efdd-0bf4-4b5d-aa1b-c48ce9bed120,-33.87,151.21,NSW,Sydney,debit,authorized,c9e4a8d162354ae4b5633d5e2884d27c,POS,20-30,2018,9,30,10,48,Sunday,7 days,54075.793
ACC-1990648130,21,135.0,6165.23,,CUS-809013380,2018-10-02,Kaitlyn,F,-28.80,114.62,,,,,,,debit,posted,e4ac977eac00431d9d387a93cef4be56,PAYMENT,20-30,2018,10,2,18,0,Tuesday,7 days,54075.793
ACC-1990648130,21,46.31,6118.92,1.0,CUS-809013380,2018-10-03,Kaitlyn,F,-28.80,114.62,,f4b6a8b6-df07-4da7-9a9d-b46f3aff014b,-28.86,153.56,NSW,Ballina,debit,authorized,69643a6cc1ab4964b317e77eef1cbd25,POS,20-30,2018,10,3,21,29,Wednesday,7 days,54075.793
ACC-1990648130,21,28.0,6090.92,,CUS-809013380,2018-10-05,Kaitlyn,F,-28.80,114.62,,,,,,,debit,posted,da3c0953aeda4775b513eef528820042,PAYMENT,20-30,2018,10,5,6,0,Friday,7 days,54075.793
ACC-1990648130,21,28.0,7099.99,,CUS-809013380,2018-10-12,Kaitlyn,F,-28.80,114.62,,,,,,,debit,posted,babacc9447254ac0a50417eae58ee44f,PAYMENT,20-30,2018,10,12,6,0,Friday,7 days,54075.793
ACC-1990648130,21,28.0,8109.06,,CUS-809013380,2018-10-19,Kaitlyn,F,-28.80,114.62,,,,,,,debit,posted,ffa92d06b27e45c5bc25c7915e9e9083,PAYMENT,20-30,2018,10,19,6,0,Friday,7 days,54075.793
ACC-1990648130,21,78.0,8031.06,,CUS-809013380,2018-10-21,Kaitlyn,F,-28.80,114.62,,,,,,,debit,posted,4e309a3456354eaf8fc31b95f84df8ea,PAYMENT,20-30,2018,10,21,19,0,Sunday,7 days,54075.793
ACC-1990648130,21,28.0,9040.13,,CUS-809013380,2018-10-26,Kaitlyn,F,-28.80,114.62,,,,,,,debit,posted,27ed12ec4ccf4f9589ed059e98a13d21,PAYMENT,20-30,2018,10,26,6,0,Friday,7 days,54075.793
ACC-1990648130,21,180.0,8860.13,,CUS-809013380,2018-10-27,Kaitlyn,F,-28.80,114.62,,,,,,,debit,posted,5952ac74b72644f8b7af2b6af7a0ed14,PAYMENT,20-30,2018,10,27,3,0,Saturday,7 days,54075.793
ACC-1990648130,21,25.09,8835.04,1.0,CUS-809013380,2018-10-28,Kaitlyn,F,-28.80,114.62,,f9391216-b25e-427b-9ec1-b12d67bfc2bd,-28.79,153.59,NSW,Lennox Head,debit,authorized,e3520740bda543aca197163108c956d6,SALES-POS,20-30,2018,10,28,19,26,Sunday,7 days,54075.793
ACC-154431271,18,36.28,38.42,1.0,CUS-3702001629,2018-08-01,Lori,F,-27.48,153.09,,b7b3f792-717c-4e96-ab82-1580ec58a612,-27.66,153.05,QLD,Browns Plains,debit,authorized,bad454ebe43940e2aaa0e8a013f49a91,POS,<20,2018,8,1,9,51,Wednesday,14 days,40089.514
ACC-154431271,18,22.49,15.93,1.0,CUS-3702001629,2018-08-02,Lori,F,-27.48,153.09,,6102e64f-516d-4b51-bc28-87dbfe089f5c,-37.83,144.97,VIC,Southbank,debit,authorized,e270736b2b074f9fb88caed03a89d347,SALES-POS,<20,2018,8,2,4,53,Thursday,14 days,40089.514
ACC-154431271,18,6.94,8.99,1.0,CUS-3702001629,2018-08-04,Lori,F,-27.48,153.09,,0aecb3cb-378d-4e37-8d63-24e6f9a2b76a,-27.49,152.98,QLD,Taringa,debit,authorized,bf4bf20f2aef47bfb94bb2a7e9280634,SALES-POS,<20,2018,8,4,15,52,Saturday,14 days,40089.514
ACC-154431271,18,13.72,1532.95,1.0,CUS-3702001629,2018-08-10,Lori,F,-27.48,153.09,,41fc5874-e10a-4671-9312-78e561c69efa,-27.5,152.97,QLD,Indooroopilly,debit,authorized,8e994ce3c721461dbe6396387d09faf0,SALES-POS,<20,2018,8,10,17,35,Friday,14 days,40089.514
ACC-154431271,18,12.07,1520.88,1.0,CUS-3702001629,2018-08-10,Lori,F,-27.48,153.09,,f19bfb68-1a07-4eb1-aab3-ae3b8b4aedcc,-27.67,153.21,QLD,Loganholme,debit,authorized,88bbee6ec2794d7082650720a5a05281,POS,<20,2018,8,10,18,57,Friday,14 days,40089.514
ACC-154431271,18,9.76,1511.12,1.0,CUS-3702001629,2018-08-11,Lori,F,-27.48,153.09,,3bdc2db8-cc83-42a7-a69f-1220270a6a58,-27.61,153.3,QLD,Redland Bay,debit,authorized,c16cd369d0bd4d65b7e71f4c7951cec5,POS,<20,2018,8,11,14,28,Saturday,14 days,40089.514
ACC-154431271,18,16.47,1494.65,1.0,CUS-3702001629,2018-08-11,Lori,F,-27.48,153.09,,b6845148-ff2f-48c3-99bf-c87ba19f297a,-27.48,153.04,QLD,East Brisbane,debit,authorized,012a36707f854907b7fd2450379d1f57,SALES-POS,<20,2018,8,11,14,43,Saturday,14 days,40089.514
ACC-154431271,18,14.09,1480.56,0.0,CUS-3702001629,2018-08-11,Lori,F,-27.48,153.09,,6606da46-c9be-4389-ba2d-0412c11694cf,-27.47,153.03,QLD,Brisbane City,debit,authorized,ca40f28daec74269ad6829b59778aac8,SALES-POS,<20,2018,8,11,20,28,Saturday,14 days,40089.514
ACC-154431271,18,50.0,1430.56,,CUS-3702001629,2018-08-12,Lori,F,-27.48,153.09,,,,,,,debit,posted,3c2037cb9f3e4a3cba0192e243e22cc5,PAYMENT,<20,2018,8,12,21,0,Sunday,14 days,40089.514
ACC-154431271,18,61.0,1369.56,,CUS-3702001629,2018-08-13,Lori,F,-27.48,153.09,,,,,,,debit,posted,f4b953befa2645d5a33eb7f87f535ce1,PAYMENT,<20,2018,8,13,20,0,Monday,14 days,40089.514
ACC-154431271,18,134.0,1235.56,,CUS-3702001629,2018-08-15,Lori,F,-27.48,153.09,,,,,,,debit,posted,aa93a31860af4824a71748dc50d8613a,PAYMENT,<20,2018,8,15,16,0,Wednesday,14 days,40089.514
ACC-154431271,18,134.02,1101.54,1.0,CUS-3702001629,2018-08-17,Lori,F,-27.48,153.09,,0b8fab23-d4fd-45e7-acac-555c96e0b1c7,-33.87,151.2,NSW,Sydney,debit,authorized,b859e736dbc34b4090f9ff6ea61b0c94,SALES-POS,<20,2018,8,17,15,41,Friday,14 days,40089.514
ACC-154431271,18,41.3,1060.24,1.0,CUS-3702001629,2018-08-17,Lori,F,-27.48,153.09,,965846ff-f4cb-4aff-b0c7-72b2e3cb7762,-27.54,151.95,QLD,Harlaxton,debit,authorized,4d7c8d7d4e8e4dd2a2b6b7e0da601835,POS,<20,2018,8,17,16,11,Friday,14 days,40089.514
ACC-154431271,18,133.31,926.93,1.0,CUS-3702001629,2018-08-17,Lori,F,-27.48,153.09,,1ba5132e-e112-4048-9313-a8af0efeedec,-42.88,147.33,TAS,Hobart,debit,authorized,958c6b9803d443b3958cc1e2da72abbf,POS,<20,2018,8,17,17,19,Friday,14 days,40089.514
ACC-154431271,18,28.23,898.7,0.0,CUS-3702001629,2018-08-18,Lori,F,-27.48,153.09,,30b7c23d-ddcf-4cdd-b60f-af96e58acd4a,-27.5,152.97,QLD,Indooroopilly,debit,authorized,6272ff27a5b044c6b17e7973bb52741d,SALES-POS,<20,2018,8,18,14,37,Saturday,14 days,40089.514
ACC-154431271,18,10.36,888.34,1.0,CUS-3702001629,2018-08-18,Lori,F,-27.48,153.09,,7a82bfa2-2088-4c68-acde-dababd8044b2,-27.79,153.25,QLD,Ormeau,debit,authorized,1be0cba760b142dca786d7a18aecddea,POS,<20,2018,8,18,14,45,Saturday,14 days,40089.514
ACC-154431271,18,24.7,863.64,1.0,CUS-3702001629,2018-08-18,Lori,F,-27.48,153.09,,5272472d-f09f-4f7f-b008-622ef7934a45,-27.67,153.21,QLD,Loganholme,debit,authorized,7c5f0a90b7d84124bb8d91f88edfcf51,POS,<20,2018,8,18,23,45,Saturday,14 days,40089.514
ACC-154431271,18,26.36,837.28,1.0,CUS-3702001629,2018-08-19,Lori,F,-27.48,153.09,,0ccf8fe8-0485-4d47-9cf3-a7cb185ac190,-27.47,153.03,QLD,Brisbane City,debit,authorized,951ca78707454aae97c702398ce22a01,SALES-POS,<20,2018,8,19,9,9,Sunday,14 days,40089.514
ACC-154431271,18,15.97,821.31,1.0,CUS-3702001629,2018-08-19,Lori,F,-27.48,153.09,,611a8844-42dc-4fd9-adf9-b4ae0c185593,-27.72,153.2,QLD,Beenleigh,debit,authorized,5c32e668435f43f9bbc035766a013ae3,SALES-POS,<20,2018,8,19,9,15,Sunday,14 days,40089.514
ACC-154431271,18,12.67,808.64,1.0,CUS-3702001629,2018-08-19,Lori,F,-27.48,153.09,,9cc02e63-d2ee-4fe3-a38b-8352abdb171e,-27.42,152.98,QLD,Mitchelton,debit,authorized,c114a80a894c4918a98209825bb2e467,SALES-POS,<20,2018,8,19,9,32,Sunday,14 days,40089.514
ACC-154431271,18,9.56,799.08,1.0,CUS-3702001629,2018-08-19,Lori,F,-27.48,153.09,,6789ef3d-38c5-44f1-bbcf-e21da6a1e487,-27.59,153.1,QLD,Eight Mile Plains,debit,authorized,2fe0427d706c487cab8a11dffbfc7b46,SALES-POS,<20,2018,8,19,20,59,Sunday,14 days,40089.514
ACC-154431271,18,50.0,749.08,,CUS-3702001629,2018-08-19,Lori,F,-27.48,153.09,,,,,,,debit,posted,666bc04d39ef41109ba800ea40aac584,PAYMENT,<20,2018,8,19,21,0,Sunday,14 days,40089.514
ACC-154431271,18,61.0,688.08,,CUS-3702001629,2018-08-20,Lori,F,-27.48,153.09,,,,,,,debit,posted,082845c3d0c542b58e901a67b44431be,PAYMENT,<20,2018,8,20,20,0,Monday,14 days,40089.514
ACC-154431271,18,5.3,682.78,1.0,CUS-3702001629,2018-08-21,Lori,F,-27.48,153.09,,79ead8d2-e09d-41b4-8020-30c6925315c9,-27.48,152.99,QLD,Toowong,debit,authorized,b8eb2cc81c0941348616c48f336ef4b5,SALES-POS,<20,2018,8,21,9,31,Tuesday,14 days,40089.514
ACC-154431271,18,22.62,660.16,1.0,CUS-3702001629,2018-08-21,Lori,F,-27.48,153.09,,e7cebec6-f27d-443c-81eb-0ce04ffd9659,-27.74,152.98,QLD,Greenbank,debit,authorized,f5bd6f106a9b4b669c215a2ce5f5419e,POS,<20,2018,8,21,12,11,Tuesday,14 days,40089.514
ACC-154431271,18,10.12,650.04,0.0,CUS-3702001629,2018-08-23,Lori,F,-27.48,153.09,,db9c1b81-1ae7-4032-8623-06e46ea919c3,-27.23,153.11,QLD,Redcliffe,debit,authorized,3e762163db5a48139ae6d3d43436c52a,SALES-POS,<20,2018,8,23,11,20,Thursday,14 days,40089.514
ACC-154431271,18,17.25,2170.47,1.0,CUS-3702001629,2018-08-25,Lori,F,-27.48,153.09,,120e98c5-0602-4a58-bc7d-e5fb8a6e8495,-27.54,153.2,QLD,Capalaba,debit,authorized,2d3c620f6ded4ad8a00d310102c0aa67,POS,<20,2018,8,25,11,21,Saturday,14 days,40089.514
ACC-154431271,18,50.0,2120.47,,CUS-3702001629,2018-08-26,Lori,F,-27.48,153.09,,,,,,,debit,posted,00a3965e100c460fb2a712e41c0f6bd1,PAYMENT,<20,2018,8,26,21,0,Sunday,14 days,40089.514
ACC-154431271,18,61.0,2059.47,,CUS-3702001629,2018-08-27,Lori,F,-27.48,153.09,,,,,,,debit,posted,f334d65e1aa742688c70dcf9b3d9e237,PAYMENT,<20,2018,8,27,20,0,Monday,14 days,40089.514
ACC-154431271,18,50.0,2009.47,,CUS-3702001629,2018-09-02,Lori,F,-27.48,153.09,,,,,,,debit,posted,53b2c550f2834cafa64b0a86dd3409fd,PAYMENT,<20,2018,9,2,21,0,Sunday,14 days,40089.514
ACC-154431271,18,61.0,1948.47,,CUS-3702001629,2018-09-03,Lori,F,-27.48,153.09,,,,,,,debit,posted,40170005652646388ec253e4c9b11f1a,PAYMENT,<20,2018,9,3,20,0,Monday,14 days,40089.514
ACC-154431271,18,66.39,1882.08,1.0,CUS-3702001629,2018-09-05,Lori,F,-27.48,153.09,,8a7abe86-6950-491c-a6c0-5e83e1e5fdbe,-27.59,153.1,QLD,Eight Mile Plains,debit,authorized,0d6616189df448c8be086ce1422b4b1f,SALES-POS,<20,2018,9,5,13,7,Wednesday,14 days,40089.514
ACC-154431271,18,261.68,1620.4,0.0,CUS-3702001629,2018-09-05,Lori,F,-27.48,153.09,,4e9dfc31-952a-4099-ab27-364bcdd2c6cd,-28.16,153.2,QLD,Beechmont,debit,authorized,80d4323f58a14ee79d02c9d23696add7,SALES-POS,<20,2018,9,5,13,45,Wednesday,14 days,40089.514
ACC-154431271,18,25.18,1595.22,1.0,CUS-3702001629,2018-09-05,Lori,F,-27.48,153.09,,5bc650f2-cd8d-46e9-b58e-2cae0ba33a03,-27.7,153.21,QLD,Eagleby,debit,authorized,b5dfca578eff4986b7ff21b28676a06b,POS,<20,2018,9,5,19,23,Wednesday,14 days,40089.514
ACC-154431271,18,9.71,3123.19,1.0,CUS-3702001629,2018-09-06,Lori,F,-27.48,153.09,,f4435455-d276-40ae-b24f-a4a6fbbe9916,-27.52,153.22,QLD,Alexandra Hills,debit,authorized,eeb3581c05c340c58e2241b6a1d70e15,POS,<20,2018,9,6,21,50,Thursday,14 days,40089.514
ACC-154431271,18,44.64,3078.55,1.0,CUS-3702001629,2018-09-08,Lori,F,-27.48,153.09,,9b194151-0828-4494-86f5-ab54d3c2a0d8,-27.54,151.93,QLD,Wilsonton,debit,authorized,250a983c51b747359c021360d17b50fb,SALES-POS,<20,2018,9,8,9,27,Saturday,14 days,40089.514
ACC-154431271,18,50.0,3028.55,,CUS-3702001629,2018-09-09,Lori,F,-27.48,153.09,,,,,,,debit,posted,1d05263203a4408391ea2697000ae1e2,PAYMENT,<20,2018,9,9,21,0,Sunday,14 days,40089.514
ACC-154431271,18,61.0,2967.55,,CUS-3702001629,2018-09-10,Lori,F,-27.48,153.09,,,,,,,debit,posted,a0034bb1ab904a3db645ed1d4df566aa,PAYMENT,<20,2018,9,10,20,0,Monday,14 days,40089.514
ACC-154431271,18,29.6,2937.95,1.0,CUS-3702001629,2018-09-13,Lori,F,-27.48,153.09,,36a1855d-f406-4c1b-a44e-89d7adb63848,-27.51,151.83,QLD,Kingsthorpe,debit,authorized,d3723b9f39194f7ea20cb7f901604439,POS,<20,2018,9,13,8,54,Thursday,14 days,40089.514
ACC-154431271,18,143.78,2794.17,1.0,CUS-3702001629,2018-09-15,Lori,F,-27.48,153.09,,acb77539-e479-4f85-b231-0330e17f620f,-27.47,153.02,QLD,Petrie Terrace,debit,authorized,abf4edf2b1184d768882ce5b582c8f52,SALES-POS,<20,2018,9,15,13,39,Saturday,14 days,40089.514
ACC-154431271,18,156.43,2637.74,0.0,CUS-3702001629,2018-09-15,Lori,F,-27.48,153.09,,280476fb-0fe2-47b6-ac51-eea8d3486cc9,-27.46,153.03,QLD,Brisbane City,debit,authorized,b7222586d2264511abe51761e3686ee1,POS,<20,2018,9,15,15,18,Saturday,14 days,40089.514
ACC-154431271,18,134.0,2503.74,,CUS-3702001629,2018-09-15,Lori,F,-27.48,153.09,,,,,,,debit,posted,e4d641ce4e934942abb68280028c153d,PAYMENT,<20,2018,9,15,16,0,Saturday,14 days,40089.514
ACC-154431271,18,54.53,2449.21,1.0,CUS-3702001629,2018-09-15,Lori,F,-27.48,153.09,,5b3c03fa-52ab-48ea-a459-810a7bf631d7,-27.66,153.17,QLD,Shailer Park,debit,authorized,2830d02472524f23820958ef6bc0d37e,SALES-POS,<20,2018,9,15,21,3,Saturday,14 days,40089.514
ACC-154431271,18,22.2,2427.01,0.0,CUS-3702001629,2018-09-15,Lori,F,-27.48,153.09,,6aec7075-9194-43a8-85c3-c7dbaa302475,-27.6,152.88,QLD,Goodna,debit,authorized,9abd8243d0374ba39c4439fb6147f627,SALES-POS,<20,2018,9,15,21,29,Saturday,14 days,40089.514
ACC-154431271,18,9.92,2417.09,1.0,CUS-3702001629,2018-09-15,Lori,F,-27.48,153.09,,89b3ba89-a3ff-4da7-9ddc-cf6e98636c52,-27.59,152.75,QLD,Brassall,debit,authorized,a040c6a7396946d8b97b95c19caa4fee,POS,<20,2018,9,15,23,26,Saturday,14 days,40089.514
ACC-154431271,18,85.94,2331.15,0.0,CUS-3702001629,2018-09-16,Lori,F,-27.48,153.09,,ea955803-4626-4f09-a7b5-becba41b1a71,-27.56,152.95,QLD,Seventeen Mile Rocks,debit,authorized,758414ffa9b3436789d4bc1db39cdbdc,POS,<20,2018,9,16,1,11,Sunday,14 days,40089.514
ACC-154431271,18,50.0,2281.15,,CUS-3702001629,2018-09-16,Lori,F,-27.48,153.09,,,,,,,debit,posted,0f14f6c62d6a4a45aaf237e50887e9d9,PAYMENT,<20,2018,9,16,21,0,Sunday,14 days,40089.514
ACC-154431271,18,61.0,2220.15,,CUS-3702001629,2018-09-17,Lori,F,-27.48,153.09,,,,,,,debit,posted,6f44fa8b70f343a7a2af9ad8ba3b0bea,PAYMENT,<20,2018,9,17,20,0,Monday,14 days,40089.514
ACC-154431271,18,23.18,3734.65,1.0,CUS-3702001629,2018-09-22,Lori,F,-27.48,153.09,,abf31fa7-2b8d-421b-85ca-1c81a4a04b64,-33.87,151.2,NSW,Sydney,debit,authorized,f2edacc232024c91865fa4140d4f8f5c,POS,<20,2018,9,22,20,42,Saturday,14 days,40089.514
ACC-154431271,18,1501.46,2233.19,1.0,CUS-3702001629,2018-09-23,Lori,F,-27.48,153.09,,04c60c34-c302-4a70-83a7-cf3a70d8a106,-27.53,153.07,QLD,Mount Gravatt,debit,authorized,c7908ec9cb8f4cc9b69ff0887c96c720,POS,<20,2018,9,23,1,38,Sunday,14 days,40089.514
ACC-154431271,18,50.0,2183.19,,CUS-3702001629,2018-09-23,Lori,F,-27.48,153.09,,,,,,,debit,posted,f2a37532f7a74a9cb850fbe1c1caaa65,PAYMENT,<20,2018,9,23,21,0,Sunday,14 days,40089.514
ACC-154431271,18,28.85,2154.34,1.0,CUS-3702001629,2018-09-24,Lori,F,-27.48,153.09,,99de3c07-fc81-4cde-bfbc-d652d621e26f,-33.86,151.21,NSW,Sydney,debit,authorized,0625ba7632484b4fb553ec11d930ea07,POS,<20,2018,9,24,19,8,Monday,14 days,40089.514
ACC-154431271,18,61.0,2093.34,,CUS-3702001629,2018-09-24,Lori,F,-27.48,153.09,,,,,,,debit,posted,d8bd7a9f3b564fdcbaa77ff22ad0df21,PAYMENT,<20,2018,9,24,20,0,Monday,14 days,40089.514
ACC-154431271,18,14.56,2078.78,1.0,CUS-3702001629,2018-09-25,Lori,F,-27.48,153.09,,f0e7431c-0605-4143-9ad2-c789c164b49d,-27.7,153.2,QLD,Eagleby,debit,authorized,e30378e4b9a54db2a2281b422dbae47f,POS,<20,2018,9,25,21,22,Tuesday,14 days,40089.514
ACC-154431271,18,11.63,2067.15,0.0,CUS-3702001629,2018-09-27,Lori,F,-27.48,153.09,,05d6d00b-d885-44de-b633-780f29f9d3c5,-27.55,153.11,QLD,Wishart,debit,authorized,bc00565ffc014b798b6148f55b47bae5,SALES-POS,<20,2018,9,27,17,41,Thursday,14 days,40089.514
ACC-154431271,18,17.95,2049.2,1.0,CUS-3702001629,2018-09-27,Lori,F,-27.48,153.09,,eac8ac0c-17f2-482e-ae36-0d596d4a2a4a,-27.53,153.27,QLD,Cleveland,debit,authorized,521ac6f6d4014a698b1c273ddaa01d6e,POS,<20,2018,9,27,18,6,Thursday,14 days,40089.514
ACC-154431271,18,50.0,1999.2,,CUS-3702001629,2018-09-30,Lori,F,-27.48,153.09,,,,,,,debit,posted,bc9d134c4f5444209d0795f9ebc5e621,PAYMENT,<20,2018,9,30,21,0,Sunday,14 days,40089.514
ACC-154431271,18,61.0,1938.2,,CUS-3702001629,2018-10-01,Lori,F,-27.48,153.09,,,,,,,debit,posted,9d7cedcc3b014a26b7b89fc29576cbb9,PAYMENT,<20,2018,10,1,20,0,Monday,14 days,40089.514
ACC-154431271,18,19.29,1918.91,0.0,CUS-3702001629,2018-10-03,Lori,F,-27.48,153.09,,ef1a4ced-eff5-43d0-80b6-f5ef33a45db2,-27.71,153.15,QLD,Waterford,debit,authorized,9a05543cb5814c98ac5f729771317ac2,SALES-POS,<20,2018,10,3,14,52,Wednesday,14 days,40089.514
ACC-154431271,18,18.64,1900.27,1.0,CUS-3702001629,2018-10-03,Lori,F,-27.48,153.09,,f97284ee-c106-4ddb-bc1a-58a367638cce,-30.29,153.13,NSW,Coffs Harbour,debit,authorized,38ee98704dcc463a8b7f4b98cce9cc90,SALES-POS,<20,2018,10,3,15,35,Wednesday,14 days,40089.514
ACC-154431271,18,7.63,1892.64,1.0,CUS-3702001629,2018-10-03,Lori,F,-27.48,153.09,,1e63d6f6-2f31-4cce-b515-8e2352ba1448,-27.57,153.06,QLD,Sunnybank,debit,authorized,40931725cbc64242a69b102d5f8028c1,SALES-POS,<20,2018,10,3,17,7,Wednesday,14 days,40089.514
ACC-154431271,18,9.71,1882.93,1.0,CUS-3702001629,2018-10-03,Lori,F,-27.48,153.09,,e3dde7d3-6a86-452f-b1f4-413110cf1b97,-27.56,151.96,QLD,Toowoomba,debit,authorized,8c403d51b08646eb93770e7b302377ac,POS,<20,2018,10,3,18,39,Wednesday,14 days,40089.514
ACC-154431271,18,17.44,1865.49,1.0,CUS-3702001629,2018-10-03,Lori,F,-27.48,153.09,,04a51f1e-ee24-4bd2-8413-bb6a08030dbb,-27.59,151.95,QLD,Kearneys Spring,debit,authorized,3bdeb1cfbe3b47b58558d7523f39a471,SALES-POS,<20,2018,10,3,19,36,Wednesday,14 days,40089.514
ACC-154431271,18,11.88,1853.61,1.0,CUS-3702001629,2018-10-03,Lori,F,-27.48,153.09,,20472137-5ba9-4ee3-8e93-3daa5e5831bc,-27.61,153.3,QLD,Brisbane,debit,authorized,bb9868f9c20c4d5da9752180c3df3516,SALES-POS,<20,2018,10,3,20,23,Wednesday,14 days,40089.514
ACC-154431271,18,8.26,3383.03,1.0,CUS-3702001629,2018-10-06,Lori,F,-27.48,153.09,,367204e2-4925-459b-aab1-9bc7807abfb5,-27.6,152.96,QLD,Richlands,debit,authorized,b0ddd19fde2a4f91a8894e9c6ba09880,SALES-POS,<20,2018,10,6,8,38,Saturday,14 days,40089.514
ACC-154431271,18,41.67,3341.36,1.0,CUS-3702001629,2018-10-06,Lori,F,-27.48,153.09,,e3e28ad9-50a4-4a33-b675-bb611d49b517,-27.7,114.17,WA,Kalbarri,debit,authorized,5dfcebbeb2904c6880f5bda2876c8ccd,SALES-POS,<20,2018,10,6,8,58,Saturday,14 days,40089.514
ACC-154431271,18,23.49,3317.87,1.0,CUS-3702001629,2018-10-06,Lori,F,-27.48,153.09,,56c12657-9a47-4bec-8e3e-fdef6095f510,-27.46,152.58,QLD,Lowood,debit,authorized,c1fb18b9bf3b407099509984acc77ccd,POS,<20,2018,10,6,14,1,Saturday,14 days,40089.514
ACC-154431271,18,22.0,3295.87,0.0,CUS-3702001629,2018-10-06,Lori,F,-27.48,153.09,,07030b6d-76a0-4fa5-a868-178e8edaaef5,-27.37,153.04,QLD,Geebung,debit,authorized,e8440a43335145adade857cced58cadf,POS,<20,2018,10,6,14,10,Saturday,14 days,40089.514
ACC-154431271,18,13.36,3282.51,1.0,CUS-3702001629,2018-10-06,Lori,F,-27.48,153.09,,16f87b35-bf91-4632-83c5-b4d9041c7cbe,-27.53,151.93,QLD,Wilsonton Heights,debit,authorized,f6e79151fcf04241969eff7bde2be007,POS,<20,2018,10,6,21,42,Saturday,14 days,40089.514
ACC-154431271,18,50.0,3232.51,,CUS-3702001629,2018-10-07,Lori,F,-27.48,153.09,,,,,,,debit,posted,98dcbf5e14dc434ca738e2d569ecaeff,PAYMENT,<20,2018,10,7,21,0,Sunday,14 days,40089.514
ACC-154431271,18,883.0,2349.51,,CUS-3702001629,2018-10-08,Lori,F,-27.48,153.09,,,,,,,debit,posted,14405c77d8184ac285425f5038ee8905,INTER BANK,<20,2018,10,8,4,0,Monday,14 days,40089.514
ACC-154431271,18,61.0,2288.51,,CUS-3702001629,2018-10-08,Lori,F,-27.48,153.09,,,,,,,debit,posted,d4a0848139b6452da9f5df2500f1ce32,PAYMENT,<20,2018,10,8,20,0,Monday,14 days,40089.514
ACC-154431271,18,12.07,2276.44,0.0,CUS-3702001629,2018-10-11,Lori,F,-27.48,153.09,,f5fa9c86-add9-4210-a1bf-9331522d6b4d,-27.52,153.25,QLD,Ormiston,debit,authorized,ad56c20dc7464217b93a82c8b40b4a43,SALES-POS,<20,2018,10,11,16,57,Thursday,14 days,40089.514
ACC-154431271,18,23.47,2252.97,1.0,CUS-3702001629,2018-10-11,Lori,F,-27.48,153.09,,b4bb9c71-54ff-4614-b0af-1fe686809a22,-27.57,153.06,QLD,Sunnybank,debit,authorized,7228eab34e5646ae85d3b2a748eec1bb,SALES-POS,<20,2018,10,11,19,20,Thursday,14 days,40089.514
ACC-154431271,18,12.29,2240.68,1.0,CUS-3702001629,2018-10-11,Lori,F,-27.48,153.09,,90cc93bc-1e61-4ca5-b4e4-6b25809a8f8b,-27.56,151.95,QLD,Toowoomba City,debit,authorized,6b91cf1d208d49bd885ecd67a97d6db9,SALES-POS,<20,2018,10,11,20,32,Thursday,14 days,40089.514
ACC-154431271,18,16.74,2223.94,1.0,CUS-3702001629,2018-10-12,Lori,F,-27.48,153.09,,ad8e3b9d-d9a8-4415-a278-a426122d17de,-37.82,144.96,VIC,Melbourne,debit,authorized,00758f7bceca42a0a3fb324f4819b4f1,POS,<20,2018,10,12,8,5,Friday,14 days,40089.514
ACC-154431271,18,23.65,2200.29,1.0,CUS-3702001629,2018-10-12,Lori,F,-27.48,153.09,,dbe576eb-3ac2-423b-9c43-89141991c500,-27.59,153.28,QLD,Victoria Point,debit,authorized,0c8b5a84decb459ea6ea2db37837cc5f,POS,<20,2018,10,12,9,44,Friday,14 days,40089.514
ACC-154431271,18,10.18,2190.11,1.0,CUS-3702001629,2018-10-12,Lori,F,-27.48,153.09,,57b56974-cd79-4bee-8d57-ea349c4e437f,-27.47,153.03,QLD,Brisbane City,debit,authorized,edf314331608430488939fac6caf982b,POS,<20,2018,10,12,9,54,Friday,14 days,40089.514
ACC-154431271,18,22.76,2167.35,0.0,CUS-3702001629,2018-10-12,Lori,F,-27.48,153.09,,01ff63de-c6a9-4cc2-8f54-4e65912b2d2d,-27.56,152.28,QLD,Gatton,debit,authorized,c7c2fb02a83a488ca522c35671fff4dd,SALES-POS,<20,2018,10,12,16,24,Friday,14 days,40089.514
ACC-154431271,18,50.0,2117.35,,CUS-3702001629,2018-10-14,Lori,F,-27.48,153.09,,,,,,,debit,posted,a8f86d7b956a4909bd3b34a9b26769fa,PAYMENT,<20,2018,10,14,21,0,Sunday,14 days,40089.514
ACC-154431271,18,134.0,1983.35,,CUS-3702001629,2018-10-15,Lori,F,-27.48,153.09,,,,,,,debit,posted,c914b51d571f4357bf259bcc2370cf21,PAYMENT,<20,2018,10,15,16,0,Monday,14 days,40089.514
ACC-154431271,18,61.0,1922.35,,CUS-3702001629,2018-10-15,Lori,F,-27.48,153.09,,,,,,,debit,posted,fed2605da7a94b8ea32ae9f2983043e0,PAYMENT,<20,2018,10,15,20,0,Monday,14 days,40089.514
ACC-154431271,18,5.71,3454.32,1.0,CUS-3702001629,2018-10-21,Lori,F,-27.48,153.09,,ab90254d-100d-4012-ab40-040195b23a62,-27.48,153.02,QLD,South Brisbane,debit,authorized,f8f40f49437844cd95af5d8e2e6b9dba,POS,<20,2018,10,21,14,41,Sunday,14 days,40089.514
ACC-154431271,18,50.0,3404.32,,CUS-3702001629,2018-10-21,Lori,F,-27.48,153.09,,,,,,,debit,posted,18a9628bb43c40b2ac75ae70e24cb596,PAYMENT,<20,2018,10,21,21,0,Sunday,14 days,40089.514
ACC-154431271,18,61.0,3343.32,,CUS-3702001629,2018-10-22,Lori,F,-27.48,153.09,,,,,,,debit,posted,e2ba2ce77fa94a44af36e3334315a4e5,PAYMENT,<20,2018,10,22,20,0,Monday,14 days,40089.514
ACC-154431271,18,8.41,3334.91,1.0,CUS-3702001629,2018-10-27,Lori,F,-27.48,153.09,,ca470f6e-b50f-48e1-ab97-cc40705bfa5b,-27.66,153.04,QLD,Browns Plains,debit,authorized,a5e5f1e30bf44a50979552d3f8266e6b,POS,<20,2018,10,27,14,30,Saturday,14 days,40089.514
ACC-154431271,18,16.0,3318.91,1.0,CUS-3702001629,2018-10-28,Lori,F,-27.48,153.09,,862c9f46-f64d-4374-83e7-ccd4450a3915,-27.38,153.03,QLD,Chermside,debit,authorized,e34c3a7ffadb49569fe262bbaa5952df,POS,<20,2018,10,28,11,39,Sunday,14 days,40089.514
ACC-154431271,18,50.0,3268.91,,CUS-3702001629,2018-10-28,Lori,F,-27.48,153.09,,,,,,,debit,posted,6207dbca1b3d4d39a2e769aa6836ac04,PAYMENT,<20,2018,10,28,21,0,Sunday,14 days,40089.514
ACC-154431271,18,113.67,3155.24,1.0,CUS-3702001629,2018-10-29,Lori,F,-27.48,153.09,,767a3cb5-44b4-4bdf-8629-0f1c9082a9f7,-27.6,153.04,QLD,Sunnybank Hills,debit,authorized,2935d736e7f64d18ac305f197faff5a1,SALES-POS,<20,2018,10,29,16,48,Monday,14 days,40089.514
ACC-154431271,18,61.0,3094.24,,CUS-3702001629,2018-10-29,Lori,F,-27.48,153.09,,,,,,,debit,posted,368402be8f6144549c0d0a6f3d1ff310,PAYMENT,<20,2018,10,29,20,0,Monday,14 days,40089.514
ACC-154431271,18,30.97,3063.27,1.0,CUS-3702001629,2018-10-29,Lori,F,-27.48,153.09,,51cbdb6a-9d29-4884-881a-6d1d66f3ed43,-27.47,153.03,QLD,Brisbane City,debit,authorized,2813a7edc3aa4fb9b505c2bb7dddf147,POS,<20,2018,10,29,21,44,Monday,14 days,40089.514
ACC-3689607373,20,15.91,1089.59,0.0,CUS-127297539,2018-08-01,Virginia,F,-31.79,115.79,,e54ebe26-344e-4084-a102-4ca6bf82b25b,-31.95,115.84,WA,West Perth,debit,authorized,303ab7bca5764bb3863758b3142b74bb,POS,<20,2018,8,1,9,55,Wednesday,7 days,59379.764
ACC-3689607373,20,15.16,1074.43,0.0,CUS-127297539,2018-08-02,Virginia,F,-31.79,115.79,,ce1760f8-fa15-46c2-9e89-9f06b0654a4a,-32.29,115.74,WA,Rockingham,debit,authorized,655e69df175447e2bef643ad678f6abb,SALES-POS,<20,2018,8,2,0,50,Thursday,7 days,59379.764
ACC-3689607373,20,8.08,1066.35,1.0,CUS-127297539,2018-08-02,Virginia,F,-31.79,115.79,,162b53e8-7a5c-4ca6-9e23-e05526f7313b,-31.87,115.95,WA,Beechboro,debit,authorized,1cf407acb18544478565fac7bb04bfb7,SALES-POS,<20,2018,8,2,4,26,Thursday,7 days,59379.764
ACC-3689607373,20,181.0,2024.14,,CUS-127297539,2018-08-03,Virginia,F,-31.79,115.79,,,,,,,debit,posted,e761e6e90b154ac99fe4b98522fefb9f,INTER BANK,<20,2018,8,3,15,0,Friday,7 days,59379.764
ACC-3689607373,20,55.0,1969.14,,CUS-127297539,2018-08-03,Virginia,F,-31.79,115.79,,,,,,,debit,posted,b937d8dde62441ee90ab02fb21e47758,INTER BANK,<20,2018,8,3,19,0,Friday,7 days,59379.764
ACC-3689607373,20,69.0,1900.14,,CUS-127297539,2018-08-03,Virginia,F,-31.79,115.79,,,,,,,debit,posted,125b29bbb6a4424e91808791b76be15e,PAYMENT,<20,2018,8,3,21,0,Friday,7 days,59379.764
ACC-3689607373,20,13.67,1886.47,1.0,CUS-127297539,2018-08-04,Virginia,F,-31.79,115.79,,4a873909-4fa6-4814-8ee4-965aef03f8b2,-31.91,115.85,WA,Yokine,debit,authorized,180f6ddf267d4b5b9ad5eddb3b629b63,SALES-POS,<20,2018,8,4,11,11,Saturday,7 days,59379.764
ACC-3689607373,20,17.89,1868.58,1.0,CUS-127297539,2018-08-06,Virginia,F,-31.79,115.79,,178a5845-b81a-421a-893c-6705ba50aeaa,-33.36,115.65,WA,Carey Park,debit,authorized,05dbc22015fc4b4c8e5762c0a7d42480,POS,<20,2018,8,6,18,22,Monday,7 days,59379.764
ACC-3689607373,20,11.57,1857.01,1.0,CUS-127297539,2018-08-08,Virginia,F,-31.79,115.79,,41b90cfc-01e1-4771-8d3a-6914f8b165a9,-31.98,141.46,NSW,Broken Hill,debit,authorized,03de156b7c994f4b9d223c1c63c81166,SALES-POS,<20,2018,8,8,9,27,Wednesday,7 days,59379.764
ACC-3689607373,20,4.1,1852.91,1.0,CUS-127297539,2018-08-08,Virginia,F,-31.79,115.79,,0573359a-48af-4d38-a1a0-00d115cb2654,-31.91,152.46,NSW,Taree,debit,authorized,282c90d4b4bf48caa197334e8da7d070,SALES-POS,<20,2018,8,8,13,13,Wednesday,7 days,59379.764
ACC-3689607373,20,13.87,1839.04,1.0,CUS-127297539,2018-08-08,Virginia,F,-31.79,115.79,,5ee09cfd-c05e-4489-8a4e-911c16c68f0c,-32.02,115.94,WA,Cannington,debit,authorized,a26ba645fae943a48f8825994f598c70,SALES-POS,<20,2018,8,8,14,14,Wednesday,7 days,59379.764
ACC-3689607373,20,55.0,2922.83,,CUS-127297539,2018-08-10,Virginia,F,-31.79,115.79,,,,,,,debit,posted,c5e0f2a1c0cc44caa8ff2f16dd51c92e,INTER BANK,<20,2018,8,10,19,0,Friday,7 days,59379.764
ACC-3689607373,20,69.0,2853.83,,CUS-127297539,2018-08-10,Virginia,F,-31.79,115.79,,,,,,,debit,posted,977eeff01dff46b79f977014328cef50,PAYMENT,<20,2018,8,10,21,0,Friday,7 days,59379.764
ACC-3689607373,20,107.0,2746.83,,CUS-127297539,2018-08-15,Virginia,F,-31.79,115.79,,,,,,,debit,posted,06ca71219ed44b4580c24968e9c7ea71,INTER BANK,<20,2018,8,15,8,0,Wednesday,7 days,59379.764
ACC-3689607373,20,55.0,3830.62,,CUS-127297539,2018-08-17,Virginia,F,-31.79,115.79,,,,,,,debit,posted,cfb15e8cba6941539b64d8c56491947c,INTER BANK,<20,2018,8,17,19,0,Friday,7 days,59379.764
ACC-3689607373,20,69.0,3761.62,,CUS-127297539,2018-08-17,Virginia,F,-31.79,115.79,,,,,,,debit,posted,cbb3a2e8faa34fbbb54accc0a897d7e3,PAYMENT,<20,2018,8,17,21,0,Friday,7 days,59379.764
ACC-3689607373,20,33.77,3727.85,1.0,CUS-127297539,2018-08-18,Virginia,F,-31.79,115.79,,789f32af-0fbe-4102-a364-1033fa3aec85,-31.9,115.81,WA,Osborne Park,debit,authorized,6173183336ef4263a65f796eaf62324d,SALES-POS,<20,2018,8,18,9,41,Saturday,7 days,59379.764
ACC-3689607373,20,12.79,3715.06,1.0,CUS-127297539,2018-08-18,Virginia,F,-31.79,115.79,,e4526954-72c6-42d9-a71f-ebf9eca9aa43,-32.1,115.76,WA,North Coogee,debit,authorized,6a4eb2b26a54494397701fdda3a34c61,POS,<20,2018,8,18,15,4,Saturday,7 days,59379.764
ACC-3689607373,20,69.31,3645.75,1.0,CUS-127297539,2018-08-18,Virginia,F,-31.79,115.79,,1e91bba1-0d71-4f5b-9fa0-a42a994810d5,-31.96,115.93,WA,Belmont,debit,authorized,854cd11804f343a9bc86f2b83ad6911b,SALES-POS,<20,2018,8,18,15,35,Saturday,7 days,59379.764
ACC-3689607373,20,55.43,3590.32,1.0,CUS-127297539,2018-08-18,Virginia,F,-31.79,115.79,,076aca33-d9b9-4603-9b68-bcb241b8fe87,-31.66,116.67,WA,Northam,debit,authorized,11c4aa47f4684d0a930c51f664690a92,SALES-POS,<20,2018,8,18,23,37,Saturday,7 days,59379.764
ACC-3689607373,20,18.1,3572.22,1.0,CUS-127297539,2018-08-18,Virginia,F,-31.79,115.79,,d60f76ae-00eb-42a8-bc8c-86e25f707aed,-32.08,115.81,WA,Coolbellup,debit,authorized,51b8053a2965432d967251f5847e08a6,SALES-POS,<20,2018,8,18,23,53,Saturday,7 days,59379.764
ACC-3689607373,20,17.37,3554.85,1.0,CUS-127297539,2018-08-19,Virginia,F,-31.79,115.79,,a1c57710-fe13-4bf0-8639-b9175cd00275,-31.92,115.84,WA,Mount Hawthorn,debit,authorized,9aa6a57179084690b59b97b46cccca7d,POS,<20,2018,8,19,17,9,Sunday,7 days,59379.764
ACC-3689607373,20,10.39,3544.46,1.0,CUS-127297539,2018-08-20,Virginia,F,-31.79,115.79,,af114e6b-3c4b-4cc2-b7da-0b8e0554ee36,-32.04,115.76,WA,East Fremantle,debit,authorized,f58d2d66ad7d43438c56ff243f939e2e,POS,<20,2018,8,20,14,8,Monday,7 days,59379.764
ACC-3689607373,20,17.59,3526.87,1.0,CUS-127297539,2018-08-21,Virginia,F,-31.79,115.79,,6c84c219-96ea-4c6f-9de5-0a28bcaec62f,-32.01,152.47,NSW,Rainbow Flat,debit,authorized,92a7819d7fdd4fb783c4f8bf8d336687,SALES-POS,<20,2018,8,21,10,34,Tuesday,7 days,59379.764
ACC-3689607373,20,11.38,3515.49,1.0,CUS-127297539,2018-08-21,Virginia,F,-31.79,115.79,,e31795fc-3756-48c8-97f8-3c55599cd769,-31.97,115.79,WA,Claremont,debit,authorized,280ba91fa3bc439db5563f14745941fe,POS,<20,2018,8,21,11,22,Tuesday,7 days,59379.764
ACC-3689607373,20,13.48,3502.01,1.0,CUS-127297539,2018-08-21,Virginia,F,-31.79,115.79,,428f9cbe-9d7a-41b8-af5b-a9fa0cf63866,-31.79,132.23,SA,Coorabie,debit,authorized,ecf6a7b68f59474783edd798d9d360f8,SALES-POS,<20,2018,8,21,15,46,Tuesday,7 days,59379.764
ACC-3689607373,20,7.57,3494.44,1.0,CUS-127297539,2018-08-21,Virginia,F,-31.79,115.79,,8a7dd9de-d45b-4a74-983b-6435e38ae017,-31.7,115.8,WA,Banksia Grove,debit,authorized,d77be63419a74cd192c479dade692b49,SALES-POS,<20,2018,8,21,19,33,Tuesday,7 days,59379.764
ACC-3689607373,20,21.71,3472.73,1.0,CUS-127297539,2018-08-23,Virginia,F,-31.79,115.79,,a4d8d152-d91f-42a2-ad21-01d2578dbd94,-31.85,115.88,WA,Malaga,debit,authorized,eeafa626c9de4992a1e1733c23ca2af2,POS,<20,2018,8,23,15,40,Thursday,7 days,59379.764
ACC-3689607373,20,4.86,3467.87,1.0,CUS-127297539,2018-08-23,Virginia,F,-31.79,115.79,,f180736e-81ba-424b-9051-53b60ae7580c,-31.92,115.87,WA,Mount Lawley,debit,authorized,481b2bb00fa04170851255b372c4346d,SALES-POS,<20,2018,8,23,21,16,Thursday,7 days,59379.764
ACC-3689607373,20,26.42,3441.45,1.0,CUS-127297539,2018-08-23,Virginia,F,-31.79,115.79,,def6f8f2-e856-4da8-b836-fc56bd595375,-32.1,115.78,WA,Spearwood,debit,authorized,890d263f1c524ae5ba7c2ad6baa02844,POS,<20,2018,8,23,22,55,Thursday,7 days,59379.764
ACC-3689607373,20,12.92,3428.53,1.0,CUS-127297539,2018-08-24,Virginia,F,-31.79,115.79,,e33831d4-02c8-435b-b0b0-8641b334b223,-32.58,115.66,WA,Falcon,debit,authorized,ff1204478c8849068c3ea4e4fbe41d80,POS,<20,2018,8,24,11,41,Friday,7 days,59379.764
ACC-3689607373,20,6.31,4561.01,1.0,CUS-127297539,2018-08-24,Virginia,F,-31.79,115.79,,45e1a8f7-7d13-45e8-8a33-bd85c2b20e00,-32.03,115.84,WA,Booragoon,debit,authorized,3f18012680c24f1297ca208a179f7063,POS,<20,2018,8,24,16,9,Friday,7 days,59379.764
ACC-3689607373,20,13.54,4547.47,1.0,CUS-127297539,2018-08-24,Virginia,F,-31.79,115.79,,4d1c882d-8b38-4de0-8b1d-c486d2202d2e,-32.01,151.96,NSW,Gloucester,debit,authorized,74b25e4577874ee69e23312b3d4cb5b2,POS,<20,2018,8,24,16,26,Friday,7 days,59379.764
ACC-3689607373,20,6.96,4540.51,1.0,CUS-127297539,2018-08-24,Virginia,F,-31.79,115.79,,20a052be-8743-4e33-b271-8b257a2b76f6,-32.07,115.89,WA,Canning Vale,debit,authorized,1c9a3d3dd8f7485eb395b26aedf72d39,SALES-POS,<20,2018,8,24,16,43,Friday,7 days,59379.764
ACC-3689607373,20,55.0,4485.51,,CUS-127297539,2018-08-24,Virginia,F,-31.79,115.79,,,,,,,debit,posted,c0c49f17ed6d4991b928db879139f7dc,INTER BANK,<20,2018,8,24,19,0,Friday,7 days,59379.764
ACC-3689607373,20,69.0,4400.41,,CUS-127297539,2018-08-24,Virginia,F,-31.79,115.79,,,,,,,debit,posted,5a009bfe7b4d4a67908682801ebd38f0,PAYMENT,<20,2018,8,24,21,0,Friday,7 days,59379.764
ACC-3689607373,20,16.1,4469.41,1.0,CUS-127297539,2018-08-24,Virginia,F,-31.79,115.79,,c84b0464-c4e1-41e7-9376-ead8986bc757,-31.96,141.47,NSW,Broken Hill,debit,authorized,9e65959003c5403b8c873b4168fd0a19,POS,<20,2018,8,24,21,47,Friday,7 days,59379.764
ACC-3689607373,20,13.79,4386.62,1.0,CUS-127297539,2018-08-25,Virginia,F,-31.79,115.79,,e8232990-ff4b-4844-a311-b6cd4e435de8,-31.94,152.47,NSW,Glenthorne,debit,authorized,3bb88918afcb44608c6fd3e5f2e83103,POS,<20,2018,8,25,3,30,Saturday,7 days,59379.764
ACC-3689607373,20,9.28,4377.34,1.0,CUS-127297539,2018-08-25,Virginia,F,-31.79,115.79,,f1ccef3b-7081-429a-acc9-c24b1ccde2e7,-31.9,115.78,WA,Doubleview,debit,authorized,f38b7b302cef43d1ac09004d6223f3dd,POS,<20,2018,8,25,12,0,Saturday,7 days,59379.764
ACC-3689607373,20,5.16,4372.18,1.0,CUS-127297539,2018-08-25,Virginia,F,-31.79,115.79,,b7da90dc-ce36-46d6-845c-a89d44a1fddc,-31.86,115.9,WA,Malaga,debit,authorized,ff6997c510c5452dbe67baee6c132cb0,SALES-POS,<20,2018,8,25,13,54,Saturday,7 days,59379.764
ACC-3689607373,20,18.09,4354.09,0.0,CUS-127297539,2018-08-25,Virginia,F,-31.79,115.79,,13e0ceb1-f8b6-4edc-9886-ef16aa48dbe1,-31.9,115.8,WA,Innaloo,debit,authorized,e9a9cf3b265344f58e7dd03b77cca0d3,SALES-POS,<20,2018,8,25,16,32,Saturday,7 days,59379.764
ACC-3689607373,20,15.59,4338.5,1.0,CUS-127297539,2018-08-26,Virginia,F,-31.79,115.79,,9c2de398-341e-4c2e-8dc3-5da1a6cfa119,-31.95,115.88,WA,East Perth,debit,authorized,f4bd316344b84c3c966dd97cdad35762,SALES-POS,<20,2018,8,26,1,31,Sunday,7 days,59379.764
ACC-3689607373,20,245.01,4093.49,1.0,CUS-127297539,2018-08-26,Virginia,F,-31.79,115.79,,62ec8580-7b7f-4024-b09a-30c94d0f43f4,-27.97,153.41,QLD,Southport,debit,authorized,6b9a8059e9ae4f85a913e37452a89b18,POS,<20,2018,8,26,10,26,Sunday,7 days,59379.764
ACC-3689607373,20,14.83,4078.66,1.0,CUS-127297539,2018-08-26,Virginia,F,-31.79,115.79,,87ba1b63-bf8b-49c7-bb2c-4ec5d4764bfb,-32.01,115.84,WA,Applecross,debit,authorized,3fa30513e5d84bd9abc820ec71d5a901,SALES-POS,<20,2018,8,26,17,46,Sunday,7 days,59379.764
ACC-3689607373,20,44.99,4033.67,1.0,CUS-127297539,2018-08-27,Virginia,F,-31.79,115.79,,4486cfb1-b6f7-466b-9473-561db42f46d5,-33.9,151.2,NSW,Alexandria,debit,authorized,ed6a5520e1c1484fbf536ee591af91d4,POS,<20,2018,8,27,19,53,Monday,7 days,59379.764
ACC-3689607373,20,5.97,4027.7,0.0,CUS-127297539,2018-08-28,Virginia,F,-31.79,115.79,,769e1f46-30a6-4d5f-8054-d11d357e200d,-31.97,115.81,WA,Nedlands,debit,authorized,4c23c9d1fd2e47d39ca7df869a4bbd31,POS,<20,2018,8,28,11,52,Tuesday,7 days,59379.764
ACC-3689607373,20,17.88,4009.82,1.0,CUS-127297539,2018-08-28,Virginia,F,-31.79,115.79,,e91acea1-8221-4492-9f2a-d4a75fe2bb61,-31.9,115.8,WA,Innaloo,debit,authorized,c077346bd2f844da8673088a8ae2cf12,SALES-POS,<20,2018,8,28,19,3,Tuesday,7 days,59379.764
ACC-3689607373,20,20.56,3989.26,1.0,CUS-127297539,2018-08-29,Virginia,F,-31.79,115.79,,ca7a3fbc-ceac-4a05-8904-9d5b05d643aa,-31.8,115.84,WA,Darch,debit,authorized,a72ee465615746feb78da64566fe9ea0,POS,<20,2018,8,29,8,58,Wednesday,7 days,59379.764
ACC-3689607373,20,18.14,3971.12,1.0,CUS-127297539,2018-08-29,Virginia,F,-31.79,115.79,,0bee35e7-b6d4-44ea-a9d7-c025acdc3d0e,-31.82,115.76,WA,Sorrento,debit,authorized,4cc80f9b880549479cb5a13f3d51c14d,SALES-POS,<20,2018,8,29,9,39,Wednesday,7 days,59379.764
ACC-3689607373,20,16.38,3954.74,1.0,CUS-127297539,2018-08-29,Virginia,F,-31.79,115.79,,0e7dc530-13fc-45db-a027-e754167a3312,-31.9,115.9,WA,Morley,debit,authorized,1d272bdc5ec14f65acc124d58c7f4014,POS,<20,2018,8,29,16,28,Wednesday,7 days,59379.764
ACC-3689607373,20,13.21,3941.53,1.0,CUS-127297539,2018-08-30,Virginia,F,-31.79,115.79,,41b90cfc-01e1-4771-8d3a-6914f8b165a9,-31.98,141.46,NSW,Broken Hill,debit,authorized,6cc8f172faea411686ad4e2bfb95d781,POS,<20,2018,8,30,1,57,Thursday,7 days,59379.764
ACC-3689607373,20,12.46,3929.07,1.0,CUS-127297539,2018-08-30,Virginia,F,-31.79,115.79,,428f9cbe-9d7a-41b8-af5b-a9fa0cf63866,-31.79,132.23,SA,Coorabie,debit,authorized,f3ec3310f9484bddabb381fe0d350bc6,POS,<20,2018,8,30,11,1,Thursday,7 days,59379.764
ACC-3689607373,20,2.05,3927.02,0.0,CUS-127297539,2018-08-30,Virginia,F,-31.79,115.79,,566e20e5-188d-4e5b-b858-4e487730d3da,-33.34,115.64,WA,South Bunbury,debit,authorized,e0e35933d94644908bd2cf6b685f244c,POS,<20,2018,8,30,11,44,Thursday,7 days,59379.764
ACC-3689607373,20,17.75,3909.27,1.0,CUS-127297539,2018-08-30,Virginia,F,-31.79,115.79,,e23c0ecf-8e9c-4b05-8ff9-b8d1e70fe08a,-31.87,115.86,WA,Mirrabooka,debit,authorized,98b4b3ad9fe24c4b9de89a0d2bae13a7,POS,<20,2018,8,30,14,26,Thursday,7 days,59379.764
ACC-3689607373,20,48.23,3861.04,1.0,CUS-127297539,2018-08-30,Virginia,F,-31.79,115.79,,14efaca9-7c78-4318-94e9-45f0415e1073,-31.88,115.78,WA,Karrinyup,debit,authorized,f28394631ad74445bd77df63a3eaa151,POS,<20,2018,8,30,16,47,Thursday,7 days,59379.764
ACC-3689607373,20,36.02,4963.81,1.0,CUS-127297539,2018-08-31,Virginia,F,-31.79,115.79,,2d97a89b-8ded-4e13-9d64-da1793a29eae,-31.65,152.8,NSW,Laurieton,debit,authorized,9a2f78b8b38b46af8cfeb152bf513ac5,POS,<20,2018,8,31,14,10,Friday,7 days,59379.764
ACC-3689607373,20,13.86,4949.95,1.0,CUS-127297539,2018-08-31,Virginia,F,-31.79,115.79,,18d056a5-a6ac-4435-a130-2a2cc5114f30,-32.04,115.85,WA,Brentwood,debit,authorized,a1041349e73646bb9145c482aa445133,SALES-POS,<20,2018,8,31,14,51,Friday,7 days,59379.764
ACC-3689607373,20,11.69,4938.26,1.0,CUS-127297539,2018-08-31,Virginia,F,-31.79,115.79,,ccbd17fa-2dc0-43d3-b0b1-95af4b6363c4,-32.08,115.78,WA,Hamilton Hill,debit,authorized,e7dae551c5564d75a30c900e5fdc804d,SALES-POS,<20,2018,8,31,15,51,Friday,7 days,59379.764
ACC-3689607373,20,15.06,4923.2,1.0,CUS-127297539,2018-08-31,Virginia,F,-31.79,115.79,,4d1c882d-8b38-4de0-8b1d-c486d2202d2e,-32.01,151.96,NSW,Gloucester,debit,authorized,1dee4a26ee9c4267b577d89880fe8d10,SALES-POS,<20,2018,8,31,16,22,Friday,7 days,59379.764
ACC-3689607373,20,55.0,4859.0,,CUS-127297539,2018-08-31,Virginia,F,-31.79,115.79,,,,,,,debit,posted,06c99811f1b8414280273369b04e6cd8,INTER BANK,<20,2018,8,31,19,0,Friday,7 days,59379.764
ACC-3689607373,20,9.2,4914.0,1.0,CUS-127297539,2018-08-31,Virginia,F,-31.79,115.79,,f1ccef3b-7081-429a-acc9-c24b1ccde2e7,-31.9,115.78,WA,Doubleview,debit,authorized,f390b6722428415292233ae865dc874a,SALES-POS,<20,2018,8,31,19,0,Friday,7 days,59379.764
ACC-3689607373,20,8.61,4850.39,1.0,CUS-127297539,2018-08-31,Virginia,F,-31.79,115.79,,1f03f1d0-3cac-42e7-b949-4efab26faebd,-33.89,151.25,NSW,Bondi Junction,debit,authorized,f980ef669bed4dabbce18c81f0c0c66a,SALES-POS,<20,2018,8,31,20,32,Friday,7 days,59379.764
ACC-3689607373,20,69.0,4781.39,,CUS-127297539,2018-08-31,Virginia,F,-31.79,115.79,,,,,,,debit,posted,f20818ffee4a446e99a8711a8898a431,PAYMENT,<20,2018,8,31,21,0,Friday,7 days,59379.764
ACC-3689607373,20,8.38,4773.01,1.0,CUS-127297539,2018-09-01,Virginia,F,-31.79,115.79,,eff5148f-7b5f-4214-8a3f-445ecf89802a,-31.95,115.86,WA,Perth,debit,authorized,4ffe36a0d389466eb8e36b4df45a196a,SALES-POS,<20,2018,9,1,10,48,Saturday,7 days,59379.764
ACC-3689607373,20,23.43,4749.58,1.0,CUS-127297539,2018-09-01,Virginia,F,-31.79,115.79,,7a696b6f-7586-4d4d-a2c6-e32904de84dd,-32.13,133.67,SA,Ceduna,debit,authorized,25c91a9983ea43848d9fd9f3d47d1e1e,POS,<20,2018,9,1,11,27,Saturday,7 days,59379.764
ACC-3689607373,20,20.28,4729.3,1.0,CUS-127297539,2018-09-01,Virginia,F,-31.79,115.79,,02e67fcd-b41a-4cb4-8b8e-b76c4ac06d96,-31.82,115.82,WA,Madeley,debit,authorized,36f166628c20496eba0d3adf2040a91a,SALES-POS,<20,2018,9,1,11,34,Saturday,7 days,59379.764
ACC-3689607373,20,26.5,4702.8,1.0,CUS-127297539,2018-09-01,Virginia,F,-31.79,115.79,,deb7ade5-9552-4ab1-abff-a0ba6721bb15,-31.71,148.67,NSW,Gilgandra,debit,authorized,9303f55ff3354e47977c802621e94ac0,SALES-POS,<20,2018,9,1,13,45,Saturday,7 days,59379.764
ACC-3689607373,20,22.86,4679.94,1.0,CUS-127297539,2018-09-01,Virginia,F,-31.79,115.79,,8096c474-820e-43b4-bfe5-c4ef722d0677,-31.82,115.74,WA,Hillarys,debit,authorized,382aad3ee5944350babc6f921d000136,SALES-POS,<20,2018,9,1,14,53,Saturday,7 days,59379.764
ACC-3689607373,20,185.78,4494.16,0.0,CUS-127297539,2018-09-01,Virginia,F,-31.79,115.79,,293fb8f1-9c16-4271-a64d-7fc03b56f673,-33.89,151.12,NSW,Ashfield,debit,authorized,29e8970ac30748ffb7eeec66f56c243e,SALES-POS,<20,2018,9,1,17,32,Saturday,7 days,59379.764
ACC-3689607373,20,46.08,4448.08,1.0,CUS-127297539,2018-09-01,Virginia,F,-31.79,115.79,,20350a17-ead5-464b-bea9-5cbf33362de2,-37.9,145.09,VIC,Oakleigh,debit,authorized,8e244424c1bc43a99fee5a72649ee9ab,SALES-POS,<20,2018,9,1,20,47,Saturday,7 days,59379.764
ACC-3689607373,20,5.23,4442.85,1.0,CUS-127297539,2018-09-01,Virginia,F,-31.79,115.79,,bd19a059-abcb-4c59-83f4-ca0a07c93d4d,-33.93,151.19,NSW,Mascot,debit,authorized,b85f936219074db7981da18222a2d154,SALES-POS,<20,2018,9,1,22,15,Saturday,7 days,59379.764
ACC-3689607373,20,32.36,4410.49,1.0,CUS-127297539,2018-09-01,Virginia,F,-31.79,115.79,,08e69e96-622a-4faa-9322-b6ba1a96d94e,-31.88,115.78,WA,Karrinyup,debit,authorized,3a412f9ae70e436c8e4b732bfc96d642,SALES-POS,<20,2018,9,1,23,27,Saturday,7 days,59379.764
ACC-3689607373,20,16.51,4393.98,1.0,CUS-127297539,2018-09-02,Virginia,F,-31.79,115.79,,7acb0082-2056-4040-8c99-ad7fba5662f3,-32.37,115.76,WA,Port Kennedy,debit,authorized,005d1b9be38d4984bf6761e5121281d6,POS,<20,2018,9,2,3,9,Sunday,7 days,59379.764
ACC-3689607373,20,18.85,4375.13,1.0,CUS-127297539,2018-09-02,Virginia,F,-31.79,115.79,,4a03543c-04c2-434d-9d76-b3bf5411cbf1,-31.84,115.79,WA,Duncraig,debit,authorized,b310b537762a4dbba2a627a1e1c64941,SALES-POS,<20,2018,9,2,7,6,Sunday,7 days,59379.764
ACC-3689607373,20,12.26,4362.87,0.0,CUS-127297539,2018-09-02,Virginia,F,-31.79,115.79,,552b4220-1a02-4608-9e48-4b81003fb6e8,-31.89,116.77,WA,York,debit,authorized,0b0609e32db546349af866fc840bf34f,SALES-POS,<20,2018,9,2,9,3,Sunday,7 days,59379.764
ACC-3689607373,20,5.57,4357.3,0.0,CUS-127297539,2018-09-02,Virginia,F,-31.79,115.79,,79adbf92-bca9-4da2-b8cf-bcc47bd73267,-31.98,115.78,WA,Claremont,debit,authorized,fee4331c3a814778a452e5a924b544f7,SALES-POS,<20,2018,9,2,15,0,Sunday,7 days,59379.764
ACC-3689607373,20,19.68,4337.62,1.0,CUS-127297539,2018-09-02,Virginia,F,-31.79,115.79,,c3d5aef3-61f9-4520-8287-28f072d870c0,-33.32,115.72,WA,Eaton,debit,authorized,02cd1ad305ac48bf883b682c1ceb68d0,POS,<20,2018,9,2,16,13,Sunday,7 days,59379.764
ACC-3689607373,20,25.24,4312.38,0.0,CUS-127297539,2018-09-02,Virginia,F,-31.79,115.79,,6ebae375-77d4-4b6d-a004-c67eef82fd1f,-31.63,117.01,WA,Meckering,debit,authorized,0ec2eed7b6174d66b73be268c6521c0f,SALES-POS,<20,2018,9,2,17,8,Sunday,7 days,59379.764
ACC-3689607373,20,11.29,4301.09,1.0,CUS-127297539,2018-09-02,Virginia,F,-31.79,115.79,,15f95e2b-b264-42da-843b-bde7a0d9c62a,-34.83,138.69,SA,Modbury,debit,authorized,18429951169a432f822fb4d2f97330a8,SALES-POS,<20,2018,9,2,19,0,Sunday,7 days,59379.764
ACC-3689607373,20,181.0,4120.09,,CUS-127297539,2018-09-03,Virginia,F,-31.79,115.79,,,,,,,debit,posted,84b83266ddbc41228b38e92ffb633857,INTER BANK,<20,2018,9,3,15,0,Monday,7 days,59379.764
ACC-3689607373,20,51.69,4068.4,1.0,CUS-127297539,2018-09-03,Virginia,F,-31.79,115.79,,5e42640e-23ee-43fa-842b-da10409a419e,-32.73,151.55,NSW,Maitland,debit,authorized,2548e905043a499986db9df3fda19979,POS,<20,2018,9,3,21,2,Monday,7 days,59379.764
ACC-3689607373,20,10.92,4057.48,1.0,CUS-127297539,2018-09-04,Virginia,F,-31.79,115.79,,5164dffa-729a-4bce-b78a-e2bebb8f395d,-32.03,115.79,WA,Bicton,debit,authorized,74abcd7020184d84934dfa912f23b5b1,SALES-POS,<20,2018,9,4,9,12,Tuesday,7 days,59379.764
ACC-3689607373,20,41.29,4016.19,1.0,CUS-127297539,2018-09-04,Virginia,F,-31.79,115.79,,9275731c-148e-43ff-8cf1-d3923b199ede,-31.76,115.77,WA,Joondalup,debit,authorized,38743774966d49879458377c4cffce6d,SALES-POS,<20,2018,9,4,11,34,Tuesday,7 days,59379.764
ACC-3689607373,20,17.15,3999.04,1.0,CUS-127297539,2018-09-04,Virginia,F,-31.79,115.79,,3588548a-e252-48e2-8747-81d0a0da6f28,-31.95,115.86,WA,Perth,debit,authorized,3b301330696e4392a2867bde4d2139a1,POS,<20,2018,9,4,21,21,Tuesday,7 days,59379.764
ACC-3689607373,20,9.98,3989.06,0.0,CUS-127297539,2018-09-05,Virginia,F,-31.79,115.79,,930dbad3-c6eb-4a18-8150-bf7c5392e9ed,-31.95,115.86,WA,Perth,debit,authorized,cdf3da8d6ebe4026bff2acbdf14520d5,SALES-POS,<20,2018,9,5,15,48,Wednesday,7 days,59379.764
ACC-3689607373,20,55.0,5072.85,,CUS-127297539,2018-09-07,Virginia,F,-31.79,115.79,,,,,,,debit,posted,816b1994d05949bcaccba0958447eee0,INTER BANK,<20,2018,9,7,19,0,Friday,7 days,59379.764
ACC-3689607373,20,69.0,5003.85,,CUS-127297539,2018-09-07,Virginia,F,-31.79,115.79,,,,,,,debit,posted,b4d1aaf4ed93474ea4e125bc5fb243ec,PAYMENT,<20,2018,9,7,21,0,Friday,7 days,59379.764
ACC-3689607373,20,16.35,4987.5,1.0,CUS-127297539,2018-09-10,Virginia,F,-31.79,115.79,,85001102-e9fe-4fe8-b52a-9e7c16a34e98,-32.13,133.67,SA,Ceduna,debit,authorized,71777c3b54324c7db7bd3b94a1fb4ee0,POS,<20,2018,9,10,16,5,Monday,7 days,59379.764
ACC-3689607373,20,26.62,4960.88,1.0,CUS-127297539,2018-09-10,Virginia,F,-31.79,115.79,,6ebae375-77d4-4b6d-a004-c67eef82fd1f,-31.63,117.01,WA,Meckering,debit,authorized,b33e67b3df6a476990271838ade7e9a0,POS,<20,2018,9,10,21,6,Monday,7 days,59379.764
ACC-3689607373,20,13.74,4947.14,0.0,CUS-127297539,2018-09-11,Virginia,F,-31.79,115.79,,c998dc19-e3c7-4154-b699-4992a61ef0df,-32.06,115.99,WA,Maddington,debit,authorized,66798357b1da42bdb6042c911be621ff,SALES-POS,<20,2018,9,11,21,48,Tuesday,7 days,59379.764
ACC-3689607373,20,16.29,4930.85,1.0,CUS-127297539,2018-09-12,Virginia,F,-31.79,115.79,,f61b0191-e68f-4fa5-b2d9-2094dcf3f822,-32.04,115.78,WA,East Fremantle,debit,authorized,0b282912598c4f299b7476cb3764ca2d,POS,<20,2018,9,12,0,42,Wednesday,7 days,59379.764
ACC-3689607373,20,12.34,4918.51,1.0,CUS-127297539,2018-09-12,Virginia,F,-31.79,115.79,,a684e8da-788b-48e2-8e9e-68dcca90266d,-31.89,116,WA,Midland,debit,authorized,29b4b882f58a4c7d80bda46cd35f7316,POS,<20,2018,9,12,4,51,Wednesday,7 days,59379.764
ACC-3689607373,20,5.43,4913.08,1.0,CUS-127297539,2018-09-12,Virginia,F,-31.79,115.79,,2d377fff-4b7e-4b96-99b6-6caa94f234e6,-31.74,115.77,WA,Joondalup,debit,authorized,37d48f7303034dceb815cd7bd9b8dade,POS,<20,2018,9,12,19,2,Wednesday,7 days,59379.764
ACC-3689607373,20,10.51,4902.57,0.0,CUS-127297539,2018-09-12,Virginia,F,-31.79,115.79,,b5d118eb-8230-43c1-afc0-c91060a2666a,-31.71,148.66,NSW,Gilgandra,debit,authorized,13520e9009824fd8bc78686652f59f83,POS,<20,2018,9,12,19,50,Wednesday,7 days,59379.764
ACC-3689607373,20,12.59,4889.98,1.0,CUS-127297539,2018-09-13,Virginia,F,-31.79,115.79,,9b03f1fb-e94f-4a23-b48e-1b2c0c4ac093,-31.95,115.85,WA,West Perth,debit,authorized,ebae6f1912bb487a8a954b02f7d720c7,POS,<20,2018,9,13,9,26,Thursday,7 days,59379.764
ACC-3689607373,20,17.67,4872.31,1.0,CUS-127297539,2018-09-13,Virginia,F,-31.79,115.79,,6c84c219-96ea-4c6f-9de5-0a28bcaec62f,-32.01,152.47,NSW,Rainbow Flat,debit,authorized,dc584099de9c4f0584d7f75327c334f9,SALES-POS,<20,2018,9,13,17,53,Thursday,7 days,59379.764
ACC-3689607373,20,15.67,4856.64,1.0,CUS-127297539,2018-09-14,Virginia,F,-31.79,115.79,,4d1c882d-8b38-4de0-8b1d-c486d2202d2e,-32.01,151.96,NSW,Gloucester,debit,authorized,fc73d812ccbc465f84105fff6a00c985,POS,<20,2018,9,14,8,0,Friday,7 days,59379.764
ACC-3689607373,20,21.16,4835.48,1.0,CUS-127297539,2018-09-14,Virginia,F,-31.79,115.79,,cebc217a-60a9-4a09-9c52-3852108f5c2d,-31.9,115.8,WA,Innaloo,debit,authorized,223cb8c0a8a5419a9cf958798f3a0bad,SALES-POS,<20,2018,9,14,9,5,Friday,7 days,59379.764
ACC-3689607373,20,13.05,4822.43,1.0,CUS-127297539,2018-09-14,Virginia,F,-31.79,115.79,,de2bf089-d4a7-4fc4-8428-a50643217748,-32.56,115.69,WA,Erskine,debit,authorized,bcaf1d56c14e4ae8aa7500a8e21d2a61,POS,<20,2018,9,14,9,24,Friday,7 days,59379.764
ACC-3689607373,20,55.0,5906.22,,CUS-127297539,2018-09-14,Virginia,F,-31.79,115.79,,,,,,,debit,posted,043288fb199743a1ae2b1d30293bef07,INTER BANK,<20,2018,9,14,19,0,Friday,7 days,59379.764
ACC-3689607373,20,69.0,5837.22,,CUS-127297539,2018-09-14,Virginia,F,-31.79,115.79,,,,,,,debit,posted,1a055251443f46d8bbb221c19951af29,PAYMENT,<20,2018,9,14,21,0,Friday,7 days,59379.764
ACC-3689607373,20,11.2,5826.02,0.0,CUS-127297539,2018-09-14,Virginia,F,-31.79,115.79,,e790fde4-fdbd-4a87-a222-37cc4cf6a044,-31.86,116.04,WA,Stratton,debit,authorized,b684dc69cac64700ae09479fc032c97a,SALES-POS,<20,2018,9,14,22,49,Friday,7 days,59379.764
ACC-3689607373,20,107.0,5719.02,,CUS-127297539,2018-09-15,Virginia,F,-31.79,115.79,,,,,,,debit,posted,183c9d7d189544d5b23b430779c36908,INTER BANK,<20,2018,9,15,8,0,Saturday,7 days,59379.764
ACC-3689607373,20,24.97,5694.05,1.0,CUS-127297539,2018-09-15,Virginia,F,-31.79,115.79,,9de66fe5-6b47-419c-b9bc-cd81f869aec8,-32.15,116.01,WA,Armadale,debit,authorized,a32862e6fe6f4afaa65b72d6ffdf60cb,SALES-POS,<20,2018,9,15,9,29,Saturday,7 days,59379.764
ACC-3689607373,20,40.87,5653.18,0.0,CUS-127297539,2018-09-15,Virginia,F,-31.79,115.79,,7b838781-85ec-4203-9401-d10563db1e4a,-31.99,115.95,WA,Welshpool,debit,authorized,e288a8c7e67846f7a90a2c781296f0e9,SALES-POS,<20,2018,9,15,10,10,Saturday,7 days,59379.764
ACC-3689607373,20,14.52,5638.66,0.0,CUS-127297539,2018-09-15,Virginia,F,-31.79,115.79,,442296c7-c041-4547-8979-25626e1a766d,-31.96,141.46,NSW,Broken Hill,debit,authorized,76747b45ad644960843e2d59b09520d3,POS,<20,2018,9,15,11,19,Saturday,7 days,59379.764
ACC-3689607373,20,14.76,5623.9,1.0,CUS-127297539,2018-09-15,Virginia,F,-31.79,115.79,,e3c60eca-6c21-4870-88ab-5323f1dfc6e4,-31.81,116,WA,Henley Brook,debit,authorized,85df0b5c454f4aa99bfff3ac4d848c71,SALES-POS,<20,2018,9,15,11,32,Saturday,7 days,59379.764
ACC-3689607373,20,37.3,5586.6,1.0,CUS-127297539,2018-09-16,Virginia,F,-31.79,115.79,,2be09a29-2f79-4cb3-9ed2-36594d0138d4,-31.67,150.15,NSW,Yarraman,debit,authorized,94a0bcb1b50e48f39170700ef749d900,POS,<20,2018,9,16,22,52,Sunday,7 days,59379.764
ACC-3689607373,20,13.77,5572.83,1.0,CUS-127297539,2018-09-17,Virginia,F,-31.79,115.79,,a8ef339b-30a0-4490-8954-d224e2ddc694,-32.12,115.8,WA,Bibra Lake,debit,authorized,d0e1a78c90544fbf85b34942f2560b7e,SALES-POS,<20,2018,9,17,17,0,Monday,7 days,59379.764
ACC-3689607373,20,3.4,5569.43,0.0,CUS-127297539,2018-09-17,Virginia,F,-31.79,115.79,,c9da73d1-9d5e-4617-84c0-745f303de973,-31.99,116.01,WA,Forrestfield,debit,authorized,70dd1842c6594f9691c2a7b723717675,SALES-POS,<20,2018,9,17,18,5,Monday,7 days,59379.764
ACC-3689607373,20,17.56,5551.87,1.0,CUS-127297539,2018-09-17,Virginia,F,-31.79,115.79,,89050fa6-0356-42df-9de3-ccb9f467a788,-31.91,152.45,NSW,Taree,debit,authorized,11d6f94408794c55807edf7a9bd77311,POS,<20,2018,9,17,19,59,Monday,7 days,59379.764
ACC-3689607373,20,8.19,5543.68,0.0,CUS-127297539,2018-09-18,Virginia,F,-31.79,115.79,,294193ff-d76e-445f-b240-dea59df2caf8,-31.94,141.47,NSW,Broken Hill,debit,authorized,a851a3c683784c15b051ff47b608e651,SALES-POS,<20,2018,9,18,10,24,Tuesday,7 days,59379.764
ACC-3689607373,20,16.63,5527.05,1.0,CUS-127297539,2018-09-18,Virginia,F,-31.79,115.79,,328d2ca7-f0fa-42ad-9d16-a088618fb7f8,-31.99,115.9,WA,East Victoria Park,debit,authorized,696b90c1dfb64e18bebc0f669111e777,POS,<20,2018,9,18,12,13,Tuesday,7 days,59379.764
ACC-3689607373,20,15.18,5511.87,1.0,CUS-127297539,2018-09-18,Virginia,F,-31.79,115.79,,d2f77f77-a2e6-4288-ac29-97e23e224f94,-31.83,115.81,WA,Greenwood,debit,authorized,2298aa439dbc4f57a3a53d0437702998,POS,<20,2018,9,18,17,26,Tuesday,7 days,59379.764
ACC-3689607373,20,36.36,5475.51,1.0,CUS-127297539,2018-09-19,Virginia,F,-31.79,115.79,,2d97a89b-8ded-4e13-9d64-da1793a29eae,-31.65,152.8,NSW,Laurieton,debit,authorized,7afae830851b4cbf8e5fd7c3d624ec57,POS,<20,2018,9,19,9,1,Wednesday,7 days,59379.764
ACC-3689607373,20,15.98,6598.32,1.0,CUS-127297539,2018-09-21,Virginia,F,-31.79,115.79,,2472999f-233d-4184-b4b6-24cfe5b25268,-33.35,115.64,WA,South Bunbury,debit,authorized,dc0272ff146c4cdb81077dabfdc44738,POS,<20,2018,9,21,15,11,Friday,7 days,59379.764
ACC-3689607373,20,55.0,6543.32,,CUS-127297539,2018-09-21,Virginia,F,-31.79,115.79,,,,,,,debit,posted,c74ceafbcbc94e7788f50bd9a3242d92,INTER BANK,<20,2018,9,21,19,0,Friday,7 days,59379.764
ACC-3689607373,20,69.0,6459.37,,CUS-127297539,2018-09-21,Virginia,F,-31.79,115.79,,,,,,,debit,posted,08f638f199d5443ab89b26f5fdba3e90,PAYMENT,<20,2018,9,21,21,0,Friday,7 days,59379.764
ACC-3689607373,20,14.95,6528.37,1.0,CUS-127297539,2018-09-21,Virginia,F,-31.79,115.79,,1548e270-35fb-4848-874f-46fc72569df1,-31.98,115.86,WA,South Perth,debit,authorized,eb7e6d42ba974447879bf0de44aa07d8,POS,<20,2018,9,21,21,33,Friday,7 days,59379.764
ACC-3689607373,20,67.49,6391.88,1.0,CUS-127297539,2018-09-22,Virginia,F,-31.79,115.79,,9e765397-3424-4d26-aab1-a37a4b5f5c96,-31.83,116.01,WA,Herne Hill,debit,authorized,adef52e1950c411b8ca9d026eaaca835,SALES-POS,<20,2018,9,22,8,19,Saturday,7 days,59379.764
ACC-3689607373,20,17.79,6374.09,1.0,CUS-127297539,2018-09-22,Virginia,F,-31.79,115.79,,89050fa6-0356-42df-9de3-ccb9f467a788,-31.91,152.45,NSW,Taree,debit,authorized,b858ba17ea764a01b53f533ca59b88c5,POS,<20,2018,9,22,14,43,Saturday,7 days,59379.764
ACC-3689607373,20,19.23,6354.86,1.0,CUS-127297539,2018-09-22,Virginia,F,-31.79,115.79,,7b0efea6-175f-4d87-b096-e32fb6281da0,-32.07,116,WA,Gosnells,debit,authorized,fd57c1a9c3cc4ede8c66cb6d79c744e0,POS,<20,2018,9,22,14,51,Saturday,7 days,59379.764
ACC-3689607373,20,36.19,6318.67,1.0,CUS-127297539,2018-09-22,Virginia,F,-31.79,115.79,,9b8cd3ba-a8fd-4c32-b0b4-980862feca16,-31.82,115.77,WA,Duncraig,debit,authorized,690536c4f6d847798b5b087685957c06,SALES-POS,<20,2018,9,22,17,7,Saturday,7 days,59379.764
ACC-3689607373,20,17.59,6301.08,0.0,CUS-127297539,2018-09-25,Virginia,F,-31.79,115.79,,2f1952ff-7f21-4476-b28b-f8427b425592,-32.07,115.95,WA,Thornlie,debit,authorized,a2a0ef7e9be5452e99a028afd8bf956c,SALES-POS,<20,2018,9,25,9,28,Tuesday,7 days,59379.764
ACC-3689607373,20,12.47,6288.61,1.0,CUS-127297539,2018-09-25,Virginia,F,-31.79,115.79,,26d8ffb3-c584-438a-a372-179ee2c9ea86,-32.05,115.88,WA,Willetton,debit,authorized,cbb73bd865194a0497475133d4c9dd5b,SALES-POS,<20,2018,9,25,9,48,Tuesday,7 days,59379.764
ACC-3689607373,20,8.65,6279.96,1.0,CUS-127297539,2018-09-25,Virginia,F,-31.79,115.79,,874e3453-6dc3-4e7e-96ea-712bfb0fa0b8,-31.82,115.82,WA,Madeley,debit,authorized,f5310a0da705410aa46e9166f7c8f7a4,SALES-POS,<20,2018,9,25,15,31,Tuesday,7 days,59379.764
ACC-3689607373,20,8.06,6271.9,1.0,CUS-127297539,2018-09-25,Virginia,F,-31.79,115.79,,5f6f52fb-a564-48cf-bf55-36537a415887,-33.87,151.21,NSW,Sydney,debit,authorized,b02e5ae4e5e3440f880d6c9518886fe8,SALES-POS,<20,2018,9,25,19,51,Tuesday,7 days,59379.764
ACC-3689607373,20,9.94,6261.96,1.0,CUS-127297539,2018-09-26,Virginia,F,-31.79,115.79,,d75b1665-af5d-40ca-a3c1-146e3225dbab,-31.65,152.8,NSW,Laurieton,debit,authorized,3d06416aaf834ee0a1afab3ae73c2a22,POS,<20,2018,9,26,6,17,Wednesday,7 days,59379.764
ACC-3689607373,20,6.25,6255.71,1.0,CUS-127297539,2018-09-26,Virginia,F,-31.79,115.79,,80c21883-14e0-4ef2-acde-d3da728d0531,-31.85,115.88,WA,Malaga,debit,authorized,18aa372d72984fb58c75700de24cd1ef,SALES-POS,<20,2018,9,26,9,54,Wednesday,7 days,59379.764
ACC-3689607373,20,2.66,6253.05,1.0,CUS-127297539,2018-09-26,Virginia,F,-31.79,115.79,,03f4de0d-d78b-421a-8a53-30a0d03479eb,-31.8,115.98,WA,Aveley,debit,authorized,2dcab2c1738143bba1f3864f641acc04,SALES-POS,<20,2018,9,26,11,17,Wednesday,7 days,59379.764
ACC-3689607373,20,3.72,6249.33,0.0,CUS-127297539,2018-09-26,Virginia,F,-31.79,115.79,,e2ec33ca-0b37-4ea1-9a09-16be996464aa,-31.95,115.86,WA,Perth,debit,authorized,9c5541524c744ce0a11789f9617e300c,SALES-POS,<20,2018,9,26,15,14,Wednesday,7 days,59379.764
ACC-3689607373,20,13.45,6235.88,1.0,CUS-127297539,2018-09-28,Virginia,F,-31.79,115.79,,af46b006-44d1-4a57-b83a-4c9d4e6f02d7,-31.76,150.83,NSW,Murrurundi,debit,authorized,e5fdf1295efa48dca88663612639c231,POS,<20,2018,9,28,9,52,Friday,7 days,59379.764
ACC-3689607373,20,7.14,7367.53,1.0,CUS-127297539,2018-09-28,Virginia,F,-31.79,115.79,,c305fe56-0346-4606-9fea-7dbac0d4a365,-31.95,115.86,WA,Northbridge,debit,authorized,07548620578841aa93d4c24ae660e25a,POS,<20,2018,9,28,14,13,Friday,7 days,59379.764
ACC-3689607373,20,12.88,7354.65,1.0,CUS-127297539,2018-09-28,Virginia,F,-31.79,115.79,,4ecd08bf-dade-41de-aa56-db153e08183d,-31.9,115.8,WA,Innaloo,debit,authorized,72f875a89ceb4cee8ad54dd35c5ecfc6,SALES-POS,<20,2018,9,28,14,37,Friday,7 days,59379.764
ACC-3689607373,20,55.0,7299.65,,CUS-127297539,2018-09-28,Virginia,F,-31.79,115.79,,,,,,,debit,posted,332e69a5f56d44a3ac019062ded5f943,INTER BANK,<20,2018,9,28,19,0,Friday,7 days,59379.764
ACC-3689607373,20,69.0,7230.65,,CUS-127297539,2018-09-28,Virginia,F,-31.79,115.79,,,,,,,debit,posted,fb2fbe4e8f8b4b82b544f0132454f806,PAYMENT,<20,2018,9,28,21,0,Friday,7 days,59379.764
ACC-3689607373,20,195.22,7035.43,1.0,CUS-127297539,2018-09-29,Virginia,F,-31.79,115.79,,9cd4ce71-52da-4385-841e-cae85382b931,-31.95,115.84,WA,West Perth,debit,authorized,7bb4dfbc733848b099a40162fcb0574e,POS,<20,2018,9,29,3,20,Saturday,7 days,59379.764
ACC-3689607373,20,17.39,7018.04,0.0,CUS-127297539,2018-09-29,Virginia,F,-31.79,115.79,,edc966ef-090f-4bad-8839-019b8db29130,-31.95,115.86,WA,Perth,debit,authorized,7d4501ccd9c14757acc6ac3a0e1529a3,SALES-POS,<20,2018,9,29,12,36,Saturday,7 days,59379.764
ACC-3689607373,20,9.85,7008.19,1.0,CUS-127297539,2018-09-30,Virginia,F,-31.79,115.79,,0cc03d95-bf40-41a7-9248-2d7c42e95c04,-32.13,133.67,SA,Ceduna,debit,authorized,5f8ebafe75f7481b9d72cd1334cde2c1,SALES-POS,<20,2018,9,30,8,24,Sunday,7 days,59379.764
ACC-3689607373,20,181.0,6827.19,,CUS-127297539,2018-10-03,Virginia,F,-31.79,115.79,,,,,,,debit,posted,614ab4a0f7b64e909f250e4cbe1478c0,INTER BANK,<20,2018,10,3,15,0,Wednesday,7 days,59379.764
ACC-3689607373,20,13.09,6814.1,1.0,CUS-127297539,2018-10-04,Virginia,F,-31.79,115.79,,41b90cfc-01e1-4771-8d3a-6914f8b165a9,-31.98,141.46,NSW,Broken Hill,debit,authorized,470b7212dc524e4fa2441260654ddda5,POS,<20,2018,10,4,8,30,Thursday,7 days,59379.764
ACC-3689607373,20,55.0,7897.89,,CUS-127297539,2018-10-05,Virginia,F,-31.79,115.79,,,,,,,debit,posted,a1f91b5ce9f745aabd5aa4f6c9b166a6,INTER BANK,<20,2018,10,5,19,0,Friday,7 days,59379.764
ACC-3689607373,20,69.0,7828.89,,CUS-127297539,2018-10-05,Virginia,F,-31.79,115.79,,,,,,,debit,posted,96eb80512faa4351ae1f7d8aa2aa7a93,PAYMENT,<20,2018,10,5,21,0,Friday,7 days,59379.764
ACC-3689607373,20,17.14,7811.75,1.0,CUS-127297539,2018-10-09,Virginia,F,-31.79,115.79,,1ddf7d5d-8a4c-480d-8068-95659f2c9580,-31.84,115.81,WA,Warwick,debit,authorized,281a591d85104fceacb3b4d5ae224297,POS,<20,2018,10,9,17,17,Tuesday,7 days,59379.764
ACC-3689607373,20,65.95,7745.8,1.0,CUS-127297539,2018-10-10,Virginia,F,-31.79,115.79,,2524fe8b-0b41-460d-b7d6-77fdba54657d,-33.81,151.26,NSW,Clontarf,debit,authorized,16dcf20171f944438423e8ecd8778a5f,SALES-POS,<20,2018,10,10,1,34,Wednesday,7 days,59379.764
ACC-3689607373,20,7.73,7738.07,1.0,CUS-127297539,2018-10-10,Virginia,F,-31.79,115.79,,4ebc6c77-466d-4bc1-84cb-79098be0f2df,-28.12,153.47,QLD,Palm Beach,debit,authorized,60221ec427ea4af0be3d4a87f6d2a63e,POS,<20,2018,10,10,21,17,Wednesday,7 days,59379.764
ACC-3689607373,20,31.24,7706.83,1.0,CUS-127297539,2018-10-11,Virginia,F,-31.79,115.79,,5f2f5ead-9477-4615-8996-f8b1ad78f208,-31.69,115.72,WA,Clarkson,debit,authorized,dbdaefa4f5004a6dbd749945815b9f7f,SALES-POS,<20,2018,10,11,0,43,Thursday,7 days,59379.764
ACC-3689607373,20,18.69,7688.14,1.0,CUS-127297539,2018-10-11,Virginia,F,-31.79,115.79,,ce6148ec-ffad-4b3a-b54c-497e5e41006c,-32.07,115.82,WA,Kardinya,debit,authorized,9f71735be174402098c0d88bf8673806,SALES-POS,<20,2018,10,11,2,49,Thursday,7 days,59379.764
ACC-3689607373,20,931.69,6756.45,0.0,CUS-127297539,2018-10-11,Virginia,F,-31.79,115.79,,79d69c85-2e85-45fc-a4ae-537ec4b232bc,-32.03,117.67,WA,Pantapin,debit,authorized,c03c284a17ce4bab9513675c3ed79e48,SALES-POS,<20,2018,10,11,9,22,Thursday,7 days,59379.764
ACC-3689607373,20,61.67,6694.78,1.0,CUS-127297539,2018-10-11,Virginia,F,-31.79,115.79,,f588b74d-c336-4f3a-931b-1c67eb0abb1f,-37.82,144.96,VIC,Melbourne,debit,authorized,ab99d0ddac6d44a89dd2dd2049c9ed1c,SALES-POS,<20,2018,10,11,12,27,Thursday,7 days,59379.764
ACC-3689607373,20,86.93,6607.85,1.0,CUS-127297539,2018-10-11,Virginia,F,-31.79,115.79,,ff61dd5e-938a-4acb-a1fd-03d1d2fbba4e,-33.87,151.21,NSW,Sydney,debit,authorized,61544eed53314ae080a8ee598ebebaab,POS,<20,2018,10,11,16,3,Thursday,7 days,59379.764
ACC-3689607373,20,19.94,6587.91,1.0,CUS-127297539,2018-10-11,Virginia,F,-31.79,115.79,,b11ffba7-2951-465c-8bbb-26c59602b43b,-32.13,115.84,WA,Cockburn Central,debit,authorized,9be583db31484079ad0a05aca70327a8,POS,<20,2018,10,11,22,14,Thursday,7 days,59379.764
ACC-3689607373,20,9.93,6577.98,0.0,CUS-127297539,2018-10-11,Virginia,F,-31.79,115.79,,37110947-d629-4d96-b849-e7f7335ab126,-31.64,115.69,WA,Butler,debit,authorized,26e60c4c72dd42768c304e7178681dda,SALES-POS,<20,2018,10,11,22,41,Thursday,7 days,59379.764
ACC-3689607373,20,64.82,7651.95,1.0,CUS-127297539,2018-10-12,Virginia,F,-31.79,115.79,,fbb901d4-6d0d-4b7a-9b4e-82cd9ec119d5,-31.87,115.86,WA,Mirrabooka,debit,authorized,7fba56d69f104dcfa367c2dc277dc39c,SALES-POS,<20,2018,10,12,17,32,Friday,7 days,59379.764
ACC-3689607373,20,55.0,7596.95,,CUS-127297539,2018-10-12,Virginia,F,-31.79,115.79,,,,,,,debit,posted,4a9d4c63fb0a47328ab6db320cffd7cb,INTER BANK,<20,2018,10,12,19,0,Friday,7 days,59379.764
ACC-3689607373,20,69.0,7527.95,,CUS-127297539,2018-10-12,Virginia,F,-31.79,115.79,,,,,,,debit,posted,b256ed2c3fdf4074b134c51529c26201,PAYMENT,<20,2018,10,12,21,0,Friday,7 days,59379.764
ACC-3689607373,20,53.54,7474.41,1.0,CUS-127297539,2018-10-13,Virginia,F,-31.79,115.79,,2af7f5b7-490c-40de-a49e-2b16d26d7d12,-31.96,115.87,WA,Perth,debit,authorized,d7218593ad164fdeb05047f016d477e5,SALES-POS,<20,2018,10,13,4,4,Saturday,7 days,59379.764
ACC-3689607373,20,23.46,7450.95,1.0,CUS-127297539,2018-10-13,Virginia,F,-31.79,115.79,,5605b47f-95a3-4928-826d-a1e3a78be850,-32.1,115.78,WA,Spearwood,debit,authorized,991d1ca129a24b1ebc14aae4d030cdc4,POS,<20,2018,10,13,4,39,Saturday,7 days,59379.764
ACC-3689607373,20,16.21,7434.74,1.0,CUS-127297539,2018-10-13,Virginia,F,-31.79,115.79,,0440addd-59e8-4f45-89c2-31da2ef8c5a5,-31.83,115.74,WA,Hillarys,debit,authorized,2ff27cbcac464440a824f51617b163d1,SALES-POS,<20,2018,10,13,9,55,Saturday,7 days,59379.764
ACC-3689607373,20,168.16,7266.58,0.0,CUS-127297539,2018-10-13,Virginia,F,-31.79,115.79,,16c87798-f575-410d-a5db-68d7c691d3b5,-31.98,115.79,WA,Claremont,debit,authorized,6de9bcc66cc24b32b80e2f3d3cdaa179,SALES-POS,<20,2018,10,13,12,58,Saturday,7 days,59379.764
ACC-3689607373,20,23.88,7242.7,1.0,CUS-127297539,2018-10-13,Virginia,F,-31.79,115.79,,b246c316-ff28-4c47-b242-735a17f0c35f,-31.89,116.01,WA,Midland,debit,authorized,6041c30a60fb4b17bc72d6aec0feac40,SALES-POS,<20,2018,10,13,22,8,Saturday,7 days,59379.764
ACC-3689607373,20,21.59,7221.11,1.0,CUS-127297539,2018-10-14,Virginia,F,-31.79,115.79,,49511063-f9fa-4731-be59-bf0843aced37,-31.85,115.91,WA,Ballajura,debit,authorized,c638143c46a14e1583e7f375b0294eed,POS,<20,2018,10,14,1,5,Sunday,7 days,59379.764
ACC-3689607373,20,107.0,7114.11,,CUS-127297539,2018-10-15,Virginia,F,-31.79,115.79,,,,,,,debit,posted,46456a91de2e4787bf5fb2f318242aaa,INTER BANK,<20,2018,10,15,8,0,Monday,7 days,59379.764
ACC-3689607373,20,16.36,7097.75,0.0,CUS-127297539,2018-10-17,Virginia,F,-31.79,115.79,,eaa7a7f9-3bda-4d2d-80e3-b3a653cfe2cc,-31.98,115.8,WA,Nedlands,debit,authorized,cb165a1eacee4dcbb94f56f9a97a102e,SALES-POS,<20,2018,10,17,20,10,Wednesday,7 days,59379.764
ACC-3689607373,20,55.0,8181.54,,CUS-127297539,2018-10-19,Virginia,F,-31.79,115.79,,,,,,,debit,posted,75cb50a85498416ebf9b9928a112af20,INTER BANK,<20,2018,10,19,19,0,Friday,7 days,59379.764
ACC-3689607373,20,69.0,8112.54,,CUS-127297539,2018-10-19,Virginia,F,-31.79,115.79,,,,,,,debit,posted,6e3303b50001404290f8e96d1fd32637,PAYMENT,<20,2018,10,19,21,0,Friday,7 days,59379.764
ACC-3689607373,20,34.69,8077.85,1.0,CUS-127297539,2018-10-20,Virginia,F,-31.79,115.79,,cb146e48-0447-41c9-989d-9454ba4c3e91,-31.93,115.96,WA,Perth,debit,authorized,7f16718dbec34f9d97e9c1c1677c9765,SALES-POS,<20,2018,10,20,14,24,Saturday,7 days,59379.764
ACC-3689607373,20,3.99,8073.86,1.0,CUS-127297539,2018-10-20,Virginia,F,-31.79,115.79,,c9610cdb-c4d5-4e98-a37f-f42310d95c2e,-31.98,115.87,WA,South Perth,debit,authorized,704d1e839185467bae5d8dd1c1fac5b8,POS,<20,2018,10,20,17,28,Saturday,7 days,59379.764
ACC-3689607373,20,12.09,8061.77,1.0,CUS-127297539,2018-10-20,Virginia,F,-31.79,115.79,,87d5733e-37a1-4c74-9520-ba063523472f,-31.94,115.84,WA,Leederville,debit,authorized,2280992446a44bee8b70ce4ae3b2856e,SALES-POS,<20,2018,10,20,19,13,Saturday,7 days,59379.764
ACC-3689607373,20,14.66,8047.11,1.0,CUS-127297539,2018-10-21,Virginia,F,-31.79,115.79,,cb61bd65-20c3-48ab-a92b-2589637547c0,-31.97,115.93,WA,Kewdale,debit,authorized,ed58c6a189614460a43e97d60741bd67,POS,<20,2018,10,21,8,57,Sunday,7 days,59379.764
ACC-3689607373,20,8.0,8039.11,0.0,CUS-127297539,2018-10-21,Virginia,F,-31.79,115.79,,9e6d0aa9-3bf5-4964-9d63-e6a43960a77d,-31.9,115.9,WA,Morley,debit,authorized,83af96403a90471c94124b7dacbb6eed,POS,<20,2018,10,21,17,15,Sunday,7 days,59379.764
ACC-3689607373,20,8.64,8030.47,1.0,CUS-127297539,2018-10-22,Virginia,F,-31.79,115.79,,a7750c41-afed-4b4e-954f-b503ecf69d0e,-32.25,148.6,NSW,Dubbo,debit,authorized,96cbf7331a9847c5a4af803e6570e9a9,POS,<20,2018,10,22,1,49,Monday,7 days,59379.764
ACC-3689607373,20,9.96,8020.51,1.0,CUS-127297539,2018-10-23,Virginia,F,-31.79,115.79,,e2591002-0bb4-4adc-a30a-49e3505355b5,-31.85,115.81,WA,Warwick,debit,authorized,5f9d36c1b6ef4ec8a760317dd251fd95,POS,<20,2018,10,23,4,14,Tuesday,7 days,59379.764
ACC-3689607373,20,8.38,8012.13,0.0,CUS-127297539,2018-10-23,Virginia,F,-31.79,115.79,,d75b1665-af5d-40ca-a3c1-146e3225dbab,-31.65,152.8,NSW,Laurieton,debit,authorized,c312a940390b4c9ea6065fa7362f39bb,POS,<20,2018,10,23,9,0,Tuesday,7 days,59379.764
ACC-3689607373,20,27.31,7984.82,1.0,CUS-127297539,2018-10-23,Virginia,F,-31.79,115.79,,a43b5201-efc3-420d-8fdd-5579e4d876df,-31.94,115.84,WA,Leederville,debit,authorized,00383c372c854f52b9bea5eddbad6b0b,POS,<20,2018,10,23,13,1,Tuesday,7 days,59379.764
ACC-3689607373,20,15.44,7969.38,1.0,CUS-127297539,2018-10-23,Virginia,F,-31.79,115.79,,5a6d6308-dd3e-4e8a-972d-720a18cb746d,-31.65,117.24,WA,Cunderdin,debit,authorized,4c29596655e24aa1a07352e5088e1f4d,POS,<20,2018,10,23,16,16,Tuesday,7 days,59379.764
ACC-3689607373,20,33.78,7935.6,1.0,CUS-127297539,2018-10-23,Virginia,F,-31.79,115.79,,04f1f4ef-1ffa-4038-9ff2-e2924bdd6efb,-27.98,153.34,QLD,Ashmore,debit,authorized,35edb10566c34bb4b938d7631c01caed,SALES-POS,<20,2018,10,23,18,36,Tuesday,7 days,59379.764
ACC-3689607373,20,6.32,7929.28,0.0,CUS-127297539,2018-10-24,Virginia,F,-31.79,115.79,,6f6848ab-1b4d-429a-a201-0a30830b0e33,-31.99,115.75,WA,Cottesloe,debit,authorized,56895fb483bd4debadb6a974df5df1c7,SALES-POS,<20,2018,10,24,15,6,Wednesday,7 days,59379.764
ACC-3689607373,20,12.87,9055.2,1.0,CUS-127297539,2018-10-26,Virginia,F,-31.79,115.79,,ca566103-e2ba-4a75-965b-e914f077fafc,-31.73,115.8,WA,Ashby,debit,authorized,ddb034c07d384ce494adbbe5d1744efa,SALES-POS,<20,2018,10,26,15,1,Friday,7 days,59379.764
ACC-3689607373,20,10.12,9045.08,1.0,CUS-127297539,2018-10-26,Virginia,F,-31.79,115.79,,09ed9394-a5e3-4ffe-b90f-7a6cf3551b2e,-31.74,115.77,WA,Joondalup,debit,authorized,59a70b3426fc4ad7a9babbeb59bf0a8f,SALES-POS,<20,2018,10,26,15,30,Friday,7 days,59379.764
ACC-3689607373,20,6.22,9038.86,1.0,CUS-127297539,2018-10-26,Virginia,F,-31.79,115.79,,7350dfd6-65f2-47b9-b799-faa752bf3d2f,-32.54,115.74,WA,Mandurah,debit,authorized,4511c1a07266468ebce72128f260491f,SALES-POS,<20,2018,10,26,18,37,Friday,7 days,59379.764
ACC-3689607373,20,55.0,8983.86,,CUS-127297539,2018-10-26,Virginia,F,-31.79,115.79,,,,,,,debit,posted,b858b953f9af4e52b88949172868ec44,INTER BANK,<20,2018,10,26,19,0,Friday,7 days,59379.764
ACC-3689607373,20,69.0,8914.86,,CUS-127297539,2018-10-26,Virginia,F,-31.79,115.79,,,,,,,debit,posted,98a1fb9cb9b14d60a5da52a44496ece7,PAYMENT,<20,2018,10,26,21,0,Friday,7 days,59379.764
ACC-3689607373,20,25.63,8889.23,1.0,CUS-127297539,2018-10-27,Virginia,F,-31.79,115.79,,feff3519-afd1-4bf9-84f8-7add57b84d0d,-31.95,115.86,WA,Perth,debit,authorized,42246360f65e4b719455f5b0e21366aa,POS,<20,2018,10,27,8,25,Saturday,7 days,59379.764
ACC-3689607373,20,17.21,8872.02,1.0,CUS-127297539,2018-10-28,Virginia,F,-31.79,115.79,,948749e3-471e-4a8f-92ad-73e934b95ec4,-33.87,151.21,NSW,Sydney,debit,authorized,c0f7b8f746df43ebb91406b9f508be0a,POS,<20,2018,10,28,11,30,Sunday,7 days,59379.764
ACC-3689607373,20,14.79,8857.23,1.0,CUS-127297539,2018-10-29,Virginia,F,-31.79,115.79,,3e2442b6-9e5c-4c09-9782-a7139d4bfe49,-31.96,115.93,WA,Belmont,debit,authorized,002ceb9e43e1409d9a800f61f179c808,POS,<20,2018,10,29,13,8,Monday,7 days,59379.764
ACC-721712940,78,25.7,49756.21,1.0,CUS-1646183815,2018-08-01,Andrew,M,-37.82,145.09,,9ba904d4-5b0e-403c-b1bc-71e6a2bcdc0f,-37.74,145.03,VIC,Preston,debit,authorized,431119a28af748cbb12920804a7fcda3,POS,70>,2018,8,1,9,59,Wednesday,7 days,40797.614
ACC-721712940,78,12.37,49743.84,1.0,CUS-1646183815,2018-08-02,Andrew,M,-37.82,145.09,,3a5629b1-d175-4133-b944-2c178bd78f69,-37.81,144.97,VIC,East Melbourne,debit,authorized,4a820c04e7ae4136a8e2779a2a41eff6,POS,70>,2018,8,2,10,12,Thursday,7 days,40797.614
ACC-721712940,78,38.0,50488.26,,CUS-1646183815,2018-08-03,Andrew,M,-37.82,145.09,,,,,,,debit,posted,e5af8f98dfce4da7bdab1152cee0c29f,PAYMENT,70>,2018,8,3,21,0,Friday,7 days,40797.614
ACC-721712940,78,33.14,50455.12,1.0,CUS-1646183815,2018-08-03,Andrew,M,-37.82,145.09,,4907689b-827d-4bb9-ba25-d0625b330a9f,-38.11,147.07,VIC,Sale,debit,authorized,7d3434b0ef214f24bbed872147fb991d,POS,70>,2018,8,3,22,7,Friday,7 days,40797.614
ACC-721712940,78,38.0,51199.54,,CUS-1646183815,2018-08-10,Andrew,M,-37.82,145.09,,,,,,,debit,posted,345aec2b262a4ed4a285b14a7fa52aa7,PAYMENT,70>,2018,8,10,21,0,Friday,7 days,40797.614
ACC-721712940,78,38.0,51943.96,,CUS-1646183815,2018-08-17,Andrew,M,-37.82,145.09,,,,,,,debit,posted,46af175ee32e437e9019acd5c12652f1,PAYMENT,70>,2018,8,17,21,0,Friday,7 days,40797.614
ACC-721712940,78,150.0,51793.96,,CUS-1646183815,2018-08-19,Andrew,M,-37.82,145.09,,,,,,,debit,posted,78be86faa7a449888bad338a6aba6539,PHONE BANK,70>,2018,8,19,13,0,Sunday,7 days,40797.614
ACC-721712940,78,147.0,51646.96,,CUS-1646183815,2018-08-20,Andrew,M,-37.82,145.09,,,,,,,debit,posted,244c50209d394c73b770354a5ab72eb7,PAYMENT,70>,2018,8,20,5,0,Monday,7 days,40797.614
ACC-721712940,78,38.0,52391.38,,CUS-1646183815,2018-08-24,Andrew,M,-37.82,145.09,,,,,,,debit,posted,9a8dde80ad3741b29f3d988fe1cbdc16,PAYMENT,70>,2018,8,24,21,0,Friday,7 days,40797.614
ACC-721712940,78,38.0,53135.8,,CUS-1646183815,2018-08-31,Andrew,M,-37.82,145.09,,,,,,,debit,posted,61480e6e03c54d58bc801ff62097e3b0,PAYMENT,70>,2018,8,31,21,0,Friday,7 days,40797.614
ACC-721712940,78,38.0,53880.22,,CUS-1646183815,2018-09-07,Andrew,M,-37.82,145.09,,,,,,,debit,posted,5f1060ab74504957b4acc982ac58d243,PAYMENT,70>,2018,9,7,21,0,Friday,7 days,40797.614
ACC-721712940,78,38.0,54624.64,,CUS-1646183815,2018-09-14,Andrew,M,-37.82,145.09,,,,,,,debit,posted,d372dbfb2c7a4e26ae922621e50c1771,PAYMENT,70>,2018,9,14,21,0,Friday,7 days,40797.614
ACC-721712940,78,150.0,54474.64,,CUS-1646183815,2018-09-19,Andrew,M,-37.82,145.09,,,,,,,debit,posted,cfb059a111c84e3e9f902f0406973b62,PHONE BANK,70>,2018,9,19,13,0,Wednesday,7 days,40797.614
ACC-721712940,78,147.0,54327.64,,CUS-1646183815,2018-09-20,Andrew,M,-37.82,145.09,,,,,,,debit,posted,56435a51f78a4da3a37fbccd6bdc9157,PAYMENT,70>,2018,9,20,5,0,Thursday,7 days,40797.614
ACC-721712940,78,38.0,55072.06,,CUS-1646183815,2018-09-21,Andrew,M,-37.82,145.09,,,,,,,debit,posted,89aef94d924645e8917222286e31cb57,PAYMENT,70>,2018,9,21,21,0,Friday,7 days,40797.614
ACC-721712940,78,38.0,55816.48,,CUS-1646183815,2018-09-28,Andrew,M,-37.82,145.09,,,,,,,debit,posted,151aba4af3354a11b09b86751ea0d128,PAYMENT,70>,2018,9,28,21,0,Friday,7 days,40797.614
ACC-721712940,78,38.0,56560.9,,CUS-1646183815,2018-10-05,Andrew,M,-37.82,145.09,,,,,,,debit,posted,1d0f6b398ba84e9c9a7892e4150d7c44,PAYMENT,70>,2018,10,5,21,0,Friday,7 days,40797.614
ACC-721712940,78,38.0,57305.32,,CUS-1646183815,2018-10-12,Andrew,M,-37.82,145.09,,,,,,,debit,posted,3f7fb98294414457b4bfa84f622bc5c2,PAYMENT,70>,2018,10,12,21,0,Friday,7 days,40797.614
ACC-721712940,78,150.0,57937.74,,CUS-1646183815,2018-10-19,Andrew,M,-37.82,145.09,,,,,,,debit,posted,003cb9026b5b4635983e4efa07505db4,PHONE BANK,70>,2018,10,19,13,0,Friday,7 days,40797.614
ACC-721712940,78,38.0,57899.74,,CUS-1646183815,2018-10-19,Andrew,M,-37.82,145.09,,,,,,,debit,posted,eae4ddf55ba54147993fe9e8c6210775,PAYMENT,70>,2018,10,19,21,0,Friday,7 days,40797.614
ACC-721712940,78,147.0,57752.74,,CUS-1646183815,2018-10-20,Andrew,M,-37.82,145.09,,,,,,,debit,posted,493257707680411c848b0dacc8e4a9b2,PAYMENT,70>,2018,10,20,5,0,Saturday,7 days,40797.614
ACC-721712940,78,38.0,58497.16,,CUS-1646183815,2018-10-26,Andrew,M,-37.82,145.09,,,,,,,debit,posted,1312712f3bde4c55bb11bee8e0a04949,PAYMENT,70>,2018,10,26,21,0,Friday,7 days,40797.614
ACC-1799207998,20,39.0,137.14,,CUS-164374203,2018-08-01,Susan,F,-33.79,150.68,,,,,,,debit,posted,b5974280c54a4547969f6de6860022d7,INTER BANK,<20,2018,8,1,10,0,Wednesday,7 days,72764.836
ACC-1799207998,20,17.26,119.88,1.0,CUS-164374203,2018-08-01,Susan,F,-33.79,150.68,,4969262f-2161-43c1-a48d-1799844fb859,-33.79,150.83,NSW,Minchinbury,debit,authorized,5af4f4be8c7344ddbb0e36b48b29d024,POS,<20,2018,8,1,14,1,Wednesday,7 days,72764.836
ACC-1799207998,20,35.0,8.06,,CUS-164374203,2018-08-01,Susan,F,-33.79,150.68,,,,,,,debit,posted,1b87da4cd76d4bbc96c64e9935253f66,PAYMENT,<20,2018,8,1,16,0,Wednesday,7 days,72764.836
ACC-1799207998,20,76.82,43.06,0.0,CUS-164374203,2018-08-01,Susan,F,-33.79,150.68,,eb3f245f-1016-416a-bab1-6743f6450d34,-33.77,151.27,NSW,Brookvale,debit,authorized,954d5cc3ef1c4dbe96219af4ae7d7b5a,POS,<20,2018,8,1,16,28,Wednesday,7 days,72764.836
ACC-1799207998,20,13.19,1390.36,1.0,CUS-164374203,2018-08-04,Susan,F,-33.79,150.68,,11a3a04e-5bd3-4437-9c22-9902e7fbcf87,-33.75,151.28,NSW,Dee Why,debit,authorized,5998016ea1584c66b0fc2270b79bcfdd,POS,<20,2018,8,4,16,4,Saturday,7 days,72764.836
ACC-1799207998,20,30.0,1360.36,,CUS-164374203,2018-08-04,Susan,F,-33.79,150.68,,,,,,,debit,posted,5442274bd1e94932868a232989cf922b,PAYMENT,<20,2018,8,4,22,0,Saturday,7 days,72764.836
ACC-1799207998,20,13.93,1346.43,1.0,CUS-164374203,2018-08-05,Susan,F,-33.79,150.68,,d09460d5-db76-47fb-b5dc-a41886a5dbee,-33.8,151.29,NSW,North Harbour,debit,authorized,82fd15cc23524710998444b1acb8aa48,POS,<20,2018,8,5,11,41,Sunday,7 days,72764.836
ACC-1799207998,20,56.0,1290.43,1.0,CUS-164374203,2018-08-05,Susan,F,-33.79,150.68,,a37ae97b-7e52-49c3-b183-9effc60c6203,-33.8,151.18,NSW,Chatswood,debit,authorized,684a16629af94855a6f07e922834b012,POS,<20,2018,8,5,15,10,Sunday,7 days,72764.836
ACC-1799207998,20,60.79,1229.64,0.0,CUS-164374203,2018-08-05,Susan,F,-33.79,150.68,,c1468f3e-98a2-4758-bb44-c537d180b3ce,-33.75,151.22,NSW,Frenchs Forest,debit,authorized,609c178c9eef4b71a17df64632a94a1f,POS,<20,2018,8,5,16,3,Sunday,7 days,72764.836
ACC-1799207998,20,8.72,1220.92,1.0,CUS-164374203,2018-08-05,Susan,F,-33.79,150.68,,5eaf5637-e53b-42d1-b3d2-ee473a60bab3,-33.78,151.05,NSW,Carlingford,debit,authorized,4dac9baffcfa44f88490ff1501c7cb96,SALES-POS,<20,2018,8,5,21,29,Sunday,7 days,72764.836
ACC-1799207998,20,39.0,1181.92,,CUS-164374203,2018-08-08,Susan,F,-33.79,150.68,,,,,,,debit,posted,9c7a4cbae36c4a4abdac8c61ea5c3734,INTER BANK,<20,2018,8,8,10,0,Wednesday,7 days,72764.836
ACC-1799207998,20,35.0,1146.92,,CUS-164374203,2018-08-08,Susan,F,-33.79,150.68,,,,,,,debit,posted,df931a197e0d4cbbae82e95dc550c4f1,PAYMENT,<20,2018,8,8,16,0,Wednesday,7 days,72764.836
ACC-1799207998,20,115.0,2427.41,,CUS-164374203,2018-08-09,Susan,F,-33.79,150.68,,,,,,,debit,posted,4fec3d223aae467c90e77de7e3c816ef,INTER BANK,<20,2018,8,9,19,0,Thursday,7 days,72764.836
ACC-1799207998,20,21.86,2405.55,1.0,CUS-164374203,2018-08-11,Susan,F,-33.79,150.68,,ab57442f-d8c9-4a52-b825-cc5c34180012,-33.75,151.05,NSW,West Pennant Hills,debit,authorized,7677209730fa4130b7de030f6f8d0cf5,SALES-POS,<20,2018,8,11,1,37,Saturday,7 days,72764.836
ACC-1799207998,20,30.0,2375.55,,CUS-164374203,2018-08-11,Susan,F,-33.79,150.68,,,,,,,debit,posted,93520d8bfa1140068983560cc4ec5f86,PAYMENT,<20,2018,8,11,22,0,Saturday,7 days,72764.836
ACC-1799207998,20,69.49,2306.06,0.0,CUS-164374203,2018-08-14,Susan,F,-33.79,150.68,,3baea83f-fd89-4630-bb0f-26360ea65796,-33.84,151.02,NSW,Auburn,debit,authorized,49fdced5439045f8b6b646bf611300e8,POS,<20,2018,8,14,10,2,Tuesday,7 days,72764.836
ACC-1799207998,20,9.8,2296.26,1.0,CUS-164374203,2018-08-14,Susan,F,-33.79,150.68,,e2127bee-c4e8-479e-a98a-431a66653546,-33.82,150.97,NSW,Wentworthville,debit,authorized,266b3e09bcf145b099f4f5bfc8a4ae1e,SALES-POS,<20,2018,8,14,10,52,Tuesday,7 days,72764.836
ACC-1799207998,20,42.53,2253.73,0.0,CUS-164374203,2018-08-15,Susan,F,-33.79,150.68,,8508a948-34d5-4d04-a9aa-416aa46bd0cc,-33.77,151.27,NSW,Brookvale,debit,authorized,4c87f837c5de45499a0efe90d8fae9e1,POS,<20,2018,8,15,9,13,Wednesday,7 days,72764.836
ACC-1799207998,20,39.0,2199.01,,CUS-164374203,2018-08-15,Susan,F,-33.79,150.68,,,,,,,debit,posted,a120f8c9d35a4c63b69de490480564cd,INTER BANK,<20,2018,8,15,10,0,Wednesday,7 days,72764.836
ACC-1799207998,20,15.72,2238.01,1.0,CUS-164374203,2018-08-15,Susan,F,-33.79,150.68,,73903428-2d9a-4549-868a-2049e3e6aea4,-37.81,144.97,VIC,Melbourne,debit,authorized,f9f22dc17139421895f6b70ac39eccca,POS,<20,2018,8,15,10,59,Wednesday,7 days,72764.836
ACC-1799207998,20,20.64,2178.37,1.0,CUS-164374203,2018-08-15,Susan,F,-33.79,150.68,,bc7aa050-b9e0-4ea7-b829-5dfc4a3eae80,-33.81,151.11,NSW,Ryde,debit,authorized,229c0a405c934be3a1181126280a8d7d,SALES-POS,<20,2018,8,15,11,20,Wednesday,7 days,72764.836
ACC-1799207998,20,15.86,2162.51,1.0,CUS-164374203,2018-08-15,Susan,F,-33.79,150.68,,73e5a846-dc10-409c-bb35-6e414b770ab5,-33.84,151.21,NSW,North Sydney,debit,authorized,7a67a4f82af0482a9817dec717045219,SALES-POS,<20,2018,8,15,12,7,Wednesday,7 days,72764.836
ACC-1799207998,20,35.0,2127.51,,CUS-164374203,2018-08-15,Susan,F,-33.79,150.68,,,,,,,debit,posted,8d9dd79577ac40f7892181bb848c953b,PAYMENT,<20,2018,8,15,16,0,Wednesday,7 days,72764.836
ACC-1799207998,20,10.5,3512.5,0.0,CUS-164374203,2018-08-15,Susan,F,-33.79,150.68,,7c7472f6-c302-4cf0-85d6-4acbf48ddb06,-33.85,151.2,NSW,Mcmahons Point,debit,authorized,0d3dafcd540a4d1aac63428f7f75c4b2,SALES-POS,<20,2018,8,15,20,2,Wednesday,7 days,72764.836
ACC-1799207998,20,10.81,3429.33,0.0,CUS-164374203,2018-08-17,Susan,F,-33.79,150.68,,0d338c2f-cf2d-4f14-ae19-e9f79c5f90aa,-33.8,151.28,NSW,Manly,debit,authorized,d8657302ecdb4545a70fad0f1ac56a27,POS,<20,2018,8,17,9,36,Friday,7 days,72764.836
ACC-1799207998,20,31.76,3397.57,0.0,CUS-164374203,2018-08-17,Susan,F,-33.79,150.68,,d7effe6e-ecfb-464b-aab6-6bb1390ffe97,-33.8,151.18,NSW,Chatswood,debit,authorized,e66aef210fa34f82a0a889b1d2c79b07,SALES-POS,<20,2018,8,17,11,2,Friday,7 days,72764.836
ACC-1799207998,20,91.0,3306.57,,CUS-164374203,2018-08-17,Susan,F,-33.79,150.68,,,,,,,debit,posted,c5a357b9cf18486b97920d273c42b6dd,INTER BANK,<20,2018,8,17,15,0,Friday,7 days,72764.836
ACC-1799207998,20,30.0,3276.57,,CUS-164374203,2018-08-18,Susan,F,-33.79,150.68,,,,,,,debit,posted,e2afc5a0c3034f938696f869fa2b6d52,PAYMENT,<20,2018,8,18,22,0,Saturday,7 days,72764.836
ACC-1799207998,20,39.0,3237.57,,CUS-164374203,2018-08-22,Susan,F,-33.79,150.68,,,,,,,debit,posted,8b7b9929ebf24840a46094c6fc98d207,INTER BANK,<20,2018,8,22,10,0,Wednesday,7 days,72764.836
ACC-1799207998,20,21.88,3215.69,1.0,CUS-164374203,2018-08-22,Susan,F,-33.79,150.68,,ee2b7bc9-a409-42a7-a36f-dcfd2177e959,-33.77,151.25,NSW,Allambie Heights,debit,authorized,706d925fe6e94aba84c6766fd3659108,SALES-POS,<20,2018,8,22,12,28,Wednesday,7 days,72764.836
ACC-1799207998,20,17.59,3198.1,1.0,CUS-164374203,2018-08-22,Susan,F,-33.79,150.68,,a25213a7-e817-44c8-8077-7e84b332e8a3,-23.13,150.74,QLD,Yeppoon,debit,authorized,c316cf3f46b64a859ddabb228ec44a67,POS,<20,2018,8,22,14,11,Wednesday,7 days,72764.836
ACC-1799207998,20,35.0,3163.1,,CUS-164374203,2018-08-22,Susan,F,-33.79,150.68,,,,,,,debit,posted,7b1dd43d1b9244b7a3abfc4ccd223698,PAYMENT,<20,2018,8,22,16,0,Wednesday,7 days,72764.836
ACC-1799207998,20,35.88,4522.71,0.0,CUS-164374203,2018-08-23,Susan,F,-33.79,150.68,,91be224a-0425-4bea-9196-58d07827a773,-33.77,151.27,NSW,Brookvale,debit,authorized,3bc0e5b3771b4bc8bc7692fa7ad49222,POS,<20,2018,8,23,19,24,Thursday,7 days,72764.836
ACC-1799207998,20,28.89,4493.82,0.0,CUS-164374203,2018-08-23,Susan,F,-33.79,150.68,,99af087f-b26e-47ff-a3aa-f89777d36bd4,-33.83,151.23,NSW,Cremorne,debit,authorized,9af77145eed54d3a95950f830b0255b4,POS,<20,2018,8,23,19,34,Thursday,7 days,72764.836
ACC-1799207998,20,21.94,4471.88,1.0,CUS-164374203,2018-08-23,Susan,F,-33.79,150.68,,39a1e428-8dc0-4cbc-8512-86162c660c51,-35.04,150.67,NSW,Huskisson,debit,authorized,67db6d98576b409cb423834e84c3673c,SALES-POS,<20,2018,8,23,21,29,Thursday,7 days,72764.836
ACC-1799207998,20,117.84,4354.04,1.0,CUS-164374203,2018-08-24,Susan,F,-33.79,150.68,,3075b265-3b29-4d54-a38e-c379113f73bf,-33.79,115.97,WA,Balingup,debit,authorized,638f52100fb040f486743c1ca8e4acbe,SALES-POS,<20,2018,8,24,9,29,Friday,7 days,72764.836
ACC-1799207998,20,7.44,4346.6,1.0,CUS-164374203,2018-08-24,Susan,F,-33.79,150.68,,db0b4ef2-1565-46e0-a207-4b2c277d09ff,-33.84,151.21,NSW,Milsons Point,debit,authorized,87edcb6c6b53474cbcd9250e1e2625ce,SALES-POS,<20,2018,8,24,11,33,Friday,7 days,72764.836
ACC-1799207998,20,5.31,4341.29,1.0,CUS-164374203,2018-08-24,Susan,F,-33.79,150.68,,75af9468-b3e2-4959-b35b-9ea9845d92c6,-33.82,151.19,NSW,St Leonards,debit,authorized,b90791cb241742668ed4952490e375b7,SALES-POS,<20,2018,8,24,12,46,Friday,7 days,72764.836
ACC-1799207998,20,197.0,4144.29,,CUS-164374203,2018-08-25,Susan,F,-33.79,150.68,,,,,,,debit,posted,fbb3bc762cea40809cffacd5cbc6256d,PAYMENT,<20,2018,8,25,15,0,Saturday,7 days,72764.836
ACC-1799207998,20,18.89,4125.4,0.0,CUS-164374203,2018-08-25,Susan,F,-33.79,150.68,,7a2ee63d-876e-4b9f-aee3-07e3215ebdd6,-35.04,150.67,NSW,Huskisson,debit,authorized,b02333688b6940029013b1a9390f1e1f,SALES-POS,<20,2018,8,25,20,38,Saturday,7 days,72764.836
ACC-1799207998,20,21.38,4104.02,1.0,CUS-164374203,2018-08-25,Susan,F,-33.79,150.68,,36a1a359-3c31-4938-93ed-ec0a85c79654,-31.94,115.82,WA,Subiaco,debit,authorized,2b5b7198c042442990676184778bb1f2,POS,<20,2018,8,25,21,39,Saturday,7 days,72764.836
ACC-1799207998,20,30.0,4074.02,,CUS-164374203,2018-08-25,Susan,F,-33.79,150.68,,,,,,,debit,posted,9fad9f104bc94b3185803fb1e1b819fc,PAYMENT,<20,2018,8,25,22,0,Saturday,7 days,72764.836
ACC-1799207998,20,26.97,4047.05,1.0,CUS-164374203,2018-08-27,Susan,F,-33.79,150.68,,87671a02-681f-463e-a72c-6d269de9ea1b,-33.79,151,NSW,Northmead,debit,authorized,9ff6e88b2c50405793c4c09450fee190,SALES-POS,<20,2018,8,27,14,55,Monday,7 days,72764.836
ACC-1799207998,20,33.4,4013.65,1.0,CUS-164374203,2018-08-27,Susan,F,-33.79,150.68,,a56f0166-ac0a-4d85-9a55-2aa088b9e8f8,-33.81,151.09,NSW,West Ryde,debit,authorized,bc6f2ca13ac2406fa1813c0157ddabe3,POS,<20,2018,8,27,15,57,Monday,7 days,72764.836
ACC-1799207998,20,21.67,3991.98,1.0,CUS-164374203,2018-08-28,Susan,F,-33.79,150.68,,472848b8-fd24-4349-9557-aa41055136bf,-33.79,151.08,NSW,Eastwood,debit,authorized,0659e4dac4f445fbb5344f4a6999d382,POS,<20,2018,8,28,18,32,Tuesday,7 days,72764.836
ACC-1799207998,20,6.7,3985.28,1.0,CUS-164374203,2018-08-28,Susan,F,-33.79,150.68,,15539947-66a5-4409-be59-f8d3a0aeeb71,-33.76,151.22,NSW,Forestville,debit,authorized,56e303255704449ca23fefc503fc5242,SALES-POS,<20,2018,8,28,20,51,Tuesday,7 days,72764.836
ACC-1799207998,20,10.96,3974.32,1.0,CUS-164374203,2018-08-29,Susan,F,-33.79,150.68,,e6b73afb-c2d4-498d-83d7-f7dc648ef2ac,-33.83,151.02,NSW,Rosehill,debit,authorized,2c4cbf2adbee461f9179d88faad49c4d,POS,<20,2018,8,29,9,52,Wednesday,7 days,72764.836
ACC-1799207998,20,39.0,3922.93,,CUS-164374203,2018-08-29,Susan,F,-33.79,150.68,,,,,,,debit,posted,b53362565aa14a408bc7d57eb836b622,INTER BANK,<20,2018,8,29,10,0,Wednesday,7 days,72764.836
ACC-1799207998,20,12.39,3961.93,1.0,CUS-164374203,2018-08-29,Susan,F,-33.79,150.68,,36849d50-8b9e-4074-b907-e4ab21901ee2,-33.84,151,NSW,Merrylands,debit,authorized,568c3d9089744d628150bcd43117b6ec,POS,<20,2018,8,29,10,19,Wednesday,7 days,72764.836
ACC-1799207998,20,35.0,3887.93,,CUS-164374203,2018-08-29,Susan,F,-33.79,150.68,,,,,,,debit,posted,bdb9a3372a624eaa80cc5715e49d67a2,PAYMENT,<20,2018,8,29,16,0,Wednesday,7 days,72764.836
ACC-1799207998,20,30.0,5253.42,,CUS-164374203,2018-09-01,Susan,F,-33.79,150.68,,,,,,,debit,posted,9305fde1a6c94788851087a28c511427,PAYMENT,<20,2018,9,1,22,0,Saturday,7 days,72764.836
ACC-1799207998,20,8.68,5244.74,0.0,CUS-164374203,2018-09-03,Susan,F,-33.79,150.68,,1458e47b-d2e2-4ea3-8e2d-2d3b995b2138,-34.54,150.79,NSW,Haywards Bay,debit,authorized,5596b8fc95b044ceb5b8baf9bb3dab8a,POS,<20,2018,9,3,15,46,Monday,7 days,72764.836
ACC-1799207998,20,39.0,5205.74,,CUS-164374203,2018-09-05,Susan,F,-33.79,150.68,,,,,,,debit,posted,5f0167484b7449238f2d56d1671d08e5,INTER BANK,<20,2018,9,5,10,0,Wednesday,7 days,72764.836
ACC-1799207998,20,35.0,5170.74,,CUS-164374203,2018-09-05,Susan,F,-33.79,150.68,,,,,,,debit,posted,75ae8eb0242c4370b9e059cf951e58ce,PAYMENT,<20,2018,9,5,16,0,Wednesday,7 days,72764.836
ACC-1799207998,20,412.71,6153.52,1.0,CUS-164374203,2018-09-08,Susan,F,-33.79,150.68,,7dee69cf-5736-4247-bccb-f9a0892ae760,-37.72,144.85,VIC,Keilor Park,debit,authorized,e97be5010aa747938b98ea726a616d98,SALES-POS,<20,2018,9,8,18,33,Saturday,7 days,72764.836
ACC-1799207998,20,8.82,6144.7,1.0,CUS-164374203,2018-09-08,Susan,F,-33.79,150.68,,cd4bfbe4-85a3-4c43-b1b8-693aaa486699,-33.84,151.21,NSW,North Sydney,debit,authorized,43cdde66c5d040a8a5df2a9080fba3c9,POS,<20,2018,9,8,21,0,Saturday,7 days,72764.836
ACC-1799207998,20,30.0,6114.7,,CUS-164374203,2018-09-08,Susan,F,-33.79,150.68,,,,,,,debit,posted,63f35fb81d9044c987e94330906443af,PAYMENT,<20,2018,9,8,22,0,Saturday,7 days,72764.836
ACC-1799207998,20,75.83,6038.87,0.0,CUS-164374203,2018-09-09,Susan,F,-33.79,150.68,,3b392f97-d1f6-4c98-8557-ce3126daf0bc,-33.73,151.1,NSW,Wahroonga,debit,authorized,6d9c14f013f24c308820370cbd4028e8,SALES-POS,<20,2018,9,9,9,46,Sunday,7 days,72764.836
ACC-1799207998,20,115.0,5923.87,,CUS-164374203,2018-09-09,Susan,F,-33.79,150.68,,,,,,,debit,posted,264b4df42952408b95634d8ff0ae1f43,INTER BANK,<20,2018,9,9,19,0,Sunday,7 days,72764.836
ACC-1799207998,20,24.94,5898.93,1.0,CUS-164374203,2018-09-11,Susan,F,-33.79,150.68,,4d8ec525-a8fc-4cf7-b133-6d36f67c5c74,-33.75,151.3,NSW,Dee Why,debit,authorized,3e0994f0b5de468398e273eb5c51e7d8,SALES-POS,<20,2018,9,11,9,20,Tuesday,7 days,72764.836
ACC-1799207998,20,35.52,5863.41,1.0,CUS-164374203,2018-09-12,Susan,F,-33.79,150.68,,d816309c-7cd6-4975-8ef4-e8b3d7ea33e8,-33.79,151.08,NSW,Eastwood,debit,authorized,a993b5d8c97e4adfab6375ae9ff7a32d,SALES-POS,<20,2018,9,12,6,51,Wednesday,7 days,72764.836
ACC-1799207998,20,39.0,5817.82,,CUS-164374203,2018-09-12,Susan,F,-33.79,150.68,,,,,,,debit,posted,40fe78b9a0334e8187c3002ade0e377e,INTER BANK,<20,2018,9,12,10,0,Wednesday,7 days,72764.836
ACC-1799207998,20,6.59,5856.82,1.0,CUS-164374203,2018-09-12,Susan,F,-33.79,150.68,,e6535425-8471-4feb-a5b2-acdc73880ba2,-33.83,151.24,NSW,Mosman,debit,authorized,6c8e05eca4824663b52f1e8e214a79fa,POS,<20,2018,9,12,10,46,Wednesday,7 days,72764.836
ACC-1799207998,20,43.63,5774.19,1.0,CUS-164374203,2018-09-12,Susan,F,-33.79,150.68,,b1e22450-945f-456f-84fa-d6582620873f,-33.75,151.3,NSW,Dee Why,debit,authorized,cf6008084b2b4e2c8fa4339b9f13160b,SALES-POS,<20,2018,9,12,11,8,Wednesday,7 days,72764.836
ACC-1799207998,20,35.0,5739.19,,CUS-164374203,2018-09-12,Susan,F,-33.79,150.68,,,,,,,debit,posted,efc129e78e52490590a70e8d727a6c06,PAYMENT,<20,2018,9,12,16,0,Wednesday,7 days,72764.836
ACC-1799207998,20,22.9,7111.78,1.0,CUS-164374203,2018-09-12,Susan,F,-33.79,150.68,,5099c8c6-7f04-4b26-aaa2-0c9f5be234a6,-33.76,150.99,NSW,Baulkham Hills,debit,authorized,e52a7ec20e08456fb98849b2ea502e61,POS,<20,2018,9,12,20,7,Wednesday,7 days,72764.836
ACC-1799207998,20,23.73,7088.05,1.0,CUS-164374203,2018-09-13,Susan,F,-33.79,150.68,,29f50e49-952e-41f4-8df5-f83d711d90c2,-33.81,151.17,NSW,Lane Cove,debit,authorized,db26db8739ef4d0583f53809cf4588d7,POS,<20,2018,9,13,9,22,Thursday,7 days,72764.836
ACC-1799207998,20,8.68,7079.37,1.0,CUS-164374203,2018-09-13,Susan,F,-33.79,150.68,,7122207c-1b4f-4613-9aa0-9eba945a86d1,-33.75,151.27,NSW,Narraweena,debit,authorized,06f751b4abfd43558aca4d8c302c5312,POS,<20,2018,9,13,17,29,Thursday,7 days,72764.836
ACC-1799207998,20,30.0,7049.37,,CUS-164374203,2018-09-15,Susan,F,-33.79,150.68,,,,,,,debit,posted,85a4c846ab8641ad813bb728db72d1f2,PAYMENT,<20,2018,9,15,22,0,Saturday,7 days,72764.836
ACC-1799207998,20,91.0,6958.37,,CUS-164374203,2018-09-17,Susan,F,-33.79,150.68,,,,,,,debit,posted,778a0d42e87548ac97d66e24933b0af2,INTER BANK,<20,2018,9,17,15,0,Monday,7 days,72764.836
ACC-1799207998,20,39.0,6919.37,,CUS-164374203,2018-09-19,Susan,F,-33.79,150.68,,,,,,,debit,posted,5782388e9b844eb18cd2d94b1c0fe85f,INTER BANK,<20,2018,9,19,10,0,Wednesday,7 days,72764.836
ACC-1799207998,20,35.0,6884.37,,CUS-164374203,2018-09-19,Susan,F,-33.79,150.68,,,,,,,debit,posted,2af22cc02f884b0d8aaa52dba6c3dc2d,PAYMENT,<20,2018,9,19,16,0,Wednesday,7 days,72764.836
ACC-1799207998,20,30.0,8228.36,,CUS-164374203,2018-09-22,Susan,F,-33.79,150.68,,,,,,,debit,posted,995349770684468a81c4d87add4c09fc,PAYMENT,<20,2018,9,22,22,0,Saturday,7 days,72764.836
ACC-1799207998,20,21.5,8258.36,0.0,CUS-164374203,2018-09-22,Susan,F,-33.79,150.68,,98ae32d6-bc9f-4ce4-9aef-96adb4ecaaf5,-33.79,151.26,NSW,Balgowlah,debit,authorized,85768fe1ead645aaa00d6e8f91bc61af,POS,<20,2018,9,22,22,25,Saturday,7 days,72764.836
ACC-1799207998,20,197.0,8031.36,,CUS-164374203,2018-09-25,Susan,F,-33.79,150.68,,,,,,,debit,posted,847d193e080646738b5a629d9f6b7942,PAYMENT,<20,2018,9,25,15,0,Tuesday,7 days,72764.836
ACC-1799207998,20,39.0,7992.36,,CUS-164374203,2018-09-26,Susan,F,-33.79,150.68,,,,,,,debit,posted,d208bc233a474c3882c673112d30e5b3,INTER BANK,<20,2018,9,26,10,0,Wednesday,7 days,72764.836
ACC-1799207998,20,35.0,7957.36,,CUS-164374203,2018-09-26,Susan,F,-33.79,150.68,,,,,,,debit,posted,41624c278b4245b08e1345eac95a5f22,PAYMENT,<20,2018,9,26,16,0,Wednesday,7 days,72764.836
ACC-1799207998,20,19.33,9333.52,1.0,CUS-164374203,2018-09-26,Susan,F,-33.79,150.68,,28de8098-98f1-4ce8-a057-8e72a18180c2,-33.75,151.06,NSW,Beecroft,debit,authorized,c55ce4f8429d43b7a7564ed4ffde58d9,SALES-POS,<20,2018,9,26,20,59,Wednesday,7 days,72764.836
ACC-1799207998,20,37.44,9296.08,1.0,CUS-164374203,2018-09-28,Susan,F,-33.79,150.68,,c4ecb332-d489-4aff-b7bc-4d6f22d5855d,-33.84,121.9,WA,Esperance,debit,authorized,95866754044c47c7b8071430bb830446,SALES-POS,<20,2018,9,28,23,1,Friday,7 days,72764.836
ACC-1799207998,20,27.2,9268.88,1.0,CUS-164374203,2018-09-28,Susan,F,-33.79,150.68,,781c61a8-18ae-41d4-a972-7127bd401c75,-33.82,151.21,NSW,Cammeray,debit,authorized,40bd18a2d3dc4244b4b225669762f4a2,POS,<20,2018,9,28,23,53,Friday,7 days,72764.836
ACC-1799207998,20,30.0,9238.88,,CUS-164374203,2018-09-29,Susan,F,-33.79,150.68,,,,,,,debit,posted,e999f246f326459a945168777c33c9cd,PAYMENT,<20,2018,9,29,22,0,Saturday,7 days,72764.836
ACC-1799207998,20,25.89,9212.99,1.0,CUS-164374203,2018-09-30,Susan,F,-33.79,150.68,,5ded19c6-08ec-43e5-8300-8ba839bb8a4d,-33.76,151.28,NSW,Brookvale,debit,authorized,7331eb72c22a409fb9c14548aa1e561a,SALES-POS,<20,2018,9,30,9,16,Sunday,7 days,72764.836
ACC-1799207998,20,13.85,9199.14,1.0,CUS-164374203,2018-09-30,Susan,F,-33.79,150.68,,c2b1df29-b44f-4006-94bc-666fc7b23ce0,-33.8,151.18,NSW,Chatswood,debit,authorized,d15df975af854d2f8ebd750adb70731a,SALES-POS,<20,2018,9,30,9,56,Sunday,7 days,72764.836
ACC-1799207998,20,1092.63,8106.51,1.0,CUS-164374203,2018-09-30,Susan,F,-33.79,150.68,,c15c27bc-2eb5-46d0-9fb8-4e2785067cc1,-33.77,151.08,NSW,Epping,debit,authorized,a9f7da9022464e7b8919900bcfad473e,SALES-POS,<20,2018,9,30,11,2,Sunday,7 days,72764.836
ACC-1799207998,20,6.84,8099.67,1.0,CUS-164374203,2018-09-30,Susan,F,-33.79,150.68,,0951ccff-0c90-4ba8-968e-17b1e6fd97f3,-33.83,151.23,NSW,Cremorne,debit,authorized,4125bbc3d0cd4ad9a0cf678b1814d30c,SALES-POS,<20,2018,9,30,12,49,Sunday,7 days,72764.836
ACC-1799207998,20,17.4,8082.27,0.0,CUS-164374203,2018-09-30,Susan,F,-33.79,150.68,,743caa53-10ab-42e0-a96b-8b456efd5229,-33.76,151.21,NSW,Forestville,debit,authorized,97f1085e1b9242288e8b8d215b988eee,SALES-POS,<20,2018,9,30,13,28,Sunday,7 days,72764.836
ACC-1799207998,20,11.31,8070.96,0.0,CUS-164374203,2018-09-30,Susan,F,-33.79,150.68,,2acbedcc-e806-43ce-8ccc-d0590e66c366,-33.84,151.05,NSW,Silverwater,debit,authorized,5c7b2a5523764c7690577a445bbdaa37,SALES-POS,<20,2018,9,30,14,39,Sunday,7 days,72764.836
ACC-1799207998,20,10.61,8060.35,0.0,CUS-164374203,2018-09-30,Susan,F,-33.79,150.68,,a42b8f3a-7157-4c6a-9de9-8eb1fb99872e,-33.85,151.05,NSW,Lidcombe,debit,authorized,dd092ce61dba4618bf2d2de8b0995380,SALES-POS,<20,2018,9,30,18,22,Sunday,7 days,72764.836
ACC-1799207998,20,13.28,8047.07,1.0,CUS-164374203,2018-10-01,Susan,F,-33.79,150.68,,12e295c3-8dac-4db5-9591-9706be85ba90,-33.83,151.14,NSW,Hunters Hill,debit,authorized,8d18b45fa1004a228046ff10ab3916d0,SALES-POS,<20,2018,10,1,9,32,Monday,7 days,72764.836
ACC-1799207998,20,82.71,7964.36,0.0,CUS-164374203,2018-10-02,Susan,F,-33.79,150.68,,0d61f57a-fcad-49bd-8d0a-eb3ec99f1867,-27.4,153.06,QLD,Nundah,debit,authorized,d0f8db1eb9b24eb0bf0d82991fb1aca6,SALES-POS,<20,2018,10,2,1,9,Tuesday,7 days,72764.836
ACC-1799207998,20,39.0,7925.36,,CUS-164374203,2018-10-03,Susan,F,-33.79,150.68,,,,,,,debit,posted,2471464c78024351b5a24e30de70ea8e,INTER BANK,<20,2018,10,3,10,0,Wednesday,7 days,72764.836
ACC-1799207998,20,1182.0,6743.36,,CUS-164374203,2018-10-03,Susan,F,-33.79,150.68,,,,,,,debit,posted,eb7f8f9520144adf8fd581ea3c4b2365,PAYMENT,<20,2018,10,3,12,0,Wednesday,7 days,72764.836
ACC-1799207998,20,45.27,6698.09,1.0,CUS-164374203,2018-10-03,Susan,F,-33.79,150.68,,66fe63d2-2e6a-416b-b094-8b7971299ec1,-33.78,151.12,NSW,Macquarie Park,debit,authorized,ab5df9f8176c45af8a458622ab4e15c5,POS,<20,2018,10,3,14,59,Wednesday,7 days,72764.836
ACC-1799207998,20,35.0,6663.09,,CUS-164374203,2018-10-03,Susan,F,-33.79,150.68,,,,,,,debit,posted,958e6101594d4576b969277a83974053,PAYMENT,<20,2018,10,3,16,0,Wednesday,7 days,72764.836
ACC-1799207998,20,11.14,8047.44,1.0,CUS-164374203,2018-10-05,Susan,F,-33.79,150.68,,e5a46fd4-2048-4bc9-ab60-1e7d9ce7d1c8,-33.77,151.27,NSW,Brookvale,debit,authorized,baf09a54e692416ab1b8ccb08cd5ad8a,POS,<20,2018,10,5,1,27,Friday,7 days,72764.836
ACC-1799207998,20,32.45,8014.99,1.0,CUS-164374203,2018-10-05,Susan,F,-33.79,150.68,,8a73c467-e58f-4df5-812e-2e5e6fc41e23,-33.79,151,NSW,Northmead,debit,authorized,34cf17849686410fa3be45c02f32fe2d,POS,<20,2018,10,5,2,42,Friday,7 days,72764.836
ACC-1799207998,20,7.47,8007.52,1.0,CUS-164374203,2018-10-05,Susan,F,-33.79,150.68,,afdc685e-65da-4263-b8f0-4dac0f5a8a15,-33.81,151.2,NSW,Willoughby,debit,authorized,ff6b3cec5c734286a0eb70f4f1e5b38f,POS,<20,2018,10,5,8,16,Friday,7 days,72764.836
ACC-1799207998,20,24.74,7982.78,1.0,CUS-164374203,2018-10-05,Susan,F,-33.79,150.68,,41f7c525-4a60-4ca6-a07d-7530c8d5f43f,-33.84,148.7,NSW,Cowra,debit,authorized,dab1aacdd190428e804dabe43b6da102,POS,<20,2018,10,5,9,8,Friday,7 days,72764.836
ACC-1799207998,20,30.0,7952.78,,CUS-164374203,2018-10-06,Susan,F,-33.79,150.68,,,,,,,debit,posted,243cb4bbc6864e72baff8aa161299431,PAYMENT,<20,2018,10,6,22,0,Saturday,7 days,72764.836
ACC-1799207998,20,115.0,7837.78,,CUS-164374203,2018-10-09,Susan,F,-33.79,150.68,,,,,,,debit,posted,4191f19a32aa40d382c8ca912b20f594,INTER BANK,<20,2018,10,9,19,0,Tuesday,7 days,72764.836
ACC-1799207998,20,39.0,7798.78,,CUS-164374203,2018-10-10,Susan,F,-33.79,150.68,,,,,,,debit,posted,90e603d007d4434da331d4a3d234863f,INTER BANK,<20,2018,10,10,10,0,Wednesday,7 days,72764.836
ACC-1799207998,20,35.0,7763.78,,CUS-164374203,2018-10-10,Susan,F,-33.79,150.68,,,,,,,debit,posted,84db4e93b3194bbebfdd55b1e156dfcd,PAYMENT,<20,2018,10,10,16,0,Wednesday,7 days,72764.836
ACC-1799207998,20,11.09,9148.18,1.0,CUS-164374203,2018-10-11,Susan,F,-33.79,150.68,,5024d6e4-302c-40df-aa6b-8906910ba0db,-33.8,151.29,NSW,Manly,debit,authorized,e896a0f555b84ab1910ad64e481f76c5,SALES-POS,<20,2018,10,11,15,2,Thursday,7 days,72764.836
ACC-1799207998,20,25.91,9122.27,0.0,CUS-164374203,2018-10-12,Susan,F,-33.79,150.68,,a89d30ae-50f2-4ea9-b0a0-90ebd5bdc2bb,-33.81,150.8,NSW,Erskine Park,debit,authorized,41d043c1b53049daa3360bf600e4ccc0,SALES-POS,<20,2018,10,12,12,3,Friday,7 days,72764.836
ACC-1799207998,20,18.2,9104.07,1.0,CUS-164374203,2018-10-13,Susan,F,-33.79,150.68,,d61e3bf3-f827-4835-8329-3764a722bf51,-33.84,151.21,NSW,North Sydney,debit,authorized,31671f7e17064719a42b1e6e290b499b,POS,<20,2018,10,13,7,29,Saturday,7 days,72764.836
ACC-1799207998,20,8.56,9095.51,1.0,CUS-164374203,2018-10-13,Susan,F,-33.79,150.68,,ece08a7e-6a89-44ae-9241-abffc730d154,-33.84,151.21,NSW,North Sydney,debit,authorized,be63980e6ee447318180ffad10cf9569,POS,<20,2018,10,13,15,40,Saturday,7 days,72764.836
ACC-1799207998,20,15.1,9080.41,1.0,CUS-164374203,2018-10-13,Susan,F,-33.79,150.68,,f59a5ea2-676b-4dfb-b3c3-6067527949cb,-33.84,151.21,NSW,North Sydney,debit,authorized,68099e712bcd474db2bb19207269951b,POS,<20,2018,10,13,20,14,Saturday,7 days,72764.836
ACC-1799207998,20,11.62,9068.79,1.0,CUS-164374203,2018-10-13,Susan,F,-33.79,150.68,,340abbb7-b018-44ee-b9df-b85b6fc355c5,-33.78,150.93,NSW,Seven Hills,debit,authorized,e60712237de8474095185ff8ddd30059,SALES-POS,<20,2018,10,13,20,21,Saturday,7 days,72764.836
ACC-1799207998,20,30.0,9038.79,,CUS-164374203,2018-10-13,Susan,F,-33.79,150.68,,,,,,,debit,posted,55b858d9176041bfb019bf5b203959c3,PAYMENT,<20,2018,10,13,22,0,Saturday,7 days,72764.836
ACC-1799207998,20,49.45,8989.34,0.0,CUS-164374203,2018-10-14,Susan,F,-33.79,150.68,,25392b6e-96a5-4167-831e-000cf9de0332,-33.82,151.15,NSW,Lane Cove,debit,authorized,6426ca33ee874ea2b92ccc1837750e3b,POS,<20,2018,10,14,7,25,Sunday,7 days,72764.836
ACC-1799207998,20,19.74,8969.6,0.0,CUS-164374203,2018-10-14,Susan,F,-33.79,150.68,,0fae656a-be64-4a18-8878-943e0ad35db0,-33.94,151.02,NSW,Revesby,debit,authorized,c5091e5ed96a4836856a26e90d2468c9,POS,<20,2018,10,14,16,32,Sunday,7 days,72764.836
ACC-1799207998,20,13.31,8956.29,1.0,CUS-164374203,2018-10-14,Susan,F,-33.79,150.68,,b116f703-dc3b-4c66-ac97-040222ad0666,-33.89,151.21,NSW,Surry Hills,debit,authorized,d8a41e1ba9aa459ea03e1c1f76f09a6e,SALES-POS,<20,2018,10,14,19,31,Sunday,7 days,72764.836
ACC-1799207998,20,24.77,8931.52,1.0,CUS-164374203,2018-10-14,Susan,F,-33.79,150.68,,59ba0b94-0a95-4a8c-b11c-7ee934e3ea4d,-31.95,115.84,WA,West Perth,debit,authorized,a38962f6f7084a8c8ac9e151891aa504,POS,<20,2018,10,14,23,22,Sunday,7 days,72764.836
ACC-1799207998,20,5.08,8926.44,1.0,CUS-164374203,2018-10-15,Susan,F,-33.79,150.68,,0bdc2a37-c0d8-44ef-92ce-6a90465e6789,-33.89,151.26,NSW,Bondi Junction,debit,authorized,7375a47c682f40dcbbbddb8995c5b4f9,POS,<20,2018,10,15,13,3,Monday,7 days,72764.836
ACC-1799207998,20,5.57,8920.87,1.0,CUS-164374203,2018-10-15,Susan,F,-33.79,150.68,,bd19a059-abcb-4c59-83f4-ca0a07c93d4d,-33.93,151.19,NSW,Mascot,debit,authorized,7cc6dbf216f34ff89bf81d6ba9229df0,SALES-POS,<20,2018,10,15,15,45,Monday,7 days,72764.836
ACC-1799207998,20,14.1,8906.77,1.0,CUS-164374203,2018-10-16,Susan,F,-33.79,150.68,,9c594401-c9b9-4ebc-be90-cd757aeecbf2,-33.73,151.16,NSW,Saint Ives,debit,authorized,cd3361b31d884844a251fb4f0105ed7b,SALES-POS,<20,2018,10,16,8,15,Tuesday,7 days,72764.836
ACC-1799207998,20,13.61,8893.16,1.0,CUS-164374203,2018-10-16,Susan,F,-33.79,150.68,,12879166-5cea-42d7-8cf6-9ab3f22e8e6f,-33.8,151.18,NSW,Chatswood,debit,authorized,dd21255189e44a10bf7a35707902a97e,SALES-POS,<20,2018,10,16,9,10,Tuesday,7 days,72764.836
ACC-1799207998,20,282.61,8610.55,1.0,CUS-164374203,2018-10-17,Susan,F,-33.79,150.68,,ea4fd943-650a-49f8-befb-81e5770baade,-33.81,151.16,NSW,Lane Cove,debit,authorized,2f19289c853c4d6e9b18e8f8a8a371ce,POS,<20,2018,10,17,2,32,Wednesday,7 days,72764.836
ACC-1799207998,20,22.74,8587.81,1.0,CUS-164374203,2018-10-17,Susan,F,-33.79,150.68,,6c2c896b-e02e-4d5e-86d6-af6651fb8b02,-33.78,151.12,NSW,Macquarie Park,debit,authorized,776ea758e6b44e79b207219f8a3c6f29,POS,<20,2018,10,17,9,41,Wednesday,7 days,72764.836
ACC-1799207998,20,39.0,8548.81,,CUS-164374203,2018-10-17,Susan,F,-33.79,150.68,,,,,,,debit,posted,0f8ef605261843b2ac451aa7aff8d1ab,INTER BANK,<20,2018,10,17,10,0,Wednesday,7 days,72764.836
ACC-1799207998,20,34.47,8514.34,1.0,CUS-164374203,2018-10-17,Susan,F,-33.79,150.68,,9fa009d7-f6dc-4fa1-acf5-b531a01ebad7,-33.8,115.1,WA,Metricup,debit,authorized,08fd0e53b4bc4fcf9437cbe2166b3a1a,POS,<20,2018,10,17,11,46,Wednesday,7 days,72764.836
ACC-1799207998,20,13.64,8500.7,0.0,CUS-164374203,2018-10-17,Susan,F,-33.79,150.68,,417a6024-581d-407c-b221-05735c043097,-33.74,151.3,NSW,Collaroy,debit,authorized,ed66c85a4227489da42f1b1208fab218,POS,<20,2018,10,17,12,41,Wednesday,7 days,72764.836
ACC-1799207998,20,91.0,8409.7,,CUS-164374203,2018-10-17,Susan,F,-33.79,150.68,,,,,,,debit,posted,3b42ad6bbae245beb474dca721965401,INTER BANK,<20,2018,10,17,15,0,Wednesday,7 days,72764.836
ACC-1799207998,20,35.0,8374.7,,CUS-164374203,2018-10-17,Susan,F,-33.79,150.68,,,,,,,debit,posted,0152e2035a7f4b7a939b52a19a069e70,PAYMENT,<20,2018,10,17,16,0,Wednesday,7 days,72764.836
ACC-1799207998,20,39.14,9731.05,1.0,CUS-164374203,2018-10-18,Susan,F,-33.79,150.68,,99877a47-3f2f-46ca-aae7-4daee491fbd1,-33.92,151.23,NSW,Kingsford,debit,authorized,3df0ca44f3fd4b5bb582938cb107e7d1,POS,<20,2018,10,18,1,12,Thursday,7 days,72764.836
ACC-1799207998,20,30.0,9701.05,,CUS-164374203,2018-10-20,Susan,F,-33.79,150.68,,,,,,,debit,posted,f83a0aced358476fbe666256ed1b3a74,PAYMENT,<20,2018,10,20,22,0,Saturday,7 days,72764.836
ACC-1799207998,20,74.31,9626.74,0.0,CUS-164374203,2018-10-22,Susan,F,-33.79,150.68,,f0ae3f23-1564-4a89-bb6e-c020b7a3e5a7,-33.82,151,NSW,Parramatta,debit,authorized,61a3e5813f7144fdb00f7c838ecf927b,POS,<20,2018,10,22,16,10,Monday,7 days,72764.836
ACC-1799207998,20,34.12,9592.62,0.0,CUS-164374203,2018-10-22,Susan,F,-33.79,150.68,,6616b896-520e-465a-88b4-2fe33239bbd4,-33.82,151,NSW,Parramatta,debit,authorized,5f286f98e5834be6ad0d5b4fb13d36be,POS,<20,2018,10,22,23,39,Monday,7 days,72764.836
ACC-1799207998,20,39.0,9553.62,,CUS-164374203,2018-10-24,Susan,F,-33.79,150.68,,,,,,,debit,posted,04f51cecee264d13be546cf4faeb8bc7,INTER BANK,<20,2018,10,24,10,0,Wednesday,7 days,72764.836
ACC-1799207998,20,42.25,9511.37,1.0,CUS-164374203,2018-10-24,Susan,F,-33.79,150.68,,f03b1d54-1cde-4213-9df6-93c3a7f5f6e1,-33.88,151.21,NSW,Darlinghurst,debit,authorized,6bd143a1498c4340801521676d1d4d7c,SALES-POS,<20,2018,10,24,12,7,Wednesday,7 days,72764.836
ACC-1799207998,20,9.76,9501.61,1.0,CUS-164374203,2018-10-24,Susan,F,-33.79,150.68,,6fc4c2ae-41d9-4c66-ae7b-193fa3ddd699,-33.72,150.84,NSW,Marsden Park,debit,authorized,2c5a015d2ec649ab9e040afb9808a587,POS,<20,2018,10,24,13,43,Wednesday,7 days,72764.836
ACC-1799207998,20,6.5,9495.11,0.0,CUS-164374203,2018-10-24,Susan,F,-33.79,150.68,,2ff8350d-f9a4-4475-ba42-77901e30112c,-33.84,151.21,NSW,North Sydney,debit,authorized,45cb7f6022154714a644e48c95011884,SALES-POS,<20,2018,10,24,14,21,Wednesday,7 days,72764.836
ACC-1799207998,20,35.0,9460.11,,CUS-164374203,2018-10-24,Susan,F,-33.79,150.68,,,,,,,debit,posted,ea4b0b99a0664e86ad151a575dc63b26,PAYMENT,<20,2018,10,24,16,0,Wednesday,7 days,72764.836
ACC-1799207998,20,9.1,10846.5,1.0,CUS-164374203,2018-10-24,Susan,F,-33.79,150.68,,8050b69d-673c-438f-b4a9-e031efccdc90,-33.84,151.21,NSW,North Sydney,debit,authorized,a25416be32fa4f728df47a75b5b30eb1,SALES-POS,<20,2018,10,24,19,9,Wednesday,7 days,72764.836
ACC-1799207998,20,8.18,10838.32,1.0,CUS-164374203,2018-10-24,Susan,F,-33.79,150.68,,43bc965b-6a74-4723-906f-3c2635fd5d02,-33.89,151.23,NSW,Moore Park,debit,authorized,7151a7fec62a4937a7a95a7a44188895,SALES-POS,<20,2018,10,24,20,14,Wednesday,7 days,72764.836
ACC-1799207998,20,18.87,10819.45,0.0,CUS-164374203,2018-10-24,Susan,F,-33.79,150.68,,805e2d12-0bb1-44ca-bf7f-ede7377f09db,-33.77,151.26,NSW,Brookvale,debit,authorized,d3570342f1484fe0913e5762063ef3c5,POS,<20,2018,10,24,22,23,Wednesday,7 days,72764.836
ACC-1799207998,20,197.0,10622.45,,CUS-164374203,2018-10-25,Susan,F,-33.79,150.68,,,,,,,debit,posted,b3238b4539df4b3ea9e7f9c5a0ce5aa6,PAYMENT,<20,2018,10,25,15,0,Thursday,7 days,72764.836
ACC-1799207998,20,16.49,10605.96,0.0,CUS-164374203,2018-10-25,Susan,F,-33.79,150.68,,65b288bd-7c00-47a4-8b82-e5f4e0ef18bc,-33.75,151.05,NSW,West Pennant Hills,debit,authorized,c9a1ff53d4e845eaa0d8937c8c3fada5,POS,<20,2018,10,25,17,18,Thursday,7 days,72764.836
ACC-1799207998,20,21.42,10584.54,1.0,CUS-164374203,2018-10-25,Susan,F,-33.79,150.68,,eae15c76-42bb-4996-9534-b655eb82128c,-33.95,151.23,NSW,Hillsdale,debit,authorized,ba2fc6a4f1d14fa78c3b05e918289650,POS,<20,2018,10,25,19,15,Thursday,7 days,72764.836
ACC-1799207998,20,7.49,10577.05,1.0,CUS-164374203,2018-10-25,Susan,F,-33.79,150.68,,3ce2653e-5bde-4459-9aef-af93e8ebaf1c,-33.84,151.21,NSW,North Sydney,debit,authorized,23df5a73e31b41a8a5a0e536acb05415,POS,<20,2018,10,25,19,26,Thursday,7 days,72764.836
ACC-1799207998,20,21.62,10555.43,0.0,CUS-164374203,2018-10-26,Susan,F,-33.79,150.68,,cd5eff86-8ffc-4e62-a5d2-31685882a236,-33.73,151.16,NSW,Saint Ives,debit,authorized,283d5dc77f8d4257944f28e9ee815ec6,POS,<20,2018,10,26,7,2,Friday,7 days,72764.836
ACC-1799207998,20,20.97,10534.46,0.0,CUS-164374203,2018-10-26,Susan,F,-33.79,150.68,,8eadfdca-0676-4c6d-abe6-78c30088e131,-33.73,151.01,NSW,Castle Hill,debit,authorized,661816e563874280a4007c20851319a3,POS,<20,2018,10,26,9,1,Friday,7 days,72764.836
ACC-1799207998,20,21.72,10512.74,1.0,CUS-164374203,2018-10-26,Susan,F,-33.79,150.68,,b6fc7027-f291-4a0a-8cbb-d68a036040bd,-33.83,117.16,WA,Kojonup,debit,authorized,731ebc9d9662464a892fbb8d9aaee85c,SALES-POS,<20,2018,10,26,14,35,Friday,7 days,72764.836
ACC-1799207998,20,10.16,10502.58,1.0,CUS-164374203,2018-10-26,Susan,F,-33.79,150.68,,8d837d9d-d673-40a5-8614-9025dbc14ed2,-33.82,151,NSW,Parramatta,debit,authorized,6b93c01dc2184c27b4c119c1b6513176,SALES-POS,<20,2018,10,26,15,11,Friday,7 days,72764.836
ACC-1799207998,20,28.85,10473.73,1.0,CUS-164374203,2018-10-26,Susan,F,-33.79,150.68,,a9ef765f-2a48-4d8d-a08f-5cf8e5ed52c9,-33.81,150.94,NSW,Greystanes,debit,authorized,3113f5811a844f6c8b2f7c1f14f67d52,SALES-POS,<20,2018,10,26,21,36,Friday,7 days,72764.836
ACC-1799207998,20,20.92,10452.81,1.0,CUS-164374203,2018-10-26,Susan,F,-33.79,150.68,,85f205ca-dc6b-43f4-b081-859a27457643,-31.86,115.81,WA,Balcatta,debit,authorized,5050dd86916449bf9219c137b932cd85,POS,<20,2018,10,26,21,52,Friday,7 days,72764.836
ACC-1799207998,20,31.44,10421.37,1.0,CUS-164374203,2018-10-27,Susan,F,-33.79,150.68,,9a73b52e-41bf-4fa4-80a8-89c19c55ea87,-33.95,151.25,NSW,Maroubra,debit,authorized,942dba65cebf420290dced189f244fc5,POS,<20,2018,10,27,2,33,Saturday,7 days,72764.836
ACC-1799207998,20,30.0,10391.37,,CUS-164374203,2018-10-27,Susan,F,-33.79,150.68,,,,,,,debit,posted,9b1d39514cde468aa50722acde0258ae,PAYMENT,<20,2018,10,27,22,0,Saturday,7 days,72764.836
ACC-1799207998,20,244.96,10146.41,1.0,CUS-164374203,2018-10-28,Susan,F,-33.79,150.68,,bf5ef231-a630-4da0-9fce-8ad2a247dd7f,-33.82,151.19,NSW,Sydney,debit,authorized,3a1fcfbd18a94d69bf8ade17cfa899cd,SALES-POS,<20,2018,10,28,11,13,Sunday,7 days,72764.836
ACC-1799207998,20,13.38,10133.03,1.0,CUS-164374203,2018-10-28,Susan,F,-33.79,150.68,,39617a7b-8f44-4987-b25d-e2b41db845b7,-33.75,151.03,NSW,West Pennant Hills,debit,authorized,50039b7ee83a46ed8e6b1e7d49aad564,POS,<20,2018,10,28,11,56,Sunday,7 days,72764.836
ACC-1799207998,20,39.0,10094.03,,CUS-164374203,2018-10-31,Susan,F,-33.79,150.68,,,,,,,debit,posted,e979fe6f77404adfb0d71abe4819bddb,INTER BANK,<20,2018,10,31,10,0,Wednesday,7 days,72764.836
ACC-1799207998,20,35.0,10059.03,,CUS-164374203,2018-10-31,Susan,F,-33.79,150.68,,,,,,,debit,posted,274ea70c2bcc491795cc15241685f582,PAYMENT,<20,2018,10,31,16,0,Wednesday,7 days,72764.836
ACC-2107684084,22,34.0,292.77,,CUS-2283904812,2018-08-01,Richard,M,-37.88,145.03,,,,,,,debit,posted,60f8a3a91b974bd783af46c24bf7dc94,PAYMENT,20-30,2018,8,1,10,0,Wednesday,14 days,57845.461
ACC-2107684084,22,17.14,2494.36,1.0,CUS-2283904812,2018-08-03,Richard,M,-37.88,145.03,,4b516659-dccc-4889-95cf-00b09d94b7f8,-37.02,145.13,VIC,Seymour,debit,authorized,ee250ab36307428396634327697357f1,SALES-POS,20-30,2018,8,3,21,39,Friday,14 days,57845.461
ACC-2107684084,22,16.4,2477.96,0.0,CUS-2283904812,2018-08-04,Richard,M,-37.88,145.03,,a114392c-e324-4316-887b-16846facad41,-38.11,147.07,VIC,Sale,debit,authorized,451b3509fc2f4b92b062c5c7c431d280,SALES-POS,20-30,2018,8,4,20,48,Saturday,14 days,57845.461
ACC-2107684084,22,25.0,2452.96,,CUS-2283904812,2018-08-05,Richard,M,-37.88,145.03,,,,,,,debit,posted,0ec4280903ad45a08aed8605bf414217,PAYMENT,20-30,2018,8,5,2,0,Sunday,14 days,57845.461
ACC-2107684084,22,33.0,2419.96,,CUS-2283904812,2018-08-05,Richard,M,-37.88,145.03,,,,,,,debit,posted,0fed7eb0c8a44812a5818b2eede887bd,INTER BANK,20-30,2018,8,5,8,0,Sunday,14 days,57845.461
ACC-2107684084,22,95.0,2324.96,,CUS-2283904812,2018-08-05,Richard,M,-37.88,145.03,,,,,,,debit,posted,70d1e79d412243a3b1af3fd8c27a4904,PAYMENT,20-30,2018,8,5,9,0,Sunday,14 days,57845.461
ACC-2107684084,22,34.0,2290.96,,CUS-2283904812,2018-08-06,Richard,M,-37.88,145.03,,,,,,,debit,posted,e67afff1e493444aae4b11435549bc36,PAYMENT,20-30,2018,8,6,5,0,Monday,14 days,57845.461
ACC-2107684084,22,34.0,2256.96,,CUS-2283904812,2018-08-08,Richard,M,-37.88,145.03,,,,,,,debit,posted,f8f2cf3c623d47dfb2027a7f83036106,PAYMENT,20-30,2018,8,8,10,0,Wednesday,14 days,57845.461
ACC-2107684084,22,25.0,2231.96,,CUS-2283904812,2018-08-12,Richard,M,-37.88,145.03,,,,,,,debit,posted,79f6dc905b034648b2f0cf1f3da037fd,PAYMENT,20-30,2018,8,12,2,0,Sunday,14 days,57845.461
ACC-2107684084,22,33.0,2198.96,,CUS-2283904812,2018-08-12,Richard,M,-37.88,145.03,,,,,,,debit,posted,9274878d4d2046188ea09cfbd2d79534,INTER BANK,20-30,2018,8,12,8,0,Sunday,14 days,57845.461
ACC-2107684084,22,34.0,2164.96,,CUS-2283904812,2018-08-13,Richard,M,-37.88,145.03,,,,,,,debit,posted,335df96f7983476a81385d6b73d1f83c,PAYMENT,20-30,2018,8,13,5,0,Monday,14 days,57845.461
ACC-2107684084,22,34.0,2130.96,,CUS-2283904812,2018-08-15,Richard,M,-37.88,145.03,,,,,,,debit,posted,ceade67a11c142e6a92d2e088a5942dd,PAYMENT,20-30,2018,8,15,10,0,Wednesday,14 days,57845.461
ACC-2107684084,22,25.0,4324.69,,CUS-2283904812,2018-08-19,Richard,M,-37.88,145.03,,,,,,,debit,posted,1b5940d2ddba4d61a94ba362d3e6f0dc,PAYMENT,20-30,2018,8,19,2,0,Sunday,14 days,57845.461
ACC-2107684084,22,33.0,4291.69,,CUS-2283904812,2018-08-19,Richard,M,-37.88,145.03,,,,,,,debit,posted,326c2708070b423e8f53f4350d90d89e,INTER BANK,20-30,2018,8,19,8,0,Sunday,14 days,57845.461
ACC-2107684084,22,34.0,4257.69,,CUS-2283904812,2018-08-20,Richard,M,-37.88,145.03,,,,,,,debit,posted,dcf2ae387c184317910ebbe8a2e00c41,PAYMENT,20-30,2018,8,20,5,0,Monday,14 days,57845.461
ACC-2107684084,22,34.0,4223.69,,CUS-2283904812,2018-08-22,Richard,M,-37.88,145.03,,,,,,,debit,posted,0beb286d8816431ba46f3c7cc0b138bc,PAYMENT,20-30,2018,8,22,10,0,Wednesday,14 days,57845.461
ACC-2107684084,22,25.0,4198.69,,CUS-2283904812,2018-08-26,Richard,M,-37.88,145.03,,,,,,,debit,posted,99b2d1d00a2e4659b570bab3ff9edb4e,PAYMENT,20-30,2018,8,26,2,0,Sunday,14 days,57845.461
ACC-2107684084,22,33.0,4165.69,,CUS-2283904812,2018-08-26,Richard,M,-37.88,145.03,,,,,,,debit,posted,f46ac8386a444f779216eb88eb3116ef,INTER BANK,20-30,2018,8,26,8,0,Sunday,14 days,57845.461
ACC-2107684084,22,34.0,4131.69,,CUS-2283904812,2018-08-27,Richard,M,-37.88,145.03,,,,,,,debit,posted,9dc139ce46af456096aeca96f49b0808,PAYMENT,20-30,2018,8,27,5,0,Monday,14 days,57845.461
ACC-2107684084,22,106.0,4025.69,,CUS-2283904812,2018-08-28,Richard,M,-37.88,145.03,,,,,,,debit,posted,7092647312164c07a09b8901f9966384,PAYMENT,20-30,2018,8,28,9,0,Tuesday,14 days,57845.461
ACC-2107684084,22,34.0,3991.69,,CUS-2283904812,2018-08-29,Richard,M,-37.88,145.03,,,,,,,debit,posted,80859ac9c9154c5bb6b1df4935c77357,PAYMENT,20-30,2018,8,29,10,0,Wednesday,14 days,57845.461
ACC-2107684084,22,25.0,6185.42,,CUS-2283904812,2018-09-02,Richard,M,-37.88,145.03,,,,,,,debit,posted,3b6d9ed44f3d4935b6221df550ba1a84,PAYMENT,20-30,2018,9,2,2,0,Sunday,14 days,57845.461
ACC-2107684084,22,33.0,6152.42,,CUS-2283904812,2018-09-02,Richard,M,-37.88,145.03,,,,,,,debit,posted,2d5ab86c17354c2e8978b585a82f0a26,INTER BANK,20-30,2018,9,2,8,0,Sunday,14 days,57845.461
ACC-2107684084,22,34.0,6118.42,,CUS-2283904812,2018-09-03,Richard,M,-37.88,145.03,,,,,,,debit,posted,326aca5f1ccc45dbb74c2b4d0d058676,PAYMENT,20-30,2018,9,3,5,0,Monday,14 days,57845.461
ACC-2107684084,22,57.46,6060.96,1.0,CUS-2283904812,2018-09-04,Richard,M,-37.88,145.03,,fd220bd4-d406-4b16-b653-3e3c0d8fa54c,-37.77,144.92,VIC,Moonee Ponds,debit,authorized,06cff491dfab4d6ca4ed4e8e437a3f4f,POS,20-30,2018,9,4,9,47,Tuesday,14 days,57845.461
ACC-2107684084,22,62.46,5998.5,1.0,CUS-2283904812,2018-09-04,Richard,M,-37.88,145.03,,51eccdb8-ffd6-4c45-bea6-4b32c8e590e8,-37.73,144.9,VIC,Essendon Fields,debit,authorized,3a951f50ab824cc4a48e598a640a09bb,POS,20-30,2018,9,4,11,49,Tuesday,14 days,57845.461
ACC-2107684084,22,95.0,5903.5,,CUS-2283904812,2018-09-05,Richard,M,-37.88,145.03,,,,,,,debit,posted,337f4f2d06df4587aa14db05be74259d,PAYMENT,20-30,2018,9,5,9,0,Wednesday,14 days,57845.461
ACC-2107684084,22,34.0,5869.5,,CUS-2283904812,2018-09-05,Richard,M,-37.88,145.03,,,,,,,debit,posted,5b9e5e9d086d4667b90626b6ae0ad127,PAYMENT,20-30,2018,9,5,10,0,Wednesday,14 days,57845.461
ACC-2107684084,22,28.83,5840.67,1.0,CUS-2283904812,2018-09-05,Richard,M,-37.88,145.03,,d67ee2f4-8e9d-4815-9929-1b9fb78779f0,-37.88,145.13,VIC,Mount Waverley,debit,authorized,b04f4b08c11448d9bdb2385ae25ba572,SALES-POS,20-30,2018,9,5,17,11,Wednesday,14 days,57845.461
ACC-2107684084,22,28.1,5812.57,1.0,CUS-2283904812,2018-09-08,Richard,M,-37.88,145.03,,d8be40eb-0359-4da7-9d6d-8d82a2763b27,-37.78,145.02,VIC,Fairfield,debit,authorized,6a47b1d3641e47dbbeb20a7d91302f36,SALES-POS,20-30,2018,9,8,9,59,Saturday,14 days,57845.461
ACC-2107684084,22,25.0,5787.57,,CUS-2283904812,2018-09-09,Richard,M,-37.88,145.03,,,,,,,debit,posted,7e53c2e1f8ac48f9ad44932b243f1b50,PAYMENT,20-30,2018,9,9,2,0,Sunday,14 days,57845.461
ACC-2107684084,22,33.0,5754.57,,CUS-2283904812,2018-09-09,Richard,M,-37.88,145.03,,,,,,,debit,posted,4a5b0341f398409bb0e9e11d781c557a,INTER BANK,20-30,2018,9,9,8,0,Sunday,14 days,57845.461
ACC-2107684084,22,34.0,5720.57,,CUS-2283904812,2018-09-10,Richard,M,-37.88,145.03,,,,,,,debit,posted,3600157f70864e42893d229de2d6d6ff,PAYMENT,20-30,2018,9,10,5,0,Monday,14 days,57845.461
ACC-2107684084,22,34.0,5686.57,,CUS-2283904812,2018-09-12,Richard,M,-37.88,145.03,,,,,,,debit,posted,8525688728b34fd78227ad84c257fb27,PAYMENT,20-30,2018,9,12,10,0,Wednesday,14 days,57845.461
ACC-2107684084,22,447.0,7458.3,,CUS-2283904812,2018-09-13,Richard,M,-37.88,145.03,,,,,,,debit,posted,cbd0e74211e6423ba4b452111c01c687,INTER BANK,20-30,2018,9,13,14,0,Thursday,14 days,57845.461
ACC-2107684084,22,25.0,7433.3,,CUS-2283904812,2018-09-16,Richard,M,-37.88,145.03,,,,,,,debit,posted,8340f3b280044079afa021e831270472,PAYMENT,20-30,2018,9,16,2,0,Sunday,14 days,57845.461
ACC-2107684084,22,33.0,7400.3,,CUS-2283904812,2018-09-16,Richard,M,-37.88,145.03,,,,,,,debit,posted,1b96358562dd4c5baefb75c59945a565,INTER BANK,20-30,2018,9,16,8,0,Sunday,14 days,57845.461
ACC-2107684084,22,27.47,7372.83,1.0,CUS-2283904812,2018-09-16,Richard,M,-37.88,145.03,,a7aacfb6-c061-46b3-afe0-d745e0692e9e,-37.87,145.24,VIC,Wantirna South,debit,authorized,c3c23a442ab045469f123ebd6ffb7e9a,POS,20-30,2018,9,16,10,28,Sunday,14 days,57845.461
ACC-2107684084,22,34.0,7338.83,,CUS-2283904812,2018-09-17,Richard,M,-37.88,145.03,,,,,,,debit,posted,b76c87ee4313428cafc809444b5b3049,PAYMENT,20-30,2018,9,17,5,0,Monday,14 days,57845.461
ACC-2107684084,22,52.56,7286.27,0.0,CUS-2283904812,2018-09-18,Richard,M,-37.88,145.03,,603eda0d-8960-4411-8832-d6f1947b8f2a,-37.86,145.23,VIC,Wantirna,debit,authorized,cbc7ab2eea1c44cc876a6aa77ad7bd93,POS,20-30,2018,9,18,9,9,Tuesday,14 days,57845.461
ACC-2107684084,22,51.09,7235.18,0.0,CUS-2283904812,2018-09-18,Richard,M,-37.88,145.03,,4b04d36a-f184-4004-a254-28a85a12a090,-37.86,145.03,VIC,Malvern,debit,authorized,9b3e0b65917d4ab6b83ea50db82ded3c,SALES-POS,20-30,2018,9,18,11,51,Tuesday,14 days,57845.461
ACC-2107684084,22,34.0,7201.18,,CUS-2283904812,2018-09-19,Richard,M,-37.88,145.03,,,,,,,debit,posted,7b94f2986ad14a958a270ecb2da27ea5,PAYMENT,20-30,2018,9,19,10,0,Wednesday,14 days,57845.461
ACC-2107684084,22,80.5,7120.68,1.0,CUS-2283904812,2018-09-19,Richard,M,-37.88,145.03,,4700f1bb-010a-43d6-91fa-0c1110bed731,-37.81,144.96,VIC,Melbourne,debit,authorized,e5e3a565a71f4acb849cbebcacb19554,POS,20-30,2018,9,19,12,13,Wednesday,14 days,57845.461
ACC-2107684084,22,48.67,7072.01,1.0,CUS-2283904812,2018-09-19,Richard,M,-37.88,145.03,,cd32bde7-1b61-404e-b093-3ba8ed7f5ebf,-37.83,140.79,SA,Mount Gambier,debit,authorized,f51ec576deba49edab067d82a448a7c8,SALES-POS,20-30,2018,9,19,18,23,Wednesday,14 days,57845.461
ACC-2107684084,22,25.0,7047.01,,CUS-2283904812,2018-09-23,Richard,M,-37.88,145.03,,,,,,,debit,posted,b48e8bc39b874946abeefe0258ab210d,PAYMENT,20-30,2018,9,23,2,0,Sunday,14 days,57845.461
ACC-2107684084,22,33.0,7014.01,,CUS-2283904812,2018-09-23,Richard,M,-37.88,145.03,,,,,,,debit,posted,285b7b0e0cef4b8996dadda6ef9835ec,INTER BANK,20-30,2018,9,23,8,0,Sunday,14 days,57845.461
ACC-2107684084,22,34.0,6980.01,,CUS-2283904812,2018-09-24,Richard,M,-37.88,145.03,,,,,,,debit,posted,f97cef15156a4d54af09caa959fbd745,PAYMENT,20-30,2018,9,24,5,0,Monday,14 days,57845.461
ACC-2107684084,22,34.0,6946.01,,CUS-2283904812,2018-09-26,Richard,M,-37.88,145.03,,,,,,,debit,posted,408f75a62b4f434eb72497571ca0b090,PAYMENT,20-30,2018,9,26,10,0,Wednesday,14 days,57845.461
ACC-2107684084,22,9.89,6936.12,1.0,CUS-2283904812,2018-09-27,Richard,M,-37.88,145.03,,42ce0544-f77c-497b-b7f9-71a2d91530cb,-37.84,144.97,VIC,South Melbourne,debit,authorized,e59749265c094b36a75b9c4917d7b20c,POS,20-30,2018,9,27,9,30,Thursday,14 days,57845.461
ACC-2107684084,22,106.0,9048.85,,CUS-2283904812,2018-09-28,Richard,M,-37.88,145.03,,,,,,,debit,posted,6f4993727de748bd9c98f45e3189b930,PAYMENT,20-30,2018,9,28,9,0,Friday,14 days,57845.461
ACC-2107684084,22,12.27,9036.58,1.0,CUS-2283904812,2018-09-29,Richard,M,-37.88,145.03,,3a5bdc06-632f-4104-9194-1c5da4c1461b,-37.78,144.97,VIC,Brunswick,debit,authorized,e3815e1c3b114f91a42e7b36c9cfe5c2,SALES-POS,20-30,2018,9,29,16,6,Saturday,14 days,57845.461
ACC-2107684084,22,27.07,9009.51,1.0,CUS-2283904812,2018-09-29,Richard,M,-37.88,145.03,,9b77d8e5-8048-4a05-8de5-6aaf25fd2282,-37.81,145.23,VIC,Ringwood,debit,authorized,0650559de84147208bafe97eb796b7d4,POS,20-30,2018,9,29,21,45,Saturday,14 days,57845.461
ACC-2107684084,22,25.0,8984.51,,CUS-2283904812,2018-09-30,Richard,M,-37.88,145.03,,,,,,,debit,posted,74a8766cf35641c0a1c7fa6915baca3b,PAYMENT,20-30,2018,9,30,2,0,Sunday,14 days,57845.461
ACC-2107684084,22,33.0,8951.51,,CUS-2283904812,2018-09-30,Richard,M,-37.88,145.03,,,,,,,debit,posted,943f81feff3e4d75b2e8a393ccb5e9d6,INTER BANK,20-30,2018,9,30,8,0,Sunday,14 days,57845.461
ACC-2107684084,22,34.0,8917.51,,CUS-2283904812,2018-10-01,Richard,M,-37.88,145.03,,,,,,,debit,posted,c2aa540c159946d099d29005357c9cfb,PAYMENT,20-30,2018,10,1,5,0,Monday,14 days,57845.461
ACC-2107684084,22,24.09,8893.42,1.0,CUS-2283904812,2018-10-02,Richard,M,-37.88,145.03,,b167b54e-f5ba-4039-97ae-2c12176d5ef9,-37.81,144.75,VIC,Truganina,debit,authorized,ef5dddf7d3ec4fee96fd71b389db2cdd,SALES-POS,20-30,2018,10,2,6,54,Tuesday,14 days,57845.461
ACC-2107684084,22,8.4,8885.02,1.0,CUS-2283904812,2018-10-03,Richard,M,-37.88,145.03,,28f5e6c6-6758-4c60-9726-129e5a76680a,-37.81,144.97,VIC,Melbourne,debit,authorized,218e5856e95f4ee69b1ae594fc536820,POS,20-30,2018,10,3,9,39,Wednesday,14 days,57845.461
ACC-2107684084,22,34.0,8851.02,,CUS-2283904812,2018-10-03,Richard,M,-37.88,145.03,,,,,,,debit,posted,2eb8e9c238b4480f887ee8988e806315,PAYMENT,20-30,2018,10,3,10,0,Wednesday,14 days,57845.461
ACC-2107684084,22,94.52,8756.5,1.0,CUS-2283904812,2018-10-04,Richard,M,-37.88,145.03,,ad7fab6a-9def-4f28-a106-8d85b10d9dcf,-37.83,144.99,VIC,Cremorne,debit,authorized,4b338d0b8a964731a54f96022757aad1,SALES-POS,20-30,2018,10,4,0,26,Thursday,14 days,57845.461
ACC-2107684084,22,95.0,8661.5,,CUS-2283904812,2018-10-05,Richard,M,-37.88,145.03,,,,,,,debit,posted,b9921199483543a0b0e95e891dc81078,PAYMENT,20-30,2018,10,5,9,0,Friday,14 days,57845.461
ACC-2107684084,22,25.0,8636.5,,CUS-2283904812,2018-10-07,Richard,M,-37.88,145.03,,,,,,,debit,posted,e72d7b037274417ca75c5184fbd03a78,PAYMENT,20-30,2018,10,7,2,0,Sunday,14 days,57845.461
ACC-2107684084,22,33.0,8603.5,,CUS-2283904812,2018-10-07,Richard,M,-37.88,145.03,,,,,,,debit,posted,1684fd675aec4f0aaefeeccd534c4b19,INTER BANK,20-30,2018,10,7,8,0,Sunday,14 days,57845.461
ACC-2107684084,22,34.0,8569.5,,CUS-2283904812,2018-10-08,Richard,M,-37.88,145.03,,,,,,,debit,posted,df9efe709c7144a2b5479f08084e3fb4,PAYMENT,20-30,2018,10,8,5,0,Monday,14 days,57845.461
ACC-2107684084,22,34.0,8535.5,,CUS-2283904812,2018-10-10,Richard,M,-37.88,145.03,,,,,,,debit,posted,e4ae1f6e86b441d89033871607140937,PAYMENT,20-30,2018,10,10,10,0,Wednesday,14 days,57845.461
ACC-2107684084,22,25.0,10729.23,,CUS-2283904812,2018-10-14,Richard,M,-37.88,145.03,,,,,,,debit,posted,3fa5b6e832c445c1a02c840a3fde967e,PAYMENT,20-30,2018,10,14,2,0,Sunday,14 days,57845.461
ACC-2107684084,22,8.66,10720.57,1.0,CUS-2283904812,2018-10-14,Richard,M,-37.88,145.03,,67e5bcbe-a2ad-400c-9b57-c539e50838e3,-37.82,144.96,VIC,Melbourne,debit,authorized,4c2c19cde0864dc68eae91825ee16f29,SALES-POS,20-30,2018,10,14,5,19,Sunday,14 days,57845.461
ACC-2107684084,22,33.0,10687.57,,CUS-2283904812,2018-10-14,Richard,M,-37.88,145.03,,,,,,,debit,posted,f46450d2f3ad4ffcb0c64c5cf96e7927,INTER BANK,20-30,2018,10,14,8,0,Sunday,14 days,57845.461
ACC-2107684084,22,34.0,10653.57,,CUS-2283904812,2018-10-15,Richard,M,-37.88,145.03,,,,,,,debit,posted,c1b88838d06b4bbe836275ef90d55069,PAYMENT,20-30,2018,10,15,5,0,Monday,14 days,57845.461
ACC-2107684084,22,13.06,10640.51,1.0,CUS-2283904812,2018-10-15,Richard,M,-37.88,145.03,,aa3f790f-969f-4773-b1ca-d02df6aedcde,-37.81,144.96,VIC,Melbourne,debit,authorized,8383cddb6ade437691835ba59f7c8fac,SALES-POS,20-30,2018,10,15,9,57,Monday,14 days,57845.461
ACC-2107684084,22,204.66,10435.85,1.0,CUS-2283904812,2018-10-15,Richard,M,-37.88,145.03,,79ea8217-9bc9-46d3-9de4-f903eb811baa,-37.81,144.99,VIC,Collingwood,debit,authorized,0fc1f42881cd40efa9786165301a98b7,POS,20-30,2018,10,15,10,19,Monday,14 days,57845.461
ACC-2107684084,22,34.0,10401.85,,CUS-2283904812,2018-10-17,Richard,M,-37.88,145.03,,,,,,,debit,posted,e8dcfaa10898421f9e734e230ce5b4b2,PAYMENT,20-30,2018,10,17,10,0,Wednesday,14 days,57845.461
ACC-2107684084,22,17.86,10383.99,1.0,CUS-2283904812,2018-10-18,Richard,M,-37.88,145.03,,f5fe8b6c-1c7b-412a-9197-57a964f67c5f,-32,115.93,WA,Bentley,debit,authorized,d366f30fd6974923a7c99489c4b80035,POS,20-30,2018,10,18,9,55,Thursday,14 days,57845.461
ACC-2107684084,22,17.3,10366.69,1.0,CUS-2283904812,2018-10-19,Richard,M,-37.88,145.03,,f7a96331-a443-4dcd-bcc4-dfbf0dfcea6d,-37.78,144.96,VIC,Brunswick,debit,authorized,754d937e84304f638fb358db35dae17d,POS,20-30,2018,10,19,21,42,Friday,14 days,57845.461
ACC-2107684084,22,25.0,10341.69,,CUS-2283904812,2018-10-21,Richard,M,-37.88,145.03,,,,,,,debit,posted,511a4c3daacc46eab1646a0af4f972d7,PAYMENT,20-30,2018,10,21,2,0,Sunday,14 days,57845.461
ACC-2107684084,22,33.0,10308.69,,CUS-2283904812,2018-10-21,Richard,M,-37.88,145.03,,,,,,,debit,posted,e9ffc01948a445358a773ac94d88d68b,INTER BANK,20-30,2018,10,21,8,0,Sunday,14 days,57845.461
ACC-2107684084,22,34.0,10274.69,,CUS-2283904812,2018-10-22,Richard,M,-37.88,145.03,,,,,,,debit,posted,e60e376d0001430d82aa79312bb151fc,PAYMENT,20-30,2018,10,22,5,0,Monday,14 days,57845.461
ACC-2107684084,22,34.0,10240.69,,CUS-2283904812,2018-10-24,Richard,M,-37.88,145.03,,,,,,,debit,posted,5658c2f86a344e4b878756c813a0a371,PAYMENT,20-30,2018,10,24,10,0,Wednesday,14 days,57845.461
ACC-2107684084,22,25.0,12434.42,,CUS-2283904812,2018-10-28,Richard,M,-37.88,145.03,,,,,,,debit,posted,39c231897e6c48c295e3b73856f2711d,PAYMENT,20-30,2018,10,28,2,0,Sunday,14 days,57845.461
ACC-2107684084,22,33.0,12401.42,,CUS-2283904812,2018-10-28,Richard,M,-37.88,145.03,,,,,,,debit,posted,d0850213651442998de0edaad1c82e91,INTER BANK,20-30,2018,10,28,8,0,Sunday,14 days,57845.461
ACC-2107684084,22,106.0,12295.42,,CUS-2283904812,2018-10-28,Richard,M,-37.88,145.03,,,,,,,debit,posted,e207924d2599402ea2990379969e56e7,PAYMENT,20-30,2018,10,28,9,0,Sunday,14 days,57845.461
ACC-2107684084,22,34.0,12261.42,,CUS-2283904812,2018-10-29,Richard,M,-37.88,145.03,,,,,,,debit,posted,82609b65e0364945bb910a19336f9e61,PAYMENT,20-30,2018,10,29,5,0,Monday,14 days,57845.461
ACC-2107684084,22,34.0,12227.42,,CUS-2283904812,2018-10-31,Richard,M,-37.88,145.03,,,,,,,debit,posted,55313fc3e12a4e41abf6b22690e75241,PAYMENT,20-30,2018,10,31,10,0,Wednesday,14 days,57845.461
ACC-2173390920,27,29.0,28.04,,CUS-3180318393,2018-08-01,Luis,M,-37.58,144.71,,,,,,,debit,posted,2bf5dc421b144a6d9f80c71d9750bbb9,PAYMENT,20-30,2018,8,1,10,0,Wednesday,7 days,72803.421
ACC-2173390920,27,21.56,6.48,1.0,CUS-3180318393,2018-08-03,Luis,M,-37.58,144.71,,1998a774-6a20-49b3-8059-19839a010729,-37.6,143.87,VIC,Mount Clear,debit,authorized,a30342e2d8bc46c5a0a56a65bbcd3aaf,POS,20-30,2018,8,3,2,32,Friday,7 days,72803.421
ACC-2173390920,27,28.0,1374.71,,CUS-3180318393,2018-08-07,Luis,M,-37.58,144.71,,,,,,,debit,posted,4502482b5f6144c189d6c389562ce08c,PAYMENT,20-30,2018,8,7,14,0,Tuesday,7 days,72803.421
ACC-2173390920,27,29.0,1345.71,,CUS-3180318393,2018-08-08,Luis,M,-37.58,144.71,,,,,,,debit,posted,949fe2a609cf4e438134e82f5146cfcd,PAYMENT,20-30,2018,8,8,10,0,Wednesday,7 days,72803.421
ACC-2173390920,27,67.0,1278.71,,CUS-3180318393,2018-08-08,Luis,M,-37.58,144.71,,,,,,,debit,posted,4c1b72b6c66549738a351ba801cb44e3,PHONE BANK,20-30,2018,8,8,21,0,Wednesday,7 days,72803.421
ACC-2173390920,27,29.0,1249.71,,CUS-3180318393,2018-08-09,Luis,M,-37.58,144.71,,,,,,,debit,posted,31e166e0c58447d0b5280b26ded5c0c9,PAYMENT,20-30,2018,8,9,17,0,Thursday,7 days,72803.421
ACC-2173390920,27,13.65,1236.06,1.0,CUS-3180318393,2018-08-11,Luis,M,-37.58,144.71,,00a628aa-244d-4ab3-add4-95202d76fd98,-37.72,145.14,VIC,Eltham,debit,authorized,186c67be36e4441bab1b44c39e2ce113,SALES-POS,20-30,2018,8,11,20,8,Saturday,7 days,72803.421
ACC-2173390920,27,105.68,1130.38,1.0,CUS-3180318393,2018-08-11,Luis,M,-37.58,144.71,,c65eebe6-b185-4d6b-b774-91d2c415b510,-37.9,144.65,VIC,Werribee,debit,authorized,7c133fbb852d4064948a00f7d35df409,SALES-POS,20-30,2018,8,11,21,15,Saturday,7 days,72803.421
ACC-2173390920,27,16.68,1113.7,1.0,CUS-3180318393,2018-08-12,Luis,M,-37.58,144.71,,6032ef0f-941a-483b-a2e7-0db62878c59c,-37.63,145.03,VIC,Epping North,debit,authorized,4d47e85ad2b74511aa2294d44eb1cbe1,POS,20-30,2018,8,12,3,29,Sunday,7 days,72803.421
ACC-2173390920,27,69.83,1043.87,1.0,CUS-3180318393,2018-08-13,Luis,M,-37.58,144.71,,f2dc53e7-1830-4e27-be3a-d7028446c121,-37.83,145.14,VIC,Box Hill South,debit,authorized,8d29d4804af4428abe0c615f9232cd9f,POS,20-30,2018,8,13,9,58,Monday,7 days,72803.421
ACC-2173390920,27,33.37,2406.73,1.0,CUS-3180318393,2018-08-14,Luis,M,-37.58,144.71,,9a7ddd5a-70d5-4c22-bdf4-d2faa8cae8fe,-37.59,144.91,VIC,Craigieburn,debit,authorized,9815f29f949848f991a9b535910b9744,POS,20-30,2018,8,14,9,0,Tuesday,7 days,72803.421
ACC-2173390920,27,48.88,2357.85,1.0,CUS-3180318393,2018-08-14,Luis,M,-37.58,144.71,,88e9a384-ca78-4520-8e67-2ecf34555d1f,-37.65,145.07,VIC,Mill Park,debit,authorized,a2020c47216041c7b2cb8ee2b58fee6e,SALES-POS,20-30,2018,8,14,9,17,Tuesday,7 days,72803.421
ACC-2173390920,27,28.0,2329.85,,CUS-3180318393,2018-08-14,Luis,M,-37.58,144.71,,,,,,,debit,posted,bffc8c86901c45b9987db37d7ef722cd,PAYMENT,20-30,2018,8,14,14,0,Tuesday,7 days,72803.421
ACC-2173390920,27,23.41,2306.44,0.0,CUS-3180318393,2018-08-14,Luis,M,-37.58,144.71,,a6769e7b-1c80-4f24-a874-7efc4ccd47bc,-37.61,144.91,VIC,Craigieburn,debit,authorized,9f18a71e571d41a8a863a056fe389469,SALES-POS,20-30,2018,8,14,21,44,Tuesday,7 days,72803.421
ACC-2173390920,27,29.0,2277.44,,CUS-3180318393,2018-08-15,Luis,M,-37.58,144.71,,,,,,,debit,posted,555f2a2f746648efb3290df82312ceab,PAYMENT,20-30,2018,8,15,10,0,Wednesday,7 days,72803.421
ACC-2173390920,27,67.0,2210.44,,CUS-3180318393,2018-08-15,Luis,M,-37.58,144.71,,,,,,,debit,posted,64bc212641884be699fc27e9332010c6,PHONE BANK,20-30,2018,8,15,21,0,Wednesday,7 days,72803.421
ACC-2173390920,27,45.34,2136.1,0.0,CUS-3180318393,2018-08-18,Luis,M,-37.58,144.71,,00a5bc50-0146-48d7-91ee-966e8be89c0b,-37.65,145.54,VIC,Healesville,debit,authorized,899d8f2414ff4e88a7fa649852d95229,POS,20-30,2018,8,18,8,20,Saturday,7 days,72803.421
ACC-2173390920,27,28.0,3504.33,,CUS-3180318393,2018-08-21,Luis,M,-37.58,144.71,,,,,,,debit,posted,55c179066d1a49b2accaf1c6679f9207,PAYMENT,20-30,2018,8,21,14,0,Tuesday,7 days,72803.421
ACC-2173390920,27,21.9,3482.43,1.0,CUS-3180318393,2018-08-21,Luis,M,-37.58,144.71,,a6769e7b-1c80-4f24-a874-7efc4ccd47bc,-37.61,144.91,VIC,Craigieburn,debit,authorized,0da4bb09c68548188712c6e6622c264f,POS,20-30,2018,8,21,19,12,Tuesday,7 days,72803.421
ACC-2173390920,27,29.0,3453.43,,CUS-3180318393,2018-08-22,Luis,M,-37.58,144.71,,,,,,,debit,posted,4af9460bf2b046968018d2361859b115,PAYMENT,20-30,2018,8,22,10,0,Wednesday,7 days,72803.421
ACC-2173390920,27,140.0,3313.43,,CUS-3180318393,2018-08-22,Luis,M,-37.58,144.71,,,,,,,debit,posted,23dfd7000f71472ebed24fdb0ac04681,INTER BANK,20-30,2018,8,22,12,0,Wednesday,7 days,72803.421
ACC-2173390920,27,9.84,3303.59,1.0,CUS-3180318393,2018-08-22,Luis,M,-37.58,144.71,,4b227720-d6ff-4a29-ba14-ce7eb6bbcdac,-37.87,144.69,VIC,Hoppers Crossing,debit,authorized,31fa183e3af34f718b4b8f929e311a38,SALES-POS,20-30,2018,8,22,17,30,Wednesday,7 days,72803.421
ACC-2173390920,27,67.0,3236.59,,CUS-3180318393,2018-08-22,Luis,M,-37.58,144.71,,,,,,,debit,posted,d046092c380e468ebd30e95e5ae58880,PHONE BANK,20-30,2018,8,22,21,0,Wednesday,7 days,72803.421
ACC-2173390920,27,26.33,3210.26,1.0,CUS-3180318393,2018-08-23,Luis,M,-37.58,144.71,,daf402ee-279e-403f-a330-28965fcfb9a1,-37.72,145.02,VIC,Reservoir,debit,authorized,33251840cfd44daa9dbe490a822dd746,POS,20-30,2018,8,23,4,19,Thursday,7 days,72803.421
ACC-2173390920,27,63.74,3146.52,1.0,CUS-3180318393,2018-08-23,Luis,M,-37.58,144.71,,d9ee12c1-f70d-43c5-b4d2-e77d0480c692,-37.83,144.99,VIC,Cremorne,debit,authorized,186d6e4c924a4e8dab1d7c317634190e,SALES-POS,20-30,2018,8,23,14,13,Thursday,7 days,72803.421
ACC-2173390920,27,29.0,3117.52,,CUS-3180318393,2018-08-23,Luis,M,-37.58,144.71,,,,,,,debit,posted,5749a560ce4f45019a0cec710e07f315,PAYMENT,20-30,2018,8,23,17,0,Thursday,7 days,72803.421
ACC-2173390920,27,27.91,3089.61,1.0,CUS-3180318393,2018-08-24,Luis,M,-37.58,144.71,,b1813830-dff6-4ef8-9a3b-a35650de29c6,-37.61,144.93,VIC,Craigieburn,debit,authorized,3f57c3096e214080a05bb159e45d7ca8,POS,20-30,2018,8,24,15,28,Friday,7 days,72803.421
ACC-2173390920,27,24.99,3064.62,1.0,CUS-3180318393,2018-08-25,Luis,M,-37.58,144.71,,aef30de1-c67e-4ab7-8577-2931a4bf3c7e,-27.97,144.64,QLD,Yowah,debit,authorized,a03ce97cf2ce47b1b6ffe485afc1ffa0,POS,20-30,2018,8,25,19,23,Saturday,7 days,72803.421
ACC-2173390920,27,17.99,3046.63,1.0,CUS-3180318393,2018-08-26,Luis,M,-37.58,144.71,,cd4dc247-4769-4eb9-a414-6ca2f82a2357,-37.58,144.73,VIC,Sunbury,debit,authorized,b014de2e6d89471e8d638034c12c72a0,SALES-POS,20-30,2018,8,26,4,43,Sunday,7 days,72803.421
ACC-2173390920,27,28.0,4414.86,,CUS-3180318393,2018-08-28,Luis,M,-37.58,144.71,,,,,,,debit,posted,43f1d8c4b787467cab3b0b9de9d7dc9a,PAYMENT,20-30,2018,8,28,14,0,Tuesday,7 days,72803.421
ACC-2173390920,27,14.14,4400.72,0.0,CUS-3180318393,2018-08-28,Luis,M,-37.58,144.71,,9dae3fdb-7610-4919-bf87-dce490d6f123,-37.73,144.75,VIC,Caroline Springs,debit,authorized,3cc05b5f601b4bc4aa1f33faa8628932,SALES-POS,20-30,2018,8,28,15,56,Tuesday,7 days,72803.421
ACC-2173390920,27,71.0,4329.72,,CUS-3180318393,2018-08-28,Luis,M,-37.58,144.71,,,,,,,debit,posted,e65824cfe3fe4e8ab6d65694f44fcb8e,PAYMENT,20-30,2018,8,28,21,0,Tuesday,7 days,72803.421
ACC-2173390920,27,29.0,4300.72,,CUS-3180318393,2018-08-29,Luis,M,-37.58,144.71,,,,,,,debit,posted,492f1fb5dd4547458e3019dc79865e73,PAYMENT,20-30,2018,8,29,10,0,Wednesday,7 days,72803.421
ACC-2173390920,27,40.44,4260.28,1.0,CUS-3180318393,2018-08-29,Luis,M,-37.58,144.71,,c1607430-2a27-4b6c-a0d1-cbb698023abf,-36.92,144.71,VIC,Heathcote,debit,authorized,433c12ec9f884c05adbe37706535c64e,SALES-POS,20-30,2018,8,29,14,12,Wednesday,7 days,72803.421
ACC-2173390920,27,67.0,4193.28,,CUS-3180318393,2018-08-29,Luis,M,-37.58,144.71,,,,,,,debit,posted,7fbab519d46944ad9395a2efdf9312fe,PHONE BANK,20-30,2018,8,29,21,0,Wednesday,7 days,72803.421
ACC-2173390920,27,29.0,4164.28,,CUS-3180318393,2018-08-30,Luis,M,-37.58,144.71,,,,,,,debit,posted,db065db8c5fb49d5bcfb99ce542a01e4,PAYMENT,20-30,2018,8,30,17,0,Thursday,7 days,72803.421
ACC-2173390920,27,24.26,4140.02,1.0,CUS-3180318393,2018-08-31,Luis,M,-37.58,144.71,,d78c4cd3-d6b0-4d6c-a800-2e7def79d9db,-37.9,144.66,VIC,Werribee,debit,authorized,52ac3a0d5a924869bbc5a02d1d46ada5,POS,20-30,2018,8,31,8,57,Friday,7 days,72803.421
ACC-2173390920,27,14.79,4125.23,1.0,CUS-3180318393,2018-08-31,Luis,M,-37.58,144.71,,451cb577-798b-4e80-be73-0cff5f8e7c4f,-37.69,144.76,VIC,Sydenham,debit,authorized,7ccb0014a82d40669f012fbca556dc4b,SALES-POS,20-30,2018,8,31,14,21,Friday,7 days,72803.421
ACC-2173390920,27,38.01,4087.22,1.0,CUS-3180318393,2018-08-31,Luis,M,-37.58,144.71,,c3f373c8-84fb-483e-a855-7364223b6521,-37.65,142.35,VIC,Dunkeld,debit,authorized,d66e6148f5af40069d04cebbae612345,POS,20-30,2018,8,31,20,23,Friday,7 days,72803.421
ACC-2173390920,27,23.24,4063.98,1.0,CUS-3180318393,2018-08-31,Luis,M,-37.58,144.71,,1e7a10df-3fec-4eec-844c-4505c1b91c94,-37.59,144.94,VIC,Craigieburn,debit,authorized,db844daf84fe468c915ee46a9cc480aa,SALES-POS,20-30,2018,8,31,21,4,Friday,7 days,72803.421
ACC-2173390920,27,27.71,4036.27,1.0,CUS-3180318393,2018-09-01,Luis,M,-37.58,144.71,,19498dcc-b4b9-4e23-9926-63f044e073a2,-37.76,144.96,VIC,Brunswick,debit,authorized,5dd20ac28644404d946c1860e34b0fb3,SALES-POS,20-30,2018,9,1,10,37,Saturday,7 days,72803.421
ACC-2173390920,27,47.24,3989.03,1.0,CUS-3180318393,2018-09-01,Luis,M,-37.58,144.71,,4009eacb-a18b-477b-b4e5-bc4eb97fcbe2,-37.57,145.64,VIC,Narbethong,debit,authorized,086541d1fdb448bfbfb211a9199a8aa8,SALES-POS,20-30,2018,9,1,21,9,Saturday,7 days,72803.421
ACC-2173390920,27,179.0,3810.03,,CUS-3180318393,2018-09-03,Luis,M,-37.58,144.71,,,,,,,debit,posted,201f8c95003c4b27a5c5b9c9cfb1bd43,PAYMENT,20-30,2018,9,3,8,0,Monday,7 days,72803.421
ACC-2173390920,27,11.89,5194.37,1.0,CUS-3180318393,2018-09-03,Luis,M,-37.58,144.71,,013eeee6-d966-402e-aa99-5dd41c8732fd,-37.72,145.14,VIC,Eltham,debit,authorized,a7554a3a8a4446c8911136340797b582,POS,20-30,2018,9,3,14,43,Monday,7 days,72803.421
ACC-2173390920,27,41.61,5152.76,1.0,CUS-3180318393,2018-09-04,Luis,M,-37.58,144.71,,36f8720a-f8ff-47d0-bc9e-12f89017fb96,-37.56,143.86,VIC,Bakery Hill,debit,authorized,18b86f205af44c5c9a876c9fc5347844,POS,20-30,2018,9,4,8,58,Tuesday,7 days,72803.421
ACC-2173390920,27,28.0,5124.76,,CUS-3180318393,2018-09-04,Luis,M,-37.58,144.71,,,,,,,debit,posted,cc50f9560da346259ef50304a8f78194,PAYMENT,20-30,2018,9,4,14,0,Tuesday,7 days,72803.421
ACC-2173390920,27,18.45,5106.31,1.0,CUS-3180318393,2018-09-05,Luis,M,-37.58,144.71,,aeff71b9-ce74-4cac-a824-b53882decb46,-37.65,145.02,VIC,Epping,debit,authorized,de3d1af0ef0946cd8659ca5b6cc4f532,SALES-POS,20-30,2018,9,5,9,31,Wednesday,7 days,72803.421
ACC-2173390920,27,29.0,5077.31,,CUS-3180318393,2018-09-05,Luis,M,-37.58,144.71,,,,,,,debit,posted,69157fab0ec3445dbf5e486fd399704a,PAYMENT,20-30,2018,9,5,10,0,Wednesday,7 days,72803.421
ACC-2173390920,27,67.0,5010.31,,CUS-3180318393,2018-09-05,Luis,M,-37.58,144.71,,,,,,,debit,posted,3fc9f49ad5154f83bcbf4638abcd15a1,PHONE BANK,20-30,2018,9,5,21,0,Wednesday,7 days,72803.421
ACC-2173390920,27,29.0,4981.31,,CUS-3180318393,2018-09-06,Luis,M,-37.58,144.71,,,,,,,debit,posted,2506294e0af34f6f8f6773a51f43fe1d,PAYMENT,20-30,2018,9,6,17,0,Thursday,7 days,72803.421
ACC-2173390920,27,32.04,4949.27,1.0,CUS-3180318393,2018-09-06,Luis,M,-37.58,144.71,,5203bce6-ca8a-4f99-b337-f68cb528a3dc,-37.83,145.05,VIC,Hawthorn East,debit,authorized,b3dc343ce5f24af0a728e1c0f777935b,POS,20-30,2018,9,6,20,28,Thursday,7 days,72803.421
ACC-2173390920,27,25.19,4924.08,1.0,CUS-3180318393,2018-09-07,Luis,M,-37.58,144.71,,97c7c248-0737-4906-b710-29fe04f36e5b,-37.59,140.35,SA,Millicent,debit,authorized,79b7be7af4a94b80b786b1052e7c21a4,SALES-POS,20-30,2018,9,7,20,9,Friday,7 days,72803.421
ACC-2173390920,27,21.11,4902.97,1.0,CUS-3180318393,2018-09-08,Luis,M,-37.58,144.71,,32741f25-ef70-46f4-9ad7-98c8636b61dc,-37.74,145.03,VIC,Preston,debit,authorized,da6e65035bcd4a08af5c0681d36c6cf9,POS,20-30,2018,9,8,1,17,Saturday,7 days,72803.421
ACC-2173390920,27,42.52,4860.45,0.0,CUS-3180318393,2018-09-08,Luis,M,-37.58,144.71,,bce20df2-d87c-40b3-b4b3-0b01d1e7a902,-37.6,143.84,VIC,Sebastopol,debit,authorized,bd584dc9be8440179caaa51ed05457bd,SALES-POS,20-30,2018,9,8,2,31,Saturday,7 days,72803.421
ACC-2173390920,27,5.86,4854.59,1.0,CUS-3180318393,2018-09-09,Luis,M,-37.58,144.71,,21a6ce99-99c6-4bd7-bf5b-2289a0b175cb,-37.83,145.03,VIC,Hawthorn,debit,authorized,d240db0ad70748b090e0c6b7681d17fe,SALES-POS,20-30,2018,9,9,4,0,Sunday,7 days,72803.421
ACC-2173390920,27,18.32,4836.27,1.0,CUS-3180318393,2018-09-09,Luis,M,-37.58,144.71,,639e6fc5-13b2-41fe-91fa-0d5498ff03b3,-37.75,144.96,VIC,Coburg,debit,authorized,1c0015084431472994fe53709110bf69,POS,20-30,2018,9,9,19,16,Sunday,7 days,72803.421
ACC-2173390920,27,28.0,6204.5,,CUS-3180318393,2018-09-11,Luis,M,-37.58,144.71,,,,,,,debit,posted,8fbce3c9f7aa442abc53d850062c183f,PAYMENT,20-30,2018,9,11,14,0,Tuesday,7 days,72803.421
ACC-2173390920,27,29.0,6175.5,,CUS-3180318393,2018-09-12,Luis,M,-37.58,144.71,,,,,,,debit,posted,7d10aa85cc6247d6b613a8957e49114a,PAYMENT,20-30,2018,9,12,10,0,Wednesday,7 days,72803.421
ACC-2173390920,27,27.42,6148.08,1.0,CUS-3180318393,2018-09-12,Luis,M,-37.58,144.71,,02496114-4eae-4edb-b083-cd130e140c71,-37.77,144.92,VIC,Ascot Vale,debit,authorized,4ed1db0960894d8e8f75bb945d91ee1e,SALES-POS,20-30,2018,9,12,15,0,Wednesday,7 days,72803.421
ACC-2173390920,27,24.37,6123.71,1.0,CUS-3180318393,2018-09-12,Luis,M,-37.58,144.71,,b0b6b706-27a4-47c5-aa00-b82739505bcc,-37.6,144.94,VIC,Craigieburn,debit,authorized,19742201c3374892b22a9a3d5b9f7a78,POS,20-30,2018,9,12,15,28,Wednesday,7 days,72803.421
ACC-2173390920,27,43.45,6080.26,1.0,CUS-3180318393,2018-09-12,Luis,M,-37.58,144.71,,db656976-26c9-45f0-931b-be20f5b4a8fb,-38.03,145.26,VIC,Hampton Park,debit,authorized,e920d22feda24295bf38be76a4c8a155,POS,20-30,2018,9,12,19,14,Wednesday,7 days,72803.421
ACC-2173390920,27,67.0,6013.26,,CUS-3180318393,2018-09-12,Luis,M,-37.58,144.71,,,,,,,debit,posted,78913571de6d4254ac93677592123087,PHONE BANK,20-30,2018,9,12,21,0,Wednesday,7 days,72803.421
ACC-2173390920,27,20.42,5992.84,1.0,CUS-3180318393,2018-09-13,Luis,M,-37.58,144.71,,a72416a7-bfa8-4182-943c-938bb28210f5,-37.83,145.06,VIC,Camberwell,debit,authorized,e8718787613d4f5ca8e57332512eb956,SALES-POS,20-30,2018,9,13,16,35,Thursday,7 days,72803.421
ACC-2173390920,27,29.0,5963.84,,CUS-3180318393,2018-09-13,Luis,M,-37.58,144.71,,,,,,,debit,posted,631436941ad34903b2205ad1192025e0,PAYMENT,20-30,2018,9,13,17,0,Thursday,7 days,72803.421
ACC-2173390920,27,34.1,5929.74,0.0,CUS-3180318393,2018-09-14,Luis,M,-37.58,144.71,,b0bfc66e-5739-461d-bf38-b02bd1c3b9ec,-37.7,145.1,VIC,Greensborough,debit,authorized,9d32f09afaec477789994561f451ce38,POS,20-30,2018,9,14,0,43,Friday,7 days,72803.421
ACC-2173390920,27,15.59,5914.15,1.0,CUS-3180318393,2018-09-14,Luis,M,-37.58,144.71,,794a7032-af6d-4b30-bbd5-d0a3757e1640,-37.73,145.14,VIC,Eltham,debit,authorized,9d6e77c111de483693602b69736519e6,POS,20-30,2018,9,14,4,36,Friday,7 days,72803.421
ACC-2173390920,27,24.53,5889.62,0.0,CUS-3180318393,2018-09-14,Luis,M,-37.58,144.71,,4a09c870-8feb-40ee-a34f-d05c8004e41a,-38.27,144.66,VIC,Queenscliff,debit,authorized,f1e66e02820e410d9d8a185f81cae29f,SALES-POS,20-30,2018,9,14,14,4,Friday,7 days,72803.421
ACC-2173390920,27,31.49,5858.13,1.0,CUS-3180318393,2018-09-14,Luis,M,-37.58,144.71,,f15d18c4-ecaf-4b25-bed9-6e7b7c177e72,-37.75,145,VIC,Thornbury,debit,authorized,245d6884e2904a96ba09ba3d7fb9266b,POS,20-30,2018,9,14,15,25,Friday,7 days,72803.421
ACC-2173390920,27,28.84,7225.52,1.0,CUS-3180318393,2018-09-18,Luis,M,-37.58,144.71,,702647d7-098f-4e9a-8caf-7767619301dd,-38.03,145.34,VIC,Berwick,debit,authorized,9cb80b77df494d9a94c6eaa8516bf60a,POS,20-30,2018,9,18,4,38,Tuesday,7 days,72803.421
ACC-2173390920,27,28.0,7197.52,,CUS-3180318393,2018-09-18,Luis,M,-37.58,144.71,,,,,,,debit,posted,6eb8b2882ef74b7e914f702aeff30679,PAYMENT,20-30,2018,9,18,14,0,Tuesday,7 days,72803.421
ACC-2173390920,27,29.0,7168.52,,CUS-3180318393,2018-09-19,Luis,M,-37.58,144.71,,,,,,,debit,posted,047d3246c6894150bb27fb815e960fc6,PAYMENT,20-30,2018,9,19,10,0,Wednesday,7 days,72803.421
ACC-2173390920,27,67.0,7101.52,,CUS-3180318393,2018-09-19,Luis,M,-37.58,144.71,,,,,,,debit,posted,499421ff39a84e5d990781a512360c9a,PHONE BANK,20-30,2018,9,19,21,0,Wednesday,7 days,72803.421
ACC-2173390920,27,76.53,7024.99,0.0,CUS-3180318393,2018-09-20,Luis,M,-37.58,144.71,,47006eee-a018-4b07-8f14-bddf4b824fef,-37.82,144.96,VIC,Melbourne,debit,authorized,5a9308fd127845a1b69dc07f617f06c3,SALES-POS,20-30,2018,9,20,8,9,Thursday,7 days,72803.421
ACC-2173390920,27,37.92,6987.07,0.0,CUS-3180318393,2018-09-20,Luis,M,-37.58,144.71,,76203fea-df0e-4e9c-bcd9-6a33418a72cf,-37.65,145.07,VIC,South Morang,debit,authorized,49963bab87f04718915a9580bac0ae03,POS,20-30,2018,9,20,8,33,Thursday,7 days,72803.421
ACC-2173390920,27,29.0,6958.07,,CUS-3180318393,2018-09-20,Luis,M,-37.58,144.71,,,,,,,debit,posted,5853fc1ba07b48a8b9bd8c412bc8195c,PAYMENT,20-30,2018,9,20,17,0,Thursday,7 days,72803.421
ACC-2173390920,27,140.0,6818.07,,CUS-3180318393,2018-09-22,Luis,M,-37.58,144.71,,,,,,,debit,posted,d82e201dcedb498e9880a1aaa6e813b6,INTER BANK,20-30,2018,9,22,12,0,Saturday,7 days,72803.421
ACC-2173390920,27,14.58,6803.49,1.0,CUS-3180318393,2018-09-22,Luis,M,-37.58,144.71,,6e6da949-1cd4-4615-8359-619f52f34184,-36.36,144.7,VIC,Rochester,debit,authorized,f7b8e7ee39ec4f2087dc0d14899eabf8,SALES-POS,20-30,2018,9,22,20,19,Saturday,7 days,72803.421
ACC-2173390920,27,22.67,6780.82,1.0,CUS-3180318393,2018-09-22,Luis,M,-37.58,144.71,,bf84c95e-b2ea-4c0b-a651-2fa3f686a890,-37.83,145.06,VIC,Camberwell,debit,authorized,5d8fd3caaec640efadc7247e003cce93,SALES-POS,20-30,2018,9,22,22,8,Saturday,7 days,72803.421
ACC-2173390920,27,31.28,6749.54,1.0,CUS-3180318393,2018-09-23,Luis,M,-37.58,144.71,,8ba5b742-71da-4488-8e4f-0fccd80871f3,-37.57,144.92,VIC,Craigieburn,debit,authorized,7d274dad38d149bc843de9acf3c6f341,POS,20-30,2018,9,23,9,3,Sunday,7 days,72803.421
ACC-2173390920,27,21.65,6727.89,0.0,CUS-3180318393,2018-09-24,Luis,M,-37.58,144.71,,c53a7265-cfeb-4c22-adc0-0b4372dcbd17,-37.65,145.02,VIC,Epping,debit,authorized,2c40000caa244ecea8d4e1b61086dd00,POS,20-30,2018,9,24,1,3,Monday,7 days,72803.421
ACC-2173390920,27,23.84,6704.05,1.0,CUS-3180318393,2018-09-24,Luis,M,-37.58,144.71,,fb06396b-7c0b-4197-8ca7-c0635e6221af,-37.74,145.03,VIC,Preston,debit,authorized,134453f0ac704972bf75fe588d17bde0,POS,20-30,2018,9,24,9,1,Monday,7 days,72803.421
ACC-2173390920,27,31.34,8068.94,1.0,CUS-3180318393,2018-09-25,Luis,M,-37.58,144.71,,7c6c5c99-7e7f-4e73-b7ca-543d10aa4901,-37.57,144.92,VIC,Craigieburn,debit,authorized,6917ac0a597344bf9b0e378359908f9b,SALES-POS,20-30,2018,9,25,8,56,Tuesday,7 days,72803.421
ACC-2173390920,27,28.0,8040.94,,CUS-3180318393,2018-09-25,Luis,M,-37.58,144.71,,,,,,,debit,posted,33fba50bab8d49dfafdd712e02173c0d,PAYMENT,20-30,2018,9,25,14,0,Tuesday,7 days,72803.421
ACC-2173390920,27,27.7,8013.24,1.0,CUS-3180318393,2018-09-25,Luis,M,-37.58,144.71,,198c2a0c-3eb7-4e5c-9c0e-5e9b4ff99a90,-37.6,140.31,SA,Millicent,debit,authorized,9f685895833643b0a7e0370380da9d36,SALES-POS,20-30,2018,9,25,19,28,Tuesday,7 days,72803.421
ACC-2173390920,27,29.0,7984.24,,CUS-3180318393,2018-09-26,Luis,M,-37.58,144.71,,,,,,,debit,posted,be83897d7ab1486bb7c563a1890f9036,PAYMENT,20-30,2018,9,26,10,0,Wednesday,7 days,72803.421
ACC-2173390920,27,67.0,7917.24,,CUS-3180318393,2018-09-26,Luis,M,-37.58,144.71,,,,,,,debit,posted,e1c8331a58c042498dd54c81355fcc30,PHONE BANK,20-30,2018,9,26,21,0,Wednesday,7 days,72803.421
ACC-2173390920,27,29.0,7888.24,,CUS-3180318393,2018-09-27,Luis,M,-37.58,144.71,,,,,,,debit,posted,fa83b0174e65454d85245e0ecda87017,PAYMENT,20-30,2018,9,27,17,0,Thursday,7 days,72803.421
ACC-2173390920,27,71.0,7817.24,,CUS-3180318393,2018-09-28,Luis,M,-37.58,144.71,,,,,,,debit,posted,de0d6f994d3146ddb43433b78e34d83f,PAYMENT,20-30,2018,9,28,21,0,Friday,7 days,72803.421
ACC-2173390920,27,30.41,7786.83,1.0,CUS-3180318393,2018-09-29,Luis,M,-37.58,144.71,,486ab587-9ee6-4a46-bf3f-49652cca5b5b,-37.65,145.07,VIC,Mill Park,debit,authorized,7ed3bb16f7794421b759793352048aac,SALES-POS,20-30,2018,9,29,13,25,Saturday,7 days,72803.421
ACC-2173390920,27,85.0,7701.83,0.0,CUS-3180318393,2018-09-29,Luis,M,-37.58,144.71,,0322397f-0018-4b53-97ee-7171659ea3ae,-37.68,144.92,VIC,Broadmeadows,debit,authorized,8a3d2efb2316420691fa9c3b667042e5,SALES-POS,20-30,2018,9,29,22,2,Saturday,7 days,72803.421
ACC-2173390920,27,28.0,9070.06,,CUS-3180318393,2018-10-02,Luis,M,-37.58,144.71,,,,,,,debit,posted,fc0e9b3d8fb54115871eb491719fee8f,PAYMENT,20-30,2018,10,2,14,0,Tuesday,7 days,72803.421
ACC-2173390920,27,179.0,8891.06,,CUS-3180318393,2018-10-03,Luis,M,-37.58,144.71,,,,,,,debit,posted,70bdd195144542118d871c17629a8692,PAYMENT,20-30,2018,10,3,8,0,Wednesday,7 days,72803.421
ACC-2173390920,27,29.0,8862.06,,CUS-3180318393,2018-10-03,Luis,M,-37.58,144.71,,,,,,,debit,posted,5c3a1865f398489d9c5d341603e16d7e,PAYMENT,20-30,2018,10,3,10,0,Wednesday,7 days,72803.421
ACC-2173390920,27,67.0,8795.06,,CUS-3180318393,2018-10-03,Luis,M,-37.58,144.71,,,,,,,debit,posted,dde2d09a692445d4a56449937dac8829,PHONE BANK,20-30,2018,10,3,21,0,Wednesday,7 days,72803.421
ACC-2173390920,27,29.0,8766.06,,CUS-3180318393,2018-10-04,Luis,M,-37.58,144.71,,,,,,,debit,posted,09ad809e54ad477c982f1a7cd851083a,PAYMENT,20-30,2018,10,4,17,0,Thursday,7 days,72803.421
ACC-2173390920,27,28.0,10134.29,,CUS-3180318393,2018-10-09,Luis,M,-37.58,144.71,,,,,,,debit,posted,d69fc28812d64d708e17286fff13f336,PAYMENT,20-30,2018,10,9,14,0,Tuesday,7 days,72803.421
ACC-2173390920,27,29.0,10105.29,,CUS-3180318393,2018-10-10,Luis,M,-37.58,144.71,,,,,,,debit,posted,7933e62bc8b54dc2a9c1d6994883e66c,PAYMENT,20-30,2018,10,10,10,0,Wednesday,7 days,72803.421
ACC-2173390920,27,67.0,10038.29,,CUS-3180318393,2018-10-10,Luis,M,-37.58,144.71,,,,,,,debit,posted,c99194b61f384c40a10634255d27db52,PHONE BANK,20-30,2018,10,10,21,0,Wednesday,7 days,72803.421
ACC-2173390920,27,29.0,10009.29,,CUS-3180318393,2018-10-11,Luis,M,-37.58,144.71,,,,,,,debit,posted,bd0a3b39c2c14e02a36a52edffc77550,PAYMENT,20-30,2018,10,11,17,0,Thursday,7 days,72803.421
ACC-2173390920,27,28.0,11377.52,,CUS-3180318393,2018-10-16,Luis,M,-37.58,144.71,,,,,,,debit,posted,2decc35c8037463588052f937aee4ac6,PAYMENT,20-30,2018,10,16,14,0,Tuesday,7 days,72803.421
ACC-2173390920,27,29.0,11348.52,,CUS-3180318393,2018-10-17,Luis,M,-37.58,144.71,,,,,,,debit,posted,ebfe676ed9f04732920bad7c00552921,PAYMENT,20-30,2018,10,17,10,0,Wednesday,7 days,72803.421
ACC-2173390920,27,67.0,11281.52,,CUS-3180318393,2018-10-17,Luis,M,-37.58,144.71,,,,,,,debit,posted,a5bfc598f27f4b31a0f3abed8912b768,PHONE BANK,20-30,2018,10,17,21,0,Wednesday,7 days,72803.421
ACC-2173390920,27,29.0,11252.52,,CUS-3180318393,2018-10-18,Luis,M,-37.58,144.71,,,,,,,debit,posted,7f0986ec3dd54190bd5c686e009a1238,PAYMENT,20-30,2018,10,18,17,0,Thursday,7 days,72803.421
ACC-2173390920,27,140.0,11112.52,,CUS-3180318393,2018-10-22,Luis,M,-37.58,144.71,,,,,,,debit,posted,3fcb334bb44c42dbb9b8c5aecb7f31c4,INTER BANK,20-30,2018,10,22,12,0,Monday,7 days,72803.421
ACC-2173390920,27,19.23,12489.52,1.0,CUS-3180318393,2018-10-22,Luis,M,-37.58,144.71,,798f87f6-f0d5-4165-b84b-d2801c47ccd2,-37.65,145.01,VIC,Epping,debit,authorized,70caa4ed02fd4429a71234f3ddd34e9c,POS,20-30,2018,10,22,15,22,Monday,7 days,72803.421
ACC-2173390920,27,28.0,12461.52,,CUS-3180318393,2018-10-23,Luis,M,-37.58,144.71,,,,,,,debit,posted,c391372fdc3b4bf9afb46b578bcd358b,PAYMENT,20-30,2018,10,23,14,0,Tuesday,7 days,72803.421
ACC-2173390920,27,29.0,12432.52,,CUS-3180318393,2018-10-24,Luis,M,-37.58,144.71,,,,,,,debit,posted,2241612aa14f47879ce09b00ef5d7764,PAYMENT,20-30,2018,10,24,10,0,Wednesday,7 days,72803.421
ACC-2173390920,27,67.0,12365.52,,CUS-3180318393,2018-10-24,Luis,M,-37.58,144.71,,,,,,,debit,posted,7308304cc8754ff18d5663bf3076fcf1,PHONE BANK,20-30,2018,10,24,21,0,Wednesday,7 days,72803.421
ACC-2173390920,27,29.0,12336.52,,CUS-3180318393,2018-10-25,Luis,M,-37.58,144.71,,,,,,,debit,posted,9d556a73ee5e4a24879badb62df909d8,PAYMENT,20-30,2018,10,25,17,0,Thursday,7 days,72803.421
ACC-2173390920,27,71.0,12265.52,,CUS-3180318393,2018-10-28,Luis,M,-37.58,144.71,,,,,,,debit,posted,5b2b022eca034e06b84c076267fe1967,PAYMENT,20-30,2018,10,28,21,0,Sunday,7 days,72803.421
ACC-2173390920,27,28.0,13633.75,,CUS-3180318393,2018-10-30,Luis,M,-37.58,144.71,,,,,,,debit,posted,0ada19b7e19748e687b4a7ebbc65ddd1,PAYMENT,20-30,2018,10,30,14,0,Tuesday,7 days,72803.421
ACC-2173390920,27,29.0,13604.75,,CUS-3180318393,2018-10-31,Luis,M,-37.58,144.71,,,,,,,debit,posted,4a1f13db0bc5458fa309759a61ae5b92,PAYMENT,20-30,2018,10,31,10,0,Wednesday,7 days,72803.421
ACC-2173390920,27,67.0,13537.75,,CUS-3180318393,2018-10-31,Luis,M,-37.58,144.71,,,,,,,debit,posted,b2c42c27bb24464cb5e3e0ffbf9b1977,PHONE BANK,20-30,2018,10,31,21,0,Wednesday,7 days,72803.421
ACC-1243371644,42,150.0,754.2,,CUS-3904958894,2018-08-01,Gregory,M,-33.78,150.90,,,,,,,debit,posted,f0f8a22361d54153a8ff90da73e5e351,PAYMENT,40-50,2018,8,1,10,0,Wednesday,14 days,43841.193
ACC-1243371644,42,64.98,689.22,1.0,CUS-3904958894,2018-08-01,Gregory,M,-33.78,150.90,,a33597e2-742c-4bde-aa32-880e687454b2,-33.79,151.2,NSW,Chatswood,debit,authorized,7439e4de7ee64643bae56d82cf6d60ec,POS,40-50,2018,8,1,11,18,Wednesday,14 days,43841.193
ACC-1243371644,42,28.16,661.06,1.0,CUS-3904958894,2018-08-02,Gregory,M,-33.78,150.90,,dd297a7b-d6e0-4706-9729-0d25cc2eba14,-34.42,150.89,NSW,Wollongong,debit,authorized,7b49e0ea5d944e88bf3991f70a2c97e7,POS,40-50,2018,8,2,17,7,Thursday,14 days,43841.193
ACC-1243371644,42,24.47,636.59,1.0,CUS-3904958894,2018-08-02,Gregory,M,-33.78,150.90,,bb7c5b63-4b10-431d-98ac-1acc5a986c0b,-33.76,151.27,NSW,Brookvale,debit,authorized,f6f7c8ad4d0b4d7bb6bf8450587badab,POS,40-50,2018,8,2,17,36,Thursday,14 days,43841.193
ACC-1243371644,42,30.69,605.9,1.0,CUS-3904958894,2018-08-02,Gregory,M,-33.78,150.90,,6ebd2df0-cac1-4f66-a979-01fb18c1f129,-33.8,150.99,NSW,Northmead,debit,authorized,5d959e6ef2204df7b0a0ec4ed5d65345,SALES-POS,40-50,2018,8,2,19,7,Thursday,14 days,43841.193
ACC-1243371644,42,17.37,588.53,1.0,CUS-3904958894,2018-08-03,Gregory,M,-33.78,150.90,,64fc3edc-7613-42c4-b969-63b58e15d159,-33.85,151.22,NSW,Kirribilli,debit,authorized,c208618388be4c299d1716b93b25c66e,POS,40-50,2018,8,3,14,40,Friday,14 days,43841.193
ACC-1243371644,42,13.19,575.34,1.0,CUS-3904958894,2018-08-03,Gregory,M,-33.78,150.90,,a676b903-4684-4757-8f5a-faa8ec453947,-33.79,151.27,NSW,Balgowlah,debit,authorized,ab0bf5ce8cb24c2db345eae52b86b35b,SALES-POS,40-50,2018,8,3,15,58,Friday,14 days,43841.193
ACC-1243371644,42,52.19,523.15,1.0,CUS-3904958894,2018-08-06,Gregory,M,-33.78,150.90,,4d0051b3-91be-4db7-b397-ac82ea844118,-33.84,151.21,NSW,North Sydney,debit,authorized,9f22d6a6bbe54ef0a131f4ad38cccc6b,SALES-POS,40-50,2018,8,6,12,28,Monday,14 days,43841.193
ACC-1243371644,42,26.34,496.81,1.0,CUS-3904958894,2018-08-06,Gregory,M,-33.78,150.90,,c38d0948-0f40-4c37-994e-9f7fee3a844d,-33.73,151.08,NSW,Thornleigh,debit,authorized,34c9ce5cf98c448d9dca986597ff914d,POS,40-50,2018,8,6,14,2,Monday,14 days,43841.193
ACC-1243371644,42,47.76,449.05,1.0,CUS-3904958894,2018-08-06,Gregory,M,-33.78,150.90,,954d32f0-8a3e-4977-94b9-ea7fd1816e9f,-33.73,151.01,NSW,Castle Hill,debit,authorized,4f486e46905e492699db9e761d61e078,POS,40-50,2018,8,6,16,18,Monday,14 days,43841.193
ACC-1243371644,42,20.0,429.05,,CUS-3904958894,2018-08-07,Gregory,M,-33.78,150.90,,,,,,,debit,posted,4f5cb51362d3467ea3313084ce030489,INTER BANK,40-50,2018,8,7,17,0,Tuesday,14 days,43841.193
ACC-1243371644,42,34.93,394.12,1.0,CUS-3904958894,2018-08-08,Gregory,M,-33.78,150.90,,991d0c98-f666-4767-a732-71ae71499c2a,-34.67,150.85,NSW,Kiama,debit,authorized,9be2579704e14b9fa7f0aa9b2dd651d1,POS,40-50,2018,8,8,19,59,Wednesday,14 days,43841.193
ACC-1243371644,42,91.0,303.12,,CUS-3904958894,2018-08-09,Gregory,M,-33.78,150.90,,,,,,,debit,posted,6529f1455f10442b8ce654a4e92e3f3f,PAYMENT,40-50,2018,8,9,2,0,Thursday,14 days,43841.193
ACC-1243371644,42,34.91,1949.79,1.0,CUS-3904958894,2018-08-10,Gregory,M,-33.78,150.90,,d1228707-83b1-46f6-9083-9d997ea30e4d,-33.79,151.2,NSW,North Willoughby,debit,authorized,85682d8da31b4cc8abd9e2d744d15731,POS,40-50,2018,8,10,12,39,Friday,14 days,43841.193
ACC-1243371644,42,12.3,1937.49,1.0,CUS-3904958894,2018-08-10,Gregory,M,-33.78,150.90,,253b63e9-4644-4eff-bfb2-12b5edb999ae,-33.93,151.17,NSW,Mascot,debit,authorized,8ac1d92fcf054eb2a93dc254dff1d3c7,SALES-POS,40-50,2018,8,10,20,50,Friday,14 days,43841.193
ACC-1243371644,42,194.0,1743.49,,CUS-3904958894,2018-08-13,Gregory,M,-33.78,150.90,,,,,,,debit,posted,1eb7c82786674064b2dd2834f3c39fd0,PAYMENT,40-50,2018,8,13,9,0,Monday,14 days,43841.193
ACC-1243371644,42,20.0,1723.49,,CUS-3904958894,2018-08-14,Gregory,M,-33.78,150.90,,,,,,,debit,posted,76a06c2818db4c37854f3bafd2ea3d7d,INTER BANK,40-50,2018,8,14,17,0,Tuesday,14 days,43841.193
ACC-1243371644,42,130.0,1593.49,,CUS-3904958894,2018-08-17,Gregory,M,-33.78,150.90,,,,,,,debit,posted,a4c9fc56da8a4c93b43a6f6749b4bf93,PAYMENT,40-50,2018,8,17,14,0,Friday,14 days,43841.193
ACC-1243371644,42,165.26,1428.23,0.0,CUS-3904958894,2018-08-20,Gregory,M,-33.78,150.90,,a8c127a3-f399-4861-91ea-159125f1837c,-33.66,115.34,WA,Busselton,debit,authorized,1ed8e800689a40a49c277dac3de6ea7b,SALES-POS,40-50,2018,8,20,14,59,Monday,14 days,43841.193
ACC-1243371644,42,20.0,1408.23,,CUS-3904958894,2018-08-21,Gregory,M,-33.78,150.90,,,,,,,debit,posted,c015ebf49c4646069d3b4ba7707ef16d,INTER BANK,40-50,2018,8,21,17,0,Tuesday,14 days,43841.193
ACC-1243371644,42,18.53,1389.7,1.0,CUS-3904958894,2018-08-22,Gregory,M,-33.78,150.90,,8ef27717-927e-4c96-ac19-e804a24c8126,-33.8,151.18,NSW,Chatswood,debit,authorized,bb2276de21594cd99530fd15f9861780,POS,40-50,2018,8,22,11,12,Wednesday,14 days,43841.193
ACC-1243371644,42,44.17,1345.53,1.0,CUS-3904958894,2018-08-22,Gregory,M,-33.78,150.90,,46905ba4-bd50-4978-9312-45a825663d35,-33.91,151.24,NSW,Randwick,debit,authorized,08bd1a857522448fa11cf30ee0d2b376,SALES-POS,40-50,2018,8,22,13,44,Wednesday,14 days,43841.193
ACC-1243371644,42,5.63,1339.9,0.0,CUS-3904958894,2018-08-22,Gregory,M,-33.78,150.90,,4fb5e5c0-e3a9-4958-80a2-dd3faff4b1c7,-33.72,151.13,NSW,Turramurra,debit,authorized,2f84f188935d4810b30731a1704969e8,SALES-POS,40-50,2018,8,22,14,39,Wednesday,14 days,43841.193
ACC-1243371644,42,19.52,1320.38,1.0,CUS-3904958894,2018-08-22,Gregory,M,-33.78,150.90,,6464e14d-4b6c-43f2-8635-061c7fd80568,-33.76,151.3,NSW,Dee Why,debit,authorized,d59e4d5cf89b4f8fa20317a2a9f89fbf,POS,40-50,2018,8,22,15,11,Wednesday,14 days,43841.193
ACC-1243371644,42,23.89,2978.07,1.0,CUS-3904958894,2018-08-23,Gregory,M,-33.78,150.90,,76420bb3-b21f-439d-bc98-9a03f6eb884e,-33.72,150.31,NSW,Katoomba,debit,authorized,49a3eec9f8374f5c8e7c5a63f3be3bb2,POS,40-50,2018,8,23,17,36,Thursday,14 days,43841.193
ACC-1243371644,42,20.0,2958.07,,CUS-3904958894,2018-08-28,Gregory,M,-33.78,150.90,,,,,,,debit,posted,3bb8778979454faf93111b09bd1c0fa8,INTER BANK,40-50,2018,8,28,17,0,Tuesday,14 days,43841.193
ACC-1243371644,42,150.0,2808.07,,CUS-3904958894,2018-09-01,Gregory,M,-33.78,150.90,,,,,,,debit,posted,c89458a5f26545069f51e4cc883c6300,PAYMENT,40-50,2018,9,1,10,0,Saturday,14 days,43841.193
ACC-1243371644,42,20.0,2788.07,,CUS-3904958894,2018-09-04,Gregory,M,-33.78,150.90,,,,,,,debit,posted,368f8d1a08eb47d4b646d6108b7d19f7,INTER BANK,40-50,2018,9,4,17,0,Tuesday,14 days,43841.193
ACC-1243371644,42,91.0,4378.65,,CUS-3904958894,2018-09-09,Gregory,M,-33.78,150.90,,,,,,,debit,posted,edc6ccdd17664e4192ecf6dfa0cc71f3,PAYMENT,40-50,2018,9,9,2,0,Sunday,14 days,43841.193
ACC-1243371644,42,20.0,4358.65,,CUS-3904958894,2018-09-11,Gregory,M,-33.78,150.90,,,,,,,debit,posted,bbb702a44e414bcaa75cedaec2edebe6,INTER BANK,40-50,2018,9,11,17,0,Tuesday,14 days,43841.193
ACC-1243371644,42,194.0,4164.65,,CUS-3904958894,2018-09-13,Gregory,M,-33.78,150.90,,,,,,,debit,posted,a97c0947d8724dd2b5ac4231da402117,PAYMENT,40-50,2018,9,13,9,0,Thursday,14 days,43841.193
ACC-1243371644,42,42.73,4121.92,1.0,CUS-3904958894,2018-09-14,Gregory,M,-33.78,150.90,,025c01c1-cea9-4f70-962c-21760f1da19d,-33.8,151.18,NSW,Chatswood,debit,authorized,ee979da881ef468b8528af09a83ec75d,SALES-POS,40-50,2018,9,14,9,37,Friday,14 days,43841.193
ACC-1243371644,42,22.34,4099.58,1.0,CUS-3904958894,2018-09-15,Gregory,M,-33.78,150.90,,80954676-2a81-4972-bd15-ff90394424db,-33.74,151.21,NSW,Frenchs Forest,debit,authorized,8e7ce8294c06406b996923e99180ae91,SALES-POS,40-50,2018,9,15,8,23,Saturday,14 days,43841.193
ACC-1243371644,42,55.24,4044.34,0.0,CUS-3904958894,2018-09-15,Gregory,M,-33.78,150.90,,c8833b7c-5cb6-4969-83cc-8f2a0651dac3,-33.79,151.14,NSW,North Ryde,debit,authorized,600df8fbccca42b39a5ae52d2d211b13,POS,40-50,2018,9,15,8,57,Saturday,14 days,43841.193
ACC-1243371644,42,25.1,4019.24,0.0,CUS-3904958894,2018-09-15,Gregory,M,-33.78,150.90,,69818774-fbbe-4b2a-a441-3e7c9581c541,-33.83,151.22,NSW,Neutral Bay,debit,authorized,356e20d99f1c4527ae9826f47862407b,POS,40-50,2018,9,15,9,39,Saturday,14 days,43841.193
ACC-1243371644,42,130.0,3889.24,,CUS-3904958894,2018-09-17,Gregory,M,-33.78,150.90,,,,,,,debit,posted,02b2b11a24284c0f9fc6ba7611fcf577,PAYMENT,40-50,2018,9,17,14,0,Monday,14 days,43841.193
ACC-1243371644,42,9.02,3880.22,1.0,CUS-3904958894,2018-09-18,Gregory,M,-33.78,150.90,,865c26d0-9dfd-4569-8f2d-67620c5121f5,-33.85,151.01,NSW,South Granville,debit,authorized,2437d7c675884238885c5b68ed7ee8cf,POS,40-50,2018,9,18,16,6,Tuesday,14 days,43841.193
ACC-1243371644,42,20.0,3832.56,,CUS-3904958894,2018-09-18,Gregory,M,-33.78,150.90,,,,,,,debit,posted,901a3a7c235c4dc79592dd2875c42752,INTER BANK,40-50,2018,9,18,17,0,Tuesday,14 days,43841.193
ACC-1243371644,42,27.66,3852.56,1.0,CUS-3904958894,2018-09-18,Gregory,M,-33.78,150.90,,51f36393-7951-4b4a-b569-d1689f4b1cd3,-33.76,151.28,NSW,Dee Why,debit,authorized,63ff5acb80594651a747d560ea122830,POS,40-50,2018,9,18,17,57,Tuesday,14 days,43841.193
ACC-1243371644,42,20.0,5494.14,,CUS-3904958894,2018-09-25,Gregory,M,-33.78,150.90,,,,,,,debit,posted,a2522ad1441d448494e68c81177a1219,INTER BANK,40-50,2018,9,25,17,0,Tuesday,14 days,43841.193
ACC-1243371644,42,150.0,5344.14,,CUS-3904958894,2018-10-01,Gregory,M,-33.78,150.90,,,,,,,debit,posted,5121c0076e114b89bc8e5d03520901d9,PAYMENT,40-50,2018,10,1,10,0,Monday,14 days,43841.193
ACC-1243371644,42,20.0,5324.14,,CUS-3904958894,2018-10-02,Gregory,M,-33.78,150.90,,,,,,,debit,posted,64ea84d471254c28a0f7bd376707d109,INTER BANK,40-50,2018,10,2,17,0,Tuesday,14 days,43841.193
ACC-1243371644,42,23.4,6982.32,1.0,CUS-3904958894,2018-10-06,Gregory,M,-33.78,150.90,,31d951c9-8a38-4573-8029-ed99335d8a50,-33.81,151.11,NSW,Ryde,debit,authorized,1347e6491037458093539496bf06a73f,SALES-POS,40-50,2018,10,6,4,52,Saturday,14 days,43841.193
ACC-1243371644,42,418.08,6564.24,0.0,CUS-3904958894,2018-10-06,Gregory,M,-33.78,150.90,,00efbb20-4fc0-4823-843a-05624e37ec5b,-33.77,150.82,NSW,Mount Druitt,debit,authorized,2c3c31d9735344288237ec4e33065354,POS,40-50,2018,10,6,11,38,Saturday,14 days,43841.193
ACC-1243371644,42,28.04,6536.2,0.0,CUS-3904958894,2018-10-06,Gregory,M,-33.78,150.90,,6102e64f-516d-4b51-bc28-87dbfe089f5c,-37.83,144.97,VIC,Southbank,debit,authorized,2d7b5da674ef44f1b69f1adaad68a68d,SALES-POS,40-50,2018,10,6,12,2,Saturday,14 days,43841.193
ACC-1243371644,42,7.54,6528.66,1.0,CUS-3904958894,2018-10-06,Gregory,M,-33.78,150.90,,f6e25247-a91e-40ef-9bf2-46a0b2bce7d2,-33.71,150.75,NSW,Llandilo,debit,authorized,d0277ec9994f42c592e1504499f5b622,POS,40-50,2018,10,6,13,46,Saturday,14 days,43841.193
ACC-1243371644,42,9.13,6519.53,1.0,CUS-3904958894,2018-10-06,Gregory,M,-33.78,150.90,,78fdf0b7-9078-4e78-b39f-9f2094e7a714,-33.76,151.21,NSW,Forestville,debit,authorized,0b722f5c338e443c9aa6345a1e725ab1,SALES-POS,40-50,2018,10,6,16,46,Saturday,14 days,43841.193
ACC-1243371644,42,24.43,6495.1,1.0,CUS-3904958894,2018-10-06,Gregory,M,-33.78,150.90,,382b8363-606d-40ae-a8b7-afac9e5d1559,-33.86,151.21,NSW,The Rocks,debit,authorized,5c08a5c5d87645f284683a2cbc7817a5,POS,40-50,2018,10,6,20,21,Saturday,14 days,43841.193
ACC-1243371644,42,487.32,6007.78,1.0,CUS-3904958894,2018-10-07,Gregory,M,-33.78,150.90,,7dee69cf-5736-4247-bccb-f9a0892ae760,-37.72,144.85,VIC,Keilor Park,debit,authorized,c76c62beabcf42808c5a3a8d4e1fffa8,SALES-POS,40-50,2018,10,7,9,19,Sunday,14 days,43841.193
ACC-1243371644,42,21.55,5986.23,1.0,CUS-3904958894,2018-10-07,Gregory,M,-33.78,150.90,,d9a00493-da23-4d6f-99ae-12323cc1ea52,-33.64,115.33,WA,Busselton,debit,authorized,df9ce7b94bb04a589c2473706d68d0fe,POS,40-50,2018,10,7,9,43,Sunday,14 days,43841.193
ACC-1243371644,42,17.26,5968.97,0.0,CUS-3904958894,2018-10-07,Gregory,M,-33.78,150.90,,f702da3a-8d3d-4878-a2bf-085dd402f5f2,-33.86,121.89,WA,Esperance,debit,authorized,1909045664cc44b19fb66b21250d1e61,SALES-POS,40-50,2018,10,7,17,25,Sunday,14 days,43841.193
ACC-1243371644,42,25.95,5943.02,0.0,CUS-3904958894,2018-10-07,Gregory,M,-33.78,150.90,,af074c2f-0f00-4fd6-8bae-9431f12f099a,-33.81,151.16,NSW,Lane Cove,debit,authorized,4bed8d7da1bb476796a4b15b8b778890,SALES-POS,40-50,2018,10,7,23,32,Sunday,14 days,43841.193
ACC-1243371644,42,17.81,5925.21,0.0,CUS-3904958894,2018-10-08,Gregory,M,-33.78,150.90,,71749ed5-03ca-4ae1-8df0-d05ceb90689d,-34.56,150.84,NSW,Shellharbour,debit,authorized,9a6054bd86a743188b209f9057d0ad47,SALES-POS,40-50,2018,10,8,9,4,Monday,14 days,43841.193
ACC-1243371644,42,196.45,5728.76,1.0,CUS-3904958894,2018-10-08,Gregory,M,-33.78,150.90,,09bb1daa-5222-4fd4-9dca-4ea49837c35f,-33.8,151.18,NSW,Chatswood,debit,authorized,6c5de2d50ce54a499f64f0abebe743b9,POS,40-50,2018,10,8,11,33,Monday,14 days,43841.193
ACC-1243371644,42,12.02,5716.74,1.0,CUS-3904958894,2018-10-08,Gregory,M,-33.78,150.90,,e5a46fd4-2048-4bc9-ab60-1e7d9ce7d1c8,-33.77,151.27,NSW,Brookvale,debit,authorized,6aaf2251bc804ebd9df05b9bc01ff283,SALES-POS,40-50,2018,10,8,18,48,Monday,14 days,43841.193
ACC-1243371644,42,15.94,5700.8,0.0,CUS-3904958894,2018-10-08,Gregory,M,-33.78,150.90,,45cfa91f-fbef-4168-93b9-b31432f44de6,-33.81,150.97,NSW,Wentworthville,debit,authorized,2dcbf24f29e547cb92540432fa4627e9,POS,40-50,2018,10,8,20,34,Monday,14 days,43841.193
ACC-1243371644,42,77.73,5623.07,0.0,CUS-3904958894,2018-10-09,Gregory,M,-33.78,150.90,,0d40d160-af20-47eb-a715-c90935884964,-33.96,151.15,NSW,Brighton-Le-Sands,debit,authorized,3dc27324f8254382a5bc5bd4d000b7b8,POS,40-50,2018,10,9,1,16,Tuesday,14 days,43841.193
ACC-1243371644,42,91.0,5532.07,,CUS-3904958894,2018-10-09,Gregory,M,-33.78,150.90,,,,,,,debit,posted,9fe13753c9864a7bb42bf3b3faab8604,PAYMENT,40-50,2018,10,9,2,0,Tuesday,14 days,43841.193
ACC-1243371644,42,30.95,5501.12,1.0,CUS-3904958894,2018-10-09,Gregory,M,-33.78,150.90,,d7715663-39b1-405a-8a79-d76feaa1f5ca,-33.71,150.32,NSW,Katoomba,debit,authorized,189c886953d54b948b6a1dd1f131c8f4,SALES-POS,40-50,2018,10,9,11,30,Tuesday,14 days,43841.193
ACC-1243371644,42,20.0,5481.12,,CUS-3904958894,2018-10-09,Gregory,M,-33.78,150.90,,,,,,,debit,posted,95bb7fe8cb7043b78c4a0e05dee1e15b,INTER BANK,40-50,2018,10,9,17,0,Tuesday,14 days,43841.193
ACC-1243371644,42,203.03,5278.09,1.0,CUS-3904958894,2018-10-12,Gregory,M,-33.78,150.90,,73aef12d-d585-45cc-aca1-9e2e55337972,-33.87,151.21,NSW,Sydney,debit,authorized,376506424fcd47d19ff1c282fded08dd,POS,40-50,2018,10,12,11,44,Friday,14 days,43841.193
ACC-1243371644,42,194.0,5084.09,,CUS-3904958894,2018-10-13,Gregory,M,-33.78,150.90,,,,,,,debit,posted,dd32d9d45e9d45c1aa9ff18403cb2718,PAYMENT,40-50,2018,10,13,9,0,Saturday,14 days,43841.193
ACC-1243371644,42,20.0,5064.09,,CUS-3904958894,2018-10-16,Gregory,M,-33.78,150.90,,,,,,,debit,posted,949b4239055f4d0ca012c149259863c9,INTER BANK,40-50,2018,10,16,17,0,Tuesday,14 days,43841.193
ACC-1243371644,42,130.0,4934.09,,CUS-3904958894,2018-10-17,Gregory,M,-33.78,150.90,,,,,,,debit,posted,3d5459f544f24121b46a4aeed44bdb6e,PAYMENT,40-50,2018,10,17,14,0,Wednesday,14 days,43841.193
ACC-1243371644,42,15.99,4918.1,0.0,CUS-3904958894,2018-10-17,Gregory,M,-33.78,150.90,,a2734444-2881-4e19-9687-cfc7814642e9,-33.77,151.26,NSW,Brookvale,debit,authorized,faf45ca672dd41a998bf8d0f0d8a24f9,SALES-POS,40-50,2018,10,17,15,9,Wednesday,14 days,43841.193
ACC-1243371644,42,53.44,6546.24,1.0,CUS-3904958894,2018-10-22,Gregory,M,-33.78,150.90,,30e4d545-b0b3-46ff-8a79-c9840ba0caab,-33.77,151.29,NSW,Curl Curl,debit,authorized,83166a86357746e3a528be62d5257d33,POS,40-50,2018,10,22,14,59,Monday,14 days,43841.193
ACC-1243371644,42,17.35,6528.89,1.0,CUS-3904958894,2018-10-22,Gregory,M,-33.78,150.90,,3ff909c2-3323-4ec5-885e-c6f6cf0b5038,-33.9,151.2,NSW,Alexandria,debit,authorized,5de4dc08e203465094ca68aa08f8cc6e,SALES-POS,40-50,2018,10,22,20,31,Monday,14 days,43841.193
ACC-1243371644,42,26.5,6502.39,0.0,CUS-3904958894,2018-10-23,Gregory,M,-33.78,150.90,,28ee26b2-8127-40b6-91b6-73b25bdbbfc0,-33.83,138.61,SA,Clare,debit,authorized,88c3607a0d5543ce8d17a707cc7b0b33,POS,40-50,2018,10,23,15,50,Tuesday,14 days,43841.193
ACC-1243371644,42,20.0,6482.39,,CUS-3904958894,2018-10-23,Gregory,M,-33.78,150.90,,,,,,,debit,posted,93f6f39e928c4942aaf4095c5dcb8eed,INTER BANK,40-50,2018,10,23,17,0,Tuesday,14 days,43841.193
ACC-1243371644,42,19.5,6462.89,0.0,CUS-3904958894,2018-10-23,Gregory,M,-33.78,150.90,,4cb86aec-ce5c-41d0-b0bf-1b7f56cf4d4a,-33.72,151.09,NSW,Thornleigh,debit,authorized,0e533d86c9424cfe913686ff4a0a1793,SALES-POS,40-50,2018,10,23,20,48,Tuesday,14 days,43841.193
ACC-1243371644,42,15.82,6447.07,1.0,CUS-3904958894,2018-10-23,Gregory,M,-33.78,150.90,,3a44104b-a925-4094-bc0e-1667f820c189,-33.98,151.08,NSW,Oatley,debit,authorized,bf3015956516431884c9d9059ffb6b64,SALES-POS,40-50,2018,10,23,22,15,Tuesday,14 days,43841.193
ACC-1243371644,42,15.95,6431.12,1.0,CUS-3904958894,2018-10-24,Gregory,M,-33.78,150.90,,f105d727-4616-4411-be10-3834a2f08f90,-33.8,151.29,NSW,Manly,debit,authorized,d54152bac9564c5e82a5c8028a349f2d,POS,40-50,2018,10,24,11,34,Wednesday,14 days,43841.193
ACC-1243371644,42,20.0,6411.12,,CUS-3904958894,2018-10-30,Gregory,M,-33.78,150.90,,,,,,,debit,posted,bccfa1a2e38d477c9c09b9e838d43db7,INTER BANK,40-50,2018,10,30,17,0,Tuesday,14 days,43841.193
ACC-1243371644,42,20.2,6390.92,1.0,CUS-3904958894,2018-10-31,Gregory,M,-33.78,150.90,,9b396220-0ff3-473d-8ad3-a169f8b37757,-37.9,145.13,VIC,Notting Hill,debit,authorized,c32375549864473b9d4d6df96c29e231,POS,40-50,2018,10,31,11,55,Wednesday,14 days,43841.193
ACC-1683215619,38,20.43,301.65,1.0,CUS-1604596597,2018-08-01,Barry,M,-34.86,138.67,,26f1b7d4-64fb-4c25-8734-47f7409fa7c1,-34.84,150.6,NSW,Bomaderry,debit,authorized,06df75936c564067b220a0660ad8b455,SALES-POS,30-40,2018,8,1,10,12,Wednesday,0 days,60833.33333333333
ACC-1683215619,38,21.79,279.86,0.0,CUS-1604596597,2018-08-01,Barry,M,-34.86,138.67,,597b6106-331b-4d3d-86f8-03931dfcf86a,-34.84,148.91,NSW,Yass,debit,authorized,685889d91567454d8b1d7074bf195504,POS,30-40,2018,8,1,21,57,Wednesday,0 days,60833.33333333333
ACC-1683215619,38,49.0,230.86,,CUS-1604596597,2018-08-02,Barry,M,-34.86,138.67,,,,,,,debit,posted,f46c7d62edb949d7a3b1810562700ad8,PAYMENT,30-40,2018,8,2,18,0,Thursday,0 days,60833.33333333333
ACC-1683215619,38,59.0,171.86,,CUS-1604596597,2018-08-03,Barry,M,-34.86,138.67,,,,,,,debit,posted,e1cd2841e99a45ff949e75c7b84cb7ec,PAYMENT,30-40,2018,8,3,3,0,Friday,0 days,60833.33333333333
ACC-1683215619,38,16.04,155.82,0.0,CUS-1604596597,2018-08-03,Barry,M,-34.86,138.67,,4fde984a-6be5-470f-ac9c-e02a6ed6fcf9,-34.96,138.61,SA,Hyde Park,debit,authorized,20c95942b3d347d9a35d06a9cc055427,POS,30-40,2018,8,3,9,58,Friday,0 days,60833.33333333333
ACC-1683215619,38,45.98,109.84,1.0,CUS-1604596597,2018-08-04,Barry,M,-34.86,138.67,,c517e9ce-fba4-4269-ac69-739d51ef969b,-30.52,151.67,NSW,Armidale,debit,authorized,9428ac7ee7314ce08052d4d9f572e7bf,POS,30-40,2018,8,4,10,25,Saturday,0 days,60833.33333333333
ACC-1683215619,38,29.95,79.89,0.0,CUS-1604596597,2018-08-04,Barry,M,-34.86,138.67,,86f838e5-2161-4e93-b259-43f5ff0db914,-34.89,150.61,NSW,Nowra,debit,authorized,c1dd0cd3a65b4bff847166a89bfafee8,POS,30-40,2018,8,4,17,6,Saturday,0 days,60833.33333333333
ACC-1683215619,38,10.3,69.59,1.0,CUS-1604596597,2018-08-04,Barry,M,-34.86,138.67,,dfa7120b-f959-4054-a8ee-81030a94eb0a,-33.87,151.21,NSW,Sydney,debit,authorized,4dfa962873424f4fa9f96db519a0354e,POS,30-40,2018,8,4,20,34,Saturday,0 days,60833.33333333333
ACC-1683215619,38,18.84,50.75,0.0,CUS-1604596597,2018-08-05,Barry,M,-34.86,138.67,,597b6106-331b-4d3d-86f8-03931dfcf86a,-34.84,148.91,NSW,Yass,debit,authorized,9c79081906824932ab9e80a394c4032b,SALES-POS,30-40,2018,8,5,8,48,Sunday,0 days,60833.33333333333
ACC-1683215619,38,7.15,43.6,0.0,CUS-1604596597,2018-08-05,Barry,M,-34.86,138.67,,bdf4377a-77a8-4634-ae40-db1fd8128577,-33.9,151.17,NSW,Enmore,debit,authorized,e66387cfde9d4ad58d0dcc0d9e1c5ed6,SALES-POS,30-40,2018,8,5,20,10,Sunday,0 days,60833.33333333333
ACC-1683215619,38,13.59,30.01,1.0,CUS-1604596597,2018-08-06,Barry,M,-34.86,138.67,,53af1b0f-e692-4178-bdc6-51fc842ecc58,-34.89,138.59,SA,Prospect,debit,authorized,007e9ef218354c9091e45b4bb82044c2,POS,30-40,2018,8,6,9,59,Monday,0 days,60833.33333333333
ACC-1683215619,38,18.78,11.23,0.0,CUS-1604596597,2018-08-07,Barry,M,-34.86,138.67,,a8723533-422b-4b61-9c94-2332339a0b59,-34.72,138.67,SA,Elizabeth,debit,authorized,0bbdfa30af574f96afa4b5a36bc854a0,POS,30-40,2018,8,7,13,24,Tuesday,0 days,60833.33333333333
ACC-1683215619,38,8.13,3.1,0.0,CUS-1604596597,2018-08-08,Barry,M,-34.86,138.67,,fcf4fe27-9b25-47cd-9d79-5107b1d6e526,-34.85,150.74,NSW,Shoalhaven Heads,debit,authorized,1ff544f193074d538c8263db41d90bd8,SALES-POS,30-40,2018,8,8,8,59,Wednesday,0 days,60833.33333333333
ACC-1683215619,38,30.94,4972.16,0.0,CUS-1604596597,2018-08-17,Barry,M,-34.86,138.67,,8459ed02-90ac-4396-9c96-2e342816d45c,-34.88,138.49,SA,West Lakes,debit,authorized,0e91dc5bb7054cb9934f19d9280a7c6f,SALES-POS,30-40,2018,8,17,16,58,Friday,0 days,60833.33333333333
ACC-1683215619,38,13.74,4958.42,1.0,CUS-1604596597,2018-08-17,Barry,M,-34.86,138.67,,1f8079f6-0f6c-4cec-8a73-393287dbca00,-34.9,138.53,SA,Findon,debit,authorized,f789fb8f56c74e61a8e6f7c3f8ae863b,SALES-POS,30-40,2018,8,17,17,9,Friday,0 days,60833.33333333333
ACC-1683215619,38,16.35,4942.07,1.0,CUS-1604596597,2018-08-17,Barry,M,-34.86,138.67,,935836d0-4b82-4fd8-82fc-4857007610a3,-34.88,150.6,NSW,Nowra,debit,authorized,6eb4349aa94442e99eaf668b6ca2bb68,POS,30-40,2018,8,17,20,16,Friday,0 days,60833.33333333333
ACC-1683215619,38,29.08,4912.99,1.0,CUS-1604596597,2018-08-17,Barry,M,-34.86,138.67,,d1b58061-e843-436f-81c9-f23508d9ba52,-34.85,138.51,SA,Port Adelaide,debit,authorized,2162da9074d64ac69f26512471edf52a,POS,30-40,2018,8,17,21,3,Friday,0 days,60833.33333333333
ACC-1683215619,38,89.18,4823.81,1.0,CUS-1604596597,2018-08-17,Barry,M,-34.86,138.67,,19e5d2d7-988b-44ff-a1b0-7523717189c3,-33.87,151.21,NSW,Sydney,debit,authorized,7a31225f08104ed090fb6a9890c333dc,SALES-POS,30-40,2018,8,17,23,18,Friday,0 days,60833.33333333333
ACC-1683215619,38,16.4,4807.41,1.0,CUS-1604596597,2018-08-17,Barry,M,-34.86,138.67,,c979d77c-5fac-48a9-8719-29a8b33d6484,-34.94,138.62,SA,Eastwood,debit,authorized,3fedbff02a164edab324303401167914,SALES-POS,30-40,2018,8,17,23,30,Friday,0 days,60833.33333333333
ACC-1683215619,38,6.93,4800.48,1.0,CUS-1604596597,2018-08-18,Barry,M,-34.86,138.67,,afbd9fcb-42d2-47b0-84b7-cca21a4ec431,-34.88,138.6,SA,Prospect,debit,authorized,808f73bf9b4f4b1d9914ce84940ea1b0,SALES-POS,30-40,2018,8,18,9,5,Saturday,0 days,60833.33333333333
ACC-1683215619,38,81.0,4719.48,,CUS-1604596597,2018-08-23,Barry,M,-34.86,138.67,,,,,,,debit,posted,7d1bd5348fdf46b680b9a81be2c3e4e1,PAYMENT,30-40,2018,8,23,10,0,Thursday,0 days,60833.33333333333
ACC-1683215619,38,49.0,4670.48,,CUS-1604596597,2018-08-23,Barry,M,-34.86,138.67,,,,,,,debit,posted,918b1058006c432e83a72fc6c5b87038,PAYMENT,30-40,2018,8,23,18,0,Thursday,0 days,60833.33333333333
ACC-1683215619,38,59.0,4611.48,,CUS-1604596597,2018-08-24,Barry,M,-34.86,138.67,,,,,,,debit,posted,43795733ed1840518b8df791d569c2a4,PAYMENT,30-40,2018,8,24,3,0,Friday,0 days,60833.33333333333
ACC-1683215619,38,49.0,4562.48,,CUS-1604596597,2018-08-30,Barry,M,-34.86,138.67,,,,,,,debit,posted,f083e4622f4d4cfabd371baaa4748001,PAYMENT,30-40,2018,8,30,18,0,Thursday,0 days,60833.33333333333
ACC-1683215619,38,59.0,4503.48,,CUS-1604596597,2018-08-31,Barry,M,-34.86,138.67,,,,,,,debit,posted,498f6951fac74dd29428721b24d8167a,PAYMENT,30-40,2018,8,31,3,0,Friday,0 days,60833.33333333333
ACC-1683215619,38,25.84,4477.64,0.0,CUS-1604596597,2018-09-04,Barry,M,-34.86,138.67,,fb5eebd0-40bd-4dbf-b74e-3a0569d6f188,-35.22,149.1,ACT,Kaleen,debit,authorized,e04c4a3681914ecdb30bac253188ae2d,POS,30-40,2018,9,4,15,46,Tuesday,0 days,60833.33333333333
ACC-1683215619,38,6.7,4470.94,1.0,CUS-1604596597,2018-09-04,Barry,M,-34.86,138.67,,155be2a9-41ee-42eb-9eb6-5d24a9497a97,-34.88,150.6,NSW,Nowra,debit,authorized,174e26e6b0164e74a145715873c47b6a,POS,30-40,2018,9,4,17,28,Tuesday,0 days,60833.33333333333
ACC-1683215619,38,49.47,4421.47,0.0,CUS-1604596597,2018-09-04,Barry,M,-34.86,138.67,,4fec12c6-b31f-41aa-a1b1-9fa793452fa5,-26.65,153.09,QLD,Maroochydore,debit,authorized,17eb7b66d33242838f29071f358fea5a,POS,30-40,2018,9,4,21,41,Tuesday,0 days,60833.33333333333
ACC-1683215619,38,70.7,4350.77,0.0,CUS-1604596597,2018-09-05,Barry,M,-34.86,138.67,,a53c08d1-0c68-44a3-9169-d73e41f55e1e,-34.86,138.58,SA,Kilburn,debit,authorized,765042a152c94697a1191fc9f60b578d,POS,30-40,2018,9,5,11,50,Wednesday,0 days,60833.33333333333
ACC-1683215619,38,49.0,4301.77,,CUS-1604596597,2018-09-06,Barry,M,-34.86,138.67,,,,,,,debit,posted,eefd9eff00034dbeb07fb48ca3feb330,PAYMENT,30-40,2018,9,6,18,0,Thursday,0 days,60833.33333333333
ACC-1683215619,38,59.0,4242.77,,CUS-1604596597,2018-09-07,Barry,M,-34.86,138.67,,,,,,,debit,posted,8480caf4d6394f13ad3e840d0fb2c856,PAYMENT,30-40,2018,9,7,3,0,Friday,0 days,60833.33333333333
ACC-1683215619,38,27.33,4215.44,1.0,CUS-1604596597,2018-09-10,Barry,M,-34.86,138.67,,8f242119-a911-4935-b7f9-39e6617b79d7,-34.88,138.49,SA,West Lakes,debit,authorized,93b0e0ce1a174b5eafefd806d242da8a,SALES-POS,30-40,2018,9,10,18,14,Monday,0 days,60833.33333333333
ACC-1683215619,38,9.68,4205.76,1.0,CUS-1604596597,2018-09-11,Barry,M,-34.86,138.67,,bf8c607e-e559-49f8-ae49-dbc068246cd2,-34.9,138.64,SA,Marden,debit,authorized,ff2916aa0da74a0a861cd30715ff0e0b,SALES-POS,30-40,2018,9,11,12,19,Tuesday,0 days,60833.33333333333
ACC-1683215619,38,53.36,4152.4,1.0,CUS-1604596597,2018-09-11,Barry,M,-34.86,138.67,,f0a81952-81ae-486d-bba2-246f4af66b5a,-34.91,150.63,NSW,Worrigee,debit,authorized,3adbafe389e34894b43b0d94525a48f2,POS,30-40,2018,9,11,14,21,Tuesday,0 days,60833.33333333333
ACC-1683215619,38,49.0,4103.4,,CUS-1604596597,2018-09-13,Barry,M,-34.86,138.67,,,,,,,debit,posted,f58087ceeee041cba22661001ad87adf,PAYMENT,30-40,2018,9,13,18,0,Thursday,0 days,60833.33333333333
ACC-1683215619,38,59.0,4044.4,,CUS-1604596597,2018-09-14,Barry,M,-34.86,138.67,,,,,,,debit,posted,daf12317a64847caa49ffc7a08e98e1c,PAYMENT,30-40,2018,9,14,3,0,Friday,0 days,60833.33333333333
ACC-1683215619,38,27.96,4016.44,1.0,CUS-1604596597,2018-09-16,Barry,M,-34.86,138.67,,42141f30-eb72-472f-8b0d-bb5d803fa00e,-34.88,150.6,NSW,Nowra,debit,authorized,914030233cfe4cb0b67d25c96c07fe62,SALES-POS,30-40,2018,9,16,21,1,Sunday,0 days,60833.33333333333
ACC-1683215619,38,18.2,3998.24,1.0,CUS-1604596597,2018-09-16,Barry,M,-34.86,138.67,,b017fbf8-ce34-4e39-a053-3eabd02c7f8e,-34.76,149.72,NSW,Goulburn,debit,authorized,a10cecb360844cd190eab1b5737402e7,POS,30-40,2018,9,16,21,28,Sunday,0 days,60833.33333333333
ACC-1683215619,38,23.47,3974.77,1.0,CUS-1604596597,2018-09-17,Barry,M,-34.86,138.67,,ad7ccfd9-0fb2-47bb-905f-6e1d97945c8c,-34.91,150.6,NSW,South Nowra,debit,authorized,0e6a32f548544636b6ff87a5cfdd68a6,POS,30-40,2018,9,17,1,39,Monday,0 days,60833.33333333333
ACC-1683215619,38,94.36,3880.41,1.0,CUS-1604596597,2018-09-17,Barry,M,-34.86,138.67,,913faf44-1f19-4b6d-a688-734c39e2ad49,-37.81,144.97,VIC,Melbourne,debit,authorized,9a5fc5148caf43a9b1be596324429c5c,POS,30-40,2018,9,17,15,21,Monday,0 days,60833.33333333333
ACC-1683215619,38,22.0,8858.41,0.0,CUS-1604596597,2018-09-19,Barry,M,-34.86,138.67,,cb30f6ec-72d1-41f9-bac8-5fe28a48f093,-34.83,148.91,NSW,Yass,debit,authorized,c701150f3fd3464e82daf9bcc4b1a769,SALES-POS,30-40,2018,9,19,11,58,Wednesday,0 days,60833.33333333333
ACC-1683215619,38,11.39,8847.02,1.0,CUS-1604596597,2018-09-19,Barry,M,-34.86,138.67,,a50076c2-94a8-4d85-9c15-35ce2c31c67f,-34.92,138.59,SA,Adelaide,debit,authorized,7aa010871ea341378f062bfdaa940a74,POS,30-40,2018,9,19,15,48,Wednesday,0 days,60833.33333333333
ACC-1683215619,38,5.39,8841.63,1.0,CUS-1604596597,2018-09-20,Barry,M,-34.86,138.67,,3b891da7-8910-4ca0-bd80-70c7d49b24d5,-34.87,150.6,NSW,Nowra,debit,authorized,85aedab2539d47bda3082da6cfd87037,POS,30-40,2018,9,20,1,55,Thursday,0 days,60833.33333333333
ACC-1683215619,38,22.91,8818.72,1.0,CUS-1604596597,2018-09-20,Barry,M,-34.86,138.67,,d6508847-14b8-4cb6-91d3-d72bb8ac0d33,-35.22,149.1,ACT,Kaleen,debit,authorized,73c5daceab7e474c9ef04ae82afbcd80,POS,30-40,2018,9,20,11,37,Thursday,0 days,60833.33333333333
ACC-1683215619,38,49.0,8769.72,,CUS-1604596597,2018-09-20,Barry,M,-34.86,138.67,,,,,,,debit,posted,3542f170c27540e8b69c01bc64fdcc02,PAYMENT,30-40,2018,9,20,18,0,Thursday,0 days,60833.33333333333
ACC-1683215619,38,24.98,8744.74,0.0,CUS-1604596597,2018-09-20,Barry,M,-34.86,138.67,,80c79cfc-4123-4733-bae7-bbfbb92b3610,-34.87,150.61,NSW,Nowra,debit,authorized,87746a5a95884faf9fcc5fa68df135c0,POS,30-40,2018,9,20,19,18,Thursday,0 days,60833.33333333333
ACC-1683215619,38,60.11,8684.63,1.0,CUS-1604596597,2018-09-20,Barry,M,-34.86,138.67,,2c4cac87-8586-4eda-8b3d-fe7be164fa00,-34.86,150.6,NSW,North Nowra,debit,authorized,7c5134a368854ace8545d72cfb66e332,POS,30-40,2018,9,20,22,21,Thursday,0 days,60833.33333333333
ACC-1683215619,38,86.45,8598.18,1.0,CUS-1604596597,2018-09-20,Barry,M,-34.86,138.67,,7d255631-a82f-4d59-8647-4daaeed18d1d,-34.96,138.64,SA,Glen Osmond,debit,authorized,cc40dea6e0fa454a848b5b72f2f3d32c,SALES-POS,30-40,2018,9,20,23,58,Thursday,0 days,60833.33333333333
ACC-1683215619,38,59.0,8539.18,,CUS-1604596597,2018-09-21,Barry,M,-34.86,138.67,,,,,,,debit,posted,c60d9b993167476a819852f48696e19c,PAYMENT,30-40,2018,9,21,3,0,Friday,0 days,60833.33333333333
ACC-1683215619,38,10.36,8528.82,1.0,CUS-1604596597,2018-09-21,Barry,M,-34.86,138.67,,fcf4fe27-9b25-47cd-9d79-5107b1d6e526,-34.85,150.74,NSW,Shoalhaven Heads,debit,authorized,7cd70dee9a6141cf9f3cf7e49c6ad336,SALES-POS,30-40,2018,9,21,14,6,Friday,0 days,60833.33333333333
ACC-1683215619,38,18.08,8510.74,1.0,CUS-1604596597,2018-09-21,Barry,M,-34.86,138.67,,eb1b9e25-f2ea-4de6-80f2-06a2e4a7a141,-34.9,138.51,SA,Seaton,debit,authorized,8f4e2e15187c463a8fbe394c6a96ce9a,SALES-POS,30-40,2018,9,21,18,27,Friday,0 days,60833.33333333333
ACC-1683215619,38,6.36,8504.38,1.0,CUS-1604596597,2018-09-21,Barry,M,-34.86,138.67,,e9f8880c-2050-4365-85df-2d7207959319,-34.88,138.49,SA,West Lakes,debit,authorized,1aa9b0c3e331473492710d4910fae2f0,POS,30-40,2018,9,21,20,2,Friday,0 days,60833.33333333333
ACC-1683215619,38,19.72,8484.66,0.0,CUS-1604596597,2018-09-21,Barry,M,-34.86,138.67,,f3b34d30-5d79-4cf1-85d4-094737b5e5e3,-34.91,138.57,SA,Hindmarsh,debit,authorized,c2acaa83dd3146f1af77e2b8ec41f166,SALES-POS,30-40,2018,9,21,20,13,Friday,0 days,60833.33333333333
ACC-1683215619,38,31.77,8452.89,1.0,CUS-1604596597,2018-09-23,Barry,M,-34.86,138.67,,c087506c-c4c6-42de-aae2-2d244e49f4be,-37.9,145.14,VIC,Mount Waverley,debit,authorized,62b024f4387140a98c60c8e9566f6927,SALES-POS,30-40,2018,9,23,2,6,Sunday,0 days,60833.33333333333
ACC-1683215619,38,81.0,8371.89,,CUS-1604596597,2018-09-23,Barry,M,-34.86,138.67,,,,,,,debit,posted,772b3a83ad1d434792e2b07f37ff247e,PAYMENT,30-40,2018,9,23,10,0,Sunday,0 days,60833.33333333333
ACC-1683215619,38,49.0,8322.89,,CUS-1604596597,2018-09-27,Barry,M,-34.86,138.67,,,,,,,debit,posted,4b1bf9939a99490b968b4cf16127a986,PAYMENT,30-40,2018,9,27,18,0,Thursday,0 days,60833.33333333333
ACC-1683215619,38,59.0,8263.89,,CUS-1604596597,2018-09-28,Barry,M,-34.86,138.67,,,,,,,debit,posted,6a57162929c149099f81c1fce98ede5d,PAYMENT,30-40,2018,9,28,3,0,Friday,0 days,60833.33333333333
ACC-1683215619,38,11.18,8252.71,0.0,CUS-1604596597,2018-10-02,Barry,M,-34.86,138.67,,5a2fe5c3-ed18-4176-907c-0b878470f70a,-34.9,138.56,SA,Welland,debit,authorized,46780426ed2b46c4a27d16194aff21ed,POS,30-40,2018,10,2,10,5,Tuesday,0 days,60833.33333333333
ACC-1683215619,38,15.2,8237.51,1.0,CUS-1604596597,2018-10-02,Barry,M,-34.86,138.67,,da253d96-3ac7-4981-a301-f86c85b6cc6d,-34.87,150.6,NSW,Nowra,debit,authorized,e1ebd58da33949c9b29e4444ad196fd7,SALES-POS,30-40,2018,10,2,13,1,Tuesday,0 days,60833.33333333333
ACC-1683215619,38,35.65,8201.86,1.0,CUS-1604596597,2018-10-03,Barry,M,-34.86,138.67,,7577cf3a-fd43-46b6-bd52-a607db99daa1,-35.01,138.52,SA,Hove,debit,authorized,f002ceebc6c646438c9a1bccc36eca19,SALES-POS,30-40,2018,10,3,0,28,Wednesday,0 days,60833.33333333333
ACC-1683215619,38,45.27,8156.59,1.0,CUS-1604596597,2018-10-04,Barry,M,-34.86,138.67,,e3a92a7a-0c39-4461-8899-25fb8a3843c2,-33.88,151.19,NSW,Ultimo,debit,authorized,c1731a5d1710423d8db61f8762d781fe,SALES-POS,30-40,2018,10,4,11,54,Thursday,0 days,60833.33333333333
ACC-1683215619,38,27.39,8129.2,0.0,CUS-1604596597,2018-10-04,Barry,M,-34.86,138.67,,2ede198d-921c-42cb-a6f9-0bb9c4238654,-34.9,138.54,SA,Findon,debit,authorized,044dd9c21a074468a3653dd27d68da53,POS,30-40,2018,10,4,15,23,Thursday,0 days,60833.33333333333
ACC-1683215619,38,13.92,8115.28,1.0,CUS-1604596597,2018-10-04,Barry,M,-34.86,138.67,,c6d9b36c-0839-448c-ba24-fc599db4dad1,-34.87,150.6,NSW,Nowra,debit,authorized,11ba5b2a53ee4db99c4c6806157abc36,SALES-POS,30-40,2018,10,4,17,8,Thursday,0 days,60833.33333333333
ACC-1683215619,38,14.8,8100.48,1.0,CUS-1604596597,2018-10-04,Barry,M,-34.86,138.67,,34fc9352-07f0-4fa2-aa8d-e2265a11926e,-34.92,138.63,SA,Norwood,debit,authorized,70f353fd31864e8d86311e1ed1cd1f58,POS,30-40,2018,10,4,17,40,Thursday,0 days,60833.33333333333
ACC-1683215619,38,49.0,8051.48,,CUS-1604596597,2018-10-04,Barry,M,-34.86,138.67,,,,,,,debit,posted,3910a4fb2e87487795f2b5f27205e45b,PAYMENT,30-40,2018,10,4,18,0,Thursday,0 days,60833.33333333333
ACC-1683215619,38,59.0,7992.48,,CUS-1604596597,2018-10-05,Barry,M,-34.86,138.67,,,,,,,debit,posted,6cbc871783ac41c19dafb8e647a9ca67,PAYMENT,30-40,2018,10,5,3,0,Friday,0 days,60833.33333333333
ACC-1683215619,38,57.98,7934.5,1.0,CUS-1604596597,2018-10-05,Barry,M,-34.86,138.67,,2c4cac87-8586-4eda-8b3d-fe7be164fa00,-34.86,150.6,NSW,North Nowra,debit,authorized,95b8f2effd564c059b1121d96476a825,SALES-POS,30-40,2018,10,5,8,49,Friday,0 days,60833.33333333333
ACC-1683215619,38,20.04,7914.46,1.0,CUS-1604596597,2018-10-05,Barry,M,-34.86,138.67,,a5d60ea9-6fbc-4dd2-b106-9c14dd48aca2,-34.87,138.55,SA,Kilkenny,debit,authorized,6e3eba748f30437e80edeb24933b0378,SALES-POS,30-40,2018,10,5,11,9,Friday,0 days,60833.33333333333
ACC-1683215619,38,23.04,7891.42,1.0,CUS-1604596597,2018-10-05,Barry,M,-34.86,138.67,,cb30f6ec-72d1-41f9-bac8-5fe28a48f093,-34.83,148.91,NSW,Yass,debit,authorized,d8920cdfa3f34433b7dec97586ab8544,SALES-POS,30-40,2018,10,5,11,24,Friday,0 days,60833.33333333333
ACC-1683215619,38,24.15,7867.27,1.0,CUS-1604596597,2018-10-05,Barry,M,-34.86,138.67,,9b95dc5c-5087-4222-a1b0-f3895eb102af,-34.87,138.49,SA,West Lakes Shore,debit,authorized,a78a0d7f6b434982aa1811a3c39a2ec2,POS,30-40,2018,10,5,17,33,Friday,0 days,60833.33333333333
ACC-1683215619,38,19.59,7847.68,1.0,CUS-1604596597,2018-10-05,Barry,M,-34.86,138.67,,b1cc2115-d9a8-4c20-817a-283686f33205,-34.85,138.5,SA,Port Adelaide,debit,authorized,f7546077ce064d1c88b1d592d554c020,SALES-POS,30-40,2018,10,5,22,6,Friday,0 days,60833.33333333333
ACC-1683215619,38,21.3,7826.38,1.0,CUS-1604596597,2018-10-06,Barry,M,-34.86,138.67,,a18e3adf-6e64-4d48-b236-5f5f58f0d3df,-35.22,149.02,ACT,Holt,debit,authorized,bf2d40162b594fbab3735d6d37fd43f1,SALES-POS,30-40,2018,10,6,20,13,Saturday,0 days,60833.33333333333
ACC-1683215619,38,22.96,7803.42,1.0,CUS-1604596597,2018-10-09,Barry,M,-34.86,138.67,,a0c40ba9-0cc6-49b1-8bdf-743091136426,-35.03,117.88,WA,Albany,debit,authorized,70600538e71c495193d6d37be03a7a9b,SALES-POS,30-40,2018,10,9,11,21,Tuesday,0 days,60833.33333333333
ACC-1683215619,38,18.57,7784.85,1.0,CUS-1604596597,2018-10-09,Barry,M,-34.86,138.67,,480fbc21-d150-4332-b961-22590e70de9b,-34.84,150.6,NSW,Bomaderry,debit,authorized,cd4e2314bcc84b789eb7d5095d344a6c,POS,30-40,2018,10,9,15,1,Tuesday,0 days,60833.33333333333
ACC-1683215619,38,13.38,7771.47,1.0,CUS-1604596597,2018-10-10,Barry,M,-34.86,138.67,,5da9f113-d911-4709-b6a3-5ff1fbb0c7be,-34.85,150.61,NSW,Bomaderry,debit,authorized,5823edc32ae1497cbcdd6ada3e8bd88f,POS,30-40,2018,10,10,10,18,Wednesday,0 days,60833.33333333333
ACC-1683215619,38,54.1,7717.37,1.0,CUS-1604596597,2018-10-10,Barry,M,-34.86,138.67,,7ed7f9e4-5e2b-40bd-b81c-4e0acd6546bc,-34.83,148.91,NSW,Yass,debit,authorized,b8325f8741e049a99045300e97d4d286,POS,30-40,2018,10,10,11,19,Wednesday,0 days,60833.33333333333
ACC-1683215619,38,96.67,7620.7,1.0,CUS-1604596597,2018-10-10,Barry,M,-34.86,138.67,,913faf44-1f19-4b6d-a688-734c39e2ad49,-37.81,144.97,VIC,Melbourne,debit,authorized,443ff333be474d25bfbf2d8a330d9714,SALES-POS,30-40,2018,10,10,12,13,Wednesday,0 days,60833.33333333333
ACC-1683215619,38,38.6,7582.1,1.0,CUS-1604596597,2018-10-10,Barry,M,-34.86,138.67,,541d1597-0657-48b1-95e4-340c4ba64956,-34.87,150.6,NSW,Nowra,debit,authorized,8c6b71f20f4c4701a83fa4dc99888a27,SALES-POS,30-40,2018,10,10,15,8,Wednesday,0 days,60833.33333333333
ACC-1683215619,38,22.86,7559.24,1.0,CUS-1604596597,2018-10-10,Barry,M,-34.86,138.67,,26f1b7d4-64fb-4c25-8734-47f7409fa7c1,-34.84,150.6,NSW,Bomaderry,debit,authorized,6e7ce0d413004a21bb96bb984a48438c,POS,30-40,2018,10,10,17,31,Wednesday,0 days,60833.33333333333
ACC-1683215619,38,95.46,7463.78,0.0,CUS-1604596597,2018-10-11,Barry,M,-34.86,138.67,,a7362ad4-39ad-40ed-a2c8-646ae8b1568d,-37.83,144.95,VIC,South Melbourne,debit,authorized,588838e679234280ba16c9da9b84208c,SALES-POS,30-40,2018,10,11,8,25,Thursday,0 days,60833.33333333333
ACC-1683215619,38,49.0,7382.9,,CUS-1604596597,2018-10-11,Barry,M,-34.86,138.67,,,,,,,debit,posted,ea40531b9efa4e878d28449500cc0bee,PAYMENT,30-40,2018,10,11,18,0,Thursday,0 days,60833.33333333333
ACC-1683215619,38,31.88,7431.9,0.0,CUS-1604596597,2018-10-11,Barry,M,-34.86,138.67,,6319318d-b8ab-478a-89f4-dbb4b2e2481e,-34.86,150.61,NSW,Bomaderry,debit,authorized,9a9a8623ea554853922b2d08b84b2086,POS,30-40,2018,10,11,18,57,Thursday,0 days,60833.33333333333
ACC-1683215619,38,59.0,7323.9,,CUS-1604596597,2018-10-12,Barry,M,-34.86,138.67,,,,,,,debit,posted,355e94d55c4043c9a8235538497cd609,PAYMENT,30-40,2018,10,12,3,0,Friday,0 days,60833.33333333333
ACC-1683215619,38,11.1,7312.8,1.0,CUS-1604596597,2018-10-13,Barry,M,-34.86,138.67,,78db6d3e-1d87-4fc5-9c22-893cd4de9fa9,-34.88,138.55,SA,Kilkenny,debit,authorized,6d77ffeaef4b4e4dbde94433f068cf1c,SALES-POS,30-40,2018,10,13,6,34,Saturday,0 days,60833.33333333333
ACC-1683215619,38,37.54,7275.26,1.0,CUS-1604596597,2018-10-13,Barry,M,-34.86,138.67,,541d1597-0657-48b1-95e4-340c4ba64956,-34.87,150.6,NSW,Nowra,debit,authorized,f4d705c0a2814ac5bd6e224040d97196,SALES-POS,30-40,2018,10,13,9,5,Saturday,0 days,60833.33333333333
ACC-1683215619,38,21.2,7254.06,0.0,CUS-1604596597,2018-10-14,Barry,M,-34.86,138.67,,c6aeaa3c-4147-4de5-9c95-f7f883a13901,-34.9,138.57,SA,Hindmarsh,debit,authorized,27fc9774dae8489483e2093b315049c8,SALES-POS,30-40,2018,10,14,3,13,Sunday,0 days,60833.33333333333
ACC-1683215619,38,29.12,7224.94,1.0,CUS-1604596597,2018-10-14,Barry,M,-34.86,138.67,,af436251-02a4-45d4-bcde-267b5cf1a562,-34.91,150.6,NSW,South Nowra,debit,authorized,ff55cc01969e4f528dd082749a8cc35d,SALES-POS,30-40,2018,10,14,8,32,Sunday,0 days,60833.33333333333
ACC-1683215619,38,62.38,7162.56,0.0,CUS-1604596597,2018-10-14,Barry,M,-34.86,138.67,,9e344a83-00aa-4814-8ba5-5c7acc0b3482,-34.88,150.6,NSW,Nowra,debit,authorized,5c0ce8f88e954e87b967b979e648a70f,POS,30-40,2018,10,14,15,59,Sunday,0 days,60833.33333333333
ACC-1683215619,38,13.01,7149.55,0.0,CUS-1604596597,2018-10-14,Barry,M,-34.86,138.67,,418f3602-0122-49c7-b9b2-66f77ad5bed2,-34.88,150.6,NSW,Nowra,debit,authorized,58364ffa22724e739d7745e4bb3b6a8d,SALES-POS,30-40,2018,10,14,18,35,Sunday,0 days,60833.33333333333
ACC-1683215619,38,16.1,7133.45,1.0,CUS-1604596597,2018-10-14,Barry,M,-34.86,138.67,,97b8c1d7-9ed2-4f57-8ffe-9760eba55ba5,-34.88,138.49,SA,West Lakes,debit,authorized,13d1d0a9b3634d58a3559dc970cd4408,SALES-POS,30-40,2018,10,14,19,9,Sunday,0 days,60833.33333333333
ACC-1683215619,38,68.35,7065.1,1.0,CUS-1604596597,2018-10-14,Barry,M,-34.86,138.67,,02dc8434-5ba7-40ee-b1c5-5771560e0c1d,-34.87,150.59,NSW,Nowra North,debit,authorized,548fb7555a364a5cb80187e70d955ff0,SALES-POS,30-40,2018,10,14,21,12,Sunday,0 days,60833.33333333333
ACC-1683215619,38,28.52,7036.58,1.0,CUS-1604596597,2018-10-15,Barry,M,-34.86,138.67,,1c58fd18-0522-4e9d-aace-f2f90c5f2027,-34.87,138.55,SA,Woodville North,debit,authorized,99ced3507f8d4285a86b540cb6d5a1db,POS,30-40,2018,10,15,9,28,Monday,0 days,60833.33333333333
ACC-1683215619,38,111.83,6924.75,1.0,CUS-1604596597,2018-10-17,Barry,M,-34.86,138.67,,202453f5-0691-418b-9164-0ccab8209fe3,-27.31,152.99,QLD,Strathpine,debit,authorized,5ef4f1fffc924283b2fc605add3f1d24,POS,30-40,2018,10,17,1,57,Wednesday,0 days,60833.33333333333
ACC-1683215619,38,10.65,6914.1,1.0,CUS-1604596597,2018-10-17,Barry,M,-34.86,138.67,,b4dead9e-8770-4cc4-abe9-9609b336fe4f,-34.89,138.61,SA,Walkerville,debit,authorized,7fdd4dcbed0845ab9ec618cd70346235,SALES-POS,30-40,2018,10,17,8,15,Wednesday,0 days,60833.33333333333
ACC-1683215619,38,30.72,6883.38,1.0,CUS-1604596597,2018-10-17,Barry,M,-34.86,138.67,,0b87405f-5f3f-4f41-9f9a-e8ad1fc726fb,-34.85,138.5,SA,Port Adelaide,debit,authorized,18e971b1ddb446229df24a2c3af8ca3b,POS,30-40,2018,10,17,9,45,Wednesday,0 days,60833.33333333333
ACC-1683215619,38,38.63,6844.75,0.0,CUS-1604596597,2018-10-17,Barry,M,-34.86,138.67,,541d1597-0657-48b1-95e4-340c4ba64956,-34.87,150.6,NSW,Nowra,debit,authorized,2371d2b7283442f19cdabfcc5be9a90a,POS,30-40,2018,10,17,10,25,Wednesday,0 days,60833.33333333333
ACC-1683215619,38,49.0,11795.75,,CUS-1604596597,2018-10-18,Barry,M,-34.86,138.67,,,,,,,debit,posted,f21a551a48d84fbd81913243b4726793,PAYMENT,30-40,2018,10,18,18,0,Thursday,0 days,60833.33333333333
ACC-1683215619,38,59.0,11736.75,,CUS-1604596597,2018-10-19,Barry,M,-34.86,138.67,,,,,,,debit,posted,162a23fb00674c93b2cfaec8a6fe6df2,PAYMENT,30-40,2018,10,19,3,0,Friday,0 days,60833.33333333333
ACC-1683215619,38,54.24,11682.51,1.0,CUS-1604596597,2018-10-19,Barry,M,-34.86,138.67,,48637546-0e61-4273-a637-d57088f5ca29,-34.87,150.6,NSW,Nowra,debit,authorized,99a7ef6990df41fb817e99104ab9a01e,SALES-POS,30-40,2018,10,19,9,57,Friday,0 days,60833.33333333333
ACC-1683215619,38,121.33,11561.18,1.0,CUS-1604596597,2018-10-19,Barry,M,-34.86,138.67,,fa2c0cba-149d-47a1-b061-8313a7642d0e,-34.84,138.48,SA,Semaphore,debit,authorized,a31fe2d39a364c48afd9cabe69ff2ded,POS,30-40,2018,10,19,11,15,Friday,0 days,60833.33333333333
ACC-1683215619,38,8.94,11552.24,1.0,CUS-1604596597,2018-10-19,Barry,M,-34.86,138.67,,13b56cec-9433-473e-a12f-5c81d27a24ae,-35.02,117.88,WA,Albany,debit,authorized,4928092ab7894401aa40455b54a4bc7f,POS,30-40,2018,10,19,15,37,Friday,0 days,60833.33333333333
ACC-1683215619,38,29.57,11522.67,1.0,CUS-1604596597,2018-10-20,Barry,M,-34.86,138.67,,42141f30-eb72-472f-8b0d-bb5d803fa00e,-34.88,150.6,NSW,Nowra,debit,authorized,3f103a5d64024d6fa088f85c5f265e2d,POS,30-40,2018,10,20,3,18,Saturday,0 days,60833.33333333333
ACC-1683215619,38,26.01,11496.66,1.0,CUS-1604596597,2018-10-20,Barry,M,-34.86,138.67,,f01cc8b4-1328-4501-8958-21e97b518510,-35.01,117.87,WA,Mount Melville,debit,authorized,db4d9db6804f4cce8e912c8b215219ef,POS,30-40,2018,10,20,9,24,Saturday,0 days,60833.33333333333
ACC-1683215619,38,26.7,11469.96,0.0,CUS-1604596597,2018-10-20,Barry,M,-34.86,138.67,,f01cc8b4-1328-4501-8958-21e97b518510,-35.01,117.87,WA,Mount Melville,debit,authorized,1449c33f392c4d26979c0d1c2503c55a,POS,30-40,2018,10,20,16,20,Saturday,0 days,60833.33333333333
ACC-1683215619,38,19.15,11450.81,1.0,CUS-1604596597,2018-10-21,Barry,M,-34.86,138.67,,a18e3adf-6e64-4d48-b236-5f5f58f0d3df,-35.22,149.02,ACT,Holt,debit,authorized,487634e755f2478aa66be896301df6de,SALES-POS,30-40,2018,10,21,10,45,Sunday,0 days,60833.33333333333
ACC-1683215619,38,21.86,11428.95,1.0,CUS-1604596597,2018-10-21,Barry,M,-34.86,138.67,,d3981e68-8c08-4c2b-89c4-99b017c1c831,-34.77,138.7,SA,Greenwith,debit,authorized,86c85f87df9c48268192682d60a7bf98,SALES-POS,30-40,2018,10,21,12,28,Sunday,0 days,60833.33333333333
ACC-1683215619,38,81.0,11347.95,,CUS-1604596597,2018-10-23,Barry,M,-34.86,138.67,,,,,,,debit,posted,843a8f5c2cb946d4b2fcddd8809899a3,PAYMENT,30-40,2018,10,23,10,0,Tuesday,0 days,60833.33333333333
ACC-1683215619,38,12.46,11335.49,1.0,CUS-1604596597,2018-10-24,Barry,M,-34.86,138.67,,5da9f113-d911-4709-b6a3-5ff1fbb0c7be,-34.85,150.61,NSW,Bomaderry,debit,authorized,e58f76836cc04f4dbb297c2bd12ea6df,POS,30-40,2018,10,24,15,44,Wednesday,0 days,60833.33333333333
ACC-1683215619,38,49.0,11286.49,,CUS-1604596597,2018-10-25,Barry,M,-34.86,138.67,,,,,,,debit,posted,347fb1b22ce14871aa4e0a8269c1f1b8,PAYMENT,30-40,2018,10,25,18,0,Thursday,0 days,60833.33333333333
ACC-1683215619,38,59.0,11227.49,,CUS-1604596597,2018-10-26,Barry,M,-34.86,138.67,,,,,,,debit,posted,82344efc80be482a9743ab9f4956b565,PAYMENT,30-40,2018,10,26,3,0,Friday,0 days,60833.33333333333
ACC-1683215619,38,23.29,11204.2,0.0,CUS-1604596597,2018-10-28,Barry,M,-34.86,138.67,,02cb9aab-54b3-489e-9189-e7750e0879aa,-34.88,150.61,NSW,Nowra,debit,authorized,364ea1132c6a4eaa9f7881fc5fe8effc,POS,30-40,2018,10,28,9,9,Sunday,0 days,60833.33333333333
ACC-1683215619,38,31.34,11172.86,1.0,CUS-1604596597,2018-10-28,Barry,M,-34.86,138.67,,3d1fb2aa-67e2-4903-adb9-97f5a8c5760e,-35.01,138.56,SA,Mitchell Park,debit,authorized,4115ea17dae7462c9012d5bf0c047dae,SALES-POS,30-40,2018,10,28,13,20,Sunday,0 days,60833.33333333333
ACC-1683215619,38,15.24,11157.62,1.0,CUS-1604596597,2018-10-29,Barry,M,-34.86,138.67,,5411564d-4045-4efd-81ca-7ebb6d473d68,-34.87,150.6,NSW,Nowra,debit,authorized,aa2f880769b0481189679e5bbf1cb497,POS,30-40,2018,10,29,22,6,Monday,0 days,60833.33333333333
ACC-1683215619,38,9.61,11148.01,1.0,CUS-1604596597,2018-10-30,Barry,M,-34.86,138.67,,abf377ce-3e2a-4f49-adff-d52bc3e93488,-35.08,147.36,NSW,North Wagga Wagga,debit,authorized,7bc679a64d954a1ebfc6d0d6c062a878,POS,30-40,2018,10,30,10,29,Tuesday,0 days,60833.33333333333
ACC-1683215619,38,12.19,11135.82,1.0,CUS-1604596597,2018-10-31,Barry,M,-34.86,138.67,,bd7c595b-b746-435d-ba9a-83e4d1a7fadd,-34.88,150.61,NSW,Nowra,debit,authorized,9c395f6d6ee245e0b6cfac7ce855c28c,SALES-POS,30-40,2018,10,31,9,59,Wednesday,0 days,60833.33333333333
ACC-1683215619,38,34.74,11101.08,0.0,CUS-1604596597,2018-10-31,Barry,M,-34.86,138.67,,ecf74caa-41c9-4559-8e49-577b1a869c67,-34.99,138.56,SA,Park Holme,debit,authorized,09823ed346ae46c08cbac6fbb3a42010,SALES-POS,30-40,2018,10,31,11,7,Wednesday,0 days,60833.33333333333
ACC-2901672282,22,31.62,1290.08,0.0,CUS-1617121891,2018-08-01,Daniel,M,-573.00,255.00,,7ce5471b-363c-46ab-b398-ca517347829a,-33.87,151.21,NSW,Sydney,debit,authorized,826f09d26daf4b7282f597cabfecaf81,SALES-POS,20-30,2018,8,1,10,27,Wednesday,14 days,86785.789
ACC-2901672282,22,95.0,1195.08,,CUS-1617121891,2018-08-01,Daniel,M,-573.00,255.00,,,,,,,debit,posted,62e49c215d7e45609556936fd7e860ce,PAYMENT,20-30,2018,8,1,11,0,Wednesday,14 days,86785.789
ACC-2901672282,22,33.0,1162.08,,CUS-1617121891,2018-08-01,Daniel,M,-573.00,255.00,,,,,,,debit,posted,c539e04478c94bb2b48af6e0069a011b,PAYMENT,20-30,2018,8,1,17,0,Wednesday,14 days,86785.789
ACC-2901672282,22,17.3,4473.55,1.0,CUS-1617121891,2018-08-04,Daniel,M,-573.00,255.00,,ac9555e4-9c7c-486b-9e65-07e2e918dd0b,-37.9,145.09,VIC,Oakleigh,debit,authorized,9467d030d2b84b4dbc419e8230fd9361,POS,20-30,2018,8,4,9,25,Saturday,14 days,86785.789
ACC-2901672282,22,17.0,4456.55,1.0,CUS-1617121891,2018-08-04,Daniel,M,-573.00,255.00,,ac9555e4-9c7c-486b-9e65-07e2e918dd0b,-37.9,145.09,VIC,Oakleigh,debit,authorized,9bf5a9c4627f4b84b16d226434842b05,SALES-POS,20-30,2018,8,4,10,6,Saturday,14 days,86785.789
ACC-2901672282,22,75.01,4381.54,0.0,CUS-1617121891,2018-08-04,Daniel,M,-573.00,255.00,,e888ea98-4249-485d-a03d-531742ecbfad,-33.74,150.95,NSW,Bella Vista,debit,authorized,ffb5612974c8491aa0879d50c642d853,POS,20-30,2018,8,4,13,57,Saturday,14 days,86785.789
ACC-2901672282,22,54.58,4326.96,1.0,CUS-1617121891,2018-08-04,Daniel,M,-573.00,255.00,,e957b3e1-e8d7-49a4-98a9-e5feba8b1a74,-33.89,151.25,NSW,Bondi Junction,debit,authorized,fb1537fbbce94c65af282b97ecbba751,POS,20-30,2018,8,4,19,27,Saturday,14 days,86785.789
ACC-2901672282,22,13.05,4313.91,1.0,CUS-1617121891,2018-08-04,Daniel,M,-573.00,255.00,,3bd6a59a-b049-4f8c-8ba0-c4285f8f5319,-37.81,144.97,VIC,Melbourne,debit,authorized,4c65c690d26f400996ee8358d7c4fed8,SALES-POS,20-30,2018,8,4,21,44,Saturday,14 days,86785.789
ACC-2901672282,22,149.91,4164.0,1.0,CUS-1617121891,2018-08-04,Daniel,M,-573.00,255.00,,1755f299-52e5-4489-a5ce-d86c236a351c,-33.82,151.19,NSW,St Leonards,debit,authorized,07dfca1297364718bd195043093ae430,SALES-POS,20-30,2018,8,4,21,49,Saturday,14 days,86785.789
ACC-2901672282,22,31.17,4132.83,1.0,CUS-1617121891,2018-08-05,Daniel,M,-573.00,255.00,,3b4cef6e-7b92-41cb-92cb-2602d25486b6,-37.82,145.03,VIC,Hawthorn,debit,authorized,efdf4db3ffa44f468ba66d0a197a5c86,POS,20-30,2018,8,5,14,3,Sunday,14 days,86785.789
ACC-2901672282,22,34.83,4098.0,0.0,CUS-1617121891,2018-08-05,Daniel,M,-573.00,255.00,,d49851c6-4f52-4118-aa58-52a8bf1465fe,-33.86,151.21,NSW,Sydney,debit,authorized,013c5a25d86e42b99bf5a840b1f5a339,SALES-POS,20-30,2018,8,5,14,54,Sunday,14 days,86785.789
ACC-2901672282,22,5.58,4092.42,1.0,CUS-1617121891,2018-08-05,Daniel,M,-573.00,255.00,,09f289b2-6d59-4325-b710-689496f66c77,-37.85,144.86,VIC,Williamstown North,debit,authorized,034e75d7425b4090983585aa86c51e48,SALES-POS,20-30,2018,8,5,15,45,Sunday,14 days,86785.789
ACC-2901672282,22,31.89,4060.53,0.0,CUS-1617121891,2018-08-05,Daniel,M,-573.00,255.00,,7fd1b176-d418-4ba9-959f-320e20a3ae05,-37.95,145.04,VIC,Highett,debit,authorized,02f5d791d31d42c49a53a5c12f284a27,POS,20-30,2018,8,5,17,4,Sunday,14 days,86785.789
ACC-2901672282,22,93.99,3966.54,0.0,CUS-1617121891,2018-08-05,Daniel,M,-573.00,255.00,,ff79add3-f5e5-441b-9c41-5b4857906995,-37.82,145,VIC,Richmond,debit,authorized,a336debb4b32448dbdb1fd3c1bb58a72,SALES-POS,20-30,2018,8,5,17,22,Sunday,14 days,86785.789
ACC-2901672282,22,58.73,3907.81,1.0,CUS-1617121891,2018-08-05,Daniel,M,-573.00,255.00,,86f6f266-ca2e-4a5e-b563-2a40bda8d2e0,-37.82,144.96,VIC,Melbourne,debit,authorized,8f1d84e15af345ffb5dbe89cec30b918,POS,20-30,2018,8,5,17,57,Sunday,14 days,86785.789
ACC-2901672282,22,1854.0,2053.81,,CUS-1617121891,2018-08-07,Daniel,M,-573.00,255.00,,,,,,,debit,posted,b242f97ab4984bb4936c4f5ed2336003,INTER BANK,20-30,2018,8,7,17,0,Tuesday,14 days,86785.789
ACC-2901672282,22,40.0,2013.81,,CUS-1617121891,2018-08-07,Daniel,M,-573.00,255.00,,,,,,,debit,posted,a6b265c698e147d99709b6e3b24f2e4b,PAYMENT,20-30,2018,8,7,23,0,Tuesday,14 days,86785.789
ACC-2901672282,22,106.0,1907.81,,CUS-1617121891,2018-08-08,Daniel,M,-573.00,255.00,,,,,,,debit,posted,16e03909a85e49e98d5d9c222097c6c4,PAYMENT,20-30,2018,8,8,12,0,Wednesday,14 days,86785.789
ACC-2901672282,22,33.0,1874.81,,CUS-1617121891,2018-08-08,Daniel,M,-573.00,255.00,,,,,,,debit,posted,f6d3df0693644ecabc3d795dfdbf77a4,PAYMENT,20-30,2018,8,8,17,0,Wednesday,14 days,86785.789
ACC-2901672282,22,136.0,1738.81,,CUS-1617121891,2018-08-14,Daniel,M,-573.00,255.00,,,,,,,debit,posted,4e6226b9878f4f919f5357b6cae1a1da,PAYMENT,20-30,2018,8,14,3,0,Tuesday,14 days,86785.789
ACC-2901672282,22,60.39,1678.42,1.0,CUS-1617121891,2018-08-14,Daniel,M,-573.00,255.00,,939bffd8-e25b-48c5-b847-c0533eb188a3,-33.87,151.21,NSW,Sydney,debit,authorized,601836ad7feb49c4895ba89d8128efd1,SALES-POS,20-30,2018,8,14,10,32,Tuesday,14 days,86785.789
ACC-2901672282,22,40.0,1638.42,,CUS-1617121891,2018-08-14,Daniel,M,-573.00,255.00,,,,,,,debit,posted,080b8c2f5dc547caa7c27037b41af875,PAYMENT,20-30,2018,8,14,23,0,Tuesday,14 days,86785.789
ACC-2901672282,22,33.0,1605.42,,CUS-1617121891,2018-08-15,Daniel,M,-573.00,255.00,,,,,,,debit,posted,115c15f7f3a248b386a56b8942c69793,PAYMENT,20-30,2018,8,15,17,0,Wednesday,14 days,86785.789
ACC-2901672282,22,17.42,1540.5,0.0,CUS-1617121891,2018-08-17,Daniel,M,-573.00,255.00,,efbb9b50-63af-4660-bb5c-37e05fca9f3f,-27.12,152.95,QLD,Morayfield,debit,authorized,796df7dabcb445a48e21428e22c7e8ce,SALES-POS,20-30,2018,8,17,9,23,Friday,14 days,86785.789
ACC-2901672282,22,53.66,4815.61,1.0,CUS-1617121891,2018-08-18,Daniel,M,-573.00,255.00,,e003ceab-8aad-4d34-9e6b-b14887e50027,-37.8,144.99,VIC,Abbotsford,debit,authorized,ea0a1451606542cf88aebac0add13342,POS,20-30,2018,8,18,0,17,Saturday,14 days,86785.789
ACC-2901672282,22,24.38,4791.23,1.0,CUS-1617121891,2018-08-18,Daniel,M,-573.00,255.00,,3c2fdebb-595a-4706-80cb-95eca94ff4ed,-27.5,153.04,QLD,Woolloongabba,debit,authorized,2d3ac23f2d3a4a05a56b2fb67472cfc9,SALES-POS,20-30,2018,8,18,1,40,Saturday,14 days,86785.789
ACC-2901672282,22,40.79,4750.44,1.0,CUS-1617121891,2018-08-18,Daniel,M,-573.00,255.00,,e073b046-7632-4b69-a46b-681be6baa67c,-33.77,151.26,NSW,Brookvale,debit,authorized,d2fde57915b04e21bfcca9cdcda8e8af,SALES-POS,20-30,2018,8,18,9,23,Saturday,14 days,86785.789
ACC-2901672282,22,1348.47,3401.97,1.0,CUS-1617121891,2018-08-18,Daniel,M,-573.00,255.00,,e15f0c00-41ea-4bbb-b1d3-ecb9c21a7abb,-35.32,149.1,ACT,Deakin,debit,authorized,2f96f2380588411e9e7ce99ab0402084,POS,20-30,2018,8,18,11,56,Saturday,14 days,86785.789
ACC-2901672282,22,40.0,3361.97,,CUS-1617121891,2018-08-21,Daniel,M,-573.00,255.00,,,,,,,debit,posted,5317552c01074558abb6207a1067054e,PAYMENT,20-30,2018,8,21,23,0,Tuesday,14 days,86785.789
ACC-2901672282,22,33.0,3328.97,,CUS-1617121891,2018-08-22,Daniel,M,-573.00,255.00,,,,,,,debit,posted,5acc41b11e1045dda0be2ecad67838d9,PAYMENT,20-30,2018,8,22,17,0,Wednesday,14 days,86785.789
ACC-2901672282,22,19.64,3309.33,1.0,CUS-1617121891,2018-08-23,Daniel,M,-573.00,255.00,,f7f1a4c4-9947-47f5-a461-2fed2ca3324c,-37.82,144.96,VIC,Melbourne,debit,authorized,03492b9e84b944b6b31d76be331155f6,SALES-POS,20-30,2018,8,23,10,3,Thursday,14 days,86785.789
ACC-2901672282,22,74.24,3235.09,1.0,CUS-1617121891,2018-08-23,Daniel,M,-573.00,255.00,,bebf9c8f-f867-42fd-b8f1-35f960d40029,-27.96,153.36,QLD,Molendinar,debit,authorized,718d05436d754a36b6c97f509b5deeeb,SALES-POS,20-30,2018,8,23,14,3,Thursday,14 days,86785.789
ACC-2901672282,22,34.25,3200.84,1.0,CUS-1617121891,2018-08-26,Daniel,M,-573.00,255.00,,f0e656b5-fcfc-44a1-b297-29826efcb2a4,-38.02,145.33,VIC,Berwick,debit,authorized,7f1c654a4fd24be48ffb7efc6dab9327,POS,20-30,2018,8,26,14,26,Sunday,14 days,86785.789
ACC-2901672282,22,74.15,3126.69,1.0,CUS-1617121891,2018-08-26,Daniel,M,-573.00,255.00,,b0e3fc82-a4d3-4740-bfb1-e2339a5e96de,-37.83,145.01,VIC,Richmond,debit,authorized,67a5be3e113745eb865e5af5688e74d6,SALES-POS,20-30,2018,8,26,14,49,Sunday,14 days,86785.789
ACC-2901672282,22,57.79,3068.9,1.0,CUS-1617121891,2018-08-26,Daniel,M,-573.00,255.00,,c517e9ce-fba4-4269-ac69-739d51ef969b,-30.52,151.67,NSW,Armidale,debit,authorized,9dbdb9e225874b948fa009329cbc347e,SALES-POS,20-30,2018,8,26,18,33,Sunday,14 days,86785.789
ACC-2901672282,22,30.37,3038.53,1.0,CUS-1617121891,2018-08-26,Daniel,M,-573.00,255.00,,b871810d-2737-45c0-8c1a-34dee0368cd3,-28.07,153.45,QLD,Miami,debit,authorized,af6ce6775c9e41e3b10ec7d60ef76cec,POS,20-30,2018,8,26,19,53,Sunday,14 days,86785.789
ACC-2901672282,22,104.04,2934.49,1.0,CUS-1617121891,2018-08-27,Daniel,M,-573.00,255.00,,19e5d2d7-988b-44ff-a1b0-7523717189c3,-33.87,151.21,NSW,Sydney,debit,authorized,d4545c15c81c482180ce5ae52b5ee7f1,POS,20-30,2018,8,27,10,3,Monday,14 days,86785.789
ACC-2901672282,22,21.42,2913.07,1.0,CUS-1617121891,2018-08-28,Daniel,M,-573.00,255.00,,ec501dcc-798e-48dd-b932-ca0fca72f92e,-37.88,145.17,VIC,Glen Waverley,debit,authorized,5f1c1b8d66934f169bb6195cf35a1ce2,SALES-POS,20-30,2018,8,28,15,35,Tuesday,14 days,86785.789
ACC-2901672282,22,7.77,2905.3,1.0,CUS-1617121891,2018-08-28,Daniel,M,-573.00,255.00,,bdf4377a-77a8-4634-ae40-db1fd8128577,-33.9,151.17,NSW,Enmore,debit,authorized,c733840ec1994e458f1a7a6abd358692,POS,20-30,2018,8,28,17,59,Tuesday,14 days,86785.789
ACC-2901672282,22,47.82,2857.48,1.0,CUS-1617121891,2018-08-28,Daniel,M,-573.00,255.00,,f6cb6b79-8707-4c6d-a6bc-2b2012de5aed,-33.87,151.19,NSW,Pyrmont,debit,authorized,719b7ea9412045308e483548391bb313,SALES-POS,20-30,2018,8,28,20,26,Tuesday,14 days,86785.789
ACC-2901672282,22,40.0,2817.48,,CUS-1617121891,2018-08-28,Daniel,M,-573.00,255.00,,,,,,,debit,posted,9e16813c687d436385bfb97c285230e7,PAYMENT,20-30,2018,8,28,23,0,Tuesday,14 days,86785.789
ACC-2901672282,22,81.46,2736.02,0.0,CUS-1617121891,2018-08-29,Daniel,M,-573.00,255.00,,9c7a33fe-c1e9-48cd-b740-26325adc0457,-33.87,151.21,NSW,Sydney,debit,authorized,249bff3bf10c4e0497e99446e094b6ae,POS,20-30,2018,8,29,4,34,Wednesday,14 days,86785.789
ACC-2901672282,22,107.09,2628.93,1.0,CUS-1617121891,2018-08-29,Daniel,M,-573.00,255.00,,f75d1ba6-c916-4906-92f6-d8beb6e19339,-37.83,145.02,VIC,Burnley,debit,authorized,552a5e273c7345b5b2eafcf24e81a9a7,SALES-POS,20-30,2018,8,29,10,5,Wednesday,14 days,86785.789
ACC-2901672282,22,33.0,2595.93,,CUS-1617121891,2018-08-29,Daniel,M,-573.00,255.00,,,,,,,debit,posted,efb9266560ff437e894dec09a19851d2,PAYMENT,20-30,2018,8,29,17,0,Wednesday,14 days,86785.789
ACC-2901672282,22,95.0,5829.7,,CUS-1617121891,2018-09-01,Daniel,M,-573.00,255.00,,,,,,,debit,posted,f810a114e2c544b0a5fcb7ebe3f19167,PAYMENT,20-30,2018,9,1,11,0,Saturday,14 days,86785.789
ACC-2901672282,22,90.62,5739.08,1.0,CUS-1617121891,2018-09-01,Daniel,M,-573.00,255.00,,b35c0649-12ba-428b-a82d-09ad6bb11bdb,-31.78,115.97,WA,Ellenbrook,debit,authorized,06f78d90b9064a48abd10d25aa20f044,POS,20-30,2018,9,1,23,14,Saturday,14 days,86785.789
ACC-2901672282,22,20.36,5718.72,1.0,CUS-1617121891,2018-09-01,Daniel,M,-573.00,255.00,,4c28d42b-d6ce-4a81-a3ed-8d69611b5bd4,-34.94,138.61,SA,Parkside,debit,authorized,813f3190221649a1b0a18678318631b8,SALES-POS,20-30,2018,9,1,23,41,Saturday,14 days,86785.789
ACC-2901672282,22,4.74,5713.98,1.0,CUS-1617121891,2018-09-02,Daniel,M,-573.00,255.00,,0e976dfc-9444-4756-930f-164e5d5aaa21,-37.85,145.05,VIC,Hawthorn East,debit,authorized,501ff15f0022414f8a13bd235f53ce03,SALES-POS,20-30,2018,9,2,11,38,Sunday,14 days,86785.789
ACC-2901672282,22,56.06,5657.92,1.0,CUS-1617121891,2018-09-02,Daniel,M,-573.00,255.00,,75b47942-0fb3-40c5-aab3-a15f60f53e61,-34.95,138.57,SA,Keswick,debit,authorized,38ed79a34ae54b579b517ab527acebc7,POS,20-30,2018,9,2,12,45,Sunday,14 days,86785.789
ACC-2901672282,22,163.55,5494.37,0.0,CUS-1617121891,2018-09-02,Daniel,M,-573.00,255.00,,9eff6ea8-061d-4e88-93a5-6711962d80ed,-37.81,145.03,VIC,Kew,debit,authorized,25c067e977ed4073826d2de0060ee6c6,POS,20-30,2018,9,2,14,8,Sunday,14 days,86785.789
ACC-2901672282,22,14.46,5479.91,1.0,CUS-1617121891,2018-09-02,Daniel,M,-573.00,255.00,,c4d6e945-af74-4562-a295-79b8b4a1d2b7,-31.95,115.85,WA,West Perth,debit,authorized,27e6c2bffc5e4501934f08be576b647e,POS,20-30,2018,9,2,18,10,Sunday,14 days,86785.789
ACC-2901672282,22,60.94,5418.97,1.0,CUS-1617121891,2018-09-03,Daniel,M,-573.00,255.00,,8c1a0ca1-7b1b-4812-8f79-8d63ca374fcc,-34.06,151.06,NSW,Royal National Park,debit,authorized,652db34e13b24f9fbd3ca72cdece6d1c,SALES-POS,20-30,2018,9,3,9,50,Monday,14 days,86785.789
ACC-2901672282,22,28.47,5390.5,0.0,CUS-1617121891,2018-09-03,Daniel,M,-573.00,255.00,,948749e3-471e-4a8f-92ad-73e934b95ec4,-33.87,151.21,NSW,Sydney,debit,authorized,13293ee513224f5db135460abd417817,SALES-POS,20-30,2018,9,3,21,38,Monday,14 days,86785.789
ACC-2901672282,22,22.42,5368.08,1.0,CUS-1617121891,2018-09-03,Daniel,M,-573.00,255.00,,abe64210-3df3-4615-83d7-5cc2c28964d6,-33.88,151.2,NSW,Ultimo,debit,authorized,303d75236c6c4add80f6768e6539c9de,POS,20-30,2018,9,3,21,50,Monday,14 days,86785.789
ACC-2901672282,22,92.49,5275.59,1.0,CUS-1617121891,2018-09-03,Daniel,M,-573.00,255.00,,f951df7c-92b7-444c-959b-e227f5bb6735,-33.85,151.05,NSW,Lidcombe,debit,authorized,da0dff91ea1f44da9cb8c8c3f6e52824,SALES-POS,20-30,2018,9,3,22,30,Monday,14 days,86785.789
ACC-2901672282,22,32.03,5243.56,1.0,CUS-1617121891,2018-09-04,Daniel,M,-573.00,255.00,,f70d646b-d9a2-44a5-9ffa-becda2a18792,-33.88,151.19,NSW,Glebe,debit,authorized,d69a0a53409e4838878224830e338488,SALES-POS,20-30,2018,9,4,1,32,Tuesday,14 days,86785.789
ACC-2901672282,22,40.0,5203.56,,CUS-1617121891,2018-09-04,Daniel,M,-573.00,255.00,,,,,,,debit,posted,d59307ecb7d349ae86a8496725703415,PAYMENT,20-30,2018,9,4,23,0,Tuesday,14 days,86785.789
ACC-2901672282,22,169.37,5034.19,1.0,CUS-1617121891,2018-09-05,Daniel,M,-573.00,255.00,,ab835c75-1a73-45bf-8b06-40c4f53a1105,-33.87,151.21,NSW,Sydney,debit,authorized,5be5010009a04e749cc05a47466c26c2,SALES-POS,20-30,2018,9,5,4,12,Wednesday,14 days,86785.789
ACC-2901672282,22,61.49,4972.7,1.0,CUS-1617121891,2018-09-05,Daniel,M,-573.00,255.00,,530dc97b-35b4-4730-8872-f9b057552c86,-34.04,150.74,NSW,Narellan,debit,authorized,36581e604ea7435688ec6f089f83d0ff,SALES-POS,20-30,2018,9,5,8,18,Wednesday,14 days,86785.789
ACC-2901672282,22,54.27,4918.43,1.0,CUS-1617121891,2018-09-05,Daniel,M,-573.00,255.00,,f03b1d54-1cde-4213-9df6-93c3a7f5f6e1,-33.88,151.21,NSW,Darlinghurst,debit,authorized,7a50fde49a4a44db9c5f928798cf563b,POS,20-30,2018,9,5,8,27,Wednesday,14 days,86785.789
ACC-2901672282,22,33.0,4885.43,,CUS-1617121891,2018-09-05,Daniel,M,-573.00,255.00,,,,,,,debit,posted,50128d8cf8b44e6396dfc9dd88107755,PAYMENT,20-30,2018,9,5,17,0,Wednesday,14 days,86785.789
ACC-2901672282,22,30.39,4855.04,1.0,CUS-1617121891,2018-09-05,Daniel,M,-573.00,255.00,,abf814cc-5f46-4652-a768-39865adf4319,-32.08,115.81,WA,Coolbellup,debit,authorized,97d1d0feef034702b2d484fdbeb02d1b,POS,20-30,2018,9,5,19,1,Wednesday,14 days,86785.789
ACC-2901672282,22,21.16,4833.88,0.0,CUS-1617121891,2018-09-05,Daniel,M,-573.00,255.00,,c9bb15db-2e66-4849-a0d2-76002bf94819,-32,115.86,WA,Como,debit,authorized,d09fad278b2b4e439f1fa275b0b05174,POS,20-30,2018,9,5,19,33,Wednesday,14 days,86785.789
ACC-2901672282,22,129.61,4704.27,1.0,CUS-1617121891,2018-09-05,Daniel,M,-573.00,255.00,,2f3bc0c3-93fd-41a4-a1cc-5ad551adbecc,-33.87,151.2,NSW,Sydney,debit,authorized,0cc65c83bd154c3b844af7edbe55692e,SALES-POS,20-30,2018,9,5,19,55,Wednesday,14 days,86785.789
ACC-2901672282,22,89.31,4614.96,0.0,CUS-1617121891,2018-09-07,Daniel,M,-573.00,255.00,,aad79b71-b881-4a40-ac25-8a8c6766a2cb,-34.42,150.89,NSW,Wollongong,debit,authorized,482771504ea24e4d9786f029f891b2b1,SALES-POS,20-30,2018,9,7,7,2,Friday,14 days,86785.789
ACC-2901672282,22,27.13,4587.83,1.0,CUS-1617121891,2018-09-07,Daniel,M,-573.00,255.00,,a95864ee-dfa5-4a65-b6ec-e5823ca2bc87,-34.92,138.59,SA,Adelaide,debit,authorized,b9a42cd316f84ac38db6b0bfe1e07aa8,POS,20-30,2018,9,7,14,48,Friday,14 days,86785.789
ACC-2901672282,22,51.8,4536.03,1.0,CUS-1617121891,2018-09-07,Daniel,M,-573.00,255.00,,b5b916b3-94c5-427e-b88f-7f60c55c35dc,-37.82,144.96,VIC,Melbourne,debit,authorized,142ea7e8c1d24af0b6e35577eaaa2566,POS,20-30,2018,9,7,15,38,Friday,14 days,86785.789
ACC-2901672282,22,40.74,4495.29,1.0,CUS-1617121891,2018-09-08,Daniel,M,-573.00,255.00,,c7d169a9-fe96-4983-8d1e-9c0c6805a31e,-33.88,151.22,NSW,Darlinghurst,debit,authorized,fb60bfe91b754a3abcfbcc23f2b6ab68,SALES-POS,20-30,2018,9,8,11,21,Saturday,14 days,86785.789
ACC-2901672282,22,106.0,4389.29,,CUS-1617121891,2018-09-08,Daniel,M,-573.00,255.00,,,,,,,debit,posted,0e51521a7e7748eaba8a1b78ff1eae75,PAYMENT,20-30,2018,9,8,12,0,Saturday,14 days,86785.789
ACC-2901672282,22,40.0,4349.29,,CUS-1617121891,2018-09-11,Daniel,M,-573.00,255.00,,,,,,,debit,posted,524aa18834004711aa7088b6c9434c31,PAYMENT,20-30,2018,9,11,23,0,Tuesday,14 days,86785.789
ACC-2901672282,22,33.0,4316.29,,CUS-1617121891,2018-09-12,Daniel,M,-573.00,255.00,,,,,,,debit,posted,643ef80181cd45c49f33312b38ba82e7,PAYMENT,20-30,2018,9,12,17,0,Wednesday,14 days,86785.789
ACC-2901672282,22,38.41,4277.88,1.0,CUS-1617121891,2018-09-13,Daniel,M,-573.00,255.00,,a1360283-370b-4de2-9c27-8c3452f7e4af,-37.82,144.97,VIC,Melbourne,debit,authorized,cda02e188eb242d09861c66bdcc9d0bd,SALES-POS,20-30,2018,9,13,0,42,Thursday,14 days,86785.789
ACC-2901672282,22,14.19,4263.69,1.0,CUS-1617121891,2018-09-13,Daniel,M,-573.00,255.00,,39d7df49-d246-45c6-bb90-5e4b3a3b003b,-33.87,151.21,NSW,Sydney,debit,authorized,9d03a54c90e44a008d0ae9bd2eaa7331,SALES-POS,20-30,2018,9,13,4,8,Thursday,14 days,86785.789
ACC-2901672282,22,15.88,4247.81,1.0,CUS-1617121891,2018-09-13,Daniel,M,-573.00,255.00,,dcd7f696-8ac8-45f0-955b-4fd3982d45cf,-37.81,144.96,VIC,Melbourne,debit,authorized,c38bb72b647d45b29b7b979394b174d4,POS,20-30,2018,9,13,8,46,Thursday,14 days,86785.789
ACC-2901672282,22,136.0,4111.81,,CUS-1617121891,2018-09-14,Daniel,M,-573.00,255.00,,,,,,,debit,posted,942768ce788848a7af5c1017c88da62d,PAYMENT,20-30,2018,9,14,3,0,Friday,14 days,86785.789
ACC-2901672282,22,132.24,3979.57,1.0,CUS-1617121891,2018-09-14,Daniel,M,-573.00,255.00,,ee7ab545-152d-45fb-b117-e98a0a6f04d7,-35.28,149.13,ACT,Canberra,debit,authorized,f158cbb8cec446a6a9e2df8ed7ed2ded,POS,20-30,2018,9,14,9,49,Friday,14 days,86785.789
ACC-2901672282,22,27.49,3952.08,1.0,CUS-1617121891,2018-09-14,Daniel,M,-573.00,255.00,,948749e3-471e-4a8f-92ad-73e934b95ec4,-33.87,151.21,NSW,Sydney,debit,authorized,66405702b5314cffafc9a2008efbe9a8,POS,20-30,2018,9,14,11,3,Friday,14 days,86785.789
ACC-2901672282,22,64.19,7216.66,1.0,CUS-1617121891,2018-09-15,Daniel,M,-573.00,255.00,,e234cbd2-be0c-4e7d-8e4b-2b84b5bac0d6,-33.87,151.21,NSW,Sydney,debit,authorized,d4ce8f349e6b405dbd7f5c3d703bf632,SALES-POS,20-30,2018,9,15,10,0,Saturday,14 days,86785.789
ACC-2901672282,22,113.25,7103.41,0.0,CUS-1617121891,2018-09-15,Daniel,M,-573.00,255.00,,2524fe8b-0b41-460d-b7d6-77fdba54657d,-33.81,151.26,NSW,Clontarf,debit,authorized,a8029ce3a2e74d0a98b15dd78c6e764c,SALES-POS,20-30,2018,9,15,10,58,Saturday,14 days,86785.789
ACC-2901672282,22,23.09,7080.32,0.0,CUS-1617121891,2018-09-16,Daniel,M,-573.00,255.00,,a1393fa3-196b-4b47-bc66-91e287c25733,-33.84,151.21,NSW,North Sydney,debit,authorized,ca7181474b59433b977f9085bea111f4,POS,20-30,2018,9,16,13,43,Sunday,14 days,86785.789
ACC-2901672282,22,70.37,7009.95,1.0,CUS-1617121891,2018-09-18,Daniel,M,-573.00,255.00,,6af715f2-d900-48df-844c-0d027f9d24fb,-33.8,151.18,NSW,Chatswood,debit,authorized,d69282a5c5f34f3d926cecfcf2822701,POS,20-30,2018,9,18,9,44,Tuesday,14 days,86785.789
ACC-2901672282,22,42.15,6967.8,1.0,CUS-1617121891,2018-09-18,Daniel,M,-573.00,255.00,,fe66093d-89d4-4bb8-ab80-a8366816ace0,-33.87,151.21,NSW,Sydney,debit,authorized,c3663c4643fc48178a0d0491a9372a15,SALES-POS,20-30,2018,9,18,22,51,Tuesday,14 days,86785.789
ACC-2901672282,22,40.0,6927.8,,CUS-1617121891,2018-09-18,Daniel,M,-573.00,255.00,,,,,,,debit,posted,5f00756424db4ac681e239d131bb719e,PAYMENT,20-30,2018,9,18,23,0,Tuesday,14 days,86785.789
ACC-2901672282,22,132.63,6795.17,1.0,CUS-1617121891,2018-09-19,Daniel,M,-573.00,255.00,,3647e656-341b-4fc7-b46e-d4b5fd2c93d4,-33.9,151.2,NSW,Alexandria,debit,authorized,e0781124736d4dfbb43b1f17ebaa4c77,POS,20-30,2018,9,19,9,28,Wednesday,14 days,86785.789
ACC-2901672282,22,56.91,6738.26,1.0,CUS-1617121891,2018-09-19,Daniel,M,-573.00,255.00,,04f1f4ef-1ffa-4038-9ff2-e2924bdd6efb,-27.98,153.34,QLD,Ashmore,debit,authorized,5f78e56befc142b380df710d100086ff,POS,20-30,2018,9,19,13,9,Wednesday,14 days,86785.789
ACC-2901672282,22,85.75,6652.51,1.0,CUS-1617121891,2018-09-19,Daniel,M,-573.00,255.00,,0888ed2d-076f-4688-a446-28a0af4cc360,-33.87,151.21,NSW,Sydney,debit,authorized,5f836ccbd110475a98b6449cdd5b2f8a,SALES-POS,20-30,2018,9,19,14,23,Wednesday,14 days,86785.789
ACC-2901672282,22,33.0,6619.51,,CUS-1617121891,2018-09-19,Daniel,M,-573.00,255.00,,,,,,,debit,posted,9e0085618ba248459f650b151221abef,PAYMENT,20-30,2018,9,19,17,0,Wednesday,14 days,86785.789
ACC-2901672282,22,40.0,6579.51,,CUS-1617121891,2018-09-25,Daniel,M,-573.00,255.00,,,,,,,debit,posted,19f46381264a4d3381b2f2781ca5b249,PAYMENT,20-30,2018,9,25,23,0,Tuesday,14 days,86785.789
ACC-2901672282,22,33.0,6546.51,,CUS-1617121891,2018-09-26,Daniel,M,-573.00,255.00,,,,,,,debit,posted,039724f0a17c4a03bedd4dfc5044322b,PAYMENT,20-30,2018,9,26,17,0,Wednesday,14 days,86785.789
ACC-2901672282,22,132.62,9742.66,0.0,CUS-1617121891,2018-09-30,Daniel,M,-573.00,255.00,,789f4f77-735c-41d4-b2dc-b9c4b5bee7d6,-33.94,151.18,NSW,Sydney,debit,authorized,168235981c80427e90cb506f57161d15,POS,20-30,2018,9,30,10,29,Sunday,14 days,86785.789
ACC-2901672282,22,64.27,9678.39,1.0,CUS-1617121891,2018-09-30,Daniel,M,-573.00,255.00,,98b27c00-c03e-4bd5-82ad-8dd92890e57e,-27.47,153.02,QLD,Brisbane City,debit,authorized,e49869c71059487eab1bda764903ce6c,SALES-POS,20-30,2018,9,30,18,50,Sunday,14 days,86785.789
ACC-2901672282,22,8.89,9669.5,0.0,CUS-1617121891,2018-09-30,Daniel,M,-573.00,255.00,,7566cead-ecd9-46fa-9555-18e453f5bad7,-33.86,151.2,NSW,Barangaroo,debit,authorized,f663c88b91b34f808ac30e3a8f9d9fde,SALES-POS,20-30,2018,9,30,19,29,Sunday,14 days,86785.789
ACC-2901672282,22,100.42,9569.08,1.0,CUS-1617121891,2018-10-01,Daniel,M,-573.00,255.00,,42ade571-5972-4160-9ecb-e0162a305fee,-33.7,151.21,NSW,Belrose,debit,authorized,2851f534fc8b4f408a487beebc28b632,POS,20-30,2018,10,1,10,34,Monday,14 days,86785.789
ACC-2901672282,22,148.7,9420.38,1.0,CUS-1617121891,2018-10-01,Daniel,M,-573.00,255.00,,ff61dd5e-938a-4acb-a1fd-03d1d2fbba4e,-33.87,151.21,NSW,Sydney,debit,authorized,0eb5487054894030a57fe35d4a9f4bfe,POS,20-30,2018,10,1,10,47,Monday,14 days,86785.789
ACC-2901672282,22,95.0,9325.38,,CUS-1617121891,2018-10-01,Daniel,M,-573.00,255.00,,,,,,,debit,posted,4337a81000014a27a73813abb4325f2e,PAYMENT,20-30,2018,10,1,11,0,Monday,14 days,86785.789
ACC-2901672282,22,28.02,9297.36,1.0,CUS-1617121891,2018-10-01,Daniel,M,-573.00,255.00,,85f205ca-dc6b-43f4-b081-859a27457643,-31.86,115.81,WA,Balcatta,debit,authorized,8f66c2538ab740aaba4c43cb6acd44ba,POS,20-30,2018,10,1,22,40,Monday,14 days,86785.789
ACC-2901672282,22,33.57,9263.79,1.0,CUS-1617121891,2018-10-02,Daniel,M,-573.00,255.00,,541ca120-5600-48cd-adca-3e638d2baffb,-27.97,153.41,QLD,Southport,debit,authorized,062d2478ff0f498d90c4110657290c50,SALES-POS,20-30,2018,10,2,2,2,Tuesday,14 days,86785.789
ACC-2901672282,22,40.0,9223.79,,CUS-1617121891,2018-10-02,Daniel,M,-573.00,255.00,,,,,,,debit,posted,4180c2de8a024c8ca3193ad4f7fda2db,PAYMENT,20-30,2018,10,2,23,0,Tuesday,14 days,86785.789
ACC-2901672282,22,30.66,9193.13,1.0,CUS-1617121891,2018-10-03,Daniel,M,-573.00,255.00,,c0fb68c6-935b-47ae-8594-e3da036d0f94,-28,153.36,QLD,Gold Coast,debit,authorized,007f48feefe3469583a1cd472616ac33,SALES-POS,20-30,2018,10,3,11,30,Wednesday,14 days,86785.789
ACC-2901672282,22,33.0,9160.13,,CUS-1617121891,2018-10-03,Daniel,M,-573.00,255.00,,,,,,,debit,posted,4e6ae5d5642b40329675e2668c478314,PAYMENT,20-30,2018,10,3,17,0,Wednesday,14 days,86785.789
ACC-2901672282,22,186.29,8973.84,1.0,CUS-1617121891,2018-10-04,Daniel,M,-573.00,255.00,,1922639f-c45a-4381-bf09-c840853a5859,-27.47,153.02,QLD,Brisbane City,debit,authorized,18a928c7e7524b3a92e3f305128e782e,POS,20-30,2018,10,4,2,38,Thursday,14 days,86785.789
ACC-2901672282,22,41.1,8932.74,1.0,CUS-1617121891,2018-10-04,Daniel,M,-573.00,255.00,,d00f8335-63b0-44a2-8584-158ee558ec6f,-34.09,151.15,NSW,Bundeena,debit,authorized,0ad400fc84964bb182f4b598db2f360c,SALES-POS,20-30,2018,10,4,8,49,Thursday,14 days,86785.789
ACC-2901672282,22,62.45,8870.29,1.0,CUS-1617121891,2018-10-04,Daniel,M,-573.00,255.00,,939bffd8-e25b-48c5-b847-c0533eb188a3,-33.87,151.21,NSW,Sydney,debit,authorized,f5e44fcf0aa645a1b7449f1b92f32d63,POS,20-30,2018,10,4,10,14,Thursday,14 days,86785.789
ACC-2901672282,22,11.23,8859.06,0.0,CUS-1617121891,2018-10-04,Daniel,M,-573.00,255.00,,5431e41f-1644-4e51-8abc-26239cb0b7c7,-16.92,145.77,QLD,Cairns City,debit,authorized,8b70fc838c574b3e836f6ad39faa52ac,POS,20-30,2018,10,4,12,39,Thursday,14 days,86785.789
ACC-2901672282,22,36.81,8822.25,1.0,CUS-1617121891,2018-10-06,Daniel,M,-573.00,255.00,,7dd64d5b-fe30-4a81-be18-03b2cf47faf1,-27.45,153.03,QLD,Fortitude Valley,debit,authorized,4768fb082c6446309183b9b20568c3fc,SALES-POS,20-30,2018,10,6,23,48,Saturday,14 days,86785.789
ACC-2901672282,22,154.56,8667.69,1.0,CUS-1617121891,2018-10-07,Daniel,M,-573.00,255.00,,0b8fab23-d4fd-45e7-acac-555c96e0b1c7,-33.87,151.2,NSW,Sydney,debit,authorized,5590969f45d7449b824bd14610788653,POS,20-30,2018,10,7,9,7,Sunday,14 days,86785.789
ACC-2901672282,22,106.0,8561.69,,CUS-1617121891,2018-10-08,Daniel,M,-573.00,255.00,,,,,,,debit,posted,07998e74cb684d78bab6533870f0516b,PAYMENT,20-30,2018,10,8,12,0,Monday,14 days,86785.789
ACC-2901672282,22,40.0,8521.69,,CUS-1617121891,2018-10-09,Daniel,M,-573.00,255.00,,,,,,,debit,posted,a5675c87b38f464b9f3a2a04cc4ea5a7,PAYMENT,20-30,2018,10,9,23,0,Tuesday,14 days,86785.789
ACC-2901672282,22,33.0,8488.69,,CUS-1617121891,2018-10-10,Daniel,M,-573.00,255.00,,,,,,,debit,posted,ff7884a9b0444d5ea9e708411ef43ccc,PAYMENT,20-30,2018,10,10,17,0,Wednesday,14 days,86785.789
ACC-2901672282,22,136.0,11681.46,,CUS-1617121891,2018-10-14,Daniel,M,-573.00,255.00,,,,,,,debit,posted,bb93fec7842c4f95a86f83bbb76a0a0c,PAYMENT,20-30,2018,10,14,3,0,Sunday,14 days,86785.789
ACC-2901672282,22,40.0,11641.46,,CUS-1617121891,2018-10-16,Daniel,M,-573.00,255.00,,,,,,,debit,posted,408d843ba0374250aec8525c9fca99e9,PAYMENT,20-30,2018,10,16,23,0,Tuesday,14 days,86785.789
ACC-2901672282,22,33.0,11608.46,,CUS-1617121891,2018-10-17,Daniel,M,-573.00,255.00,,,,,,,debit,posted,7b6fa14e2bd841d09b8acc8dd250324b,PAYMENT,20-30,2018,10,17,17,0,Wednesday,14 days,86785.789
ACC-2901672282,22,40.0,11568.46,,CUS-1617121891,2018-10-23,Daniel,M,-573.00,255.00,,,,,,,debit,posted,a89ff25555584da79787436589b93eac,PAYMENT,20-30,2018,10,23,23,0,Tuesday,14 days,86785.789
ACC-2901672282,22,33.0,11535.46,,CUS-1617121891,2018-10-24,Daniel,M,-573.00,255.00,,,,,,,debit,posted,64733ce8979142feaaf6733e5fba2c39,PAYMENT,20-30,2018,10,24,17,0,Wednesday,14 days,86785.789
ACC-2901672282,22,40.0,14824.23,,CUS-1617121891,2018-10-30,Daniel,M,-573.00,255.00,,,,,,,debit,posted,911f3f57e72b4cc9a0af0eed117ed262,PAYMENT,20-30,2018,10,30,23,0,Tuesday,14 days,86785.789
ACC-2901672282,22,33.0,14791.23,,CUS-1617121891,2018-10-31,Daniel,M,-573.00,255.00,,,,,,,debit,posted,a2e88a94fe7c4efa893fcb460251a4f8,PAYMENT,20-30,2018,10,31,17,0,Wednesday,14 days,86785.789
ACC-1652235822,38,16.13,18784.07,1.0,CUS-2206365095,2018-08-01,Renee,F,-37.81,144.89,,932b9301-65da-4718-aa78-679daba791fb,-37.78,145.13,VIC,Doncaster,debit,authorized,0a0aaf7ca4894fbeb41e69a695458fa1,SALES-POS,30-40,2018,8,1,10,41,Wednesday,14 days,40179.2
ACC-1652235822,38,7.93,18776.14,1.0,CUS-2206365095,2018-08-03,Renee,F,-37.81,144.89,,d88eb79c-ac14-4225-8615-964b35b4f638,-37.66,145.07,VIC,Mill Park,debit,authorized,a8aac4add4004a6399dd56fdd0eca68e,POS,30-40,2018,8,3,13,24,Friday,14 days,40179.2
ACC-1652235822,38,28.23,18747.91,1.0,CUS-2206365095,2018-08-03,Renee,F,-37.81,144.89,,c7d169a9-fe96-4983-8d1e-9c0c6805a31e,-33.88,151.22,NSW,Darlinghurst,debit,authorized,2e08e09018b84708a8c41a9e3e561230,POS,30-40,2018,8,3,17,28,Friday,14 days,40179.2
ACC-1652235822,38,66.0,18681.91,,CUS-2206365095,2018-08-03,Renee,F,-37.81,144.89,,,,,,,debit,posted,acdb304508c34fc2b578010bd31ee79c,PAYMENT,30-40,2018,8,3,18,0,Friday,14 days,40179.2
ACC-1652235822,38,13.09,18668.82,1.0,CUS-2206365095,2018-08-03,Renee,F,-37.81,144.89,,100ade3c-d35b-43be-a74e-be6029ebf30e,-37.88,145.13,VIC,Mount Waverley,debit,authorized,583a2f5cffd241d39fe7429a2bf06d5d,POS,30-40,2018,8,3,20,37,Friday,14 days,40179.2
ACC-1652235822,38,8.81,18660.01,1.0,CUS-2206365095,2018-08-04,Renee,F,-37.81,144.89,,b66746aa-d7ac-44e6-97d2-a53fc97c3334,-37.89,145.14,VIC,Mount Waverley,debit,authorized,29d28ba2337f4038a4fefdfe85cf58d9,SALES-POS,30-40,2018,8,4,1,5,Saturday,14 days,40179.2
ACC-1652235822,38,45.0,18615.01,,CUS-2206365095,2018-08-04,Renee,F,-37.81,144.89,,,,,,,debit,posted,6a57c7f8d47e4332a4cd00392c14f498,PAYMENT,30-40,2018,8,4,5,0,Saturday,14 days,40179.2
ACC-1652235822,38,18.4,18596.61,1.0,CUS-2206365095,2018-08-04,Renee,F,-37.81,144.89,,b9e09fbc-1e21-41af-b6c8-82285c8df261,-37.85,145.1,VIC,Burwood,debit,authorized,86c5da3cee38469d9c1a73513af1d579,POS,30-40,2018,8,4,9,49,Saturday,14 days,40179.2
ACC-1652235822,38,11.19,18585.42,1.0,CUS-2206365095,2018-08-08,Renee,F,-37.81,144.89,,3148f5c1-0e76-466e-9c35-bef02039f53c,-37.79,145.16,VIC,Doncaster East,debit,authorized,d7e674baf34a4441874cdedee680446f,SALES-POS,30-40,2018,8,8,9,15,Wednesday,14 days,40179.2
ACC-1652235822,38,24.13,18561.29,1.0,CUS-2206365095,2018-08-09,Renee,F,-37.81,144.89,,0fad9ab3-9f39-461d-bc77-af7fb8bcd525,-37.82,145,VIC,Richmond,debit,authorized,39c5856539d941d0928ec138ec7e18e2,POS,30-40,2018,8,9,8,43,Thursday,14 days,40179.2
ACC-1652235822,38,19.63,18541.66,0.0,CUS-2206365095,2018-08-09,Renee,F,-37.81,144.89,,fa87be58-f484-4b31-84fa-ea1aad15bea3,-37.75,145,VIC,Thornbury,debit,authorized,ae8edaf205ad428b9a6b850849bd29df,SALES-POS,30-40,2018,8,9,15,25,Thursday,14 days,40179.2
ACC-1652235822,38,25.27,18516.39,1.0,CUS-2206365095,2018-08-09,Renee,F,-37.81,144.89,,865fe5b0-0e48-48e6-8e88-d74145d23706,-37.87,145.15,VIC,Mount Waverley,debit,authorized,7d76f6c51649411eaaf43ad2f5972878,SALES-POS,30-40,2018,8,9,16,22,Thursday,14 days,40179.2
ACC-1652235822,38,6.62,18509.77,0.0,CUS-2206365095,2018-08-09,Renee,F,-37.81,144.89,,cb8b537a-c5b7-47fb-a581-820a35d84899,-37.83,144.99,VIC,Richmond,debit,authorized,fe1efe86e5774fe0bba124a4b1ad3dc6,POS,30-40,2018,8,9,16,56,Thursday,14 days,40179.2
ACC-1652235822,38,28.3,18481.47,1.0,CUS-2206365095,2018-08-10,Renee,F,-37.81,144.89,,8ec59b50-d959-4dfe-af86-b05c501de93c,-37.91,144.99,VIC,Brighton,debit,authorized,035db15643df4151bd68ce9d33a7617f,SALES-POS,30-40,2018,8,10,17,15,Friday,14 days,40179.2
ACC-1652235822,38,66.0,18415.47,,CUS-2206365095,2018-08-10,Renee,F,-37.81,144.89,,,,,,,debit,posted,dad81c2c16e743ab8a85bf4f8cf66f0c,PAYMENT,30-40,2018,8,10,18,0,Friday,14 days,40179.2
ACC-1652235822,38,45.0,18370.47,,CUS-2206365095,2018-08-11,Renee,F,-37.81,144.89,,,,,,,debit,posted,d1fd963608ca4cd194d7e6c14c599734,PAYMENT,30-40,2018,8,11,5,0,Saturday,14 days,40179.2
ACC-1652235822,38,29.71,18340.76,1.0,CUS-2206365095,2018-08-12,Renee,F,-37.81,144.89,,d7055f01-32a5-4e23-b538-94d643e0c57c,-37.68,145.07,VIC,Bundoora,debit,authorized,22b4b305c915435ea00f5c7dd946be08,POS,30-40,2018,8,12,11,41,Sunday,14 days,40179.2
ACC-1652235822,38,24.66,18316.1,1.0,CUS-2206365095,2018-08-12,Renee,F,-37.81,144.89,,ed8dc00e-8676-4e69-b0d9-d07a57cb57db,-37.83,140.78,SA,Mount Gambier,debit,authorized,bbecd1fc77be44e7b676c1956e92b16d,SALES-POS,30-40,2018,8,12,15,59,Sunday,14 days,40179.2
ACC-1652235822,38,6.73,18309.37,1.0,CUS-2206365095,2018-08-12,Renee,F,-37.81,144.89,,e47ba9b4-955d-49f3-b977-dc2977348d17,-37.81,144.96,VIC,Melbourne,debit,authorized,93749ba0834f4d3aaccb1e093108b0e4,POS,30-40,2018,8,12,16,19,Sunday,14 days,40179.2
ACC-1652235822,38,18.47,18290.9,0.0,CUS-2206365095,2018-08-12,Renee,F,-37.81,144.89,,7433e9fb-e8a6-428d-bee1-75430af5c2ae,-37.76,145.31,VIC,Chirnside Park,debit,authorized,be8c91e12e684dd38e7f6133f63ea025,SALES-POS,30-40,2018,8,12,17,36,Sunday,14 days,40179.2
ACC-1652235822,38,9.64,18281.26,0.0,CUS-2206365095,2018-08-12,Renee,F,-37.81,144.89,,4f28c3ab-53db-4053-a61d-6dc0bd5f0ff8,-37.76,145.31,VIC,Chirnside Park,debit,authorized,010c5a159ac849d5b7a117ee613f3e8b,SALES-POS,30-40,2018,8,12,21,20,Sunday,14 days,40179.2
ACC-1652235822,38,66.0,19756.38,,CUS-2206365095,2018-08-17,Renee,F,-37.81,144.89,,,,,,,debit,posted,bda8c0723a69462aa9e0f95a6a0f4c2d,PAYMENT,30-40,2018,8,17,18,0,Friday,14 days,40179.2
ACC-1652235822,38,45.0,19711.38,,CUS-2206365095,2018-08-18,Renee,F,-37.81,144.89,,,,,,,debit,posted,5ac91ded432949659a26b91d83f55303,PAYMENT,30-40,2018,8,18,5,0,Saturday,14 days,40179.2
ACC-1652235822,38,66.0,19645.38,,CUS-2206365095,2018-08-24,Renee,F,-37.81,144.89,,,,,,,debit,posted,7c90c5c3f53f4fab91090b210bd27d43,PAYMENT,30-40,2018,8,24,18,0,Friday,14 days,40179.2
ACC-1652235822,38,45.0,19600.38,,CUS-2206365095,2018-08-25,Renee,F,-37.81,144.89,,,,,,,debit,posted,1d9db781160649abb3e5c0d0fb00d3ec,PAYMENT,30-40,2018,8,25,5,0,Saturday,14 days,40179.2
ACC-1652235822,38,18.09,19582.29,1.0,CUS-2206365095,2018-08-28,Renee,F,-37.81,144.89,,614e9f14-156f-47d5-8d89-704d21cefea9,-37.77,145.09,VIC,Bulleen,debit,authorized,71b0d464a935438997d75d43244250ea,POS,30-40,2018,8,28,16,59,Tuesday,14 days,40179.2
ACC-1652235822,38,66.0,21057.41,,CUS-2206365095,2018-08-31,Renee,F,-37.81,144.89,,,,,,,debit,posted,2c6f6838e6a945d2860b604cc0ebaf0d,PAYMENT,30-40,2018,8,31,18,0,Friday,14 days,40179.2
ACC-1652235822,38,45.0,21012.41,,CUS-2206365095,2018-09-01,Renee,F,-37.81,144.89,,,,,,,debit,posted,2d41ede9848e49a8ad8e8ff86450fe76,PAYMENT,30-40,2018,9,1,5,0,Saturday,14 days,40179.2
ACC-1652235822,38,24.2,20988.21,1.0,CUS-2206365095,2018-09-02,Renee,F,-37.81,144.89,,f0e656b5-fcfc-44a1-b297-29826efcb2a4,-38.02,145.33,VIC,Berwick,debit,authorized,f022209e439d4fc2b2fe40ecabb14bec,POS,30-40,2018,9,2,20,24,Sunday,14 days,40179.2
ACC-1652235822,38,13.88,20974.33,1.0,CUS-2206365095,2018-09-04,Renee,F,-37.81,144.89,,b0e9b970-e545-463f-a38e-882084d8cd59,-37.76,145.17,VIC,Doncaster East,debit,authorized,4a4afc5a1cf94b11b18e6e5e494c4071,SALES-POS,30-40,2018,9,4,20,12,Tuesday,14 days,40179.2
ACC-1652235822,38,7.35,20966.98,1.0,CUS-2206365095,2018-09-05,Renee,F,-37.81,144.89,,1cd28770-b755-41a0-b7bc-4d3b2ed72596,-37.87,144.99,VIC,Saint Kilda,debit,authorized,e111831686c8463c8e3c5cb6dc7342fc,POS,30-40,2018,9,5,14,12,Wednesday,14 days,40179.2
ACC-1652235822,38,66.0,20900.98,,CUS-2206365095,2018-09-07,Renee,F,-37.81,144.89,,,,,,,debit,posted,5f7c75748f494e098f5d0bb095515f43,PAYMENT,30-40,2018,9,7,18,0,Friday,14 days,40179.2
ACC-1652235822,38,9.24,20891.74,1.0,CUS-2206365095,2018-09-07,Renee,F,-37.81,144.89,,2ad77476-1279-414b-9793-7744c8c19306,-33.89,151.21,NSW,Surry Hills,debit,authorized,00c39900c6094ceab1c8ab2e6ee01d19,SALES-POS,30-40,2018,9,7,23,29,Friday,14 days,40179.2
ACC-1652235822,38,45.0,20846.74,,CUS-2206365095,2018-09-08,Renee,F,-37.81,144.89,,,,,,,debit,posted,d5376b18372e464c9c8cb6f655ff88f3,PAYMENT,30-40,2018,9,8,5,0,Saturday,14 days,40179.2
ACC-1652235822,38,17.6,20829.14,1.0,CUS-2206365095,2018-09-08,Renee,F,-37.81,144.89,,df39e155-fa65-4da8-a339-13a91b6841e0,-37.87,144.98,VIC,Saint Kilda,debit,authorized,f736f2fe1f3b4d14a925ce11de3d4520,POS,30-40,2018,9,8,9,3,Saturday,14 days,40179.2
ACC-1652235822,38,59.98,20769.16,1.0,CUS-2206365095,2018-09-08,Renee,F,-37.81,144.89,,98d951b2-c2d0-4f20-a148-a8a09208e801,-37.89,145.08,VIC,Malvern East,debit,authorized,e9a0b606efe244678dc73b3483898239,POS,30-40,2018,9,8,11,29,Saturday,14 days,40179.2
ACC-1652235822,38,29.32,20739.84,1.0,CUS-2206365095,2018-09-08,Renee,F,-37.81,144.89,,e288a819-9b84-424f-b17c-e4e4869472b4,-37.83,140.78,SA,Mount Gambier,debit,authorized,bea3d72601c94d7dbcf78a44b077676b,POS,30-40,2018,9,8,23,39,Saturday,14 days,40179.2
ACC-1652235822,38,9.15,20730.69,0.0,CUS-2206365095,2018-09-09,Renee,F,-37.81,144.89,,aee9de67-d016-4f8d-88f9-4f91c303aa83,-37.83,145.25,VIC,Heathmont,debit,authorized,b88a8d4885614d1c8a4d328c7a65f01f,SALES-POS,30-40,2018,9,9,8,1,Sunday,14 days,40179.2
ACC-1652235822,38,9.1,20721.59,1.0,CUS-2206365095,2018-09-09,Renee,F,-37.81,144.89,,ce703c72-b44c-4c26-86ac-c1d6ea67852e,-37.86,145.03,VIC,Armadale,debit,authorized,bc2407dcc0d74ae984b0a240d5ccc523,POS,30-40,2018,9,9,10,34,Sunday,14 days,40179.2
ACC-1652235822,38,29.64,20691.95,1.0,CUS-2206365095,2018-09-10,Renee,F,-37.81,144.89,,c5e4a467-5150-49ac-a137-7a5cc2435941,-37.77,144.89,VIC,Maribyrnong,debit,authorized,0dad5b0cab2542ad92bbc96379e50f5d,SALES-POS,30-40,2018,9,10,9,40,Monday,14 days,40179.2
ACC-1652235822,38,38.41,20653.54,1.0,CUS-2206365095,2018-09-11,Renee,F,-37.81,144.89,,30c61efb-ed82-4b2c-9e95-984a4f61131c,-37.76,145.31,VIC,Chirnside Park,debit,authorized,63f4a94f3b02439dbdc0d530a85ac03e,SALES-POS,30-40,2018,9,11,9,57,Tuesday,14 days,40179.2
ACC-1652235822,38,13.73,20639.81,0.0,CUS-2206365095,2018-09-11,Renee,F,-37.81,144.89,,9a8701d6-a0ff-4550-b48e-a1e9d0af4136,-37.73,144.96,VIC,Coburg North,debit,authorized,52b54307c6bc4381b513ccc07f36f9c0,POS,30-40,2018,9,11,10,54,Tuesday,14 days,40179.2
ACC-1652235822,38,6.41,20633.4,1.0,CUS-2206365095,2018-09-11,Renee,F,-37.81,144.89,,552a2246-f940-4e3d-86e1-b12a892390f1,-37.74,142.03,VIC,Hamilton,debit,authorized,fc8968ac53e64005ad51e28ccce380e3,POS,30-40,2018,9,11,11,31,Tuesday,14 days,40179.2
ACC-1652235822,38,35.92,20597.48,1.0,CUS-2206365095,2018-09-11,Renee,F,-37.81,144.89,,ccf58766-88af-4323-bfc4-bcdb63c01dc6,-37.79,145.13,VIC,Doncaster,debit,authorized,1a72f2aed974403bbe8d40f1b087c6db,SALES-POS,30-40,2018,9,11,12,41,Tuesday,14 days,40179.2
ACC-1652235822,38,49.28,20548.2,1.0,CUS-2206365095,2018-09-11,Renee,F,-37.81,144.89,,8805b863-9ef4-42d8-bc16-2f1bb490ec54,-37.89,145.06,VIC,Carnegie,debit,authorized,c205ff7b641342c785bce00e235ff8ef,SALES-POS,30-40,2018,9,11,13,49,Tuesday,14 days,40179.2
ACC-1652235822,38,9.76,20538.44,1.0,CUS-2206365095,2018-09-11,Renee,F,-37.81,144.89,,33e1691c-0d64-423d-b54f-347c13bd22d0,-37.78,145.13,VIC,Doncaster,debit,authorized,8a648d075ff54471aff595e333702592,POS,30-40,2018,9,11,17,34,Tuesday,14 days,40179.2
ACC-1652235822,38,16.99,22062.57,1.0,CUS-2206365095,2018-09-12,Renee,F,-37.81,144.89,,9ec84008-4fe5-454a-bf32-599071a3e6db,-37.83,145.06,VIC,Camberwell,debit,authorized,873c44df07cb4adb9859ce0f7549c665,SALES-POS,30-40,2018,9,12,9,28,Wednesday,14 days,40179.2
ACC-1652235822,38,17.85,22044.72,1.0,CUS-2206365095,2018-09-12,Renee,F,-37.81,144.89,,ae373432-0f87-44d6-9966-6ddaf7ee2785,-37.84,145.01,VIC,Toorak,debit,authorized,bbc8657953414afea7ef92a4a92dbaf4,SALES-POS,30-40,2018,9,12,11,29,Wednesday,14 days,40179.2
ACC-1652235822,38,1883.04,20161.68,1.0,CUS-2206365095,2018-09-12,Renee,F,-37.81,144.89,,3a07b841-ea22-4cd7-b378-a46239d1c282,-37.77,144.89,VIC,Maribyrnong,debit,authorized,1a8a2e38b6df457396d7f079d764dce5,SALES-POS,30-40,2018,9,12,12,29,Wednesday,14 days,40179.2
ACC-1652235822,38,16.7,20144.98,1.0,CUS-2206365095,2018-09-12,Renee,F,-37.81,144.89,,c0fab9eb-a843-4853-a6f7-5ccdc0010fe2,-37.71,144.89,VIC,Airport West,debit,authorized,652eb46a37994ab09bd8fb6be81f79ca,SALES-POS,30-40,2018,9,12,15,21,Wednesday,14 days,40179.2
ACC-1652235822,38,20.69,20124.29,0.0,CUS-2206365095,2018-09-12,Renee,F,-37.81,144.89,,8e68935b-e428-453e-a778-0f14980a7419,-37.68,144.92,VIC,Broadmeadows,debit,authorized,32cc234a05874f3288ad6f4a872b0a53,SALES-POS,30-40,2018,9,12,16,59,Wednesday,14 days,40179.2
ACC-1652235822,38,38.15,20086.14,1.0,CUS-2206365095,2018-09-12,Renee,F,-37.81,144.89,,c88dba05-1c36-4bbb-877d-9278a5e1180d,-37.75,145.36,VIC,Lilydale,debit,authorized,d454d5b6b8a0446e9265833f456840d4,SALES-POS,30-40,2018,9,12,17,25,Wednesday,14 days,40179.2
ACC-1652235822,38,20.97,20065.17,1.0,CUS-2206365095,2018-09-12,Renee,F,-37.81,144.89,,77e97e63-ffc1-418f-aa89-f8881c02ac42,-37.7,145.42,VIC,Coldstream,debit,authorized,0da5f627dca34369a730e99b76a7fa58,POS,30-40,2018,9,12,22,14,Wednesday,14 days,40179.2
ACC-1652235822,38,39.2,20025.97,1.0,CUS-2206365095,2018-09-13,Renee,F,-37.81,144.89,,dc72ced4-7989-42cc-b650-46c249793433,-37.83,145.06,VIC,Camberwell,debit,authorized,3f129fcc506e433a9e7eb586d7b639db,POS,30-40,2018,9,13,19,19,Thursday,14 days,40179.2
ACC-1652235822,38,13.3,20012.67,1.0,CUS-2206365095,2018-09-13,Renee,F,-37.81,144.89,,3f7ff446-2ca9-4575-bd2d-df7033a76968,-37.83,145.05,VIC,Hawthorn East,debit,authorized,22702eb5e0124583a2b1c0e53aebb16f,POS,30-40,2018,9,13,19,29,Thursday,14 days,40179.2
ACC-1652235822,38,13.6,19999.07,1.0,CUS-2206365095,2018-09-14,Renee,F,-37.81,144.89,,90295d36-a6a7-4392-9046-23eb997aa494,-37.81,144.97,VIC,Melbourne,debit,authorized,1155e070a2824acfa39a99ba4d4ce8f9,SALES-POS,30-40,2018,9,14,14,38,Friday,14 days,40179.2
ACC-1652235822,38,66.0,19933.07,,CUS-2206365095,2018-09-14,Renee,F,-37.81,144.89,,,,,,,debit,posted,11247607bf0b42769d8fe1e9aa2209b6,PAYMENT,30-40,2018,9,14,18,0,Friday,14 days,40179.2
ACC-1652235822,38,10.01,19923.06,1.0,CUS-2206365095,2018-09-15,Renee,F,-37.81,144.89,,d1db0203-8b5e-4578-b69b-9426e3b136b4,-37.76,144.97,VIC,Brunswick,debit,authorized,db74ab07efcb484aa4bb569553b14e52,SALES-POS,30-40,2018,9,15,1,49,Saturday,14 days,40179.2
ACC-1652235822,38,45.0,19878.06,,CUS-2206365095,2018-09-15,Renee,F,-37.81,144.89,,,,,,,debit,posted,533b34863c414210b6a425894d4d66e2,PAYMENT,30-40,2018,9,15,5,0,Saturday,14 days,40179.2
ACC-1652235822,38,13.17,19864.89,1.0,CUS-2206365095,2018-09-15,Renee,F,-37.81,144.89,,fdb6a7b3-8197-4892-8322-7666da16a7ba,-38.1,145.18,VIC,Carrum Downs,debit,authorized,f4bc2d8bdec2437b8bb21e19ca995278,POS,30-40,2018,9,15,8,5,Saturday,14 days,40179.2
ACC-1652235822,38,19.46,19845.43,0.0,CUS-2206365095,2018-09-15,Renee,F,-37.81,144.89,,0bc72e38-dadd-4fac-8814-7cb964246beb,-37.84,144.78,VIC,Laverton North,debit,authorized,3ae07f23b0bc4a8c9301d55a411161eb,POS,30-40,2018,9,15,11,52,Saturday,14 days,40179.2
ACC-1652235822,38,23.81,19821.62,1.0,CUS-2206365095,2018-09-15,Renee,F,-37.81,144.89,,a46386be-4fc6-4445-829c-c885f9ff9ab1,-37.89,145.08,VIC,Chadstone,debit,authorized,0fc7c0f1d7fe46a39e7e5d036aa962c7,POS,30-40,2018,9,15,15,41,Saturday,14 days,40179.2
ACC-1652235822,38,66.0,19755.62,,CUS-2206365095,2018-09-21,Renee,F,-37.81,144.89,,,,,,,debit,posted,85aa85e5799d4f0098ff7b17bcc45bc5,PAYMENT,30-40,2018,9,21,18,0,Friday,14 days,40179.2
ACC-1652235822,38,45.0,19710.62,,CUS-2206365095,2018-09-22,Renee,F,-37.81,144.89,,,,,,,debit,posted,7eaa420e76264cdaa15fd3a2965fc584,PAYMENT,30-40,2018,9,22,5,0,Saturday,14 days,40179.2
ACC-1652235822,38,700.44,20551.3,1.0,CUS-2206365095,2018-09-28,Renee,F,-37.81,144.89,,b04f283c-5807-4329-ad1d-a113d5f25bc1,-37.79,145.16,VIC,Doncaster East,debit,authorized,e87513e0e9dc42f3ac692c915acbbfd5,SALES-POS,30-40,2018,9,28,15,30,Friday,14 days,40179.2
ACC-1652235822,38,66.0,20485.3,,CUS-2206365095,2018-09-28,Renee,F,-37.81,144.89,,,,,,,debit,posted,db87d2339fff4a8892bc79ad81dabca3,PAYMENT,30-40,2018,9,28,18,0,Friday,14 days,40179.2
ACC-1652235822,38,22.64,20462.66,1.0,CUS-2206365095,2018-09-28,Renee,F,-37.81,144.89,,19a3e690-51ac-4885-848c-1c8363c7c49f,-37.71,144.89,VIC,Airport West,debit,authorized,125bb5e579864d368ed209460fd9e82a,SALES-POS,30-40,2018,9,28,21,52,Friday,14 days,40179.2
ACC-1652235822,38,10.61,20452.05,1.0,CUS-2206365095,2018-09-28,Renee,F,-37.81,144.89,,2f1cfccd-c0d3-4c30-9e2b-46390b7fd4dd,-37.82,144.96,VIC,Melbourne,debit,authorized,4191c7a471a64305a239532d2737ce10,SALES-POS,30-40,2018,9,28,23,16,Friday,14 days,40179.2
ACC-1652235822,38,12.62,20439.43,0.0,CUS-2206365095,2018-09-29,Renee,F,-37.81,144.89,,2e855da4-787c-4095-9e1c-0c4b004e324d,-37.8,144.98,VIC,Fitzroy,debit,authorized,8fd9107f09a249f8bb6c89d86115b03a,POS,30-40,2018,9,29,1,39,Saturday,14 days,40179.2
ACC-1652235822,38,45.0,20394.43,,CUS-2206365095,2018-09-29,Renee,F,-37.81,144.89,,,,,,,debit,posted,029e961e44a3455db21aa25767d49de2,PAYMENT,30-40,2018,9,29,5,0,Saturday,14 days,40179.2
ACC-1652235822,38,11.59,20382.84,1.0,CUS-2206365095,2018-09-29,Renee,F,-37.81,144.89,,80e385f5-f9c6-459e-9b35-84fa988fd982,-37.76,145.36,VIC,Lilydale,debit,authorized,789c773a195f4f388efed95d70b14950,POS,30-40,2018,9,29,11,16,Saturday,14 days,40179.2
ACC-1652235822,38,31.18,20351.66,1.0,CUS-2206365095,2018-09-29,Renee,F,-37.81,144.89,,138f6cfa-501e-47f6-9abc-2b7534acaec2,-37.91,145.19,VIC,Wheelers Hill,debit,authorized,08e43778fff94f0382b1323688d95589,POS,30-40,2018,9,29,14,28,Saturday,14 days,40179.2
ACC-1652235822,38,21.8,20329.86,1.0,CUS-2206365095,2018-09-29,Renee,F,-37.81,144.89,,f8404f44-f730-4531-abf3-a05bfe5dccd3,-37.78,145.29,VIC,Croydon,debit,authorized,b370d95362ec433bb0ede6b89681c5fd,POS,30-40,2018,9,29,15,18,Saturday,14 days,40179.2
ACC-1652235822,38,31.93,20297.93,0.0,CUS-2206365095,2018-09-29,Renee,F,-37.81,144.89,,e98b306d-8324-4b40-a038-457546bb99bc,-37.83,147.63,VIC,Bairnsdale,debit,authorized,609de1cee94542dd80db6951332c3161,SALES-POS,30-40,2018,9,29,23,54,Saturday,14 days,40179.2
ACC-1652235822,38,16.12,20281.81,1.0,CUS-2206365095,2018-09-30,Renee,F,-37.81,144.89,,ccd34722-ed5b-4549-9afe-93bb5869a9fb,-37.89,145.08,VIC,Chadstone,debit,authorized,692b01f9427c4a06a3da57fd4db9fa3a,POS,30-40,2018,9,30,3,58,Sunday,14 days,40179.2
ACC-1652235822,38,9.53,20272.28,1.0,CUS-2206365095,2018-09-30,Renee,F,-37.81,144.89,,935cdef4-6217-406c-80b5-1185c4097031,-37.91,145.15,VIC,Mulgrave,debit,authorized,10d4fbc5da984f688141fe80801a148f,POS,30-40,2018,9,30,10,2,Sunday,14 days,40179.2
ACC-1652235822,38,11.29,20260.99,1.0,CUS-2206365095,2018-09-30,Renee,F,-37.81,144.89,,ae6edca6-977e-4bb6-aeff-74c8d39a622f,-37.83,147.62,VIC,Bairnsdale,debit,authorized,fad7059d8c7b4f8191e6e5943c59e652,POS,30-40,2018,9,30,14,51,Sunday,14 days,40179.2
ACC-1652235822,38,14.84,20246.15,1.0,CUS-2206365095,2018-10-02,Renee,F,-37.81,144.89,,a08463b0-6be6-478b-abaa-78f23f81c07b,-37.76,145.35,VIC,Lilydale,debit,authorized,83b80b1606dc42589692546110261cf8,SALES-POS,30-40,2018,10,2,16,58,Tuesday,14 days,40179.2
ACC-1652235822,38,66.0,20180.15,,CUS-2206365095,2018-10-05,Renee,F,-37.81,144.89,,,,,,,debit,posted,4514c45348d046658a085f6095903651,PAYMENT,30-40,2018,10,5,18,0,Friday,14 days,40179.2
ACC-1652235822,38,16.61,20163.54,1.0,CUS-2206365095,2018-10-05,Renee,F,-37.81,144.89,,c794e437-402d-4f03-ba26-c4d705c498ca,-37.91,145.19,VIC,Wheelers Hill,debit,authorized,2a5d4d42f8b848b8beb0eedbd34c7188,POS,30-40,2018,10,5,20,42,Friday,14 days,40179.2
ACC-1652235822,38,45.0,20118.54,,CUS-2206365095,2018-10-06,Renee,F,-37.81,144.89,,,,,,,debit,posted,213f2e8300a44fbdad8b7596300f8674,PAYMENT,30-40,2018,10,6,5,0,Saturday,14 days,40179.2
ACC-1652235822,38,12.01,20106.53,1.0,CUS-2206365095,2018-10-06,Renee,F,-37.81,144.89,,e78a0aea-594b-4fba-959b-0d3a64870e40,-37.89,144.99,VIC,Elwood,debit,authorized,58715f8109fa4c33b377756c1e0927bb,POS,30-40,2018,10,6,14,51,Saturday,14 days,40179.2
ACC-1652235822,38,15.93,20090.6,1.0,CUS-2206365095,2018-10-06,Renee,F,-37.81,144.89,,906a8374-5221-4585-ae63-f1717fe54c33,-37.77,144.89,VIC,Maribyrnong,debit,authorized,6baacaeb524741d68a7cc0ff58643bdd,SALES-POS,30-40,2018,10,6,20,43,Saturday,14 days,40179.2
ACC-1652235822,38,30.42,20060.18,1.0,CUS-2206365095,2018-10-06,Renee,F,-37.81,144.89,,75e600e1-bf94-47c6-923a-e1c97021bf8f,-37.82,145.17,VIC,Nunawading,debit,authorized,3a3e523c2aa94f149c2e02dbd4599858,SALES-POS,30-40,2018,10,6,20,50,Saturday,14 days,40179.2
ACC-1652235822,38,19.38,20040.8,1.0,CUS-2206365095,2018-10-07,Renee,F,-37.81,144.89,,d49c7364-41a4-4a48-be59-a2034aa21419,-37.88,144.68,VIC,Hoppers Crossing,debit,authorized,b860ec5b904b444a9a5fab49db16ddf5,SALES-POS,30-40,2018,10,7,11,45,Sunday,14 days,40179.2
ACC-1652235822,38,23.97,21557.95,1.0,CUS-2206365095,2018-10-10,Renee,F,-37.81,144.89,,25d49778-24b9-43de-9e83-e86795d3d2fe,-37.74,142.03,VIC,Hamilton,debit,authorized,d67d0cb82451448894c82aa024753986,POS,30-40,2018,10,10,4,2,Wednesday,14 days,40179.2
ACC-1652235822,38,34.06,21523.89,0.0,CUS-2206365095,2018-10-10,Renee,F,-37.81,144.89,,c6717cc7-5c1e-4779-b147-d59ecd7f3827,-33.82,151,NSW,Parramatta,debit,authorized,7ef33100b01c49919e30b7017827f2c3,POS,30-40,2018,10,10,7,18,Wednesday,14 days,40179.2
ACC-1652235822,38,8.28,21515.61,0.0,CUS-2206365095,2018-10-10,Renee,F,-37.81,144.89,,407c1edf-c8f6-455c-a492-99ba6940488f,-37.81,145.23,VIC,Ringwood,debit,authorized,00e964c8513d49b2b2dc785541912863,POS,30-40,2018,10,10,8,9,Wednesday,14 days,40179.2
ACC-1652235822,38,32.92,21482.69,1.0,CUS-2206365095,2018-10-10,Renee,F,-37.81,144.89,,b2a83cf4-8216-4f61-a9a1-537cf234f93a,-37.99,145.17,VIC,Keysborough,debit,authorized,b9c19d2e62134e29a7abe182c05bd30a,POS,30-40,2018,10,10,9,18,Wednesday,14 days,40179.2
ACC-1652235822,38,54.41,21428.28,1.0,CUS-2206365095,2018-10-10,Renee,F,-37.81,144.89,,5cf787f7-83e4-4354-bae2-05be0334d290,-27.41,153.08,QLD,Eagle Farm,debit,authorized,6bed8b0a3f344dfcbbe560f40f38f865,SALES-POS,30-40,2018,10,10,16,49,Wednesday,14 days,40179.2
ACC-1652235822,38,13.39,21414.89,1.0,CUS-2206365095,2018-10-11,Renee,F,-37.81,144.89,,4a3d930a-5a63-4f6d-b752-a33c713b5986,-37.86,145.03,VIC,Malvern,debit,authorized,c579ba1478a94ed6aa7a3660befaf307,POS,30-40,2018,10,11,21,16,Thursday,14 days,40179.2
ACC-1652235822,38,66.0,21348.89,,CUS-2206365095,2018-10-12,Renee,F,-37.81,144.89,,,,,,,debit,posted,3229a71fa1d84b0480303c5dc7719f03,PAYMENT,30-40,2018,10,12,18,0,Friday,14 days,40179.2
ACC-1652235822,38,45.0,21303.89,,CUS-2206365095,2018-10-13,Renee,F,-37.81,144.89,,,,,,,debit,posted,f5dbf9ead72c4dbe985c696a91c99be3,PAYMENT,30-40,2018,10,13,5,0,Saturday,14 days,40179.2
ACC-1652235822,38,16.07,21287.82,1.0,CUS-2206365095,2018-10-13,Renee,F,-37.81,144.89,,932b9301-65da-4718-aa78-679daba791fb,-37.78,145.13,VIC,Doncaster,debit,authorized,95258e9a809d4dbabafa22f6fc80ffec,SALES-POS,30-40,2018,10,13,9,13,Saturday,14 days,40179.2
ACC-1652235822,38,18.16,21269.66,1.0,CUS-2206365095,2018-10-13,Renee,F,-37.81,144.89,,3fa0b67e-f7f9-462f-8175-b50057e8f016,-37.79,144.93,VIC,Kensington,debit,authorized,56623f2d2dc841ef9e94c4e1e329bada,SALES-POS,30-40,2018,10,13,16,31,Saturday,14 days,40179.2
ACC-1652235822,38,36.01,21233.65,1.0,CUS-2206365095,2018-10-13,Renee,F,-37.81,144.89,,ae25e03e-2770-49f2-b1e1-4474577c194f,-37.79,145.27,VIC,Croydon,debit,authorized,bca6082943b94ed0b454ded26f19c5b4,SALES-POS,30-40,2018,10,13,21,36,Saturday,14 days,40179.2
ACC-1652235822,38,10.28,21223.37,0.0,CUS-2206365095,2018-10-13,Renee,F,-37.81,144.89,,1f03f1d0-3cac-42e7-b949-4efab26faebd,-33.89,151.25,NSW,Bondi Junction,debit,authorized,de4b798fe2854045878194fce8b77aa4,POS,30-40,2018,10,13,23,28,Saturday,14 days,40179.2
ACC-1652235822,38,29.56,21193.81,1.0,CUS-2206365095,2018-10-14,Renee,F,-37.81,144.89,,acb279e4-d129-4863-84b6-61f86cceebb8,-37.86,145.18,VIC,Vermont South,debit,authorized,f868a86342fb48b9a89cf8059716e8cf,POS,30-40,2018,10,14,9,49,Sunday,14 days,40179.2
ACC-1652235822,38,24.32,21169.49,1.0,CUS-2206365095,2018-10-14,Renee,F,-37.81,144.89,,496bc96a-4a77-47e6-ad1d-0782db826584,-37.69,144.57,VIC,Melton West,debit,authorized,30e3c1b1756c43de9e7067e149dc94af,POS,30-40,2018,10,14,13,21,Sunday,14 days,40179.2
ACC-1652235822,38,6.26,21163.23,1.0,CUS-2206365095,2018-10-15,Renee,F,-37.81,144.89,,2ee17ea7-70e8-40a3-8a95-056ceb1dde29,-37.78,145.31,VIC,Mooroolbark,debit,authorized,bf8a936cbd90489d96c8fed5894efb77,SALES-POS,30-40,2018,10,15,22,43,Monday,14 days,40179.2
ACC-1652235822,38,9.9,21153.33,1.0,CUS-2206365095,2018-10-16,Renee,F,-37.81,144.89,,72db15f7-207e-46ab-bf48-2e9ba0073c31,-37.88,145.1,VIC,Chadstone,debit,authorized,5498b2b3917e4443bdb854f88220091b,POS,30-40,2018,10,16,5,17,Tuesday,14 days,40179.2
ACC-1652235822,38,34.27,21119.06,1.0,CUS-2206365095,2018-10-16,Renee,F,-37.81,144.89,,cd32bde7-1b61-404e-b093-3ba8ed7f5ebf,-37.83,140.79,SA,Mount Gambier,debit,authorized,e1aa7e15c3fb4acfb11249c81907a683,SALES-POS,30-40,2018,10,16,10,5,Tuesday,14 days,40179.2
ACC-1652235822,38,20.52,21098.54,1.0,CUS-2206365095,2018-10-16,Renee,F,-37.81,144.89,,e9f5301e-34d7-472b-93fc-58f95441845d,-37.76,144.94,VIC,Brunswick West,debit,authorized,3f155f42f3e149cb87fcacb5b4be1a21,POS,30-40,2018,10,16,12,32,Tuesday,14 days,40179.2
ACC-1652235822,38,23.21,21075.33,1.0,CUS-2206365095,2018-10-16,Renee,F,-37.81,144.89,,91cb3503-88f3-4362-9445-27ed2021ed83,-37.77,144.97,VIC,Brunswick East,debit,authorized,6b1ac30ca69b4a529111cd6d7bcd25c6,POS,30-40,2018,10,16,15,11,Tuesday,14 days,40179.2
ACC-1652235822,38,24.72,21050.61,1.0,CUS-2206365095,2018-10-17,Renee,F,-37.81,144.89,,a110d5b8-126f-494c-9231-71640252c2dc,-33.86,151.21,NSW,Dawes Point,debit,authorized,71aae7d56270408e9d0e2b16ba7fbc6c,POS,30-40,2018,10,17,8,48,Wednesday,14 days,40179.2
ACC-1652235822,38,66.0,20984.61,,CUS-2206365095,2018-10-19,Renee,F,-37.81,144.89,,,,,,,debit,posted,e59f50391bd84385aec2833277c70d1e,PAYMENT,30-40,2018,10,19,18,0,Friday,14 days,40179.2
ACC-1652235822,38,45.0,20939.61,,CUS-2206365095,2018-10-20,Renee,F,-37.81,144.89,,,,,,,debit,posted,df18acc3bfab421bb225d0d0f02f87ca,PAYMENT,30-40,2018,10,20,5,0,Saturday,14 days,40179.2
ACC-1652235822,38,66.0,22414.73,,CUS-2206365095,2018-10-26,Renee,F,-37.81,144.89,,,,,,,debit,posted,f8c5da29428c4f1d8dcc8131829a0a1b,PAYMENT,30-40,2018,10,26,18,0,Friday,14 days,40179.2
ACC-1652235822,38,45.0,22369.73,,CUS-2206365095,2018-10-27,Renee,F,-37.81,144.89,,,,,,,debit,posted,730d78473bde497ca27cdafa83248088,PAYMENT,30-40,2018,10,27,5,0,Saturday,14 days,40179.2
ACC-1652235822,38,27.05,22342.68,1.0,CUS-2206365095,2018-10-31,Renee,F,-37.81,144.89,,138d4caf-1025-4013-a659-628b4148eb08,-33.87,151.2,NSW,Sydney,debit,authorized,7f905c723e824c02935af7bd0cf06946,SALES-POS,30-40,2018,10,31,10,31,Wednesday,14 days,40179.2
ACC-1652235822,38,17.72,22324.96,1.0,CUS-2206365095,2018-10-31,Renee,F,-37.81,144.89,,ce34e639-f832-4cc3-adf5-13ea8ed57a0a,-37.68,144.92,VIC,Broadmeadows,debit,authorized,07194490facf4b288ab37c2f15db12e9,SALES-POS,30-40,2018,10,31,20,21,Wednesday,14 days,40179.2
ACC-1652235822,38,93.46,22231.5,1.0,CUS-2206365095,2018-10-31,Renee,F,-37.81,144.89,,74916a86-5a3d-4d26-9bb2-28d4e6db0c8d,-37.82,144.95,VIC,Docklands,debit,authorized,97b16185befc4982bd6fdd8aadf492d3,SALES-POS,30-40,2018,10,31,21,24,Wednesday,14 days,40179.2
ACC-414431115,43,28.0,27.86,1.0,CUS-2599279756,2018-08-01,Amy,F,-37.06,142.77,,6beb3465-4cb7-449b-b395-0eaa7764d4fe,-34.58,142.77,VIC,Robinvale,debit,authorized,3f549647f8c64c35a471c57296fa3ee3,POS,40-50,2018,8,1,11,11,Wednesday,14 days,41071.83428571428
ACC-414431115,43,23.45,4.41,1.0,CUS-2599279756,2018-08-02,Amy,F,-37.06,142.77,,106e1272-44ab-4dcb-a438-dd98e0071e51,-37.06,149.9,NSW,Eden,debit,authorized,131f8f53737e4ccea47dc25160f2ebac,SALES-POS,40-50,2018,8,2,11,52,Thursday,14 days,41071.83428571428
ACC-414431115,43,26.49,1608.28,1.0,CUS-2599279756,2018-08-02,Amy,F,-37.06,142.77,,959694dd-5121-4e68-9d7f-ad35790519e3,-37.05,146.09,VIC,Mansfield,debit,authorized,630fea11417b4a6f8bc2f2133869df7d,POS,40-50,2018,8,2,19,15,Thursday,14 days,41071.83428571428
ACC-414431115,43,18.0,1590.28,,CUS-2599279756,2018-08-03,Amy,F,-37.06,142.77,,,,,,,debit,posted,6db2c44fc4be4c71a93f543e953f70b1,INTER BANK,40-50,2018,8,3,11,0,Friday,14 days,41071.83428571428
ACC-414431115,43,19.12,1571.16,1.0,CUS-2599279756,2018-08-03,Amy,F,-37.06,142.77,,6ddddc40-5b69-4253-8a26-167999a8bf96,-37.06,144.22,VIC,Castlemaine,debit,authorized,18fec17ca9da4cbf9b9cbdce2a46a2b0,POS,40-50,2018,8,3,16,28,Friday,14 days,41071.83428571428
ACC-414431115,43,39.24,1531.92,1.0,CUS-2599279756,2018-08-03,Amy,F,-37.06,142.77,,fead27c2-a33d-4870-9cce-29f199b117ad,-37.06,144.22,VIC,Castlemaine,debit,authorized,5df47d0a623f4cd087b714ab59406ad6,POS,40-50,2018,8,3,23,41,Friday,14 days,41071.83428571428
ACC-414431115,43,24.93,1506.99,1.0,CUS-2599279756,2018-08-04,Amy,F,-37.06,142.77,,106e1272-44ab-4dcb-a438-dd98e0071e51,-37.06,149.9,NSW,Eden,debit,authorized,6e9488285000422284b89c8272a97736,SALES-POS,40-50,2018,8,4,11,26,Saturday,14 days,41071.83428571428
ACC-414431115,43,26.3,1480.69,0.0,CUS-2599279756,2018-08-04,Amy,F,-37.06,142.77,,106e1272-44ab-4dcb-a438-dd98e0071e51,-37.06,149.9,NSW,Eden,debit,authorized,750572fbd164408ca8053af2eeae54ce,SALES-POS,40-50,2018,8,4,14,41,Saturday,14 days,41071.83428571428
ACC-414431115,43,18.55,1462.14,1.0,CUS-2599279756,2018-08-06,Amy,F,-37.06,142.77,,6ddddc40-5b69-4253-8a26-167999a8bf96,-37.06,144.22,VIC,Castlemaine,debit,authorized,f865e2fa0d014daba9f5cb8dc884b192,SALES-POS,40-50,2018,8,6,9,2,Monday,14 days,41071.83428571428
ACC-414431115,43,26.89,1435.25,1.0,CUS-2599279756,2018-08-06,Amy,F,-37.06,142.77,,959694dd-5121-4e68-9d7f-ad35790519e3,-37.05,146.09,VIC,Mansfield,debit,authorized,535681f0ff89436fa6bc73f365df3ecf,SALES-POS,40-50,2018,8,6,20,39,Monday,14 days,41071.83428571428
ACC-414431115,43,480.51,954.74,0.0,CUS-2599279756,2018-08-07,Amy,F,-37.06,142.77,,4f379cad-d380-4426-b39d-32132f77fe27,-33.87,151.21,NSW,Sydney,debit,authorized,a7cd308cd7d84e68b4f7c112cae4e9f9,POS,40-50,2018,8,7,21,7,Tuesday,14 days,41071.83428571428
ACC-414431115,43,18.79,935.95,1.0,CUS-2599279756,2018-08-08,Amy,F,-37.06,142.77,,6ddddc40-5b69-4253-8a26-167999a8bf96,-37.06,144.22,VIC,Castlemaine,debit,authorized,d0468af832b84de48f4c4055e216ee9f,POS,40-50,2018,8,8,1,14,Wednesday,14 days,41071.83428571428
ACC-414431115,43,18.91,917.04,0.0,CUS-2599279756,2018-08-08,Amy,F,-37.06,142.77,,6ddddc40-5b69-4253-8a26-167999a8bf96,-37.06,144.22,VIC,Castlemaine,debit,authorized,d7bd6e1d8227461aa9aaa7aa448da811,SALES-POS,40-50,2018,8,8,9,3,Wednesday,14 days,41071.83428571428
ACC-414431115,43,25.88,891.16,1.0,CUS-2599279756,2018-08-08,Amy,F,-37.06,142.77,,aae46e80-4849-4373-abed-68c23ec8e54f,-37.06,144.22,VIC,Castlemaine,debit,authorized,3af702410ae84e9394a281683a49061b,SALES-POS,40-50,2018,8,8,9,35,Wednesday,14 days,41071.83428571428
ACC-414431115,43,24.63,866.53,1.0,CUS-2599279756,2018-08-08,Amy,F,-37.06,142.77,,aae46e80-4849-4373-abed-68c23ec8e54f,-37.06,144.22,VIC,Castlemaine,debit,authorized,7e94d4ac51be4356bbaf9047c2786ca3,SALES-POS,40-50,2018,8,8,11,59,Wednesday,14 days,41071.83428571428
ACC-414431115,43,402.09,464.44,0.0,CUS-2599279756,2018-08-09,Amy,F,-37.06,142.77,,c680aa56-8c8f-4c4f-9055-06cb5719f9cd,-37.05,146.09,VIC,Mansfield,debit,authorized,dcfdd244b0bd4ea491c4b16b557b8dda,POS,40-50,2018,8,9,7,9,Thursday,14 days,41071.83428571428
ACC-414431115,43,18.0,446.44,,CUS-2599279756,2018-08-10,Amy,F,-37.06,142.77,,,,,,,debit,posted,08d4487a89994a3bacd5879eb11fe3a6,INTER BANK,40-50,2018,8,10,11,0,Friday,14 days,41071.83428571428
ACC-414431115,43,18.44,428.0,0.0,CUS-2599279756,2018-08-11,Amy,F,-37.06,142.77,,badab24c-8962-483e-ad02-6635f839f1e6,-37.07,144.21,VIC,Castlemaine,debit,authorized,a78d3f9d12314931b37ec321a598ee7c,SALES-POS,40-50,2018,8,11,21,19,Saturday,14 days,41071.83428571428
ACC-414431115,43,25.71,402.29,0.0,CUS-2599279756,2018-08-11,Amy,F,-37.06,142.77,,106e1272-44ab-4dcb-a438-dd98e0071e51,-37.06,149.9,NSW,Eden,debit,authorized,89bf679b98fd4d02804d935ff89fce25,SALES-POS,40-50,2018,8,11,21,29,Saturday,14 days,41071.83428571428
ACC-414431115,43,21.72,380.57,1.0,CUS-2599279756,2018-08-11,Amy,F,-37.06,142.77,,badab24c-8962-483e-ad02-6635f839f1e6,-37.07,144.21,VIC,Castlemaine,debit,authorized,2e66cf80196b49e9a295e43418a419cc,POS,40-50,2018,8,11,21,57,Saturday,14 days,41071.83428571428
ACC-414431115,43,26.35,354.22,1.0,CUS-2599279756,2018-08-12,Amy,F,-37.06,142.77,,106e1272-44ab-4dcb-a438-dd98e0071e51,-37.06,149.9,NSW,Eden,debit,authorized,61deea1993de4b5fa9c1eb6000619bfe,SALES-POS,40-50,2018,8,12,10,14,Sunday,14 days,41071.83428571428
ACC-414431115,43,179.0,175.22,,CUS-2599279756,2018-08-12,Amy,F,-37.06,142.77,,,,,,,debit,posted,3653fd56409b41c3bd1b4d33a7509589,INTER BANK,40-50,2018,8,12,12,0,Sunday,14 days,41071.83428571428
ACC-414431115,43,29.71,145.51,1.0,CUS-2599279756,2018-08-12,Amy,F,-37.06,142.77,,df59f83b-b2e2-4625-85ba-58d31275e329,-37.05,146.07,VIC,Mansfield,debit,authorized,ff6b7a6484d84e2a90c845d4210c0941,POS,40-50,2018,8,12,20,0,Sunday,14 days,41071.83428571428
ACC-414431115,43,30.13,115.38,1.0,CUS-2599279756,2018-08-13,Amy,F,-37.06,142.77,,df59f83b-b2e2-4625-85ba-58d31275e329,-37.05,146.07,VIC,Mansfield,debit,authorized,148ac9724fc94ceeb7ac5933263764c9,SALES-POS,40-50,2018,8,13,0,9,Monday,14 days,41071.83428571428
ACC-414431115,43,76.54,38.84,1.0,CUS-2599279756,2018-08-13,Amy,F,-37.06,142.77,,12199c94-c98a-454d-86c7-330b9d109260,-27.45,153.04,QLD,Newstead,debit,authorized,8603249c82b24c9ca70855aa0ea5f99e,SALES-POS,40-50,2018,8,13,21,3,Monday,14 days,41071.83428571428
ACC-414431115,43,12.87,25.97,1.0,CUS-2599279756,2018-08-14,Amy,F,-37.06,142.77,,3ca72510-6f2b-4705-8ec3-e09d10afab20,-37.07,144.22,VIC,Castlemaine,debit,authorized,979f5e85039e41a2a067004fc512248e,POS,40-50,2018,8,14,9,43,Tuesday,14 days,41071.83428571428
ACC-414431115,43,13.43,12.54,1.0,CUS-2599279756,2018-08-14,Amy,F,-37.06,142.77,,3ca72510-6f2b-4705-8ec3-e09d10afab20,-37.07,144.22,VIC,Castlemaine,debit,authorized,ee6d8dec26724313b1094e6481cc4022,SALES-POS,40-50,2018,8,14,12,28,Tuesday,14 days,41071.83428571428
ACC-414431115,43,8.14,4.4,0.0,CUS-2599279756,2018-08-15,Amy,F,-37.06,142.77,,0f5a03c0-3990-4e63-9549-e25eeb604815,-37.05,143.74,VIC,Maryborough,debit,authorized,d72076bbecc84aa2a0a1a94d8962b802,SALES-POS,40-50,2018,8,15,15,14,Wednesday,14 days,41071.83428571428
ACC-414431115,43,18.0,1616.76,,CUS-2599279756,2018-08-17,Amy,F,-37.06,142.77,,,,,,,debit,posted,4c3c544fa93c401bb109a91d31be366f,INTER BANK,40-50,2018,8,17,11,0,Friday,14 days,41071.83428571428
ACC-414431115,43,39.54,1577.22,0.0,CUS-2599279756,2018-08-17,Amy,F,-37.06,142.77,,fead27c2-a33d-4870-9cce-29f199b117ad,-37.06,144.22,VIC,Castlemaine,debit,authorized,74789ffef944453ab1bd4e74d2ea1b8f,POS,40-50,2018,8,17,22,0,Friday,14 days,41071.83428571428
ACC-414431115,43,7.84,1569.38,1.0,CUS-2599279756,2018-08-17,Amy,F,-37.06,142.77,,bd30bd03-b96b-4c7b-8a63-c18105e1d6be,-37.05,146.09,VIC,Mansfield,debit,authorized,64272e81534c4690887ecae366dcefb1,POS,40-50,2018,8,17,22,39,Friday,14 days,41071.83428571428
ACC-414431115,43,39.34,1530.04,1.0,CUS-2599279756,2018-08-18,Amy,F,-37.06,142.77,,fead27c2-a33d-4870-9cce-29f199b117ad,-37.06,144.22,VIC,Castlemaine,debit,authorized,1f34f0aae1214f11ba4f706e2b727420,SALES-POS,40-50,2018,8,18,17,9,Saturday,14 days,41071.83428571428
ACC-414431115,43,29.7,1500.34,1.0,CUS-2599279756,2018-08-18,Amy,F,-37.06,142.77,,6beb3465-4cb7-449b-b395-0eaa7764d4fe,-34.58,142.77,VIC,Robinvale,debit,authorized,6bb4e3f840674a22a29e84bec94a87f5,POS,40-50,2018,8,18,19,3,Saturday,14 days,41071.83428571428
ACC-414431115,43,16.4,1483.94,1.0,CUS-2599279756,2018-08-19,Amy,F,-37.06,142.77,,667abc92-cb0d-45be-b17f-06f90eaddf82,-37.05,143.74,VIC,Maryborough,debit,authorized,5a739a849b1d4a54bf2c0b162ef88f22,SALES-POS,40-50,2018,8,19,9,27,Sunday,14 days,41071.83428571428
ACC-414431115,43,18.0,1465.94,,CUS-2599279756,2018-08-24,Amy,F,-37.06,142.77,,,,,,,debit,posted,7b4724be22cc47629d302bd29279efca,INTER BANK,40-50,2018,8,24,11,0,Friday,14 days,41071.83428571428
ACC-414431115,43,189.0,1276.94,,CUS-2599279756,2018-08-27,Amy,F,-37.06,142.77,,,,,,,debit,posted,e6546280589443dfbdcecd29a9073ddb,PAYMENT,40-50,2018,8,27,18,0,Monday,14 days,41071.83428571428
ACC-414431115,43,18.0,2889.3,,CUS-2599279756,2018-08-31,Amy,F,-37.06,142.77,,,,,,,debit,posted,4953101aaa5f49649e4ef6cc901a800b,INTER BANK,40-50,2018,8,31,11,0,Friday,14 days,41071.83428571428
ACC-414431115,43,18.0,2871.3,,CUS-2599279756,2018-09-07,Amy,F,-37.06,142.77,,,,,,,debit,posted,9d4ee593efb74cdeaf8aa19394fea1d5,INTER BANK,40-50,2018,9,7,11,0,Friday,14 days,41071.83428571428
ACC-414431115,43,18.84,2852.46,1.0,CUS-2599279756,2018-09-10,Amy,F,-37.06,142.77,,6ddddc40-5b69-4253-8a26-167999a8bf96,-37.06,144.22,VIC,Castlemaine,debit,authorized,c06dd69af6944c03b0c86c146b968caa,SALES-POS,40-50,2018,9,10,20,52,Monday,14 days,41071.83428571428
ACC-414431115,43,14.18,2838.28,1.0,CUS-2599279756,2018-09-11,Amy,F,-37.06,142.77,,6932e4aa-e374-4279-903f-509d72b60737,-37.05,143.74,VIC,Maryborough,debit,authorized,b5ae2f6511894449b04d80a60af79d20,POS,40-50,2018,9,11,5,18,Tuesday,14 days,41071.83428571428
ACC-414431115,43,15.54,2822.74,1.0,CUS-2599279756,2018-09-12,Amy,F,-37.06,142.77,,02383a7d-f0f7-4696-a94c-81cf6af67141,-37.05,146.09,VIC,Mansfield,debit,authorized,d459dc847e254118853e4f0d97c28ee1,SALES-POS,40-50,2018,9,12,8,20,Wednesday,14 days,41071.83428571428
ACC-414431115,43,20.15,2802.59,1.0,CUS-2599279756,2018-09-12,Amy,F,-37.06,142.77,,2f827786-043b-43d1-bd25-55db007b365f,-37.05,143.74,VIC,Maryborough,debit,authorized,a41ac38ef8ef4847a41b4ca19a4c1566,POS,40-50,2018,9,12,9,43,Wednesday,14 days,41071.83428571428
ACC-414431115,43,27.69,2774.9,1.0,CUS-2599279756,2018-09-12,Amy,F,-37.06,142.77,,106e1272-44ab-4dcb-a438-dd98e0071e51,-37.06,149.9,NSW,Eden,debit,authorized,0fac5670fb6d463090f04defa72068f9,SALES-POS,40-50,2018,9,12,11,49,Wednesday,14 days,41071.83428571428
ACC-414431115,43,179.0,2595.9,,CUS-2599279756,2018-09-12,Amy,F,-37.06,142.77,,,,,,,debit,posted,7199104b360042d4a95225295e2813fd,INTER BANK,40-50,2018,9,12,12,0,Wednesday,14 days,41071.83428571428
ACC-414431115,43,26.25,2569.65,1.0,CUS-2599279756,2018-09-13,Amy,F,-37.06,142.77,,959694dd-5121-4e68-9d7f-ad35790519e3,-37.05,146.09,VIC,Mansfield,debit,authorized,d9300757e17d43d0b84b45c2ac3914f7,SALES-POS,40-50,2018,9,13,8,21,Thursday,14 days,41071.83428571428
ACC-414431115,43,32.31,2537.34,1.0,CUS-2599279756,2018-09-13,Amy,F,-37.06,142.77,,df59f83b-b2e2-4625-85ba-58d31275e329,-37.05,146.07,VIC,Mansfield,debit,authorized,7ad2e3251ca74427968be8015b0e588d,SALES-POS,40-50,2018,9,13,11,1,Thursday,14 days,41071.83428571428
ACC-414431115,43,34.52,2502.82,1.0,CUS-2599279756,2018-09-13,Amy,F,-37.06,142.77,,394e10ae-ecde-49cc-a245-c0fe9511f088,-37.07,144.21,VIC,Castlemaine,debit,authorized,8cb3605ffcef436da64600907b8d3b76,SALES-POS,40-50,2018,9,13,12,4,Thursday,14 days,41071.83428571428
ACC-414431115,43,24.22,2478.6,0.0,CUS-2599279756,2018-09-13,Amy,F,-37.06,142.77,,66029090-5982-4b1d-bc91-a23383b48058,-37.05,143.74,VIC,Maryborough,debit,authorized,4cbcf30dc9144447b33467fbd395ccd5,SALES-POS,40-50,2018,9,13,14,59,Thursday,14 days,41071.83428571428
ACC-414431115,43,36.18,2442.42,1.0,CUS-2599279756,2018-09-13,Amy,F,-37.06,142.77,,394e10ae-ecde-49cc-a245-c0fe9511f088,-37.07,144.21,VIC,Castlemaine,debit,authorized,8591ccdc6e4e4360b3f41edd57760380,POS,40-50,2018,9,13,15,37,Thursday,14 days,41071.83428571428
ACC-414431115,43,18.0,4012.96,,CUS-2599279756,2018-09-14,Amy,F,-37.06,142.77,,,,,,,debit,posted,231cfb23870b4e16b38b2fb446a348f8,INTER BANK,40-50,2018,9,14,11,0,Friday,14 days,41071.83428571428
ACC-414431115,43,41.82,4030.96,1.0,CUS-2599279756,2018-09-14,Amy,F,-37.06,142.77,,fead27c2-a33d-4870-9cce-29f199b117ad,-37.06,144.22,VIC,Castlemaine,debit,authorized,d30cc148895a415f98e0fe8c509777b0,POS,40-50,2018,9,14,11,28,Friday,14 days,41071.83428571428
ACC-414431115,43,172.0,3840.96,,CUS-2599279756,2018-09-14,Amy,F,-37.06,142.77,,,,,,,debit,posted,5d7492b4bd3b463ca4e232cc98c6592d,PAYMENT,40-50,2018,9,14,13,0,Friday,14 days,41071.83428571428
ACC-414431115,43,14.57,3826.39,1.0,CUS-2599279756,2018-09-16,Amy,F,-37.06,142.77,,6932e4aa-e374-4279-903f-509d72b60737,-37.05,143.74,VIC,Maryborough,debit,authorized,447b4f6a3bc045b79cf24a16ec7a9e3d,SALES-POS,40-50,2018,9,16,11,14,Sunday,14 days,41071.83428571428
ACC-414431115,43,6.48,3819.91,1.0,CUS-2599279756,2018-09-16,Amy,F,-37.06,142.77,,bd30bd03-b96b-4c7b-8a63-c18105e1d6be,-37.05,146.09,VIC,Mansfield,debit,authorized,c0579405d0ef440f92fd4cf8dd3a1726,POS,40-50,2018,9,16,11,28,Sunday,14 days,41071.83428571428
ACC-414431115,43,17.95,3801.96,1.0,CUS-2599279756,2018-09-17,Amy,F,-37.06,142.77,,667abc92-cb0d-45be-b17f-06f90eaddf82,-37.05,143.74,VIC,Maryborough,debit,authorized,f9f07e81d57445ce933ece48de6aee75,POS,40-50,2018,9,17,20,50,Monday,14 days,41071.83428571428
ACC-414431115,43,17.07,3784.89,1.0,CUS-2599279756,2018-09-18,Amy,F,-37.06,142.77,,dd84b7c1-a725-4da6-896a-15d1c788ccfe,-37.05,143.74,VIC,Maryborough,debit,authorized,9d225c47382147edb294a84689159244,POS,40-50,2018,9,18,23,59,Tuesday,14 days,41071.83428571428
ACC-414431115,43,14.01,3770.88,1.0,CUS-2599279756,2018-09-20,Amy,F,-37.06,142.77,,3ca72510-6f2b-4705-8ec3-e09d10afab20,-37.07,144.22,VIC,Castlemaine,debit,authorized,57f5731d3809465cb0684bd3dc16671a,POS,40-50,2018,9,20,15,13,Thursday,14 days,41071.83428571428
ACC-414431115,43,18.0,3752.88,,CUS-2599279756,2018-09-21,Amy,F,-37.06,142.77,,,,,,,debit,posted,2487232a9c404c1fb9dccae5e1bc71e0,INTER BANK,40-50,2018,9,21,11,0,Friday,14 days,41071.83428571428
ACC-414431115,43,26.67,3726.21,1.0,CUS-2599279756,2018-09-21,Amy,F,-37.06,142.77,,106e1272-44ab-4dcb-a438-dd98e0071e51,-37.06,149.9,NSW,Eden,debit,authorized,b5e0edfe508342bf8d164d1657b1baff,SALES-POS,40-50,2018,9,21,17,10,Friday,14 days,41071.83428571428
ACC-414431115,43,14.97,3711.24,1.0,CUS-2599279756,2018-09-21,Amy,F,-37.06,142.77,,6932e4aa-e374-4279-903f-509d72b60737,-37.05,143.74,VIC,Maryborough,debit,authorized,aaa3451c68e341f29d71fc88c5a38b90,SALES-POS,40-50,2018,9,21,19,52,Friday,14 days,41071.83428571428
ACC-414431115,43,18.6,3692.64,0.0,CUS-2599279756,2018-09-22,Amy,F,-37.06,142.77,,6ddddc40-5b69-4253-8a26-167999a8bf96,-37.06,144.22,VIC,Castlemaine,debit,authorized,c16ce491329d479bab1f1645ca4b405e,POS,40-50,2018,9,22,9,43,Saturday,14 days,41071.83428571428
ACC-414431115,43,39.59,3653.05,1.0,CUS-2599279756,2018-09-22,Amy,F,-37.06,142.77,,fead27c2-a33d-4870-9cce-29f199b117ad,-37.06,144.22,VIC,Castlemaine,debit,authorized,95c846dddba94c8c844ed0a65110161e,POS,40-50,2018,9,22,15,25,Saturday,14 days,41071.83428571428
ACC-414431115,43,29.74,3623.31,1.0,CUS-2599279756,2018-09-22,Amy,F,-37.06,142.77,,6beb3465-4cb7-449b-b395-0eaa7764d4fe,-34.58,142.77,VIC,Robinvale,debit,authorized,e73d02bfc69e4c258e198fb2c1ba3ece,POS,40-50,2018,9,22,16,22,Saturday,14 days,41071.83428571428
ACC-414431115,43,28.12,3595.19,1.0,CUS-2599279756,2018-09-22,Amy,F,-37.06,142.77,,106e1272-44ab-4dcb-a438-dd98e0071e51,-37.06,149.9,NSW,Eden,debit,authorized,f1f6bf0a28c343a6b4968d2b46d0684c,POS,40-50,2018,9,22,19,45,Saturday,14 days,41071.83428571428
ACC-414431115,43,35.22,3559.97,1.0,CUS-2599279756,2018-09-22,Amy,F,-37.06,142.77,,96454e2a-ea7e-4c25-9d99-728b7160d2c8,-37.05,146.09,VIC,Mansfield,debit,authorized,61506d549ede4a8798b8467d3539b1a3,POS,40-50,2018,9,22,21,2,Saturday,14 days,41071.83428571428
ACC-414431115,43,22.15,3537.82,0.0,CUS-2599279756,2018-09-23,Amy,F,-37.06,142.77,,badab24c-8962-483e-ad02-6635f839f1e6,-37.07,144.21,VIC,Castlemaine,debit,authorized,ec61593549354f57840a5362e0e3ebb0,SALES-POS,40-50,2018,9,23,11,38,Sunday,14 days,41071.83428571428
ACC-414431115,43,18.72,3519.1,1.0,CUS-2599279756,2018-09-23,Amy,F,-37.06,142.77,,c9bb15db-2e66-4849-a0d2-76002bf94819,-32,115.86,WA,Como,debit,authorized,5aca9e23c6414d66b7d839a766b9f7ea,SALES-POS,40-50,2018,9,23,16,17,Sunday,14 days,41071.83428571428
ACC-414431115,43,45.88,3473.22,1.0,CUS-2599279756,2018-09-23,Amy,F,-37.06,142.77,,8c1bfecb-95f3-44f9-96e7-54bea0ed04ba,-33.88,151.21,NSW,Sydney,debit,authorized,2a5d5ff08b0046a5897e4f9c4376d849,SALES-POS,40-50,2018,9,23,19,8,Sunday,14 days,41071.83428571428
ACC-414431115,43,27.23,3445.99,1.0,CUS-2599279756,2018-09-23,Amy,F,-37.06,142.77,,aae46e80-4849-4373-abed-68c23ec8e54f,-37.06,144.22,VIC,Castlemaine,debit,authorized,c7f9651c883448aaab969239cd90a33b,SALES-POS,40-50,2018,9,23,19,25,Sunday,14 days,41071.83428571428
ACC-414431115,43,28.06,3417.93,1.0,CUS-2599279756,2018-09-24,Amy,F,-37.06,142.77,,106e1272-44ab-4dcb-a438-dd98e0071e51,-37.06,149.9,NSW,Eden,debit,authorized,0d81496d876a4174a5ed3d2f28ff392d,SALES-POS,40-50,2018,9,24,19,52,Monday,14 days,41071.83428571428
ACC-414431115,43,17.39,3400.54,0.0,CUS-2599279756,2018-09-26,Amy,F,-37.06,142.77,,02383a7d-f0f7-4696-a94c-81cf6af67141,-37.05,146.09,VIC,Mansfield,debit,authorized,1be038e7aeb548bfb27c79362e389f5a,POS,40-50,2018,9,26,8,35,Wednesday,14 days,41071.83428571428
ACC-414431115,43,34.89,3365.65,1.0,CUS-2599279756,2018-09-26,Amy,F,-37.06,142.77,,df59f83b-b2e2-4625-85ba-58d31275e329,-37.05,146.07,VIC,Mansfield,debit,authorized,ddc465c64b984ad1b8195226ad0341a9,SALES-POS,40-50,2018,9,26,15,29,Wednesday,14 days,41071.83428571428
ACC-414431115,43,6.66,3358.99,1.0,CUS-2599279756,2018-09-26,Amy,F,-37.06,142.77,,bd30bd03-b96b-4c7b-8a63-c18105e1d6be,-37.05,146.09,VIC,Mansfield,debit,authorized,1274f92e9b02434b85b3bdba69c5f39f,SALES-POS,40-50,2018,9,26,15,43,Wednesday,14 days,41071.83428571428
ACC-414431115,43,12.36,3346.63,1.0,CUS-2599279756,2018-09-26,Amy,F,-37.06,142.77,,be172563-5944-47ae-ad39-c01576a33450,-37.82,144.97,VIC,Melbourne,debit,authorized,29bc24153a064cedb1de3680e39b00a9,POS,40-50,2018,9,26,16,12,Wednesday,14 days,41071.83428571428
ACC-414431115,43,26.05,3320.58,1.0,CUS-2599279756,2018-09-26,Amy,F,-37.06,142.77,,959694dd-5121-4e68-9d7f-ad35790519e3,-37.05,146.09,VIC,Mansfield,debit,authorized,955b142d9a944273b63bfa08674f7732,POS,40-50,2018,9,26,17,40,Wednesday,14 days,41071.83428571428
ACC-414431115,43,23.43,3297.15,1.0,CUS-2599279756,2018-09-26,Amy,F,-37.06,142.77,,435f87c7-4e7a-43a6-8f9c-5db8733554e2,-37.05,143.74,VIC,Maryborough,debit,authorized,aa37c37f720e41a08b5ac9569a40cedb,POS,40-50,2018,9,26,20,4,Wednesday,14 days,41071.83428571428
ACC-414431115,43,18.3,3278.85,0.0,CUS-2599279756,2018-09-26,Amy,F,-37.06,142.77,,667abc92-cb0d-45be-b17f-06f90eaddf82,-37.05,143.74,VIC,Maryborough,debit,authorized,5b244b9e71ab4c9c8f6f1a6e645c5125,POS,40-50,2018,9,26,23,7,Wednesday,14 days,41071.83428571428
ACC-414431115,43,49.67,3229.18,1.0,CUS-2599279756,2018-09-27,Amy,F,-37.06,142.77,,20eaacff-3654-4e9c-9558-7da5bc6edaec,-37.05,146.09,VIC,Mansfield,debit,authorized,7f0d41ae6862429491720400d2f59310,SALES-POS,40-50,2018,9,27,7,10,Thursday,14 days,41071.83428571428
ACC-414431115,43,26.3,3202.88,1.0,CUS-2599279756,2018-09-27,Amy,F,-37.06,142.77,,106e1272-44ab-4dcb-a438-dd98e0071e51,-37.06,149.9,NSW,Eden,debit,authorized,05a0668f1ada4f60913e195682bc475d,SALES-POS,40-50,2018,9,27,8,22,Thursday,14 days,41071.83428571428
ACC-414431115,43,8.41,3194.47,1.0,CUS-2599279756,2018-09-27,Amy,F,-37.06,142.77,,0f5a03c0-3990-4e63-9549-e25eeb604815,-37.05,143.74,VIC,Maryborough,debit,authorized,69e50b1abd7945059d8536da1f51b651,SALES-POS,40-50,2018,9,27,8,31,Thursday,14 days,41071.83428571428
ACC-414431115,43,189.0,4635.83,,CUS-2599279756,2018-09-27,Amy,F,-37.06,142.77,,,,,,,debit,posted,840388b7f42b4758a9dbbf17a1bac29f,PAYMENT,40-50,2018,9,27,18,0,Thursday,14 days,41071.83428571428
ACC-414431115,43,18.0,4617.83,,CUS-2599279756,2018-09-28,Amy,F,-37.06,142.77,,,,,,,debit,posted,48b63085063643368db7fc3561296af2,INTER BANK,40-50,2018,9,28,11,0,Friday,14 days,41071.83428571428
ACC-414431115,43,42.76,4575.07,1.0,CUS-2599279756,2018-09-30,Amy,F,-37.06,142.77,,fead27c2-a33d-4870-9cce-29f199b117ad,-37.06,144.22,VIC,Castlemaine,debit,authorized,fdf782ea309646d1b30530d069ff1f6f,POS,40-50,2018,9,30,0,22,Sunday,14 days,41071.83428571428
ACC-414431115,43,15.4,4559.67,1.0,CUS-2599279756,2018-09-30,Amy,F,-37.06,142.77,,6932e4aa-e374-4279-903f-509d72b60737,-37.05,143.74,VIC,Maryborough,debit,authorized,85ba5302ef5044bca571f39f11f878a6,POS,40-50,2018,9,30,10,35,Sunday,14 days,41071.83428571428
ACC-414431115,43,35.44,4524.23,1.0,CUS-2599279756,2018-09-30,Amy,F,-37.06,142.77,,96454e2a-ea7e-4c25-9d99-728b7160d2c8,-37.05,146.09,VIC,Mansfield,debit,authorized,986dd0f6bc474be09de629dc87f6b2a2,SALES-POS,40-50,2018,9,30,11,24,Sunday,14 days,41071.83428571428
ACC-414431115,43,20.69,4503.54,1.0,CUS-2599279756,2018-10-01,Amy,F,-37.06,142.77,,6ddddc40-5b69-4253-8a26-167999a8bf96,-37.06,144.22,VIC,Castlemaine,debit,authorized,459bb4cd2b6642c6b6bb814f79878f1f,POS,40-50,2018,10,1,10,20,Monday,14 days,41071.83428571428
ACC-414431115,43,40.28,4463.26,1.0,CUS-2599279756,2018-10-01,Amy,F,-37.06,142.77,,fead27c2-a33d-4870-9cce-29f199b117ad,-37.06,144.22,VIC,Castlemaine,debit,authorized,79c7885c5c3c43c7a1825652d6c4e119,POS,40-50,2018,10,1,11,2,Monday,14 days,41071.83428571428
ACC-414431115,43,19.74,4443.52,1.0,CUS-2599279756,2018-10-02,Amy,F,-37.06,142.77,,6ddddc40-5b69-4253-8a26-167999a8bf96,-37.06,144.22,VIC,Castlemaine,debit,authorized,393ad15846ea49f486036091168abf43,POS,40-50,2018,10,2,13,26,Tuesday,14 days,41071.83428571428
ACC-414431115,43,18.0,4425.52,,CUS-2599279756,2018-10-05,Amy,F,-37.06,142.77,,,,,,,debit,posted,d12f982d64e24f799356fa40cbc390e7,INTER BANK,40-50,2018,10,5,11,0,Friday,14 days,41071.83428571428
ACC-414431115,43,18.0,6037.88,,CUS-2599279756,2018-10-12,Amy,F,-37.06,142.77,,,,,,,debit,posted,2f9f19806fcb40eda0594d7b6d648a90,INTER BANK,40-50,2018,10,12,11,0,Friday,14 days,41071.83428571428
ACC-414431115,43,179.0,5858.88,,CUS-2599279756,2018-10-12,Amy,F,-37.06,142.77,,,,,,,debit,posted,a41479109c3942fc98d317d2403244c3,INTER BANK,40-50,2018,10,12,12,0,Friday,14 days,41071.83428571428
ACC-414431115,43,26.19,5832.69,1.0,CUS-2599279756,2018-10-13,Amy,F,-37.06,142.77,,106e1272-44ab-4dcb-a438-dd98e0071e51,-37.06,149.9,NSW,Eden,debit,authorized,67102c935fd54dfcaf45aec6d543d0b4,SALES-POS,40-50,2018,10,13,20,48,Saturday,14 days,41071.83428571428
ACC-414431115,43,172.0,5660.69,,CUS-2599279756,2018-10-14,Amy,F,-37.06,142.77,,,,,,,debit,posted,50ccbe9499d843d3916186b23ef091ef,PAYMENT,40-50,2018,10,14,13,0,Sunday,14 days,41071.83428571428
ACC-414431115,43,15.28,5645.41,0.0,CUS-2599279756,2018-10-17,Amy,F,-37.06,142.77,,3ca72510-6f2b-4705-8ec3-e09d10afab20,-37.07,144.22,VIC,Castlemaine,debit,authorized,91b9c0716ff243359b2700d175f2735c,SALES-POS,40-50,2018,10,17,11,31,Wednesday,14 days,41071.83428571428
ACC-414431115,43,27.26,5618.15,1.0,CUS-2599279756,2018-10-18,Amy,F,-37.06,142.77,,106e1272-44ab-4dcb-a438-dd98e0071e51,-37.06,149.9,NSW,Eden,debit,authorized,f0a357f9ac074cbdb4c69c9821c8f081,POS,40-50,2018,10,18,8,46,Thursday,14 days,41071.83428571428
ACC-414431115,43,16.5,5601.65,1.0,CUS-2599279756,2018-10-18,Amy,F,-37.06,142.77,,3ca72510-6f2b-4705-8ec3-e09d10afab20,-37.07,144.22,VIC,Castlemaine,debit,authorized,b5353602f58643409fc5d3ce81b4de46,POS,40-50,2018,10,18,9,28,Thursday,14 days,41071.83428571428
ACC-414431115,43,41.15,5560.5,1.0,CUS-2599279756,2018-10-18,Amy,F,-37.06,142.77,,124ba636-21b8-4c36-8751-440a2fbb73fc,-37.05,143.74,VIC,Maryborough,debit,authorized,a652a08ca135492199a7def23aa9665d,SALES-POS,40-50,2018,10,18,9,41,Thursday,14 days,41071.83428571428
ACC-414431115,43,36.95,5523.55,1.0,CUS-2599279756,2018-10-18,Amy,F,-37.06,142.77,,96454e2a-ea7e-4c25-9d99-728b7160d2c8,-37.05,146.09,VIC,Mansfield,debit,authorized,beeae5b516254a1389e7b0a75aa223e5,POS,40-50,2018,10,18,9,51,Thursday,14 days,41071.83428571428
ACC-414431115,43,19.46,5504.09,1.0,CUS-2599279756,2018-10-18,Amy,F,-37.06,142.77,,6ddddc40-5b69-4253-8a26-167999a8bf96,-37.06,144.22,VIC,Castlemaine,debit,authorized,040ca8b585484c30837085a27e413a6d,SALES-POS,40-50,2018,10,18,14,11,Thursday,14 days,41071.83428571428
ACC-414431115,43,18.0,5486.09,,CUS-2599279756,2018-10-19,Amy,F,-37.06,142.77,,,,,,,debit,posted,a00b2d6fe2064f1db15f0df97a9be603,INTER BANK,40-50,2018,10,19,11,0,Friday,14 days,41071.83428571428
ACC-414431115,43,28.31,5457.78,1.0,CUS-2599279756,2018-10-20,Amy,F,-37.06,142.77,,106e1272-44ab-4dcb-a438-dd98e0071e51,-37.06,149.9,NSW,Eden,debit,authorized,0b1ee05b07b948fca97d772de281f2c2,POS,40-50,2018,10,20,11,24,Saturday,14 days,41071.83428571428
ACC-414431115,43,25.91,5431.87,1.0,CUS-2599279756,2018-10-20,Amy,F,-37.06,142.77,,959694dd-5121-4e68-9d7f-ad35790519e3,-37.05,146.09,VIC,Mansfield,debit,authorized,fec561c1d47b48ab9baec24608b7023f,SALES-POS,40-50,2018,10,20,22,43,Saturday,14 days,41071.83428571428
ACC-414431115,43,24.04,5407.83,1.0,CUS-2599279756,2018-10-21,Amy,F,-37.06,142.77,,66029090-5982-4b1d-bc91-a23383b48058,-37.05,143.74,VIC,Maryborough,debit,authorized,ea7dd45293d44f298b09c927ad98b3ac,SALES-POS,40-50,2018,10,21,9,13,Sunday,14 days,41071.83428571428
ACC-414431115,43,33.76,5374.07,0.0,CUS-2599279756,2018-10-22,Amy,F,-37.06,142.77,,df59f83b-b2e2-4625-85ba-58d31275e329,-37.05,146.07,VIC,Mansfield,debit,authorized,eadf99577329489e8d26f449d1098f99,POS,40-50,2018,10,22,8,13,Monday,14 days,41071.83428571428
ACC-414431115,43,15.79,5358.28,1.0,CUS-2599279756,2018-10-22,Amy,F,-37.06,142.77,,02383a7d-f0f7-4696-a94c-81cf6af67141,-37.05,146.09,VIC,Mansfield,debit,authorized,a0f4cbf0e53c4589baaa39590db51160,SALES-POS,40-50,2018,10,22,9,9,Monday,14 days,41071.83428571428
ACC-414431115,43,18.0,6970.64,,CUS-2599279756,2018-10-26,Amy,F,-37.06,142.77,,,,,,,debit,posted,7c714f4b2388462ebffe3d6114e75638,INTER BANK,40-50,2018,10,26,11,0,Friday,14 days,41071.83428571428
ACC-414431115,43,21.55,6949.09,1.0,CUS-2599279756,2018-10-26,Amy,F,-37.06,142.77,,2f827786-043b-43d1-bd25-55db007b365f,-37.05,143.74,VIC,Maryborough,debit,authorized,00aacfd80be841c7b11eafa65165045f,SALES-POS,40-50,2018,10,26,22,41,Friday,14 days,41071.83428571428
ACC-414431115,43,25.98,6923.11,1.0,CUS-2599279756,2018-10-27,Amy,F,-37.06,142.77,,959694dd-5121-4e68-9d7f-ad35790519e3,-37.05,146.09,VIC,Mansfield,debit,authorized,d03fb326e6a8401d9caf815301c07009,SALES-POS,40-50,2018,10,27,11,19,Saturday,14 days,41071.83428571428
ACC-414431115,43,30.59,6892.52,1.0,CUS-2599279756,2018-10-27,Amy,F,-37.06,142.77,,7ce5471b-363c-46ab-b398-ca517347829a,-33.87,151.21,NSW,Sydney,debit,authorized,dd77620be5d04118bc11a7fa73017e46,SALES-POS,40-50,2018,10,27,13,14,Saturday,14 days,41071.83428571428
ACC-414431115,43,50.36,6842.16,0.0,CUS-2599279756,2018-10-27,Amy,F,-37.06,142.77,,20eaacff-3654-4e9c-9558-7da5bc6edaec,-37.05,146.09,VIC,Mansfield,debit,authorized,dbc8c376856b4784891587d29a306a28,POS,40-50,2018,10,27,14,38,Saturday,14 days,41071.83428571428
ACC-414431115,43,189.0,6632.32,,CUS-2599279756,2018-10-27,Amy,F,-37.06,142.77,,,,,,,debit,posted,1ee4b2e55b8046d289d0cf17b3f7bf5e,PAYMENT,40-50,2018,10,27,18,0,Saturday,14 days,41071.83428571428
ACC-414431115,43,20.84,6821.32,1.0,CUS-2599279756,2018-10-27,Amy,F,-37.06,142.77,,2f827786-043b-43d1-bd25-55db007b365f,-37.05,143.74,VIC,Maryborough,debit,authorized,7439749c5579428fa35b823649c108a7,SALES-POS,40-50,2018,10,27,18,9,Saturday,14 days,41071.83428571428
ACC-414431115,43,20.71,6611.61,1.0,CUS-2599279756,2018-10-27,Amy,F,-37.06,142.77,,6ddddc40-5b69-4253-8a26-167999a8bf96,-37.06,144.22,VIC,Castlemaine,debit,authorized,4338c5c2fc8846a1bc416868001067a4,SALES-POS,40-50,2018,10,27,20,1,Saturday,14 days,41071.83428571428
ACC-414431115,43,26.16,6585.45,1.0,CUS-2599279756,2018-10-27,Amy,F,-37.06,142.77,,aae46e80-4849-4373-abed-68c23ec8e54f,-37.06,144.22,VIC,Castlemaine,debit,authorized,e4c1877e206e4585b13052f0ff37fcb0,SALES-POS,40-50,2018,10,27,20,41,Saturday,14 days,41071.83428571428
ACC-414431115,43,7.07,6578.38,1.0,CUS-2599279756,2018-10-28,Amy,F,-37.06,142.77,,bd30bd03-b96b-4c7b-8a63-c18105e1d6be,-37.05,146.09,VIC,Mansfield,debit,authorized,97e4756f604c4fb6959a7cf0a791c65c,POS,40-50,2018,10,28,17,0,Sunday,14 days,41071.83428571428
ACC-414431115,43,16.84,6561.54,1.0,CUS-2599279756,2018-10-28,Amy,F,-37.06,142.77,,3ca72510-6f2b-4705-8ec3-e09d10afab20,-37.07,144.22,VIC,Castlemaine,debit,authorized,fb8862854359497aa1ee4e0b6b1f7110,POS,40-50,2018,10,28,17,47,Sunday,14 days,41071.83428571428
ACC-414431115,43,41.03,6520.51,0.0,CUS-2599279756,2018-10-29,Amy,F,-37.06,142.77,,fead27c2-a33d-4870-9cce-29f199b117ad,-37.06,144.22,VIC,Castlemaine,debit,authorized,91e5a9e2cb8f417ba0a1dbdaf20fb545,POS,40-50,2018,10,29,8,34,Monday,14 days,41071.83428571428
ACC-414431115,43,33.11,6487.4,0.0,CUS-2599279756,2018-10-29,Amy,F,-37.06,142.77,,df59f83b-b2e2-4625-85ba-58d31275e329,-37.05,146.07,VIC,Mansfield,debit,authorized,18ce510895f644f69759d789b83e6f25,POS,40-50,2018,10,29,10,4,Monday,14 days,41071.83428571428
ACC-1334819143,33,17.97,58154.74,1.0,CUS-3117610635,2018-08-01,Christopher,M,-37.70,145.13,,1e7209b8-f5d6-4241-a328-f0aa772d0c3b,-37.7,144.63,VIC,Rockbank,debit,authorized,de0afdbea75448bab771d107c3d9634a,POS,30-40,2018,8,1,11,38,Wednesday,14 days,70875.439
ACC-1334819143,33,43.7,58111.04,1.0,CUS-3117610635,2018-08-02,Christopher,M,-37.70,145.13,,f708d3ed-a8a7-4185-8b3c-ec53bacbe56f,-37.83,145.12,VIC,Box Hill South,debit,authorized,85c6bc4eec2d47b38a338158f889ed68,SALES-POS,30-40,2018,8,2,2,43,Thursday,14 days,70875.439
ACC-1334819143,33,59.0,58052.04,,CUS-3117610635,2018-08-02,Christopher,M,-37.70,145.13,,,,,,,debit,posted,71b634df4e944df09754ac90521af500,INTER BANK,30-40,2018,8,2,23,0,Thursday,14 days,70875.439
ACC-1334819143,33,50.0,58002.04,,CUS-3117610635,2018-08-03,Christopher,M,-37.70,145.13,,,,,,,debit,posted,f65bb723d2374633bb9d11a2756af587,PAYMENT,30-40,2018,8,3,10,0,Friday,14 days,70875.439
ACC-1334819143,33,25.19,57976.85,1.0,CUS-3117610635,2018-08-05,Christopher,M,-37.70,145.13,,44b6f886-0c28-4c97-a758-8b1770124f50,-37.94,145.1,VIC,Clarinda,debit,authorized,30d7bc6bd4304a3094773f83a762dbf5,POS,30-40,2018,8,5,7,34,Sunday,14 days,70875.439
ACC-1334819143,33,17.39,57959.46,1.0,CUS-3117610635,2018-08-06,Christopher,M,-37.70,145.13,,bec58f68-5893-4cc9-a9fa-729feaccc665,-37.81,144.98,VIC,Collingwood,debit,authorized,70c455794c4749b5b0210401035254fc,POS,30-40,2018,8,6,9,54,Monday,14 days,70875.439
ACC-1334819143,33,22.31,57937.15,1.0,CUS-3117610635,2018-08-06,Christopher,M,-37.70,145.13,,a74a9219-5b40-4cd0-aec0-5a47816fcc96,-38.11,145.16,VIC,Seaford,debit,authorized,c69ba35b016243e58d69555741923fcb,POS,30-40,2018,8,6,21,34,Monday,14 days,70875.439
ACC-1334819143,33,112.0,57825.15,,CUS-3117610635,2018-08-09,Christopher,M,-37.70,145.13,,,,,,,debit,posted,22b8798ac45b408bb841277c845785a2,PAYMENT,30-40,2018,8,9,10,0,Thursday,14 days,70875.439
ACC-1334819143,33,84.76,57740.39,0.0,CUS-3117610635,2018-08-09,Christopher,M,-37.70,145.13,,96f23b7a-2abb-4bdb-a0bb-62314d50ca73,-23.44,144.27,QLD,Longreach,debit,authorized,b0b9a477e96946bb8cb065a3335e34c9,SALES-POS,30-40,2018,8,9,13,23,Thursday,14 days,70875.439
ACC-1334819143,33,12.15,57728.24,0.0,CUS-3117610635,2018-08-09,Christopher,M,-37.70,145.13,,1fffd4c3-b550-4c8f-a5ba-d73a5b4e0a2e,-37.74,142.03,VIC,Hamilton,debit,authorized,1f903f5aaed54944b89704711f676545,SALES-POS,30-40,2018,8,9,15,13,Thursday,14 days,70875.439
ACC-1334819143,33,59.0,57669.24,,CUS-3117610635,2018-08-09,Christopher,M,-37.70,145.13,,,,,,,debit,posted,75d9ee215d4243dca44df19726c5dd7c,INTER BANK,30-40,2018,8,9,23,0,Thursday,14 days,70875.439
ACC-1334819143,33,50.0,57619.24,,CUS-3117610635,2018-08-10,Christopher,M,-37.70,145.13,,,,,,,debit,posted,c16bf6bc917b41f8a39bd685df7312e0,PAYMENT,30-40,2018,8,10,10,0,Friday,14 days,70875.439
ACC-1334819143,33,9.26,57609.98,0.0,CUS-3117610635,2018-08-10,Christopher,M,-37.70,145.13,,f6d24b03-5ca8-4cb3-83e2-73db22103a8a,-37.91,145.25,VIC,Rowville,debit,authorized,2c9b73c3545241dbaaf0ddf4f1c3833f,POS,30-40,2018,8,10,17,45,Friday,14 days,70875.439
ACC-1334819143,33,22.92,57587.06,1.0,CUS-3117610635,2018-08-10,Christopher,M,-37.70,145.13,,af951f2e-1850-4126-8b40-ad0d80ceeb06,-37.78,144.83,VIC,Sunshine,debit,authorized,6381a646da874f4ab725ac6d483efdd3,POS,30-40,2018,8,10,21,59,Friday,14 days,70875.439
ACC-1334819143,33,40.43,57546.63,1.0,CUS-3117610635,2018-08-11,Christopher,M,-37.70,145.13,,a3224a1c-36f1-4640-9b17-3a566c71f5f5,-37.78,144.83,VIC,Sunshine,debit,authorized,3550f0fb06a44b79ad89457698715776,POS,30-40,2018,8,11,7,3,Saturday,14 days,70875.439
ACC-1334819143,33,446.98,57099.65,1.0,CUS-3117610635,2018-08-11,Christopher,M,-37.70,145.13,,e9195c52-7050-454d-aa27-bad1ad4b4ee0,-33.88,151.21,NSW,Sydney,debit,authorized,dfed9f118fc34f0390c2ae5a13f03843,POS,30-40,2018,8,11,14,6,Saturday,14 days,70875.439
ACC-1334819143,33,27.07,57072.58,1.0,CUS-3117610635,2018-08-12,Christopher,M,-37.70,145.13,,fa38d743-985d-4138-b7cd-09ff48b3742d,-27.46,153.02,QLD,Brisbane City,debit,authorized,4fb1936f69ca45b4bb0a4c5c7769acb3,POS,30-40,2018,8,12,10,46,Sunday,14 days,70875.439
ACC-1334819143,33,156.6,56915.98,1.0,CUS-3117610635,2018-08-13,Christopher,M,-37.70,145.13,,ff61dd5e-938a-4acb-a1fd-03d1d2fbba4e,-33.87,151.21,NSW,Sydney,debit,authorized,bb13a963a62040428a8552d90804ffc1,SALES-POS,30-40,2018,8,13,15,22,Monday,14 days,70875.439
ACC-1334819143,33,31.95,56884.03,1.0,CUS-3117610635,2018-08-14,Christopher,M,-37.70,145.13,,def7d3ad-50ef-48e1-a75e-fce2a91b7774,-37.77,144.96,VIC,Brunswick,debit,authorized,b83ae87ac00a46319cacfcdd317dcf78,SALES-POS,30-40,2018,8,14,10,42,Tuesday,14 days,70875.439
ACC-1334819143,33,44.49,56839.54,1.0,CUS-3117610635,2018-08-14,Christopher,M,-37.70,145.13,,e241b15a-e08e-4c7c-acd3-d11a720316b3,-37.7,144.78,VIC,Taylors Lakes,debit,authorized,847dd1603cfc41e4a4286544665fd3a8,SALES-POS,30-40,2018,8,14,11,19,Tuesday,14 days,70875.439
ACC-1334819143,33,30.66,59527.39,1.0,CUS-3117610635,2018-08-14,Christopher,M,-37.70,145.13,,0460f0ca-8482-469a-98be-fab7407a14e3,-38.11,145.28,VIC,Cranbourne,debit,authorized,e6ddf51319e54480b9ad1266ead1d9a5,POS,30-40,2018,8,14,14,26,Tuesday,14 days,70875.439
ACC-1334819143,33,33.29,59494.1,1.0,CUS-3117610635,2018-08-14,Christopher,M,-37.70,145.13,,949af94c-4d8c-4e36-92df-c99a68fe1cf8,-37.7,145.17,VIC,Eltham,debit,authorized,84e11483fb72413f8567983d3bc73416,POS,30-40,2018,8,14,19,46,Tuesday,14 days,70875.439
ACC-1334819143,33,151.97,59342.13,0.0,CUS-3117610635,2018-08-14,Christopher,M,-37.70,145.13,,423556ec-70b1-47b0-b3ca-93bb99cdb18f,-37.81,140.79,SA,Mount Gambier,debit,authorized,afebe8cc15434750bfe332cfb570669a,SALES-POS,30-40,2018,8,14,20,35,Tuesday,14 days,70875.439
ACC-1334819143,33,18.47,59323.66,1.0,CUS-3117610635,2018-08-15,Christopher,M,-37.70,145.13,,c6879eaa-1cb9-4057-aa12-47d2d4c3ac4e,-37.77,144.96,VIC,Brunswick,debit,authorized,7f1856fec69e421d961a2058a9f31481,POS,30-40,2018,8,15,19,40,Wednesday,14 days,70875.439
ACC-1334819143,33,13.03,59310.63,1.0,CUS-3117610635,2018-08-15,Christopher,M,-37.70,145.13,,769a3b32-c71d-4e07-8ff9-539b579324f5,-37.77,145,VIC,Northcote,debit,authorized,39f96e7e99ea4ad691fbebe004035e1d,POS,30-40,2018,8,15,23,36,Wednesday,14 days,70875.439
ACC-1334819143,33,50.0,59064.23,,CUS-3117610635,2018-08-17,Christopher,M,-37.70,145.13,,,,,,,debit,posted,2408222330bb41e3b7722ad3c59142f3,PAYMENT,30-40,2018,8,17,10,0,Friday,14 days,70875.439
ACC-1334819143,33,77.56,58986.67,1.0,CUS-3117610635,2018-08-17,Christopher,M,-37.70,145.13,,7e7c5bf8-10af-438f-9441-2e3baf6e0c94,-38.11,145.14,VIC,Seaford,debit,authorized,832b3535e5f247f1a79f13c0cb107dab,POS,30-40,2018,8,17,21,25,Friday,14 days,70875.439
ACC-1334819143,33,111.0,58875.67,,CUS-3117610635,2018-08-19,Christopher,M,-37.70,145.13,,,,,,,debit,posted,43f761b789cd4428a6d9fe667de10687,PAYMENT,30-40,2018,8,19,6,0,Sunday,14 days,70875.439
ACC-1334819143,33,74.97,58800.7,1.0,CUS-3117610635,2018-08-19,Christopher,M,-37.70,145.13,,f3e1f057-7924-4195-aa29-a7706688c4e1,-27.46,153.03,QLD,Spring Hill,debit,authorized,72e61b3030f145ffa515e2b9a75d06aa,SALES-POS,30-40,2018,8,19,9,4,Sunday,14 days,70875.439
ACC-1334819143,33,36.55,58764.15,1.0,CUS-3117610635,2018-08-19,Christopher,M,-37.70,145.13,,6c6e5c0b-7e61-4649-bdad-e0c4364c0e2a,-37.74,142.02,VIC,Hamilton,debit,authorized,2e0da9c5d99743ddb433efce54f66ea9,SALES-POS,30-40,2018,8,19,14,8,Sunday,14 days,70875.439
ACC-1334819143,33,91.39,58672.76,1.0,CUS-3117610635,2018-08-19,Christopher,M,-37.70,145.13,,4c843dbc-0934-4af5-bacb-9a813503bb6d,-28.1,153.42,QLD,Burleigh Heads,debit,authorized,40e24060446a4d34bf0fb22773e9cbb5,POS,30-40,2018,8,19,14,21,Sunday,14 days,70875.439
ACC-1334819143,33,41.81,58630.95,0.0,CUS-3117610635,2018-08-19,Christopher,M,-37.70,145.13,,e3d248b5-3704-4ca9-8af1-519078df5e74,-37.81,144.94,VIC,Docklands,debit,authorized,658d2d5fc45f482685914d8d312fc84e,POS,30-40,2018,8,19,19,33,Sunday,14 days,70875.439
ACC-1334819143,33,15.2,58615.75,1.0,CUS-3117610635,2018-08-19,Christopher,M,-37.70,145.13,,a9fffd41-73d2-427d-aea2-6fd308b08fc0,-37.87,145.41,VIC,Monbulk,debit,authorized,49e0da7edeb1447194443b7b5f83ee1a,SALES-POS,30-40,2018,8,19,22,52,Sunday,14 days,70875.439
ACC-1334819143,33,115.46,58500.29,1.0,CUS-3117610635,2018-08-21,Christopher,M,-37.70,145.13,,6468acc7-68d9-43a9-905f-ab9a4e1f225f,-37.83,145.07,VIC,Camberwell,debit,authorized,97602c9abde245dfb8c45bac7562d595,SALES-POS,30-40,2018,8,21,8,51,Tuesday,14 days,70875.439
ACC-1334819143,33,17.12,58483.17,1.0,CUS-3117610635,2018-08-23,Christopher,M,-37.70,145.13,,28402957-e943-478f-8d2b-19e6b7e0c2fe,-37.8,144.79,VIC,Sunshine West,debit,authorized,7814cfceab3c4bf19dc055d7af494bd4,SALES-POS,30-40,2018,8,23,10,45,Thursday,14 days,70875.439
ACC-1334819143,33,30.64,58452.53,1.0,CUS-3117610635,2018-08-23,Christopher,M,-37.70,145.13,,6102e64f-516d-4b51-bc28-87dbfe089f5c,-37.83,144.97,VIC,Southbank,debit,authorized,c81921b7bba143a1921e8b244572d1dd,SALES-POS,30-40,2018,8,23,15,8,Thursday,14 days,70875.439
ACC-1334819143,33,59.0,58393.53,,CUS-3117610635,2018-08-23,Christopher,M,-37.70,145.13,,,,,,,debit,posted,775303cc708f47c68dfcc0ee02f2b0bb,INTER BANK,30-40,2018,8,23,23,0,Thursday,14 days,70875.439
ACC-1334819143,33,50.0,58343.53,,CUS-3117610635,2018-08-24,Christopher,M,-37.70,145.13,,,,,,,debit,posted,d2552249592544debd43e3001b0c7022,PAYMENT,30-40,2018,8,24,10,0,Friday,14 days,70875.439
ACC-1334819143,33,124.0,58219.53,,CUS-3117610635,2018-08-24,Christopher,M,-37.70,145.13,,,,,,,debit,posted,e2014146302a49968f77a3ba78714570,PAYMENT,30-40,2018,8,24,11,0,Friday,14 days,70875.439
ACC-1334819143,33,6.93,58212.6,1.0,CUS-3117610635,2018-08-24,Christopher,M,-37.70,145.13,,0ff03fe3-6c40-4713-8024-7023fb9cf9d5,-37.8,144.89,VIC,Footscray,debit,authorized,d51cda9d370842c2932d5517ffef2bf2,SALES-POS,30-40,2018,8,24,17,9,Friday,14 days,70875.439
ACC-1334819143,33,14.37,58198.23,1.0,CUS-3117610635,2018-08-25,Christopher,M,-37.70,145.13,,57108e96-8985-42b9-8a4c-4f2753f1c7cc,-37.86,145.03,VIC,Armadale,debit,authorized,273d4d53c5814e2fa934995931fa6e15,POS,30-40,2018,8,25,9,8,Saturday,14 days,70875.439
ACC-1334819143,33,157.0,58041.23,,CUS-3117610635,2018-08-27,Christopher,M,-37.70,145.13,,,,,,,debit,posted,9ad19033295141f293690581a1a8d288,INTER BANK,30-40,2018,8,27,14,0,Monday,14 days,70875.439
ACC-1334819143,33,20.7,58020.53,1.0,CUS-3117610635,2018-08-28,Christopher,M,-37.70,145.13,,9d59bd81-7a2e-4c7e-8a1c-09032217662f,-37.81,144.96,VIC,Melbourne,debit,authorized,69d79d8bc7254e508bbe507f73754763,POS,30-40,2018,8,28,8,40,Tuesday,14 days,70875.439
ACC-1334819143,33,11.87,60727.17,1.0,CUS-3117610635,2018-08-28,Christopher,M,-37.70,145.13,,cdd4ca72-31ed-42a0-b33f-217e138d30aa,-37.81,144.97,VIC,Melbourne,debit,authorized,22ccbdaf05ae4fb2903e53aa7af98d98,SALES-POS,30-40,2018,8,28,15,25,Tuesday,14 days,70875.439
ACC-1334819143,33,23.46,60703.71,0.0,CUS-3117610635,2018-08-28,Christopher,M,-37.70,145.13,,c53fdadc-08f2-4241-b655-00c1f31c4917,-37.81,144.96,VIC,Melbourne,debit,authorized,6e901eb154de4893b321342eae9839b4,SALES-POS,30-40,2018,8,28,23,28,Tuesday,14 days,70875.439
ACC-1334819143,33,33.67,60670.04,0.0,CUS-3117610635,2018-08-29,Christopher,M,-37.70,145.13,,b7595e30-e20c-4bd7-a024-094f3fa4a5b8,-37.88,145,VIC,Elsternwick,debit,authorized,8702df5077944a8b8bc7a2e9e2c17d30,SALES-POS,30-40,2018,8,29,18,24,Wednesday,14 days,70875.439
ACC-1334819143,33,20.43,60649.61,1.0,CUS-3117610635,2018-08-29,Christopher,M,-37.70,145.13,,1ddea015-d916-49e5-9705-a18ba0076a80,-37.8,144.95,VIC,North Melbourne,debit,authorized,4d26a83c0de340c79fb53b7fb9548689,SALES-POS,30-40,2018,8,29,22,54,Wednesday,14 days,70875.439
ACC-1334819143,33,29.06,60620.55,1.0,CUS-3117610635,2018-08-30,Christopher,M,-37.70,145.13,,317eb39a-df81-4a76-8ade-8bf0d049657e,-37.88,145.23,VIC,Wantirna South,debit,authorized,b69a37fd8fc94d06b61359a7419e24c4,SALES-POS,30-40,2018,8,30,8,37,Thursday,14 days,70875.439
ACC-1334819143,33,21.83,60598.72,0.0,CUS-3117610635,2018-08-30,Christopher,M,-37.70,145.13,,c6299974-d50a-4eea-8b23-a567df6e28ed,-37.8,144.97,VIC,Carlton,debit,authorized,e53b3c5c13e541959025fc93faacafbd,POS,30-40,2018,8,30,9,41,Thursday,14 days,70875.439
ACC-1334819143,33,53.44,60545.28,1.0,CUS-3117610635,2018-08-30,Christopher,M,-37.70,145.13,,0554e4ea-166b-4f1d-9515-53ef3c3980f4,-37.88,145.36,VIC,Sherbrooke,debit,authorized,d2a713f7ef8c4d9da2390844ba215af8,POS,30-40,2018,8,30,12,4,Thursday,14 days,70875.439
ACC-1334819143,33,26.17,60519.11,0.0,CUS-3117610635,2018-08-30,Christopher,M,-37.70,145.13,,ff0d46d6-c939-474e-8a08-6974387a4ed9,-37.78,144.83,VIC,Sunshine,debit,authorized,fc5e6e94008947dd8568a58f09ccac80,POS,30-40,2018,8,30,12,57,Thursday,14 days,70875.439
ACC-1334819143,33,59.0,60460.11,,CUS-3117610635,2018-08-30,Christopher,M,-37.70,145.13,,,,,,,debit,posted,c42258b1bc374ac3a7fbcd5d95e890ce,INTER BANK,30-40,2018,8,30,23,0,Thursday,14 days,70875.439
ACC-1334819143,33,50.0,60410.11,,CUS-3117610635,2018-08-31,Christopher,M,-37.70,145.13,,,,,,,debit,posted,c96a3cb7f63d4f0ea6ec298cba9bf747,PAYMENT,30-40,2018,8,31,10,0,Friday,14 days,70875.439
ACC-1334819143,33,7.77,60402.34,1.0,CUS-3117610635,2018-08-31,Christopher,M,-37.70,145.13,,d1e92e58-202c-4640-aa12-295663cde4c2,-37.81,144.96,VIC,Melbourne,debit,authorized,d7914c4565f841ec99db178453ecd0c9,SALES-POS,30-40,2018,8,31,13,6,Friday,14 days,70875.439
ACC-1334819143,33,27.05,60375.29,1.0,CUS-3117610635,2018-08-31,Christopher,M,-37.70,145.13,,05702806-40c5-4a79-82ac-e1bf781a723c,-37.81,144.97,VIC,Melbourne,debit,authorized,007c9b9c221341769e5335952de61fc3,POS,30-40,2018,8,31,15,26,Friday,14 days,70875.439
ACC-1334819143,33,18.08,60357.21,1.0,CUS-3117610635,2018-09-02,Christopher,M,-37.70,145.13,,b2e29946-a170-4f2c-a164-43a06197ae92,-37.82,144.97,VIC,Melbourne,debit,authorized,dc470041c8004186803aa2ab59f19980,SALES-POS,30-40,2018,9,2,8,53,Sunday,14 days,70875.439
ACC-1334819143,33,22.31,60334.9,1.0,CUS-3117610635,2018-09-02,Christopher,M,-37.70,145.13,,878da03f-55da-4c4a-9a65-568dea0206cd,-37.72,144.81,VIC,Keilor Downs,debit,authorized,cade45de93c447d089617e858daa6902,SALES-POS,30-40,2018,9,2,9,20,Sunday,14 days,70875.439
ACC-1334819143,33,24.83,60310.07,1.0,CUS-3117610635,2018-09-02,Christopher,M,-37.70,145.13,,fc77266a-68d0-47a5-8d33-b7bdf25d3330,-37.8,144.98,VIC,Fitzroy,debit,authorized,f4e5a65eafe6469ea58119a63af153fc,POS,30-40,2018,9,2,14,51,Sunday,14 days,70875.439
ACC-1334819143,33,9.7,60300.37,1.0,CUS-3117610635,2018-09-05,Christopher,M,-37.70,145.13,,7d66dd5a-cea8-4575-8ad7-3dc78752cb82,-37.69,144.44,VIC,Bacchus Marsh,debit,authorized,a8009acd0b784f6b948331725b9842de,SALES-POS,30-40,2018,9,5,15,0,Wednesday,14 days,70875.439
ACC-1334819143,33,16.02,60284.35,1.0,CUS-3117610635,2018-09-06,Christopher,M,-37.70,145.13,,f9ead686-3a62-4217-8031-0a9a5c892fb1,-37.78,144.83,VIC,Sunshine,debit,authorized,9f91a87f9d8f4507a73ab343f074e77d,POS,30-40,2018,9,6,8,28,Thursday,14 days,70875.439
ACC-1334819143,33,37.4,60246.95,0.0,CUS-3117610635,2018-09-06,Christopher,M,-37.70,145.13,,aa8af5d1-53d4-448b-a612-6acd4b5bb310,-33.66,151.31,NSW,Newport,debit,authorized,fe02e9fdca564bb68b3015f06f5d986f,POS,30-40,2018,9,6,9,27,Thursday,14 days,70875.439
ACC-1334819143,33,59.0,60187.95,,CUS-3117610635,2018-09-06,Christopher,M,-37.70,145.13,,,,,,,debit,posted,334e5006fff14876b03664b1a30d114c,INTER BANK,30-40,2018,9,6,23,0,Thursday,14 days,70875.439
ACC-1334819143,33,25.7,60162.25,1.0,CUS-3117610635,2018-09-07,Christopher,M,-37.70,145.13,,5339d6a8-a898-4314-9bf4-4e028757448f,-37.93,145.17,VIC,Mulgrave,debit,authorized,30397853431f4bb0b7ba8b871f45df47,POS,30-40,2018,9,7,7,33,Friday,14 days,70875.439
ACC-1334819143,33,11.23,60151.02,1.0,CUS-3117610635,2018-09-07,Christopher,M,-37.70,145.13,,db263a80-777b-4587-96e0-4eb3f6d719f8,-37.85,144.71,VIC,Tarneit,debit,authorized,928c88fd06514bc7902e71d7547ae29a,SALES-POS,30-40,2018,9,7,8,12,Friday,14 days,70875.439
ACC-1334819143,33,47.61,60103.41,0.0,CUS-3117610635,2018-09-07,Christopher,M,-37.70,145.13,,6c97fa19-15f7-4be4-a1ce-2ef7ddb79eb6,-37.8,148.53,VIC,Marlo,debit,authorized,ab2a758d111144aa8c449aca9a30b130,SALES-POS,30-40,2018,9,7,9,8,Friday,14 days,70875.439
ACC-1334819143,33,28.26,60075.15,1.0,CUS-3117610635,2018-09-07,Christopher,M,-37.70,145.13,,2f6f5d86-df84-4ea2-9ff0-a728e48c4dbe,-37.81,144.96,VIC,Melbourne,debit,authorized,6160f3d056eb45408489119725da26b3,SALES-POS,30-40,2018,9,7,9,32,Friday,14 days,70875.439
ACC-1334819143,33,50.0,60025.15,,CUS-3117610635,2018-09-07,Christopher,M,-37.70,145.13,,,,,,,debit,posted,8cc2af3606c5435ba0fc51e51c5d362c,PAYMENT,30-40,2018,9,7,10,0,Friday,14 days,70875.439
ACC-1334819143,33,38.69,59986.46,1.0,CUS-3117610635,2018-09-08,Christopher,M,-37.70,145.13,,cafe47f2-556a-4080-895b-f2adf7c0b8b3,-37.83,144.85,VIC,Altona North,debit,authorized,3c594f033ed14432938b24bb50929f9d,SALES-POS,30-40,2018,9,8,17,54,Saturday,14 days,70875.439
ACC-1334819143,33,53.74,59932.72,1.0,CUS-3117610635,2018-09-08,Christopher,M,-37.70,145.13,,94197892-7827-479f-9239-022e9cd8fba8,-37.87,144.78,VIC,Altona Meadows,debit,authorized,f752cecbb5e643d2a28db36271a0a8cb,SALES-POS,30-40,2018,9,8,20,1,Saturday,14 days,70875.439
ACC-1334819143,33,19.39,59913.33,1.0,CUS-3117610635,2018-09-08,Christopher,M,-37.70,145.13,,77d4a1d1-4c03-48fe-bfd1-b39fd7f350aa,-37.77,144.97,VIC,Brunswick East,debit,authorized,9027cfb42aba46c6886b65f226501c94,POS,30-40,2018,9,8,20,34,Saturday,14 days,70875.439
ACC-1334819143,33,112.0,59801.33,,CUS-3117610635,2018-09-09,Christopher,M,-37.70,145.13,,,,,,,debit,posted,9aa1a20c914f4394acd5b4a04fd8b44b,PAYMENT,30-40,2018,9,9,10,0,Sunday,14 days,70875.439
ACC-1334819143,33,59.0,62460.84,,CUS-3117610635,2018-09-13,Christopher,M,-37.70,145.13,,,,,,,debit,posted,3676a03d73894f3f8e6a3f6eb112c6ad,INTER BANK,30-40,2018,9,13,23,0,Thursday,14 days,70875.439
ACC-1334819143,33,50.0,62410.84,,CUS-3117610635,2018-09-14,Christopher,M,-37.70,145.13,,,,,,,debit,posted,e39b018e9a0a4564a802f5e5dc51280d,PAYMENT,30-40,2018,9,14,10,0,Friday,14 days,70875.439
ACC-1334819143,33,111.0,62299.84,,CUS-3117610635,2018-09-19,Christopher,M,-37.70,145.13,,,,,,,debit,posted,40f5433ccea941b9a8dedfe3e2a7dffc,PAYMENT,30-40,2018,9,19,6,0,Wednesday,14 days,70875.439
ACC-1334819143,33,59.0,62240.84,,CUS-3117610635,2018-09-20,Christopher,M,-37.70,145.13,,,,,,,debit,posted,d71317e413db4f85b87fd93a13397cc1,INTER BANK,30-40,2018,9,20,23,0,Thursday,14 days,70875.439
ACC-1334819143,33,50.0,62190.84,,CUS-3117610635,2018-09-21,Christopher,M,-37.70,145.13,,,,,,,debit,posted,b9e7c1f59efd4ecdaef353dfe4ecae88,PAYMENT,30-40,2018,9,21,10,0,Friday,14 days,70875.439
ACC-1334819143,33,14.8,62176.04,1.0,CUS-3117610635,2018-09-22,Christopher,M,-37.70,145.13,,51bed653-b991-46e2-af21-8f5a76492eb7,-37.81,144.96,VIC,Melbourne,debit,authorized,caabcc84ea1b4f4b9a5599cb298f1141,POS,30-40,2018,9,22,19,3,Saturday,14 days,70875.439
ACC-1334819143,33,29.84,62146.2,1.0,CUS-3117610635,2018-09-23,Christopher,M,-37.70,145.13,,fa8c4421-d919-492d-854b-9b4119dfa13b,-37.86,145.04,VIC,Malvern,debit,authorized,69ea8ac316ee40c5b2a088b6391f0c6a,SALES-POS,30-40,2018,9,23,9,51,Sunday,14 days,70875.439
ACC-1334819143,33,49.23,62096.97,0.0,CUS-3117610635,2018-09-23,Christopher,M,-37.70,145.13,,cd32bde7-1b61-404e-b093-3ba8ed7f5ebf,-37.83,140.79,SA,Mount Gambier,debit,authorized,ff2be2ea6616447eb806681037d96d51,POS,30-40,2018,9,23,10,25,Sunday,14 days,70875.439
ACC-1334819143,33,15.11,62081.86,1.0,CUS-3117610635,2018-09-23,Christopher,M,-37.70,145.13,,e1f6407e-16d6-4779-99b5-52ee31a6dad8,-37.8,145.04,VIC,Kew,debit,authorized,18d3155d723f4460bbaa80da793326bf,POS,30-40,2018,9,23,10,54,Sunday,14 days,70875.439
ACC-1334819143,33,44.2,62037.66,1.0,CUS-3117610635,2018-09-23,Christopher,M,-37.70,145.13,,1cdb4555-d0c2-458f-82dc-8ce2dee7fde9,-38,145.08,VIC,Parkdale,debit,authorized,31533e5ac63b4f39b742c915304264ef,POS,30-40,2018,9,23,14,0,Sunday,14 days,70875.439
ACC-1334819143,33,12.87,62024.79,1.0,CUS-3117610635,2018-09-24,Christopher,M,-37.70,145.13,,d2697166-8763-4124-9bc5-d07eae9add4f,-37.77,144.92,VIC,Moonee Ponds,debit,authorized,fc6f474e0dd942af93f74812b036f7d1,POS,30-40,2018,9,24,9,26,Monday,14 days,70875.439
ACC-1334819143,33,124.0,61900.79,,CUS-3117610635,2018-09-24,Christopher,M,-37.70,145.13,,,,,,,debit,posted,79f4eeec164540e6ae4a56688e24e645,PAYMENT,30-40,2018,9,24,11,0,Monday,14 days,70875.439
ACC-1334819143,33,34.61,61866.18,1.0,CUS-3117610635,2018-09-24,Christopher,M,-37.70,145.13,,3fa0f231-07d8-4168-941a-edf1c708e449,-37.78,144.83,VIC,Sunshine,debit,authorized,9f2bd4a53e6a4843a54cded49a031a6b,POS,30-40,2018,9,24,22,12,Monday,14 days,70875.439
ACC-1334819143,33,26.37,61839.81,1.0,CUS-3117610635,2018-09-25,Christopher,M,-37.70,145.13,,7dd0e3c6-fe60-4710-b396-9e4e09bf7340,-37.8,144.89,VIC,Footscray,debit,authorized,dc68d57aa89242aa8bb84c081042242b,SALES-POS,30-40,2018,9,25,10,30,Tuesday,14 days,70875.439
ACC-1334819143,33,15.24,64543.08,1.0,CUS-3117610635,2018-09-25,Christopher,M,-37.70,145.13,,dc03fd83-eb30-4259-a566-91aa876f677a,-37.83,144.95,VIC,South Melbourne,debit,authorized,4bf3624cbaeb4ecfa3d38b3f6b1d9c1d,POS,30-40,2018,9,25,15,12,Tuesday,14 days,70875.439
ACC-1334819143,33,31.95,64511.13,1.0,CUS-3117610635,2018-09-25,Christopher,M,-37.70,145.13,,f156c6e4-b5dd-463e-9e8a-b382f080a88c,-37.88,144.7,VIC,Hoppers Crossing,debit,authorized,6fc01b98798b40e283f40224253d8f9d,SALES-POS,30-40,2018,9,25,17,24,Tuesday,14 days,70875.439
ACC-1334819143,33,14.09,64497.04,1.0,CUS-3117610635,2018-09-26,Christopher,M,-37.70,145.13,,2c65ee3e-11e7-47ec-bb1a-dd1f2d60d029,-37.82,145.12,VIC,Box Hill,debit,authorized,21786e530b0c451a93c0057b7ebd7820,POS,30-40,2018,9,26,8,1,Wednesday,14 days,70875.439
ACC-1334819143,33,21.35,64475.69,1.0,CUS-3117610635,2018-09-26,Christopher,M,-37.70,145.13,,9d6061d4-6af3-4302-a4a0-49bcb04ed82c,-37.88,144.68,VIC,Werribee,debit,authorized,6162c705b113446a8896521decb84e4b,SALES-POS,30-40,2018,9,26,19,14,Wednesday,14 days,70875.439
ACC-1334819143,33,29.16,64446.53,1.0,CUS-3117610635,2018-09-27,Christopher,M,-37.70,145.13,,ad0b6f81-5d48-430d-af3b-286fda428190,-37.81,144.96,VIC,Melbourne,debit,authorized,1a3a8bd4b4344a6a93bb98ad901c13ee,SALES-POS,30-40,2018,9,27,8,39,Thursday,14 days,70875.439
ACC-1334819143,33,157.0,64289.53,,CUS-3117610635,2018-09-27,Christopher,M,-37.70,145.13,,,,,,,debit,posted,0441124ad4fd48dca1afabb3c196b2c4,INTER BANK,30-40,2018,9,27,14,0,Thursday,14 days,70875.439
ACC-1334819143,33,22.21,64267.32,1.0,CUS-3117610635,2018-09-27,Christopher,M,-37.70,145.13,,7af41c2c-b789-47c0-a098-b7c8fbcaf66f,-37.81,144.96,VIC,Melbourne,debit,authorized,4bf20313e2e848e990a68d527e2f8f9f,SALES-POS,30-40,2018,9,27,15,26,Thursday,14 days,70875.439
ACC-1334819143,33,59.0,64208.32,,CUS-3117610635,2018-09-27,Christopher,M,-37.70,145.13,,,,,,,debit,posted,0ed40c484c5f4bfd8fe417d9b1ba7a65,INTER BANK,30-40,2018,9,27,23,0,Thursday,14 days,70875.439
ACC-1334819143,33,37.15,64171.17,1.0,CUS-3117610635,2018-09-28,Christopher,M,-37.70,145.13,,c78493f7-fa00-484f-98f6-166b3969b1bc,-37.86,144.69,VIC,Hoppers Crossing,debit,authorized,b255406dce8c49e7aa2f513dccc2bfcd,POS,30-40,2018,9,28,8,24,Friday,14 days,70875.439
ACC-1334819143,33,50.0,64121.17,,CUS-3117610635,2018-09-28,Christopher,M,-37.70,145.13,,,,,,,debit,posted,78c28eda9134415fb858e7e0a447a59c,PAYMENT,30-40,2018,9,28,10,0,Friday,14 days,70875.439
ACC-1334819143,33,15.0,64106.17,1.0,CUS-3117610635,2018-09-28,Christopher,M,-37.70,145.13,,415420c9-e853-41de-8288-dcee1d4cc4ed,-37.81,144.98,VIC,East Melbourne,debit,authorized,e8064b94d54a4b868b85289ba7af6d9a,SALES-POS,30-40,2018,9,28,15,0,Friday,14 days,70875.439
ACC-1334819143,33,120.38,63985.79,1.0,CUS-3117610635,2018-09-29,Christopher,M,-37.70,145.13,,cb29c0f6-9ef0-49e6-9ea6-2c91a2465084,-37.81,144.97,VIC,Melbourne,debit,authorized,de4acefc99914f4d9c4a3525cb2f2a04,SALES-POS,30-40,2018,9,29,5,34,Saturday,14 days,70875.439
ACC-1334819143,33,46.38,63939.41,1.0,CUS-3117610635,2018-09-29,Christopher,M,-37.70,145.13,,fb9b1676-d6c7-4c57-847e-69906493122c,-37.79,145.12,VIC,Doncaster,debit,authorized,7ae60eae802c46f5a9e196f2cdd429ad,SALES-POS,30-40,2018,9,29,17,53,Saturday,14 days,70875.439
ACC-1334819143,33,9.06,63930.35,0.0,CUS-3117610635,2018-09-29,Christopher,M,-37.70,145.13,,2ce60e2b-ed37-4e89-ab6b-d57ef6471c77,-37.81,144.97,VIC,Melbourne,debit,authorized,e6d41c513a2846559b2563ddb442eb69,POS,30-40,2018,9,29,21,12,Saturday,14 days,70875.439
ACC-1334819143,33,25.97,63904.38,1.0,CUS-3117610635,2018-09-30,Christopher,M,-37.70,145.13,,66b6c18d-60fe-452e-a5c0-e80edbb355e9,-37.82,144.88,VIC,Yarraville,debit,authorized,e3f8a6a3ff644bb48107c6bf76919a69,SALES-POS,30-40,2018,9,30,9,39,Sunday,14 days,70875.439
ACC-1334819143,33,6.86,63897.52,0.0,CUS-3117610635,2018-09-30,Christopher,M,-37.70,145.13,,4ca6aecf-6064-4cc8-b2c1-90323e02a30a,-37.81,144.96,VIC,North Melbourne,debit,authorized,6c948b2c27d84bddac3e3646484330c3,SALES-POS,30-40,2018,9,30,12,12,Sunday,14 days,70875.439
ACC-1334819143,33,38.67,63858.85,0.0,CUS-3117610635,2018-09-30,Christopher,M,-37.70,145.13,,407ce64d-5d07-4c5d-bff1-5c2119839e63,-37.8,144.94,VIC,North Melbourne,debit,authorized,2d869e4b403a4241a151c215e9b9a708,SALES-POS,30-40,2018,9,30,15,56,Sunday,14 days,70875.439
ACC-1334819143,33,98.43,63760.42,1.0,CUS-3117610635,2018-10-01,Christopher,M,-37.70,145.13,,7e703324-854e-497c-b055-6fe1b35d428c,-33.86,151.21,NSW,Sydney,debit,authorized,d17e40da666b4bf1b24fafa994421b48,SALES-POS,30-40,2018,10,1,10,14,Monday,14 days,70875.439
ACC-1334819143,33,29.64,63730.78,1.0,CUS-3117610635,2018-10-03,Christopher,M,-37.70,145.13,,b708cfca-8f02-4a13-a2da-806c89994d67,-37.82,145,VIC,Richmond,debit,authorized,d774254e8b2b4497ac2c35cd8a0d08ad,SALES-POS,30-40,2018,10,3,10,41,Wednesday,14 days,70875.439
ACC-1334819143,33,27.97,63702.81,1.0,CUS-3117610635,2018-10-03,Christopher,M,-37.70,145.13,,6bdf134e-f04a-448d-b5f1-c02478dcbbc6,-37.87,145.24,VIC,Wantirna South,debit,authorized,ceb8788ad08e4cb5b940302d0d80c2bb,SALES-POS,30-40,2018,10,3,11,6,Wednesday,14 days,70875.439
ACC-1334819143,33,59.0,63643.81,,CUS-3117610635,2018-10-04,Christopher,M,-37.70,145.13,,,,,,,debit,posted,2805fe9320ca437e8c2e6595aadf5c5b,INTER BANK,30-40,2018,10,4,23,0,Thursday,14 days,70875.439
ACC-1334819143,33,50.0,63593.81,,CUS-3117610635,2018-10-05,Christopher,M,-37.70,145.13,,,,,,,debit,posted,9165e4e611f74ad99b74af45308cecc7,PAYMENT,30-40,2018,10,5,10,0,Friday,14 days,70875.439
ACC-1334819143,33,37.27,63556.54,1.0,CUS-3117610635,2018-10-05,Christopher,M,-37.70,145.13,,ed8dc00e-8676-4e69-b0d9-d07a57cb57db,-37.83,140.78,SA,Mount Gambier,debit,authorized,80d32f34df214851a7c09dc5d4a3bd87,SALES-POS,30-40,2018,10,5,15,43,Friday,14 days,70875.439
ACC-1334819143,33,8.09,63548.45,0.0,CUS-3117610635,2018-10-05,Christopher,M,-37.70,145.13,,f7f17c87-2a50-4edc-8151-7a14ccebe561,-37.82,144.96,VIC,Melbourne,debit,authorized,443df5c698ed47cc8d7eec30842145e3,SALES-POS,30-40,2018,10,5,17,53,Friday,14 days,70875.439
ACC-1334819143,33,9.9,63538.55,1.0,CUS-3117610635,2018-10-05,Christopher,M,-37.70,145.13,,1238eee5-7e56-43ac-9d44-b62038c95642,-37.78,145.03,VIC,Fairfield,debit,authorized,ad4a9b1f157140a3b9ba2f2c0558705a,POS,30-40,2018,10,5,19,15,Friday,14 days,70875.439
ACC-1334819143,33,22.86,63515.69,1.0,CUS-3117610635,2018-10-05,Christopher,M,-37.70,145.13,,3c2b94f9-75a0-45bd-b2aa-c20ace65c325,-37.97,145.22,VIC,Dandenong,debit,authorized,ebb420f001464e27a496ca50a5c76888,POS,30-40,2018,10,5,23,5,Friday,14 days,70875.439
ACC-1334819143,33,8.91,63506.78,1.0,CUS-3117610635,2018-10-06,Christopher,M,-37.70,145.13,,253ccdff-41c7-47cd-8bb6-8032f6098b18,-37.82,145.12,VIC,Boxhill,debit,authorized,413ce4047e8e41fb9bdf5484e98ac847,SALES-POS,30-40,2018,10,6,17,2,Saturday,14 days,70875.439
ACC-1334819143,33,58.86,63447.92,1.0,CUS-3117610635,2018-10-06,Christopher,M,-37.70,145.13,,e170b598-8961-4c29-9ee1-d9a98196801c,-37.83,140.78,SA,Mount Gambier,debit,authorized,bd3ff76526464c3daf2c436831a7893c,POS,30-40,2018,10,6,17,24,Saturday,14 days,70875.439
ACC-1334819143,33,30.26,63417.66,1.0,CUS-3117610635,2018-10-06,Christopher,M,-37.70,145.13,,93663348-7244-4899-8da2-bf9bf9948b55,-37.88,145,VIC,Elsternwick,debit,authorized,10c0248b06b8471fad8ce5a4c75d8776,SALES-POS,30-40,2018,10,6,19,58,Saturday,14 days,70875.439
ACC-1334819143,33,62.15,63355.51,1.0,CUS-3117610635,2018-10-09,Christopher,M,-37.70,145.13,,b952dc05-e859-4ade-b09f-1a138db6d88b,-37.73,144.9,VIC,Strathmore,debit,authorized,755fc527f78a412fad35ece6007af789,SALES-POS,30-40,2018,10,9,9,3,Tuesday,14 days,70875.439
ACC-1334819143,33,112.0,63243.51,,CUS-3117610635,2018-10-09,Christopher,M,-37.70,145.13,,,,,,,debit,posted,3f0f11ef5f194e3c969f164dcf175692,PAYMENT,30-40,2018,10,9,10,0,Tuesday,14 days,70875.439
ACC-1334819143,33,32.56,63210.95,1.0,CUS-3117610635,2018-10-09,Christopher,M,-37.70,145.13,,1a642b2b-4105-4b4f-8d30-3ec8171706a5,-37.8,144.88,VIC,West Footscray,debit,authorized,fed6b21b4fda40a8a855d1ce28e3a282,POS,30-40,2018,10,9,11,4,Tuesday,14 days,70875.439
ACC-1334819143,33,28.15,65901.31,1.0,CUS-3117610635,2018-10-09,Christopher,M,-37.70,145.13,,e4bc12e1-0e87-439e-bc3b-961a06af1371,-37.84,145,VIC,South Yarra,debit,authorized,563cb70fd1ba482cb3013f67262d5f39,SALES-POS,30-40,2018,10,9,16,58,Tuesday,14 days,70875.439
ACC-1334819143,33,14.83,65886.48,1.0,CUS-3117610635,2018-10-09,Christopher,M,-37.70,145.13,,a1dbeae7-c107-43c9-8d39-b7011109179d,-37.87,145.24,VIC,Wantirna South,debit,authorized,68f68a1b99134e9daea558d2bf49d695,POS,30-40,2018,10,9,19,57,Tuesday,14 days,70875.439
ACC-1334819143,33,6.5,65879.98,1.0,CUS-3117610635,2018-10-10,Christopher,M,-37.70,145.13,,0e976dfc-9444-4756-930f-164e5d5aaa21,-37.85,145.05,VIC,Hawthorn East,debit,authorized,d0c554ee737a41628b3e0ae3d29c7d7c,POS,30-40,2018,10,10,11,38,Wednesday,14 days,70875.439
ACC-1334819143,33,8.42,65871.56,1.0,CUS-3117610635,2018-10-10,Christopher,M,-37.70,145.13,,fcdd5fd9-fa81-42f7-b047-c13f013267a8,-37.85,144.99,VIC,Windsor,debit,authorized,b9cdb5bb33c149f69b727cc026798698,POS,30-40,2018,10,10,16,13,Wednesday,14 days,70875.439
ACC-1334819143,33,26.54,65845.02,1.0,CUS-3117610635,2018-10-11,Christopher,M,-37.70,145.13,,061ffafb-8781-4844-9286-541ba757e9cc,-37.81,144.97,VIC,Melbourne,debit,authorized,5d46c53833764f34985b6ddbb7a254d1,SALES-POS,30-40,2018,10,11,14,13,Thursday,14 days,70875.439
ACC-1334819143,33,27.9,65817.12,1.0,CUS-3117610635,2018-10-11,Christopher,M,-37.70,145.13,,0bc72e38-dadd-4fac-8814-7cb964246beb,-37.84,144.78,VIC,Laverton North,debit,authorized,8cf2860e30834e979d7cc75cdc14d1e0,POS,30-40,2018,10,11,15,54,Thursday,14 days,70875.439
ACC-1334819143,33,39.1,65778.02,1.0,CUS-3117610635,2018-10-11,Christopher,M,-37.70,145.13,,46971495-3cda-4d23-9cc5-a62df31880a5,-37.99,145.08,VIC,Parkdale,debit,authorized,7959889272424bb8928bf00c82fe1650,POS,30-40,2018,10,11,18,7,Thursday,14 days,70875.439
ACC-1334819143,33,59.0,65719.02,,CUS-3117610635,2018-10-11,Christopher,M,-37.70,145.13,,,,,,,debit,posted,76c6191a4acf460b8f874bf6fe0e5967,INTER BANK,30-40,2018,10,11,23,0,Thursday,14 days,70875.439
ACC-1334819143,33,50.0,65669.02,,CUS-3117610635,2018-10-12,Christopher,M,-37.70,145.13,,,,,,,debit,posted,3de8e0b485e94a01b1b45879819432c4,PAYMENT,30-40,2018,10,12,10,0,Friday,14 days,70875.439
ACC-1334819143,33,59.0,65610.02,,CUS-3117610635,2018-10-18,Christopher,M,-37.70,145.13,,,,,,,debit,posted,353dbad250c04f16954bde7449cf2f91,INTER BANK,30-40,2018,10,18,23,0,Thursday,14 days,70875.439
ACC-1334819143,33,111.0,65499.02,,CUS-3117610635,2018-10-19,Christopher,M,-37.70,145.13,,,,,,,debit,posted,97f4569e6cf9463a95fad49cad238d25,PAYMENT,30-40,2018,10,19,6,0,Friday,14 days,70875.439
ACC-1334819143,33,50.0,65449.02,,CUS-3117610635,2018-10-19,Christopher,M,-37.70,145.13,,,,,,,debit,posted,63a5a2f6efe841fab5bd8e1bf1f69264,PAYMENT,30-40,2018,10,19,10,0,Friday,14 days,70875.439
ACC-1334819143,33,124.0,68043.53,,CUS-3117610635,2018-10-24,Christopher,M,-37.70,145.13,,,,,,,debit,posted,2a18f3c7783b4a739573ca21122016ca,PAYMENT,30-40,2018,10,24,11,0,Wednesday,14 days,70875.439
ACC-1334819143,33,59.0,67984.53,,CUS-3117610635,2018-10-25,Christopher,M,-37.70,145.13,,,,,,,debit,posted,955dc81df3d9412287f6c07c559761dc,INTER BANK,30-40,2018,10,25,23,0,Thursday,14 days,70875.439
ACC-1334819143,33,50.0,67934.53,,CUS-3117610635,2018-10-26,Christopher,M,-37.70,145.13,,,,,,,debit,posted,7fa07b71ad8d415baef488206e1daaa5,PAYMENT,30-40,2018,10,26,10,0,Friday,14 days,70875.439
ACC-1334819143,33,157.0,67777.53,,CUS-3117610635,2018-10-27,Christopher,M,-37.70,145.13,,,,,,,debit,posted,d42e89ce824b4855975e98120c462852,INTER BANK,30-40,2018,10,27,14,0,Saturday,14 days,70875.439
ACC-3541460373,24,27.39,1109.58,1.0,CUS-1433879684,2018-08-01,Jeffrey,M,-37.83,145.00,,b64b1423-0992-4942-b955-5785b81c1cd6,-37.8,145.32,VIC,Kilsyth,debit,authorized,a4c5dbf8884f40efb7d37ee62c121da5,POS,20-30,2018,8,1,11,59,Wednesday,14 days,36710.657
ACC-3541460373,24,41.0,2476.66,,CUS-1433879684,2018-08-02,Jeffrey,M,-37.83,145.00,,,,,,,debit,posted,114c12ff4117427aa5e400d4e794151f,PAYMENT,20-30,2018,8,2,11,0,Thursday,14 days,36710.657
ACC-3541460373,24,19.56,2457.1,1.0,CUS-1433879684,2018-08-03,Jeffrey,M,-37.83,145.00,,78d90404-f349-4ced-8850-13bdc909ab03,-37.8,144.98,VIC,Fitzroy,debit,authorized,4fafd13d287744689d51c434bcfd0e8b,POS,20-30,2018,8,3,6,35,Friday,14 days,36710.657
ACC-3541460373,24,53.0,2404.1,,CUS-1433879684,2018-08-03,Jeffrey,M,-37.83,145.00,,,,,,,debit,posted,aa7a71846dea4bde85dc64bafb44cbca,PAYMENT,20-30,2018,8,3,18,0,Friday,14 days,36710.657
ACC-3541460373,24,41.0,2363.1,,CUS-1433879684,2018-08-03,Jeffrey,M,-37.83,145.00,,,,,,,debit,posted,9d5a94f2cfe742c59e08810ca09a10be,PAYMENT,20-30,2018,8,3,23,0,Friday,14 days,36710.657
ACC-3541460373,24,9.3,2353.8,1.0,CUS-1433879684,2018-08-04,Jeffrey,M,-37.83,145.00,,4159b40b-5139-404b-9b88-f858db684cba,-37.81,144.97,VIC,Melbourne,debit,authorized,040abafbfba344209e88924bc6450a9c,SALES-POS,20-30,2018,8,4,17,17,Saturday,14 days,36710.657
ACC-3541460373,24,46.13,2307.67,1.0,CUS-1433879684,2018-08-04,Jeffrey,M,-37.83,145.00,,6c97fa19-15f7-4be4-a1ce-2ef7ddb79eb6,-37.8,148.53,VIC,Marlo,debit,authorized,d72ec18fd3b3498591092736649530ac,SALES-POS,20-30,2018,8,4,21,30,Saturday,14 days,36710.657
ACC-3541460373,24,546.94,1760.73,1.0,CUS-1433879684,2018-08-05,Jeffrey,M,-37.83,145.00,,54f1e39c-55ce-4e75-96e4-b03580738c32,-37.86,145.03,VIC,Malvern,debit,authorized,97906f1768944b609affe51eaf5d5c29,POS,20-30,2018,8,5,20,46,Sunday,14 days,36710.657
ACC-3541460373,24,40.47,1720.26,1.0,CUS-1433879684,2018-08-05,Jeffrey,M,-37.83,145.00,,27b825d9-1f8b-4488-ad57-d344607b1c9b,-37.81,144.72,VIC,Truganina,debit,authorized,c694ee2839e44346b05c66398d8dd25f,POS,20-30,2018,8,5,21,42,Sunday,14 days,36710.657
ACC-3541460373,24,18.61,1701.65,0.0,CUS-1433879684,2018-08-07,Jeffrey,M,-37.83,145.00,,b53bc667-bb5c-4901-9955-3c4401cc6c7c,-37.84,147.6,VIC,Bairnsdale,debit,authorized,aa4b2367705d4297a32f35b2ee9b200a,SALES-POS,20-30,2018,8,7,9,21,Tuesday,14 days,36710.657
ACC-3541460373,24,132.19,1569.46,1.0,CUS-1433879684,2018-08-07,Jeffrey,M,-37.83,145.00,,f126f15e-30c2-456f-8b10-a28f9762e41d,-27.47,153.02,QLD,Brisbane City,debit,authorized,9c12844854e54180a04674dc2c088361,SALES-POS,20-30,2018,8,7,10,37,Tuesday,14 days,36710.657
ACC-3541460373,24,11.85,1557.61,1.0,CUS-1433879684,2018-08-07,Jeffrey,M,-37.83,145.00,,5f48db08-54c9-4e98-b110-e080d230e629,-37.88,145.22,VIC,Wantirna South,debit,authorized,52e22ace7d2d40f6837fbff2fdeb5c00,POS,20-30,2018,8,7,16,22,Tuesday,14 days,36710.657
ACC-3541460373,24,52.73,1504.88,1.0,CUS-1433879684,2018-08-08,Jeffrey,M,-37.83,145.00,,c0c9ed3a-fd36-4944-a3aa-9b3522ff4367,-37.78,145.27,VIC,Croydon,debit,authorized,9979949722c54d4bbfea2bbb9714d867,POS,20-30,2018,8,8,9,7,Wednesday,14 days,36710.657
ACC-3541460373,24,27.98,1476.9,1.0,CUS-1433879684,2018-08-08,Jeffrey,M,-37.83,145.00,,c3eb7d47-28a1-42c1-9a27-d1f01e9c696f,-37.78,144.91,VIC,Ascot Vale,debit,authorized,7b7d9ff946d84b1a88d67479a3718631,SALES-POS,20-30,2018,8,8,15,7,Wednesday,14 days,36710.657
ACC-3541460373,24,6.08,1470.82,1.0,CUS-1433879684,2018-08-09,Jeffrey,M,-37.83,145.00,,0cba524f-3785-423b-8da3-a135eae74a43,-37.82,144.95,VIC,Melbourne,debit,authorized,4cc1398909664f1d8fb9c4f9d483855e,SALES-POS,20-30,2018,8,9,9,18,Thursday,14 days,36710.657
ACC-3541460373,24,41.0,1413.9,,CUS-1433879684,2018-08-09,Jeffrey,M,-37.83,145.00,,,,,,,debit,posted,29ea9b97ffb6424bb4afda9aceacbb3e,PAYMENT,20-30,2018,8,9,11,0,Thursday,14 days,36710.657
ACC-3541460373,24,15.92,1454.9,1.0,CUS-1433879684,2018-08-09,Jeffrey,M,-37.83,145.00,,b0315440-bfc8-49db-8889-0b0991a3b7d8,-37.78,144.84,VIC,Sunshine,debit,authorized,64f42ec7a6574fd4b36bfa4a0a68ee0f,SALES-POS,20-30,2018,8,9,11,30,Thursday,14 days,36710.657
ACC-3541460373,24,14.39,1399.51,1.0,CUS-1433879684,2018-08-09,Jeffrey,M,-37.83,145.00,,2b1f7db1-7170-4c35-80e3-8dc2635a87d7,-37.76,145.08,VIC,Bulleen,debit,authorized,1c918fcf7ef94c00939dd748ef76553d,POS,20-30,2018,8,9,14,51,Thursday,14 days,36710.657
ACC-3541460373,24,53.0,1346.51,,CUS-1433879684,2018-08-10,Jeffrey,M,-37.83,145.00,,,,,,,debit,posted,c23963217e58425893574d39a0ef440d,PAYMENT,20-30,2018,8,10,18,0,Friday,14 days,36710.657
ACC-3541460373,24,41.0,1305.51,,CUS-1433879684,2018-08-10,Jeffrey,M,-37.83,145.00,,,,,,,debit,posted,03e6baf3d37e45b79301fa091b7a2d47,PAYMENT,20-30,2018,8,10,23,0,Friday,14 days,36710.657
ACC-3541460373,24,53.0,2619.59,,CUS-1433879684,2018-08-17,Jeffrey,M,-37.83,145.00,,,,,,,debit,posted,c9041ec0bcc34622bc93e47cffd229e6,PAYMENT,20-30,2018,8,17,18,0,Friday,14 days,36710.657
ACC-3541460373,24,41.0,2578.59,,CUS-1433879684,2018-08-17,Jeffrey,M,-37.83,145.00,,,,,,,debit,posted,801ea7f599034bda8eca205688d44873,PAYMENT,20-30,2018,8,17,23,0,Friday,14 days,36710.657
ACC-3541460373,24,41.0,2537.59,,CUS-1433879684,2018-08-23,Jeffrey,M,-37.83,145.00,,,,,,,debit,posted,84a09a6dca044db6a498ee08bd087517,PAYMENT,20-30,2018,8,23,11,0,Thursday,14 days,36710.657
ACC-3541460373,24,12.51,2525.08,1.0,CUS-1433879684,2018-08-24,Jeffrey,M,-37.83,145.00,,aeb73b3b-ac40-46d2-a744-6104193fa88e,-38.03,145.13,VIC,Chelsea Heights,debit,authorized,0c31ec92e2544a2f9bef5af5b2e3856e,SALES-POS,20-30,2018,8,24,1,51,Friday,14 days,36710.657
ACC-3541460373,24,53.0,2472.08,,CUS-1433879684,2018-08-24,Jeffrey,M,-37.83,145.00,,,,,,,debit,posted,b6951d171be244bd98c39d8a8e3874ed,PAYMENT,20-30,2018,8,24,18,0,Friday,14 days,36710.657
ACC-3541460373,24,41.0,2431.08,,CUS-1433879684,2018-08-24,Jeffrey,M,-37.83,145.00,,,,,,,debit,posted,711e5eca9a7a4f2d90582f00a22ff220,PAYMENT,20-30,2018,8,24,23,0,Friday,14 days,36710.657
ACC-3541460373,24,14.78,2416.3,1.0,CUS-1433879684,2018-08-25,Jeffrey,M,-37.83,145.00,,1a48ffe9-8e3c-4ff1-969e-fff37762269a,-37.83,147.63,VIC,Bairnsdale,debit,authorized,3882a961482c4ad393f09fab36253c4c,SALES-POS,20-30,2018,8,25,0,58,Saturday,14 days,36710.657
ACC-3541460373,24,25.96,2390.34,1.0,CUS-1433879684,2018-08-25,Jeffrey,M,-37.83,145.00,,d29dc1fe-1240-45ff-afcb-1e17efda422a,-37.88,144.98,VIC,Elwood,debit,authorized,c4d2b436cf094015ae832f7231431c2b,SALES-POS,20-30,2018,8,25,17,58,Saturday,14 days,36710.657
ACC-3541460373,24,11.04,2379.3,1.0,CUS-1433879684,2018-08-25,Jeffrey,M,-37.83,145.00,,6f26079c-0269-473c-8db5-48c93b871572,-37.76,145.17,VIC,Doncaster East,debit,authorized,f7b42a3bbc3d4ae0a04e982df94bf7d5,POS,20-30,2018,8,25,19,1,Saturday,14 days,36710.657
ACC-3541460373,24,17.26,2362.04,1.0,CUS-1433879684,2018-08-26,Jeffrey,M,-37.83,145.00,,e060817e-ea41-469e-addb-01a2eb5411a2,-37.81,140.79,SA,Mount Gambier,debit,authorized,40e7a0c616474425b69dd049a5f75931,POS,20-30,2018,8,26,11,39,Sunday,14 days,36710.657
ACC-3541460373,24,22.43,2339.61,1.0,CUS-1433879684,2018-08-26,Jeffrey,M,-37.83,145.00,,f62d6734-f21c-454a-af57-55f77786e13c,-37.9,145.06,VIC,Murrumbeena,debit,authorized,5ef2ecee77bc4347bf98b08f0c15c7aa,POS,20-30,2018,8,26,21,43,Sunday,14 days,36710.657
ACC-3541460373,24,7.98,2331.63,1.0,CUS-1433879684,2018-08-26,Jeffrey,M,-37.83,145.00,,9492bbba-b5f2-4372-afdc-bc0675f56014,-37.76,145.31,VIC,Chirnside Park,debit,authorized,dd5b912c2ad3451e84d2b84d8491e1c9,SALES-POS,20-30,2018,8,26,22,6,Sunday,14 days,36710.657
ACC-3541460373,24,19.97,2311.66,0.0,CUS-1433879684,2018-08-28,Jeffrey,M,-37.83,145.00,,04e58626-ce51-4a2a-bc19-6a0862228acf,-37.99,145.22,VIC,Dandenong,debit,authorized,7c6bf4eae4ec4a91a811a2591d880091,SALES-POS,20-30,2018,8,28,9,16,Tuesday,14 days,36710.657
ACC-3541460373,24,13.06,2298.6,0.0,CUS-1433879684,2018-08-28,Jeffrey,M,-37.83,145.00,,e99b6b59-5e0b-41bd-96f3-d68537fb3fa9,-37.81,144.96,VIC,Melbourne,debit,authorized,c41ec678e06640948923181d0b15712a,SALES-POS,20-30,2018,8,28,9,52,Tuesday,14 days,36710.657
ACC-3541460373,24,30.87,2267.73,1.0,CUS-1433879684,2018-08-28,Jeffrey,M,-37.83,145.00,,6ec641b3-30d9-493e-ad0b-1aef39b6e7c7,-37.7,144.63,VIC,Rockbank,debit,authorized,7abbcb8b6e0f4d9aa71e2197760ea1b2,SALES-POS,20-30,2018,8,28,12,3,Tuesday,14 days,36710.657
ACC-3541460373,24,12.82,2254.91,1.0,CUS-1433879684,2018-08-29,Jeffrey,M,-37.83,145.00,,b0f26c5a-1cb9-49d7-b2e7-566f0438e8cf,-37.92,144.99,VIC,Brighton,debit,authorized,faf923237ced4971b6649f422504bd60,SALES-POS,20-30,2018,8,29,11,17,Wednesday,14 days,36710.657
ACC-3541460373,24,44.53,2210.38,1.0,CUS-1433879684,2018-08-29,Jeffrey,M,-37.83,145.00,,2a01a45e-ff49-483a-9306-a26564c7d1fc,-37.81,144.97,VIC,Melbourne,debit,authorized,f6045b1c0edf48afb6ac7c9825deb45b,POS,20-30,2018,8,29,11,49,Wednesday,14 days,36710.657
ACC-3541460373,24,45.1,3573.36,1.0,CUS-1433879684,2018-08-29,Jeffrey,M,-37.83,145.00,,f3c386d7-c74f-4eb5-ad11-71607fcdbb71,-33.87,151.21,NSW,Sydney,debit,authorized,e8427f80ec334ba1a3decde09e4ea966,SALES-POS,20-30,2018,8,29,15,49,Wednesday,14 days,36710.657
ACC-3541460373,24,41.0,3532.36,,CUS-1433879684,2018-08-30,Jeffrey,M,-37.83,145.00,,,,,,,debit,posted,b859c3c294924c60b6da09364707727f,PAYMENT,20-30,2018,8,30,11,0,Thursday,14 days,36710.657
ACC-3541460373,24,109.02,3423.34,1.0,CUS-1433879684,2018-08-30,Jeffrey,M,-37.83,145.00,,9148f42a-c5b8-487d-8f5a-a38264d30552,-37.82,144.97,VIC,Melbourne,debit,authorized,7963ca2d8a604a13a6188603430111fe,POS,20-30,2018,8,30,12,39,Thursday,14 days,36710.657
ACC-3541460373,24,69.32,3354.02,1.0,CUS-1433879684,2018-08-30,Jeffrey,M,-37.83,145.00,,fd372897-1e23-436a-9a72-92a685570e3f,-37.76,145.3,VIC,Chirnside Park,debit,authorized,48ceb2095a8c40889fb33d2a9cc92984,SALES-POS,20-30,2018,8,30,13,36,Thursday,14 days,36710.657
ACC-3541460373,24,36.55,3317.47,1.0,CUS-1433879684,2018-08-30,Jeffrey,M,-37.83,145.00,,bb32264f-eb69-4761-9d4a-9a7e6217496a,-37.94,145,VIC,Hampton,debit,authorized,a9fd7e68795847838785e32f9566437d,SALES-POS,20-30,2018,8,30,20,31,Thursday,14 days,36710.657
ACC-3541460373,24,11.79,3305.68,0.0,CUS-1433879684,2018-08-31,Jeffrey,M,-37.83,145.00,,d504059c-aac7-47bd-95f0-d89fa29b3eff,-37.81,145.23,VIC,Ringwood,debit,authorized,8d3cb515314744209875933dbdaa2125,SALES-POS,20-30,2018,8,31,10,49,Friday,14 days,36710.657
ACC-3541460373,24,53.0,3252.68,,CUS-1433879684,2018-08-31,Jeffrey,M,-37.83,145.00,,,,,,,debit,posted,a519ab98a8234ccc8ca557560b34246d,PAYMENT,20-30,2018,8,31,18,0,Friday,14 days,36710.657
ACC-3541460373,24,41.0,3211.68,,CUS-1433879684,2018-08-31,Jeffrey,M,-37.83,145.00,,,,,,,debit,posted,6374a019a1144381bea331fad2c7b330,PAYMENT,20-30,2018,8,31,23,0,Friday,14 days,36710.657
ACC-3541460373,24,14.87,3196.81,1.0,CUS-1433879684,2018-09-01,Jeffrey,M,-37.83,145.00,,727f70ec-7434-44fd-8cd7-0583a1b07097,-37.83,147.63,VIC,Bairnsdale,debit,authorized,7301eeeda28a4ca3a578b2e09a786ed8,SALES-POS,20-30,2018,9,1,1,46,Saturday,14 days,36710.657
ACC-3541460373,24,32.15,3164.66,0.0,CUS-1433879684,2018-09-01,Jeffrey,M,-37.83,145.00,,59ba0b94-0a95-4a8c-b11c-7ee934e3ea4d,-31.95,115.84,WA,West Perth,debit,authorized,0e186c77594c48f7a2027653f636c5eb,POS,20-30,2018,9,1,13,28,Saturday,14 days,36710.657
ACC-3541460373,24,69.39,3095.27,1.0,CUS-1433879684,2018-09-04,Jeffrey,M,-37.83,145.00,,317c1996-373c-4f62-8558-75edee82cbf7,-37.89,145.25,VIC,Knoxfield,debit,authorized,4a4863ac8ef8464f93831012515c10fc,SALES-POS,20-30,2018,9,4,15,11,Tuesday,14 days,36710.657
ACC-3541460373,24,17.44,3077.83,0.0,CUS-1433879684,2018-09-04,Jeffrey,M,-37.83,145.00,,6ac1000d-561a-4655-8e0d-4a0348db9cac,-37.79,144.99,VIC,Clifton Hill,debit,authorized,c8646738837d41c6b294eee44c2aaddb,SALES-POS,20-30,2018,9,4,16,17,Tuesday,14 days,36710.657
ACC-3541460373,24,134.42,2943.41,1.0,CUS-1433879684,2018-09-04,Jeffrey,M,-37.83,145.00,,142514bf-19ef-4bf7-a00d-aac13c51fbe9,-37.78,145.26,VIC,Ringwood,debit,authorized,ea4a33fe5379444199b7c6813e12db4b,SALES-POS,20-30,2018,9,4,18,27,Tuesday,14 days,36710.657
ACC-3541460373,24,23.26,2920.15,1.0,CUS-1433879684,2018-09-05,Jeffrey,M,-37.83,145.00,,87deec86-18fa-46aa-965c-d7be3015f93d,-38.04,145.14,VIC,Chelsea Heights,debit,authorized,192f495110804e93ae76d2147e13dcac,SALES-POS,20-30,2018,9,5,9,54,Wednesday,14 days,36710.657
ACC-3541460373,24,14.17,2905.98,1.0,CUS-1433879684,2018-09-05,Jeffrey,M,-37.83,145.00,,29f0b89e-fba1-4e6d-8104-f13078787ede,-37.83,140.78,SA,Mount Gambier,debit,authorized,f2b32cd0cd614885a2c2b9d98432b411,SALES-POS,20-30,2018,9,5,10,24,Wednesday,14 days,36710.657
ACC-3541460373,24,12.26,2893.72,1.0,CUS-1433879684,2018-09-05,Jeffrey,M,-37.83,145.00,,5f82e811-6c8f-44b1-83b7-83b70afa2867,-37.86,145.18,VIC,Vermont South,debit,authorized,9531693d44cd422092878720922e88a9,SALES-POS,20-30,2018,9,5,15,41,Wednesday,14 days,36710.657
ACC-3541460373,24,16.33,2877.39,1.0,CUS-1433879684,2018-09-06,Jeffrey,M,-37.83,145.00,,4521c822-0336-4748-899f-3e4d18cf1a8b,-37.78,144.83,VIC,Sunshine,debit,authorized,ee1a1b1cac3a408095685e550c017ccb,SALES-POS,20-30,2018,9,6,8,19,Thursday,14 days,36710.657
ACC-3541460373,24,41.0,2836.39,,CUS-1433879684,2018-09-06,Jeffrey,M,-37.83,145.00,,,,,,,debit,posted,ab4596950452461885741aecff243430,PAYMENT,20-30,2018,9,6,11,0,Thursday,14 days,36710.657
ACC-3541460373,24,18.72,2817.67,1.0,CUS-1433879684,2018-09-06,Jeffrey,M,-37.83,145.00,,56281b7c-c276-41fc-96bc-3ccd2d38659f,-37.82,145.04,VIC,Hawthorn,debit,authorized,eb3f455eef11480799edaaab6e8e96c9,POS,20-30,2018,9,6,17,14,Thursday,14 days,36710.657
ACC-3541460373,24,22.89,2794.78,1.0,CUS-1433879684,2018-09-07,Jeffrey,M,-37.83,145.00,,82b1dd92-4c54-4aac-8d5c-d376352a3364,-37.92,145.04,VIC,Bentleigh,debit,authorized,7456702023e349d09d28099b220af4f8,SALES-POS,20-30,2018,9,7,2,32,Friday,14 days,36710.657
ACC-3541460373,24,25.24,2769.54,0.0,CUS-1433879684,2018-09-07,Jeffrey,M,-37.83,145.00,,a206448a-a483-472d-a0c8-1ee76b7a4bf6,-37.73,145.07,VIC,Macleod,debit,authorized,9a0570e7878d424e9c235afdc9cae83d,SALES-POS,20-30,2018,9,7,15,55,Friday,14 days,36710.657
ACC-3541460373,24,53.0,2716.54,,CUS-1433879684,2018-09-07,Jeffrey,M,-37.83,145.00,,,,,,,debit,posted,38693c8aafa448468a18a64f55403145,PAYMENT,20-30,2018,9,7,18,0,Friday,14 days,36710.657
ACC-3541460373,24,10.54,2706.0,1.0,CUS-1433879684,2018-09-07,Jeffrey,M,-37.83,145.00,,4179a6ae-b81c-4c3f-82bb-e9868d7d1437,-27.9,153.32,QLD,Helensvale,debit,authorized,3611e5d753aa468aa704f063d22d9ac9,POS,20-30,2018,9,7,21,7,Friday,14 days,36710.657
ACC-3541460373,24,41.0,2665.0,,CUS-1433879684,2018-09-07,Jeffrey,M,-37.83,145.00,,,,,,,debit,posted,81f9426fb924473296e4794cdfd30470,PAYMENT,20-30,2018,9,7,23,0,Friday,14 days,36710.657
ACC-3541460373,24,74.06,2590.94,1.0,CUS-1433879684,2018-09-08,Jeffrey,M,-37.83,145.00,,98b850d7-13b8-4a3b-9369-b4c10322002b,-37.83,140.77,SA,Mount Gambier,debit,authorized,4b8ff6338764433094018f152b9eb5d9,POS,20-30,2018,9,8,23,53,Saturday,14 days,36710.657
ACC-3541460373,24,34.23,2556.71,1.0,CUS-1433879684,2018-09-09,Jeffrey,M,-37.83,145.00,,45cd2a6b-0f81-405f-88af-79328651758c,-37.82,145.1,VIC,Surrey Hills,debit,authorized,0674bdf238f74dec95a16c0ef2cde2d6,SALES-POS,20-30,2018,9,9,9,13,Sunday,14 days,36710.657
ACC-3541460373,24,35.32,2521.39,1.0,CUS-1433879684,2018-09-09,Jeffrey,M,-37.83,145.00,,78c10cbb-b9be-4476-ac5a-cf36e02d1564,-37.86,145.18,VIC,Vermont South,debit,authorized,b981569b7a024ab381ee548d78eb373d,SALES-POS,20-30,2018,9,9,17,25,Sunday,14 days,36710.657
ACC-3541460373,24,13.09,2508.3,1.0,CUS-1433879684,2018-09-09,Jeffrey,M,-37.83,145.00,,0e088ddb-6fb4-45e8-bf92-f92bbd7b34c8,-37.79,145.13,VIC,Doncaster,debit,authorized,5fab1961bc9643f1bcdcde794cb42ab9,SALES-POS,20-30,2018,9,9,19,34,Sunday,14 days,36710.657
ACC-3541460373,24,25.3,2483.0,1.0,CUS-1433879684,2018-09-11,Jeffrey,M,-37.83,145.00,,ea659ca5-7c95-4e24-807e-83b16bbfa39f,-37.81,145.24,VIC,Ringwood East,debit,authorized,6dd78ae276724ed9a63c2f1bc93951a2,POS,20-30,2018,9,11,4,14,Tuesday,14 days,36710.657
ACC-3541460373,24,16.11,2466.89,1.0,CUS-1433879684,2018-09-11,Jeffrey,M,-37.83,145.00,,759d8ced-e171-4238-9465-00cbe78e0d06,-37.87,144.83,VIC,Altona,debit,authorized,c498a805ed0044bf9da4879d52ba820a,POS,20-30,2018,9,11,9,16,Tuesday,14 days,36710.657
ACC-3541460373,24,22.22,3852.75,0.0,CUS-1433879684,2018-09-12,Jeffrey,M,-37.83,145.00,,d03ec57b-fe15-4d6e-89b9-00a81103914b,-37.7,144.78,VIC,Taylors Lakes,debit,authorized,8d427ab19e124c01a98290b5218fbc8d,SALES-POS,20-30,2018,9,12,15,7,Wednesday,14 days,36710.657
ACC-3541460373,24,12.43,3840.32,1.0,CUS-1433879684,2018-09-13,Jeffrey,M,-37.83,145.00,,72cdcf17-312b-49c3-9fbe-bd3cdcf97d42,-37.81,144.95,VIC,West Melbourne,debit,authorized,fad3222695584b179cd6352340f06c96,POS,20-30,2018,9,13,7,44,Thursday,14 days,36710.657
ACC-3541460373,24,41.0,3799.32,,CUS-1433879684,2018-09-13,Jeffrey,M,-37.83,145.00,,,,,,,debit,posted,10721f6b20714ea7ad2287b019a410a4,PAYMENT,20-30,2018,9,13,11,0,Thursday,14 days,36710.657
ACC-3541460373,24,14.14,3785.18,1.0,CUS-1433879684,2018-09-13,Jeffrey,M,-37.83,145.00,,934890a0-37c4-4745-be2f-271aa98c235a,-37.88,144.73,VIC,Point Cook,debit,authorized,79278af205284c24b96e0f0151ef4c64,SALES-POS,20-30,2018,9,13,16,1,Thursday,14 days,36710.657
ACC-3541460373,24,52.45,3732.73,1.0,CUS-1433879684,2018-09-13,Jeffrey,M,-37.83,145.00,,9d50c611-15be-4907-a853-c3589c97b53e,-37.81,144.96,VIC,Melbourne,debit,authorized,1c082b8fe96046ed8f8a9fd555b9bdda,SALES-POS,20-30,2018,9,13,19,9,Thursday,14 days,36710.657
ACC-3541460373,24,53.0,3679.73,,CUS-1433879684,2018-09-14,Jeffrey,M,-37.83,145.00,,,,,,,debit,posted,f9a8300280a94defb272e9388e2794cb,PAYMENT,20-30,2018,9,14,18,0,Friday,14 days,36710.657
ACC-3541460373,24,41.0,3638.73,,CUS-1433879684,2018-09-14,Jeffrey,M,-37.83,145.00,,,,,,,debit,posted,92150603d22a443782a83aa4bab0cfc9,PAYMENT,20-30,2018,9,14,23,0,Friday,14 days,36710.657
ACC-3541460373,24,13.99,3624.74,1.0,CUS-1433879684,2018-09-15,Jeffrey,M,-37.83,145.00,,7a391ea8-226a-4ce0-b418-8cadd5443672,-37.82,144.96,VIC,Melbourne,debit,authorized,59103e9e3b7b4e7e96afbdb4c570452d,SALES-POS,20-30,2018,9,15,1,12,Saturday,14 days,36710.657
ACC-3541460373,24,72.54,3552.2,0.0,CUS-1433879684,2018-09-15,Jeffrey,M,-37.83,145.00,,e8253ae8-09bd-4bbe-9b01-3ee3a5489dd6,-37.84,145,VIC,South Yarra,debit,authorized,f90756fdf8264fea92c8304f9d5709cd,SALES-POS,20-30,2018,9,15,3,55,Saturday,14 days,36710.657
ACC-3541460373,24,56.52,3495.68,1.0,CUS-1433879684,2018-09-15,Jeffrey,M,-37.83,145.00,,e170b598-8961-4c29-9ee1-d9a98196801c,-37.83,140.78,SA,Mount Gambier,debit,authorized,a48a15e27024423bbbe9ee6c5f3d3f43,SALES-POS,20-30,2018,9,15,18,20,Saturday,14 days,36710.657
ACC-3541460373,24,39.72,3455.96,1.0,CUS-1433879684,2018-09-15,Jeffrey,M,-37.83,145.00,,e288a819-9b84-424f-b17c-e4e4869472b4,-37.83,140.78,SA,Mount Gambier,debit,authorized,144717ba910348398f594b01e3525084,POS,20-30,2018,9,15,21,39,Saturday,14 days,36710.657
ACC-3541460373,24,24.45,3431.51,1.0,CUS-1433879684,2018-09-16,Jeffrey,M,-37.83,145.00,,7d57de78-57a2-4583-9cf3-32792fc3231a,-37.88,145.16,VIC,Glen Waverley,debit,authorized,204a794135104f0f8843a02c0e5c21db,POS,20-30,2018,9,16,11,1,Sunday,14 days,36710.657
ACC-3541460373,24,21.82,3409.69,1.0,CUS-1433879684,2018-09-16,Jeffrey,M,-37.83,145.00,,c2549a79-da41-42cd-99ae-7147e0fe0711,-37.9,145.09,VIC,Oakleigh,debit,authorized,66538be13ce04e47a3f3c7456df2c77d,POS,20-30,2018,9,16,22,15,Sunday,14 days,36710.657
ACC-3541460373,24,10.06,3399.63,1.0,CUS-1433879684,2018-09-17,Jeffrey,M,-37.83,145.00,,4afe3599-f463-4248-8dff-69fe630e75f6,-37.83,145.35,VIC,Mount Dandenong,debit,authorized,9825d611136845bbb1705182dbb2dc00,POS,20-30,2018,9,17,22,39,Monday,14 days,36710.657
ACC-3541460373,24,47.47,3352.16,1.0,CUS-1433879684,2018-09-18,Jeffrey,M,-37.83,145.00,,1d7c7609-e834-44f4-9d0c-6c542cf2be73,-37.79,145.16,VIC,Doncaster East,debit,authorized,edcf04956f2545ef8b1a42aa763a959c,SALES-POS,20-30,2018,9,18,10,17,Tuesday,14 days,36710.657
ACC-3541460373,24,27.09,3325.07,1.0,CUS-1433879684,2018-09-18,Jeffrey,M,-37.83,145.00,,19cd8160-fb02-4288-89ea-e457cb22ea27,-33.88,151.23,NSW,Paddington,debit,authorized,8e587a98573b4549bc1f7e670339a253,SALES-POS,20-30,2018,9,18,19,38,Tuesday,14 days,36710.657
ACC-3541460373,24,43.41,3281.66,1.0,CUS-1433879684,2018-09-19,Jeffrey,M,-37.83,145.00,,a7757fd8-1f60-4201-a7fd-b6c4cf90871c,-37.76,145.35,VIC,Lilydale,debit,authorized,31d5dd552166441592015db4e28b9f7e,SALES-POS,20-30,2018,9,19,1,38,Wednesday,14 days,36710.657
ACC-3541460373,24,0.1,3281.56,1.0,CUS-1433879684,2018-09-19,Jeffrey,M,-37.83,145.00,,a6a341db-200c-4833-a93d-893d18b019ea,-37.82,144.96,VIC,Southbank,debit,authorized,392deeb7fff748f48b19ad95381e8aa2,POS,20-30,2018,9,19,17,21,Wednesday,14 days,36710.657
ACC-3541460373,24,24.33,3257.23,1.0,CUS-1433879684,2018-09-20,Jeffrey,M,-37.83,145.00,,ce147a40-090d-4945-8933-f67c02d087be,-37.91,145.35,VIC,Belgrave,debit,authorized,74c15d6fcd6240d3b3458c238e004aec,SALES-POS,20-30,2018,9,20,8,41,Thursday,14 days,36710.657
ACC-3541460373,24,41.0,3216.23,,CUS-1433879684,2018-09-20,Jeffrey,M,-37.83,145.00,,,,,,,debit,posted,331504f69f70439ea436ae8a68707524,PAYMENT,20-30,2018,9,20,11,0,Thursday,14 days,36710.657
ACC-3541460373,24,22.03,3194.2,1.0,CUS-1433879684,2018-09-20,Jeffrey,M,-37.83,145.00,,e387c054-20aa-4d9e-9157-2fc50267aa1f,-37.99,145.22,VIC,Dandenong,debit,authorized,97f5d4cdd7a9431eb1985156eb6b0fd2,POS,20-30,2018,9,20,12,25,Thursday,14 days,36710.657
ACC-3541460373,24,5.69,3188.51,1.0,CUS-1433879684,2018-09-21,Jeffrey,M,-37.83,145.00,,d1af80fc-8d5f-4e56-9305-a3028370c49d,-37.89,145.08,VIC,Chadstone,debit,authorized,8224ebf146c2429897f0d64932330ff9,POS,20-30,2018,9,21,4,15,Friday,14 days,36710.657
ACC-3541460373,24,16.46,3172.05,1.0,CUS-1433879684,2018-09-21,Jeffrey,M,-37.83,145.00,,29ca19f2-f0eb-4925-8dac-d36357610087,-37.77,144.89,VIC,Maribyrnong,debit,authorized,07485c9b2e174ee3994da1df79f5805e,POS,20-30,2018,9,21,14,14,Friday,14 days,36710.657
ACC-3541460373,24,19.42,3152.63,1.0,CUS-1433879684,2018-09-21,Jeffrey,M,-37.83,145.00,,82870677-c75b-4a97-bc13-acdb5bef0d71,-37.88,144.7,VIC,Hoppers Crossing,debit,authorized,48b4683d61414e99b79f4f7eeba1d308,POS,20-30,2018,9,21,15,1,Friday,14 days,36710.657
ACC-3541460373,24,53.0,3099.63,,CUS-1433879684,2018-09-21,Jeffrey,M,-37.83,145.00,,,,,,,debit,posted,1d92942757154001b83fd4c1086f60f1,PAYMENT,20-30,2018,9,21,18,0,Friday,14 days,36710.657
ACC-3541460373,24,43.56,3056.07,1.0,CUS-1433879684,2018-09-21,Jeffrey,M,-37.83,145.00,,635f047e-65f0-4c24-8596-9ef6c1df36fb,-37.85,145.06,VIC,Camberwell,debit,authorized,87dacb627b7d47a7bc235496a1874b44,POS,20-30,2018,9,21,19,4,Friday,14 days,36710.657
ACC-3541460373,24,41.0,3015.07,,CUS-1433879684,2018-09-21,Jeffrey,M,-37.83,145.00,,,,,,,debit,posted,0b70b5cebdce4009bba8e220394f74f5,PAYMENT,20-30,2018,9,21,23,0,Friday,14 days,36710.657
ACC-3541460373,24,39.91,2975.16,1.0,CUS-1433879684,2018-09-22,Jeffrey,M,-37.83,145.00,,98d1a1bd-3c96-42fb-98e8-eeacb5d1ed47,-37.82,144.96,VIC,Melbourne,debit,authorized,4b55dbaa5a714ad0a9df242d39d9f193,POS,20-30,2018,9,22,1,15,Saturday,14 days,36710.657
ACC-3541460373,24,8.26,2966.9,1.0,CUS-1433879684,2018-09-22,Jeffrey,M,-37.83,145.00,,ece151d2-3e52-4c95-b47c-38cc75b4a517,-33.84,151.21,NSW,North Sydney,debit,authorized,b09353bebb2641409c16518f0ec936cd,SALES-POS,20-30,2018,9,22,1,33,Saturday,14 days,36710.657
ACC-3541460373,24,20.04,2946.86,0.0,CUS-1433879684,2018-09-22,Jeffrey,M,-37.83,145.00,,5889edf0-d375-4bd8-9268-0017d60fda33,-37.59,144.24,VIC,Ballan,debit,authorized,3d2e5b66134c40cd9bff96210bea6fd3,POS,20-30,2018,9,22,2,37,Saturday,14 days,36710.657
ACC-3541460373,24,45.41,2901.45,1.0,CUS-1433879684,2018-09-22,Jeffrey,M,-37.83,145.00,,3c702f7c-61b3-454e-93f7-508b5da49dab,-37.73,144.91,VIC,Essendon Fields,debit,authorized,11f808cdb7a8488ab89a57249f5f603e,POS,20-30,2018,9,22,20,53,Saturday,14 days,36710.657
ACC-3541460373,24,9.98,2891.47,1.0,CUS-1433879684,2018-09-24,Jeffrey,M,-37.83,145.00,,11611d02-ff60-4ddb-98d5-d2e8673b8ddd,-37.78,144.97,VIC,Carlton North,debit,authorized,a7e9cb4d72cf4360ae2f9083cca5860f,POS,20-30,2018,9,24,14,19,Monday,14 days,36710.657
ACC-3541460373,24,41.7,2849.77,1.0,CUS-1433879684,2018-09-25,Jeffrey,M,-37.83,145.00,,781468b4-f237-491b-a784-49ec96e513ec,-37.79,145.15,VIC,Doncaster East,debit,authorized,2d579d4b76bc4e35a78d53c2bcd6d070,SALES-POS,20-30,2018,9,25,6,26,Tuesday,14 days,36710.657
ACC-3541460373,24,46.24,4211.61,0.0,CUS-1433879684,2018-09-26,Jeffrey,M,-37.83,145.00,,53aa79c7-e02f-45d1-bb25-97f870c01d03,-37.85,145.13,VIC,Burwood East,debit,authorized,db54eba267504f1499111d374af0b7ff,SALES-POS,20-30,2018,9,26,18,11,Wednesday,14 days,36710.657
ACC-3541460373,24,13.29,4198.32,1.0,CUS-1433879684,2018-09-26,Jeffrey,M,-37.83,145.00,,81fe1636-2edb-4a2f-ae93-3d375027047b,-37.76,145.31,VIC,Chirnside Park,debit,authorized,23e58ad67d814053966f81086eca9776,POS,20-30,2018,9,26,22,13,Wednesday,14 days,36710.657
ACC-3541460373,24,41.0,4125.23,,CUS-1433879684,2018-09-27,Jeffrey,M,-37.83,145.00,,,,,,,debit,posted,9380617979e84f6985763ed4283375b5,PAYMENT,20-30,2018,9,27,11,0,Thursday,14 days,36710.657
ACC-3541460373,24,32.09,4166.23,1.0,CUS-1433879684,2018-09-27,Jeffrey,M,-37.83,145.00,,5941e390-ce05-4d4e-b6ca-659b64f430b9,-37.81,145.34,VIC,Montrose,debit,authorized,8bc04ceb66ad405b831a211ed05d0963,POS,20-30,2018,9,27,11,49,Thursday,14 days,36710.657
ACC-3541460373,24,70.49,4054.74,1.0,CUS-1433879684,2018-09-27,Jeffrey,M,-37.83,145.00,,c287e5be-17a3-49ad-80ef-3bd295033671,-37.58,143.87,VIC,Golden Point,debit,authorized,32d5867464df4730a6b3af440f6da014,SALES-POS,20-30,2018,9,27,14,12,Thursday,14 days,36710.657
ACC-3541460373,24,14.08,4040.66,1.0,CUS-1433879684,2018-09-27,Jeffrey,M,-37.83,145.00,,55fd952f-fbc5-4a8f-bc54-dcf283b64e71,-37.78,144.98,VIC,Fitzroy North,debit,authorized,e9c4bc20efd749ecaea671cd0f90ba5e,POS,20-30,2018,9,27,18,29,Thursday,14 days,36710.657
ACC-3541460373,24,55.35,3985.31,0.0,CUS-1433879684,2018-09-27,Jeffrey,M,-37.83,145.00,,4ab378f4-0296-4703-b313-0ef9018d1f65,-37.87,144.76,VIC,Laverton,debit,authorized,310060abdc56426ba8a1ad7f6cd3e647,SALES-POS,20-30,2018,9,27,22,2,Thursday,14 days,36710.657
ACC-3541460373,24,95.1,3890.21,1.0,CUS-1433879684,2018-09-27,Jeffrey,M,-37.83,145.00,,de40a78f-04af-4402-933c-4f192ad264bb,-37.82,145.19,VIC,Mitcham,debit,authorized,701f65886beb431fbbb1ced02a0beaf8,POS,20-30,2018,9,27,23,52,Thursday,14 days,36710.657
ACC-3541460373,24,11.24,3878.97,0.0,CUS-1433879684,2018-09-28,Jeffrey,M,-37.83,145.00,,33c50690-dfde-45c6-8794-fbda0f3bae88,-37.77,144.89,VIC,Maribyrnong,debit,authorized,5b0e3b1858f645f89b7a7ad1c1363099,SALES-POS,20-30,2018,9,28,1,19,Friday,14 days,36710.657
ACC-3541460373,24,53.0,3825.97,,CUS-1433879684,2018-09-28,Jeffrey,M,-37.83,145.00,,,,,,,debit,posted,e1a3b1da123b4d15ab72f9d1a496348d,PAYMENT,20-30,2018,9,28,18,0,Friday,14 days,36710.657
ACC-3541460373,24,41.0,3784.97,,CUS-1433879684,2018-09-28,Jeffrey,M,-37.83,145.00,,,,,,,debit,posted,fdbe0c19c79c4e66a1a7cdbc91b87cb5,PAYMENT,20-30,2018,9,28,23,0,Friday,14 days,36710.657
ACC-3541460373,24,16.6,3768.37,1.0,CUS-1433879684,2018-09-30,Jeffrey,M,-37.83,145.00,,188b1a51-2d0a-45d7-bfac-d86b8ce59299,-37.88,145.09,VIC,Malvern East,debit,authorized,546a350aa7de4cfeab36a2edc8cb4c7f,POS,20-30,2018,9,30,17,19,Sunday,14 days,36710.657
ACC-3541460373,24,17.36,3751.01,1.0,CUS-1433879684,2018-09-30,Jeffrey,M,-37.83,145.00,,80e385f5-f9c6-459e-9b35-84fa988fd982,-37.76,145.36,VIC,Lilydale,debit,authorized,bc7ed6034bb749779138d2a1eadb4fb8,SALES-POS,20-30,2018,9,30,22,50,Sunday,14 days,36710.657
ACC-3541460373,24,12.61,3738.4,1.0,CUS-1433879684,2018-10-02,Jeffrey,M,-37.83,145.00,,f68c62a7-1504-46f6-85a1-330957af1a26,-37.81,144.98,VIC,East Melbourne,debit,authorized,1c9deeb657a04bdf9bcd270fb8047880,POS,20-30,2018,10,2,4,9,Tuesday,14 days,36710.657
ACC-3541460373,24,18.88,3719.52,1.0,CUS-1433879684,2018-10-03,Jeffrey,M,-37.83,145.00,,81c8cb90-12b3-46ad-9436-f628a82a5d81,-37.81,140.78,SA,Mount Gambier,debit,authorized,aebb338860cf47f9ab9efbeeef62df2e,SALES-POS,20-30,2018,10,3,10,3,Wednesday,14 days,36710.657
ACC-3541460373,24,16.92,3702.6,1.0,CUS-1433879684,2018-10-03,Jeffrey,M,-37.83,145.00,,cceaf6d4-7f1c-4389-93e8-291bfca85037,-37.67,145.02,VIC,Lalor,debit,authorized,f85f8cdc398a4783a4fd00709006c39c,SALES-POS,20-30,2018,10,3,14,38,Wednesday,14 days,36710.657
ACC-3541460373,24,48.42,3654.18,1.0,CUS-1433879684,2018-10-04,Jeffrey,M,-37.83,145.00,,c9b45e80-4d60-48c6-b2fb-fa3e13c0b589,-37.88,145.15,VIC,Glen Waverley,debit,authorized,461c32e295cd4c7fa9faeeaf8abf354c,POS,20-30,2018,10,4,7,6,Thursday,14 days,36710.657
ACC-3541460373,24,41.0,3613.18,,CUS-1433879684,2018-10-04,Jeffrey,M,-37.83,145.00,,,,,,,debit,posted,6cf61c1d92c04dd6add2810caf1fdade,PAYMENT,20-30,2018,10,4,11,0,Thursday,14 days,36710.657
ACC-3541460373,24,53.0,3560.18,,CUS-1433879684,2018-10-05,Jeffrey,M,-37.83,145.00,,,,,,,debit,posted,b2a9496d678a4e879f8f2d1b173aefcb,PAYMENT,20-30,2018,10,5,18,0,Friday,14 days,36710.657
ACC-3541460373,24,9.95,3550.23,1.0,CUS-1433879684,2018-10-05,Jeffrey,M,-37.83,145.00,,999074c6-a0c7-4578-bbb3-556bf4e8b4d3,-37.83,144.95,VIC,South Wharf,debit,authorized,dc3ee38d8ed24daa80f1c10526f6f891,SALES-POS,20-30,2018,10,5,20,4,Friday,14 days,36710.657
ACC-3541460373,24,36.63,3513.6,1.0,CUS-1433879684,2018-10-05,Jeffrey,M,-37.83,145.00,,c2ff94fb-ce84-4514-b0fb-d04873357bce,-37.82,145.2,VIC,Mitcham,debit,authorized,043cd1d631314851b158f4a64f7c2951,POS,20-30,2018,10,5,22,44,Friday,14 days,36710.657
ACC-3541460373,24,41.0,3472.6,,CUS-1433879684,2018-10-05,Jeffrey,M,-37.83,145.00,,,,,,,debit,posted,5588eee6786d48c0b008c3e442f85580,PAYMENT,20-30,2018,10,5,23,0,Friday,14 days,36710.657
ACC-3541460373,24,43.83,3428.77,1.0,CUS-1433879684,2018-10-06,Jeffrey,M,-37.83,145.00,,32aac8ce-69eb-407d-bbbc-cb40571549f8,-33.84,151.21,NSW,North Sydney,debit,authorized,265e7f6dc66e46b2934244bbb6d27e2b,POS,20-30,2018,10,6,21,32,Saturday,14 days,36710.657
ACC-3541460373,24,20.83,3407.94,1.0,CUS-1433879684,2018-10-07,Jeffrey,M,-37.83,145.00,,d3097fc5-77e4-413b-a35b-5e6dabda03a8,-37.82,145.12,VIC,Box Hill,debit,authorized,81cc623505604637ade2ef2c1bed049f,POS,20-30,2018,10,7,19,33,Sunday,14 days,36710.657
ACC-3541460373,24,12.02,3395.92,0.0,CUS-1433879684,2018-10-08,Jeffrey,M,-37.83,145.00,,5f6c94bc-0ebe-4837-89f3-9bf9b4ce4438,-37.78,145.13,VIC,Doncaster,debit,authorized,d2833a0d1b734e02a4b2f5a50de28100,SALES-POS,20-30,2018,10,8,20,18,Monday,14 days,36710.657
ACC-3541460373,24,24.35,3371.57,1.0,CUS-1433879684,2018-10-08,Jeffrey,M,-37.83,145.00,,f19f2a55-5bc6-4f5b-9c7a-48cdd07f6a44,-37.88,144.68,VIC,Hoppers Crossing,debit,authorized,13c1979efee94176abc0b600cad75f8d,SALES-POS,20-30,2018,10,8,22,58,Monday,14 days,36710.657
ACC-3541460373,24,23.06,3348.51,1.0,CUS-1433879684,2018-10-09,Jeffrey,M,-37.83,145.00,,9bf1a1f0-92a2-4492-ab6d-e541bee98d43,-37.81,145.23,VIC,Ringwood,debit,authorized,192b814f3c794a20ab070c51b207643c,POS,20-30,2018,10,9,11,48,Tuesday,14 days,36710.657
ACC-3541460373,24,41.0,4715.59,,CUS-1433879684,2018-10-11,Jeffrey,M,-37.83,145.00,,,,,,,debit,posted,939aef5e481e4296b1608b5b46c833e6,PAYMENT,20-30,2018,10,11,11,0,Thursday,14 days,36710.657
ACC-3541460373,24,8.78,4706.81,1.0,CUS-1433879684,2018-10-11,Jeffrey,M,-37.83,145.00,,faa4d6dd-bf56-4c04-b467-1a85a66e3768,-37.88,145.29,VIC,Ferntree Gully,debit,authorized,f91495f036d84dcfb1498600f46c5f72,SALES-POS,20-30,2018,10,11,19,41,Thursday,14 days,36710.657
ACC-3541460373,24,12.64,4694.17,1.0,CUS-1433879684,2018-10-11,Jeffrey,M,-37.83,145.00,,ebdad21e-5e9e-4d2c-82bb-06e8a2351f5a,-37.81,144.97,VIC,Melbourne,debit,authorized,32d8a86728ce48e1be6d67f066ef6671,SALES-POS,20-30,2018,10,11,23,48,Thursday,14 days,36710.657
ACC-3541460373,24,13.97,4680.2,1.0,CUS-1433879684,2018-10-12,Jeffrey,M,-37.83,145.00,,90886a0e-929a-46a2-aa43-66e80bd7220a,-37.91,145.34,VIC,Tecoma,debit,authorized,05e1c40e91bd45158b3e8f24ed0226a3,POS,20-30,2018,10,12,4,6,Friday,14 days,36710.657
ACC-3541460373,24,59.15,4621.05,1.0,CUS-1433879684,2018-10-12,Jeffrey,M,-37.83,145.00,,5a5cd05d-59cc-4ef8-b2da-c890498147e2,-37.81,144.94,VIC,Docklands,debit,authorized,da30160727f642b591bf7ed200c1e55c,POS,20-30,2018,10,12,7,49,Friday,14 days,36710.657
ACC-3541460373,24,53.0,4568.05,,CUS-1433879684,2018-10-12,Jeffrey,M,-37.83,145.00,,,,,,,debit,posted,a4c47409575c4850b9dd07fa5ce340d3,PAYMENT,20-30,2018,10,12,18,0,Friday,14 days,36710.657
ACC-3541460373,24,41.0,4527.05,,CUS-1433879684,2018-10-12,Jeffrey,M,-37.83,145.00,,,,,,,debit,posted,39dc22cd31b14ec2af1bf39e59551096,PAYMENT,20-30,2018,10,12,23,0,Friday,14 days,36710.657
ACC-3541460373,24,23.36,4503.69,1.0,CUS-1433879684,2018-10-14,Jeffrey,M,-37.83,145.00,,ba72418f-5d6f-48a5-b76f-ce25bb88dee4,-37.76,145.23,VIC,Warrandyte,debit,authorized,fe80e86367834f778f74559c0695dcd3,SALES-POS,20-30,2018,10,14,19,20,Sunday,14 days,36710.657
ACC-3541460373,24,201.6,4302.09,1.0,CUS-1433879684,2018-10-14,Jeffrey,M,-37.83,145.00,,c66cb3b9-33f4-4151-8e5b-26221d600847,-37.84,145.27,VIC,Bayswater,debit,authorized,d0d1f72c91d64da69ae26dfbbe2e9d5c,POS,20-30,2018,10,14,21,29,Sunday,14 days,36710.657
ACC-3541460373,24,24.84,4277.25,1.0,CUS-1433879684,2018-10-14,Jeffrey,M,-37.83,145.00,,5d6a017b-a8a1-484b-8796-a12805e41a63,-37.82,145.29,VIC,Bayswater North,debit,authorized,f95db48be5ac4556a4a2830662e41460,POS,20-30,2018,10,14,21,56,Sunday,14 days,36710.657
ACC-3541460373,24,28.41,4248.84,1.0,CUS-1433879684,2018-10-15,Jeffrey,M,-37.83,145.00,,9bbfb763-311a-4836-ae89-c074aaf49373,-37.81,145.23,VIC,Ringwood,debit,authorized,8e59684280e744b48fbd06baaec5f125,POS,20-30,2018,10,15,21,59,Monday,14 days,36710.657
ACC-3541460373,24,31.35,4217.49,1.0,CUS-1433879684,2018-10-18,Jeffrey,M,-37.83,145.00,,200fbadd-de7f-4e3e-97ec-74522cc27f22,-37.8,145.26,VIC,Ringwood East,debit,authorized,aeffe77121164edc84ce900d0c4958bd,POS,20-30,2018,10,18,9,23,Thursday,14 days,36710.657
ACC-3541460373,24,41.0,4176.49,,CUS-1433879684,2018-10-18,Jeffrey,M,-37.83,145.00,,,,,,,debit,posted,a2372a88d09c4299972417ac3730cc15,PAYMENT,20-30,2018,10,18,11,0,Thursday,14 days,36710.657
ACC-3541460373,24,53.83,4122.66,1.0,CUS-1433879684,2018-10-19,Jeffrey,M,-37.83,145.00,,ae25e03e-2770-49f2-b1e1-4474577c194f,-37.79,145.27,VIC,Croydon,debit,authorized,bd5fc52792114408bad9752fd9107fa9,POS,20-30,2018,10,19,1,22,Friday,14 days,36710.657
ACC-3541460373,24,53.0,4069.66,,CUS-1433879684,2018-10-19,Jeffrey,M,-37.83,145.00,,,,,,,debit,posted,f3eb9dc18812474db33e92e6538b07f4,PAYMENT,20-30,2018,10,19,18,0,Friday,14 days,36710.657
ACC-3541460373,24,41.0,4028.66,,CUS-1433879684,2018-10-19,Jeffrey,M,-37.83,145.00,,,,,,,debit,posted,561e01ec2fa343a59adca61afafc37a7,PAYMENT,20-30,2018,10,19,23,0,Friday,14 days,36710.657
ACC-3541460373,24,34.19,3994.47,1.0,CUS-1433879684,2018-10-21,Jeffrey,M,-37.83,145.00,,0359e1a0-5efd-4921-8c41-89f1f0783aa1,-33.86,151.2,NSW,Sydney,debit,authorized,07657281851b4d3198008bb99f1461bc,POS,20-30,2018,10,21,23,35,Sunday,14 days,36710.657
ACC-3541460373,24,41.0,5361.55,,CUS-1433879684,2018-10-25,Jeffrey,M,-37.83,145.00,,,,,,,debit,posted,aae9efb461f14213ba1d0e9f214d8942,PAYMENT,20-30,2018,10,25,11,0,Thursday,14 days,36710.657
ACC-3541460373,24,53.0,5308.55,,CUS-1433879684,2018-10-26,Jeffrey,M,-37.83,145.00,,,,,,,debit,posted,e50816ce5d6e4f8b95ac4f2504d2ceac,PAYMENT,20-30,2018,10,26,18,0,Friday,14 days,36710.657
ACC-3541460373,24,41.0,5267.55,,CUS-1433879684,2018-10-26,Jeffrey,M,-37.83,145.00,,,,,,,debit,posted,df628dbcfad547ec9ee5bf699c174f4a,PAYMENT,20-30,2018,10,26,23,0,Friday,14 days,36710.657
ACC-3541460373,24,21.82,5245.73,1.0,CUS-1433879684,2018-10-29,Jeffrey,M,-37.83,145.00,,fcd90045-4be5-4be8-b7fa-779842ae4f18,-37.82,145.2,VIC,Mitcham,debit,authorized,e1cec243913145a9bfe1160909734973,POS,20-30,2018,10,29,20,1,Monday,14 days,36710.657
ACC-3879258709,40,170.0,186371.86,,CUS-527400765,2018-08-01,Natasha,F,-37.66,143.83,,,,,,,debit,posted,d644e56e0d2e4288beb67ec2c5e66346,PAYMENT,30-40,2018,8,1,12,0,Wednesday,14 days,109918.186
ACC-3879258709,40,26.91,186344.95,0.0,CUS-527400765,2018-08-01,Natasha,F,-37.66,143.83,,d8baa380-1cf2-485e-8b61-e6b73aab3400,-37.55,143.81,VIC,Ballarat,debit,authorized,1eb22646ff724bfb9d3f3b8108abf785,POS,30-40,2018,8,1,16,45,Wednesday,14 days,109918.186
ACC-3879258709,40,108.65,186236.3,1.0,CUS-527400765,2018-08-02,Natasha,F,-37.66,143.83,,42ade571-5972-4160-9ecb-e0162a305fee,-33.7,151.21,NSW,Belrose,debit,authorized,da7d50bf71c14c7f884a3328cff0467b,POS,30-40,2018,8,2,8,16,Thursday,14 days,109918.186
ACC-3879258709,40,41.0,186195.3,,CUS-527400765,2018-08-02,Natasha,F,-37.66,143.83,,,,,,,debit,posted,531d40e876f04bad8882716ae4744fa4,PHONE BANK,30-40,2018,8,2,12,0,Thursday,14 days,109918.186
ACC-3879258709,40,21.0,186174.3,,CUS-527400765,2018-08-02,Natasha,F,-37.66,143.83,,,,,,,debit,posted,a2e7d5fdee694a9abf056bb90023f6df,PAYMENT,30-40,2018,8,2,18,0,Thursday,14 days,109918.186
ACC-3879258709,40,39.78,186134.52,1.0,CUS-527400765,2018-08-05,Natasha,F,-37.66,143.83,,a05ead10-828d-44b3-bdfa-083e6fdb323c,-37.63,144.72,VIC,Diggers Rest,debit,authorized,09fd24682b8e4fab92921e5d83b2b965,SALES-POS,30-40,2018,8,5,9,55,Sunday,14 days,109918.186
ACC-3879258709,40,51.0,186083.52,,CUS-527400765,2018-08-06,Natasha,F,-37.66,143.83,,,,,,,debit,posted,f85f98cbf3184ad18585785e71a922df,INTER BANK,30-40,2018,8,6,8,0,Monday,14 days,109918.186
ACC-3879258709,40,29.0,190270.56,,CUS-527400765,2018-08-07,Natasha,F,-37.66,143.83,,,,,,,debit,posted,dd19da8a3b2343f0a57e97306fe8ce31,PAYMENT,30-40,2018,8,7,18,0,Tuesday,14 days,109918.186
ACC-3879258709,40,41.0,190229.56,,CUS-527400765,2018-08-09,Natasha,F,-37.66,143.83,,,,,,,debit,posted,80f14e25be6242aaa31298ea77713112,PHONE BANK,30-40,2018,8,9,12,0,Thursday,14 days,109918.186
ACC-3879258709,40,21.0,190208.56,,CUS-527400765,2018-08-09,Natasha,F,-37.66,143.83,,,,,,,debit,posted,154080320bfe4357a71c67727cc024b5,PAYMENT,30-40,2018,8,9,18,0,Thursday,14 days,109918.186
ACC-3879258709,40,41.91,190166.65,1.0,CUS-527400765,2018-08-11,Natasha,F,-37.66,143.83,,a9df8b81-7a28-42f0-9762-5480968141da,-37.74,144.83,VIC,Kealba,debit,authorized,61bf967da4ea4452a36e5377456bc3ca,SALES-POS,30-40,2018,8,11,10,25,Saturday,14 days,109918.186
ACC-3879258709,40,28.9,190137.75,1.0,CUS-527400765,2018-08-11,Natasha,F,-37.66,143.83,,a61580ea-86e1-469c-84f6-b1e3bf8f81c5,-37.78,145.27,VIC,Croydon,debit,authorized,0027a2b02a7c4e6888e8662296971391,SALES-POS,30-40,2018,8,11,11,33,Saturday,14 days,109918.186
ACC-3879258709,40,51.0,190086.75,,CUS-527400765,2018-08-13,Natasha,F,-37.66,143.83,,,,,,,debit,posted,8767bd14812246eaa726d20ee0f58e3f,INTER BANK,30-40,2018,8,13,8,0,Monday,14 days,109918.186
ACC-3879258709,40,70.73,190016.02,1.0,CUS-527400765,2018-08-14,Natasha,F,-37.66,143.83,,56e6e402-e7c4-4ac8-a287-59a04a1bdd93,-37.54,143.78,VIC,Lucas,debit,authorized,6c42333b16084f40bdd00ff964fd4b61,SALES-POS,30-40,2018,8,14,4,13,Tuesday,14 days,109918.186
ACC-3879258709,40,30.01,189986.01,1.0,CUS-527400765,2018-08-14,Natasha,F,-37.66,143.83,,35b7dcfe-3f60-4c25-a8e3-2891c0170a02,-37.54,140.81,SA,Nangwarry,debit,authorized,12d00ee4bec540debbf96e77abf57263,SALES-POS,30-40,2018,8,14,9,48,Tuesday,14 days,109918.186
ACC-3879258709,40,29.0,189957.01,,CUS-527400765,2018-08-14,Natasha,F,-37.66,143.83,,,,,,,debit,posted,2519e2039b24413b8c9dbbfc0ce405fb,PAYMENT,30-40,2018,8,14,18,0,Tuesday,14 days,109918.186
ACC-3879258709,40,87.8,189869.21,0.0,CUS-527400765,2018-08-14,Natasha,F,-37.66,143.83,,7c9bbad5-5476-4344-b5f5-31b6231783b1,-37.8,144.98,VIC,Collingwood,debit,authorized,bacc25d7fcf6456eba5572618341153d,POS,30-40,2018,8,14,21,0,Tuesday,14 days,109918.186
ACC-3879258709,40,40.16,189829.05,1.0,CUS-527400765,2018-08-15,Natasha,F,-37.66,143.83,,7dd64d5b-fe30-4a81-be18-03b2cf47faf1,-27.45,153.03,QLD,Fortitude Valley,debit,authorized,72d6c325b7ab49918d239ebc632e9819,POS,30-40,2018,8,15,13,57,Wednesday,14 days,109918.186
ACC-3879258709,40,169.0,189456.45,,CUS-527400765,2018-08-19,Natasha,F,-37.66,143.83,,,,,,,debit,posted,946cdf87589e4f50a55da2e2156225f8,PAYMENT,30-40,2018,8,19,5,0,Sunday,14 days,109918.186
ACC-3879258709,40,51.0,189405.45,,CUS-527400765,2018-08-20,Natasha,F,-37.66,143.83,,,,,,,debit,posted,aee8c2f26e1a4478abef9ded55aafa2b,INTER BANK,30-40,2018,8,20,8,0,Monday,14 days,109918.186
ACC-3879258709,40,29.0,193592.49,,CUS-527400765,2018-08-21,Natasha,F,-37.66,143.83,,,,,,,debit,posted,6dac882586c74966a98a048d1fecbbb6,PAYMENT,30-40,2018,8,21,18,0,Tuesday,14 days,109918.186
ACC-3879258709,40,41.0,193551.49,,CUS-527400765,2018-08-23,Natasha,F,-37.66,143.83,,,,,,,debit,posted,ceb27c43861142d898af2ae99763a77c,PHONE BANK,30-40,2018,8,23,12,0,Thursday,14 days,109918.186
ACC-3879258709,40,21.0,193530.49,,CUS-527400765,2018-08-23,Natasha,F,-37.66,143.83,,,,,,,debit,posted,f432e5e672224808b03fe37af298dc10,PAYMENT,30-40,2018,8,23,18,0,Thursday,14 days,109918.186
ACC-3879258709,40,51.0,193479.49,,CUS-527400765,2018-08-27,Natasha,F,-37.66,143.83,,,,,,,debit,posted,bbc9943f1d1b4a0a96a80b3076a5bf99,INTER BANK,30-40,2018,8,27,8,0,Monday,14 days,109918.186
ACC-3879258709,40,24.49,193455.0,1.0,CUS-527400765,2018-08-27,Natasha,F,-37.66,143.83,,31b42b02-9c44-41fa-a885-42de728851ca,-37.79,145.3,VIC,Croydon,debit,authorized,58106c8bc26e42bebd9fbd5f53419b09,SALES-POS,30-40,2018,8,27,9,2,Monday,14 days,109918.186
ACC-3879258709,40,29.0,193426.0,,CUS-527400765,2018-08-28,Natasha,F,-37.66,143.83,,,,,,,debit,posted,3dd05d9ffd9143d18151aa1037e16152,PAYMENT,30-40,2018,8,28,18,0,Tuesday,14 days,109918.186
ACC-3879258709,40,181.0,193245.0,,CUS-527400765,2018-08-28,Natasha,F,-37.66,143.83,,,,,,,debit,posted,db80c93f5d8a44f78e7255b31b62b780,PAYMENT,30-40,2018,8,28,23,0,Tuesday,14 days,109918.186
ACC-3879258709,40,161.0,193084.0,,CUS-527400765,2018-08-28,Natasha,F,-37.66,143.83,,,,,,,debit,posted,37747849381c4171b752a32a88838f80,PAYMENT,30-40,2018,8,28,23,0,Tuesday,14 days,109918.186
ACC-3879258709,40,41.0,193043.0,,CUS-527400765,2018-08-30,Natasha,F,-37.66,143.83,,,,,,,debit,posted,9df14c1972b2419ab1ccd0f5c6a07d85,PHONE BANK,30-40,2018,8,30,12,0,Thursday,14 days,109918.186
ACC-3879258709,40,21.0,193022.0,,CUS-527400765,2018-08-30,Natasha,F,-37.66,143.83,,,,,,,debit,posted,aa32867a674047fab62c497d22446975,PAYMENT,30-40,2018,8,30,18,0,Thursday,14 days,109918.186
ACC-3879258709,40,35.51,192986.49,1.0,CUS-527400765,2018-08-31,Natasha,F,-37.66,143.83,,055b3022-a5b4-44b4-b4b6-a03eaea535d5,-37.77,144.89,VIC,Maribyrnong,debit,authorized,88978db38fc24a16bf30dc33ad0d7776,POS,30-40,2018,8,31,14,31,Friday,14 days,109918.186
ACC-3879258709,40,170.0,192816.49,,CUS-527400765,2018-09-01,Natasha,F,-37.66,143.83,,,,,,,debit,posted,91305a8a6afa4daa95c85be8a00224c7,PAYMENT,30-40,2018,9,1,12,0,Saturday,14 days,109918.186
ACC-3879258709,40,26.2,192790.29,1.0,CUS-527400765,2018-09-01,Natasha,F,-37.66,143.83,,acf1a6ca-3f83-4511-aa48-302b1bfef3aa,-35.73,143.92,VIC,Kerang,debit,authorized,e41382be940b4138b95f6e751ef32531,SALES-POS,30-40,2018,9,1,17,56,Saturday,14 days,109918.186
ACC-3879258709,40,21.37,192768.92,1.0,CUS-527400765,2018-09-02,Natasha,F,-37.66,143.83,,4731a2be-f711-4ba0-8eb5-59d9af96296a,-37.8,144.96,VIC,Carlton,debit,authorized,d6465489a5b943869cf47d0a2c9fa241,SALES-POS,30-40,2018,9,2,20,41,Sunday,14 days,109918.186
ACC-3879258709,40,51.0,192717.92,,CUS-527400765,2018-09-03,Natasha,F,-37.66,143.83,,,,,,,debit,posted,68d1b0db0d5b41d38e228b08186895d4,INTER BANK,30-40,2018,9,3,8,0,Monday,14 days,109918.186
ACC-3879258709,40,29.0,196904.96,,CUS-527400765,2018-09-04,Natasha,F,-37.66,143.83,,,,,,,debit,posted,2ec054cfa3e942acac76a22c1452ea30,PAYMENT,30-40,2018,9,4,18,0,Tuesday,14 days,109918.186
ACC-3879258709,40,69.41,196835.55,1.0,CUS-527400765,2018-09-05,Natasha,F,-37.66,143.83,,530dc97b-35b4-4730-8872-f9b057552c86,-34.04,150.74,NSW,Narellan,debit,authorized,fbf94a00fcba4718bd0ec1acb839526c,SALES-POS,30-40,2018,9,5,9,39,Wednesday,14 days,109918.186
ACC-3879258709,40,136.28,196699.27,1.0,CUS-527400765,2018-09-06,Natasha,F,-37.66,143.83,,bcbd4135-4f71-489a-8267-93ceed452aba,-37.74,145.03,VIC,Preston,debit,authorized,d63d2c2456644854afb022fd665528c1,SALES-POS,30-40,2018,9,6,0,52,Thursday,14 days,109918.186
ACC-3879258709,40,21.15,196678.12,1.0,CUS-527400765,2018-09-06,Natasha,F,-37.66,143.83,,6fe86407-d02f-4671-81d0-03e195630e89,-37.67,145.06,VIC,Mill Park,debit,authorized,9aaf36d29e4640c19e3d506ac153f4f1,POS,30-40,2018,9,6,9,1,Thursday,14 days,109918.186
ACC-3879258709,40,41.0,196607.18,,CUS-527400765,2018-09-06,Natasha,F,-37.66,143.83,,,,,,,debit,posted,8b16aea7e89e4804ba955f69e4367338,PHONE BANK,30-40,2018,9,6,12,0,Thursday,14 days,109918.186
ACC-3879258709,40,29.94,196648.18,1.0,CUS-527400765,2018-09-06,Natasha,F,-37.66,143.83,,28fc99de-3536-4863-bd8f-5353c5276ec0,-37.71,145.05,VIC,Bundoora,debit,authorized,b6d3878e84ea462fba226fd67dccfffe,SALES-POS,30-40,2018,9,6,12,33,Thursday,14 days,109918.186
ACC-3879258709,40,21.0,196586.18,,CUS-527400765,2018-09-06,Natasha,F,-37.66,143.83,,,,,,,debit,posted,b440ba335bf9442aabee49332f160424,PAYMENT,30-40,2018,9,6,18,0,Thursday,14 days,109918.186
ACC-3879258709,40,32.01,196554.17,0.0,CUS-527400765,2018-09-07,Natasha,F,-37.66,143.83,,f37fb109-48b6-477b-b12c-3a6dc91fbbaf,-37.59,144.93,VIC,Craigieburn,debit,authorized,235c614929af4f6cb8c6ea2c28a747a2,POS,30-40,2018,9,7,9,2,Friday,14 days,109918.186
ACC-3879258709,40,27.13,196527.04,0.0,CUS-527400765,2018-09-07,Natasha,F,-37.66,143.83,,ff76a026-fa28-4445-982e-8987b29ed813,-37.05,143.75,VIC,Maryborough,debit,authorized,55a7dfbd59024cf3ba51619df9ca1c2f,POS,30-40,2018,9,7,10,40,Friday,14 days,109918.186
ACC-3879258709,40,15.09,196511.95,1.0,CUS-527400765,2018-09-07,Natasha,F,-37.66,143.83,,1c33ae03-554a-4cd7-baeb-69ecce04719c,-37.85,145.06,VIC,Camberwell,debit,authorized,311e077a5d5041ea8f519103abe34e08,SALES-POS,30-40,2018,9,7,11,27,Friday,14 days,109918.186
ACC-3879258709,40,34.06,196477.89,1.0,CUS-527400765,2018-09-07,Natasha,F,-37.66,143.83,,7ee9a1ff-0737-4028-9c1c-2fc5d392a6fc,-37.79,145.33,VIC,Mooroolbark,debit,authorized,e0994f17b10b4dca81316acca447eb46,SALES-POS,30-40,2018,9,7,13,16,Friday,14 days,109918.186
ACC-3879258709,40,48.89,196429.0,0.0,CUS-527400765,2018-09-07,Natasha,F,-37.66,143.83,,6c12fd89-f5b3-4b16-84fe-ffe384d9954b,-37.48,145.27,VIC,Kinglake West,debit,authorized,f1513a0920ac41cd88506980e6fa3fd1,POS,30-40,2018,9,7,17,51,Friday,14 days,109918.186
ACC-3879258709,40,64.04,196364.96,1.0,CUS-527400765,2018-09-08,Natasha,F,-37.66,143.83,,a85a9434-228d-4e56-b855-6494f0887f01,-37.56,143.85,VIC,Ballarat Central,debit,authorized,930720f3a346481389d87c6984fcaa03,SALES-POS,30-40,2018,9,8,15,53,Saturday,14 days,109918.186
ACC-3879258709,40,25.49,196339.47,1.0,CUS-527400765,2018-09-09,Natasha,F,-37.66,143.83,,b0b6b706-27a4-47c5-aa00-b82739505bcc,-37.6,144.94,VIC,Craigieburn,debit,authorized,c660a9aa841145999e1aa02de935332d,POS,30-40,2018,9,9,12,34,Sunday,14 days,109918.186
ACC-3879258709,40,51.0,196288.47,,CUS-527400765,2018-09-10,Natasha,F,-37.66,143.83,,,,,,,debit,posted,391fd785d822478280c6580ea4612b95,INTER BANK,30-40,2018,9,10,8,0,Monday,14 days,109918.186
ACC-3879258709,40,29.0,196259.47,,CUS-527400765,2018-09-11,Natasha,F,-37.66,143.83,,,,,,,debit,posted,47a8bfc5dc4a47d9a63fa425f8728d3b,PAYMENT,30-40,2018,9,11,18,0,Tuesday,14 days,109918.186
ACC-3879258709,40,41.0,196218.47,,CUS-527400765,2018-09-13,Natasha,F,-37.66,143.83,,,,,,,debit,posted,66370982b69949bb8deaf7e872d2b027,PHONE BANK,30-40,2018,9,13,12,0,Thursday,14 days,109918.186
ACC-3879258709,40,21.0,196197.47,,CUS-527400765,2018-09-13,Natasha,F,-37.66,143.83,,,,,,,debit,posted,26bfc67329c84e6ca333350dfdca2ca2,PAYMENT,30-40,2018,9,13,18,0,Thursday,14 days,109918.186
ACC-3879258709,40,7.08,196190.39,1.0,CUS-527400765,2018-09-14,Natasha,F,-37.66,143.83,,6cc9aaf2-e927-43f7-9308-ce15edf05915,-37.82,144.95,VIC,Docklands,debit,authorized,3dabef678cd847c8b3ec2383fd82106b,POS,30-40,2018,9,14,8,39,Friday,14 days,109918.186
ACC-3879258709,40,48.7,196141.69,0.0,CUS-527400765,2018-09-14,Natasha,F,-37.66,143.83,,6c12fd89-f5b3-4b16-84fe-ffe384d9954b,-37.48,145.27,VIC,Kinglake West,debit,authorized,f25caf3ae29e4e6f88aa2d194c8f9139,POS,30-40,2018,9,14,12,0,Friday,14 days,109918.186
ACC-3879258709,40,22.12,196119.57,1.0,CUS-527400765,2018-09-15,Natasha,F,-37.66,143.83,,98b27892-36ea-4240-a710-55be6a60aaf2,-37.82,145.03,VIC,Hawthorn,debit,authorized,37e22f431a4747dea630a9edffb88dfc,POS,30-40,2018,9,15,20,7,Saturday,14 days,109918.186
ACC-3879258709,40,51.56,196068.01,1.0,CUS-527400765,2018-09-15,Natasha,F,-37.66,143.83,,3c5b0f0a-c9a7-4728-afd2-ad2057375228,-37.78,145.32,VIC,Mooroolbark,debit,authorized,c7694a20f2a949b68422e52677ee5c40,SALES-POS,30-40,2018,9,15,20,14,Saturday,14 days,109918.186
ACC-3879258709,40,45.25,196022.76,1.0,CUS-527400765,2018-09-15,Natasha,F,-37.66,143.83,,d9298262-4c0b-43ca-b210-0ffa784e9b58,-37.64,144.93,VIC,Roxburgh Park,debit,authorized,caf651d657df4a7f84754432e0e09a22,SALES-POS,30-40,2018,9,15,22,8,Saturday,14 days,109918.186
ACC-3879258709,40,36.99,195985.77,1.0,CUS-527400765,2018-09-16,Natasha,F,-37.66,143.83,,649ce507-e945-49ea-b0aa-dc386c0a5fe2,-37.56,143.88,VIC,Ballarat East,debit,authorized,24fa311f3d944ca08da1bd0d605531f5,SALES-POS,30-40,2018,9,16,5,55,Sunday,14 days,109918.186
ACC-3879258709,40,127.0,195858.77,,CUS-527400765,2018-09-16,Natasha,F,-37.66,143.83,,,,,,,debit,posted,bda9d0b0e01a4e5c96661d009349acb6,INTER BANK,30-40,2018,9,16,16,0,Sunday,14 days,109918.186
ACC-3879258709,40,51.0,195807.77,,CUS-527400765,2018-09-17,Natasha,F,-37.66,143.83,,,,,,,debit,posted,af5dbd63d7c94db887542d2624030ad0,INTER BANK,30-40,2018,9,17,8,0,Monday,14 days,109918.186
ACC-3879258709,40,29.0,199994.81,,CUS-527400765,2018-09-18,Natasha,F,-37.66,143.83,,,,,,,debit,posted,9af5a4b395714c2cb1827aa2eeac3627,PAYMENT,30-40,2018,9,18,18,0,Tuesday,14 days,109918.186
ACC-3879258709,40,169.0,199825.81,,CUS-527400765,2018-09-19,Natasha,F,-37.66,143.83,,,,,,,debit,posted,2a7a6a092bf1442ab3f8a43f76294108,PAYMENT,30-40,2018,9,19,5,0,Wednesday,14 days,109918.186
ACC-3879258709,40,41.0,199784.81,,CUS-527400765,2018-09-20,Natasha,F,-37.66,143.83,,,,,,,debit,posted,e627ba6e09eb4111b9f8f33f0476f52b,PHONE BANK,30-40,2018,9,20,12,0,Thursday,14 days,109918.186
ACC-3879258709,40,23.27,199761.54,1.0,CUS-527400765,2018-09-20,Natasha,F,-37.66,143.83,,b9243e36-0774-4ecf-9f2b-5680cccbfa12,-38.75,143.67,VIC,Apollo Bay,debit,authorized,026f88118f8d4e858195effafdc3cc31,POS,30-40,2018,9,20,17,22,Thursday,14 days,109918.186
ACC-3879258709,40,21.0,199740.54,,CUS-527400765,2018-09-20,Natasha,F,-37.66,143.83,,,,,,,debit,posted,e11d81ed0ecb4e10bdc5f38f63d06127,PAYMENT,30-40,2018,9,20,18,0,Thursday,14 days,109918.186
ACC-3879258709,40,51.0,199689.54,,CUS-527400765,2018-09-24,Natasha,F,-37.66,143.83,,,,,,,debit,posted,d8c7ece223d74349aaf14b355179ebd3,INTER BANK,30-40,2018,9,24,8,0,Monday,14 days,109918.186
ACC-3879258709,40,29.0,199660.54,,CUS-527400765,2018-09-25,Natasha,F,-37.66,143.83,,,,,,,debit,posted,47cb004da4324258bf8defe151e2dfea,PAYMENT,30-40,2018,9,25,18,0,Tuesday,14 days,109918.186
ACC-3879258709,40,31.74,199628.8,1.0,CUS-527400765,2018-09-26,Natasha,F,-37.66,143.83,,3106a7ab-36fe-4456-9046-0346fe280818,-37.54,143.83,VIC,Wendouree,debit,authorized,687a3d4f9cc4437585c8bcf821553ba1,POS,30-40,2018,9,26,9,58,Wednesday,14 days,109918.186
ACC-3879258709,40,20.11,199608.69,0.0,CUS-527400765,2018-09-26,Natasha,F,-37.66,143.83,,438dd11a-c4ee-42f4-bbbb-09b03f278170,-37.69,144.56,VIC,Melton West,debit,authorized,721a41ec5ac54f9196878bebe7f7aed4,SALES-POS,30-40,2018,9,26,10,54,Wednesday,14 days,109918.186
ACC-3879258709,40,10.04,199598.65,1.0,CUS-527400765,2018-09-27,Natasha,F,-37.66,143.83,,40055409-b76b-4015-a2bb-167aabf50935,-37.72,145.14,VIC,Eltham,debit,authorized,1bcb8cf44890448d9404e4448d2ff701,POS,30-40,2018,9,27,4,18,Thursday,14 days,109918.186
ACC-3879258709,40,48.45,199550.2,1.0,CUS-527400765,2018-09-27,Natasha,F,-37.66,143.83,,6c12fd89-f5b3-4b16-84fe-ffe384d9954b,-37.48,145.27,VIC,Kinglake West,debit,authorized,aec53c1036fb40f18c0a1afbfba34407,POS,30-40,2018,9,27,9,2,Thursday,14 days,109918.186
ACC-3879258709,40,36.6,199513.6,1.0,CUS-527400765,2018-09-27,Natasha,F,-37.66,143.83,,a03db1e2-6e3e-408b-a023-355149eaaf18,-37.79,145.28,VIC,Croydon,debit,authorized,6dbfade49f2f42ea89710447cf19924b,SALES-POS,30-40,2018,9,27,10,8,Thursday,14 days,109918.186
ACC-3879258709,40,41.0,199413.68,,CUS-527400765,2018-09-27,Natasha,F,-37.66,143.83,,,,,,,debit,posted,7ba458efb30b4497bd31cbe4f924c7e5,PHONE BANK,30-40,2018,9,27,12,0,Thursday,14 days,109918.186
ACC-3879258709,40,58.92,199454.68,1.0,CUS-527400765,2018-09-27,Natasha,F,-37.66,143.83,,a46906c1-9d2d-498d-8f9a-ba9b448b583d,-33.87,151.21,NSW,Sydney,debit,authorized,f11b3d913f394e51909bf704a30d197b,SALES-POS,30-40,2018,9,27,12,50,Thursday,14 days,109918.186
ACC-3879258709,40,21.0,199392.68,,CUS-527400765,2018-09-27,Natasha,F,-37.66,143.83,,,,,,,debit,posted,ff592c24f7ad4749bc9ed9f641e3402d,PAYMENT,30-40,2018,9,27,18,0,Thursday,14 days,109918.186
ACC-3879258709,40,36.73,199355.95,1.0,CUS-527400765,2018-09-27,Natasha,F,-37.66,143.83,,c92484c9-8c73-4cc8-b281-09e91c8f4c57,-37.77,144.96,VIC,Brunswick,debit,authorized,0d36ae51623d4762b95c5fa3298a0a81,POS,30-40,2018,9,27,19,36,Thursday,14 days,109918.186
ACC-3879258709,40,181.0,199174.95,,CUS-527400765,2018-09-28,Natasha,F,-37.66,143.83,,,,,,,debit,posted,fa94e6effcfc485782c7852aea30a5fb,PAYMENT,30-40,2018,9,28,23,0,Friday,14 days,109918.186
ACC-3879258709,40,161.0,199013.95,,CUS-527400765,2018-09-28,Natasha,F,-37.66,143.83,,,,,,,debit,posted,0895040bff404f54bf720219c8a6bcca,PAYMENT,30-40,2018,9,28,23,0,Friday,14 days,109918.186
ACC-3879258709,40,27.57,198986.38,1.0,CUS-527400765,2018-09-29,Natasha,F,-37.66,143.83,,c0fab9eb-a843-4853-a6f7-5ccdc0010fe2,-37.71,144.89,VIC,Airport West,debit,authorized,fddead5ebf8b482f853b8733d4daa897,SALES-POS,30-40,2018,9,29,15,7,Saturday,14 days,109918.186
ACC-3879258709,40,5.06,198981.32,1.0,CUS-527400765,2018-09-29,Natasha,F,-37.66,143.83,,c0411601-6569-48fc-8c8d-24e38e1388aa,-33.83,150.98,NSW,Merrylands,debit,authorized,d59abe2b795a47be84cb7bbd8665ffa5,POS,30-40,2018,9,29,18,6,Saturday,14 days,109918.186
ACC-3879258709,40,10.77,198970.55,1.0,CUS-527400765,2018-09-29,Natasha,F,-37.66,143.83,,3fbc2fcc-15cb-49f0-bdaf-1d5cf1218138,-33.8,151.14,NSW,North Ryde,debit,authorized,9ffd1e0ee3c1433d8e4acc1c7236c9cf,POS,30-40,2018,9,29,19,26,Saturday,14 days,109918.186
ACC-3879258709,40,28.48,198942.07,1.0,CUS-527400765,2018-09-29,Natasha,F,-37.66,143.83,,f5c25f89-43a5-478f-9890-78d3e726520d,-37.59,144.91,VIC,Craigieburn,debit,authorized,7115742de873494fb4d9670596195774,SALES-POS,30-40,2018,9,29,21,23,Saturday,14 days,109918.186
ACC-3879258709,40,15.11,198926.96,1.0,CUS-527400765,2018-09-29,Natasha,F,-37.66,143.83,,0d45849a-3eb0-461a-910a-8d9618b2801a,-37.69,145.06,VIC,Bundoora,debit,authorized,eec82126045f4d129506eb6b8023f850,SALES-POS,30-40,2018,9,29,22,14,Saturday,14 days,109918.186
ACC-3879258709,40,19.79,198907.17,1.0,CUS-527400765,2018-09-29,Natasha,F,-37.66,143.83,,f2f0cbbe-38b6-4da4-b43e-dace31e2daf3,-37.52,145.11,VIC,Whittlesea,debit,authorized,7c3571dfbbae47a79208a81911767a27,POS,30-40,2018,9,29,22,32,Saturday,14 days,109918.186
ACC-3879258709,40,26.21,198880.96,1.0,CUS-527400765,2018-09-29,Natasha,F,-37.66,143.83,,46950084-b323-4510-8170-81e44170e89f,-37.59,144.91,VIC,Craigieburn,debit,authorized,a046cefc61a84cd98e3d2e0127e569e3,POS,30-40,2018,9,29,22,50,Saturday,14 days,109918.186
ACC-3879258709,40,51.0,198829.96,,CUS-527400765,2018-10-01,Natasha,F,-37.66,143.83,,,,,,,debit,posted,610b3d73c90c4113b8c312ee5343365b,INTER BANK,30-40,2018,10,1,8,0,Monday,14 days,109918.186
ACC-3879258709,40,170.0,202876.0,,CUS-527400765,2018-10-01,Natasha,F,-37.66,143.83,,,,,,,debit,posted,2d97242e01894d7eaefa6a09ffb0bb25,PAYMENT,30-40,2018,10,1,12,0,Monday,14 days,109918.186
ACC-3879258709,40,52.93,202823.07,1.0,CUS-527400765,2018-10-02,Natasha,F,-37.66,143.83,,4009eacb-a18b-477b-b4e5-bc4eb97fcbe2,-37.57,145.64,VIC,Narbethong,debit,authorized,161bd85f5b54404bb9296563f8bbfc7d,POS,30-40,2018,10,2,13,52,Tuesday,14 days,109918.186
ACC-3879258709,40,27.49,202795.58,1.0,CUS-527400765,2018-10-02,Natasha,F,-37.66,143.83,,81e0744e-281c-43de-b088-286740dc1e97,-37.51,145.75,VIC,Marysville,debit,authorized,7c74ccdff206470c99721574dd844659,SALES-POS,30-40,2018,10,2,15,14,Tuesday,14 days,109918.186
ACC-3879258709,40,29.0,202766.58,,CUS-527400765,2018-10-02,Natasha,F,-37.66,143.83,,,,,,,debit,posted,868fabbffd3d4c189b3f244635cad1a7,PAYMENT,30-40,2018,10,2,18,0,Tuesday,14 days,109918.186
ACC-3879258709,40,135.4,202631.18,0.0,CUS-527400765,2018-10-03,Natasha,F,-37.66,143.83,,04d39df5-0957-4ab9-bd8a-024f142cbae5,-38.15,144.36,VIC,Geelong,debit,authorized,dea583f80c1740c597cf805388c83e9d,SALES-POS,30-40,2018,10,3,4,21,Wednesday,14 days,109918.186
ACC-3879258709,40,32.64,202598.54,0.0,CUS-527400765,2018-10-03,Natasha,F,-37.66,143.83,,7c6c5c99-7e7f-4e73-b7ca-543d10aa4901,-37.57,144.92,VIC,Craigieburn,debit,authorized,b943b69540444fa895a027efbefa00c1,POS,30-40,2018,10,3,11,54,Wednesday,14 days,109918.186
ACC-3879258709,40,30.69,202567.85,0.0,CUS-527400765,2018-10-03,Natasha,F,-37.66,143.83,,2dca5f51-025a-444a-8e19-055e95f964d8,-37.72,144.85,VIC,Keilor Park,debit,authorized,71c1c88c31364f47b56fe3af5fa55265,SALES-POS,30-40,2018,10,3,13,48,Wednesday,14 days,109918.186
ACC-3879258709,40,53.55,202514.3,1.0,CUS-527400765,2018-10-03,Natasha,F,-37.66,143.83,,e1597598-44ba-4a5e-bc10-06df1e3e113a,-37.67,145.04,VIC,Lalor,debit,authorized,8c936cb8d5d04457bd025a2edc18459e,POS,30-40,2018,10,3,23,6,Wednesday,14 days,109918.186
ACC-3879258709,40,41.0,202473.3,,CUS-527400765,2018-10-04,Natasha,F,-37.66,143.83,,,,,,,debit,posted,1670507cab2f4eb69fc894542366457e,PHONE BANK,30-40,2018,10,4,12,0,Thursday,14 days,109918.186
ACC-3879258709,40,21.0,202452.3,,CUS-527400765,2018-10-04,Natasha,F,-37.66,143.83,,,,,,,debit,posted,ac88ec8d4a2f475db8f27525e6b3c060,PAYMENT,30-40,2018,10,4,18,0,Thursday,14 days,109918.186
ACC-3879258709,40,38.58,202413.72,1.0,CUS-527400765,2018-10-05,Natasha,F,-37.66,143.83,,4e4301ac-7690-491a-ab3a-035b3b2854cd,-37.7,145.11,VIC,Greensborough,debit,authorized,c60b07bb68da4c979d42f31713501c5d,POS,30-40,2018,10,5,10,39,Friday,14 days,109918.186
ACC-3879258709,40,18.12,202395.6,1.0,CUS-527400765,2018-10-05,Natasha,F,-37.66,143.83,,7793a019-24d9-4ccd-a30c-dbd7755c0b65,-37.81,145.03,VIC,Kew,debit,authorized,60648c9261174eb5b41f7090712ff0e0,SALES-POS,30-40,2018,10,5,13,29,Friday,14 days,109918.186
ACC-3879258709,40,40.09,202355.51,1.0,CUS-527400765,2018-10-05,Natasha,F,-37.66,143.83,,c150a727-80a9-4b0c-9ac8-8787431c38ba,-37.62,145.01,VIC,Epping,debit,authorized,b2822e3cc7744f4a98d66661a2b61625,POS,30-40,2018,10,5,14,36,Friday,14 days,109918.186
ACC-3879258709,40,54.59,202300.92,1.0,CUS-527400765,2018-10-05,Natasha,F,-37.66,143.83,,e1597598-44ba-4a5e-bc10-06df1e3e113a,-37.67,145.04,VIC,Lalor,debit,authorized,cbc01c94c9e84d6bb023aeec2ff6b7d1,POS,30-40,2018,10,5,17,13,Friday,14 days,109918.186
ACC-3879258709,40,30.85,202270.07,1.0,CUS-527400765,2018-10-07,Natasha,F,-37.66,143.83,,b0299acf-7955-4b74-b24b-05fe5c2f65f8,-37.6,144.94,VIC,Craigieburn,debit,authorized,fbfb939ec36a42ae8690922841af999e,SALES-POS,30-40,2018,10,7,12,31,Sunday,14 days,109918.186
ACC-3879258709,40,51.0,202219.07,,CUS-527400765,2018-10-08,Natasha,F,-37.66,143.83,,,,,,,debit,posted,16e88911fb744955bc8783efc64201bc,INTER BANK,30-40,2018,10,8,8,0,Monday,14 days,109918.186
ACC-3879258709,40,27.54,202191.53,1.0,CUS-527400765,2018-10-09,Natasha,F,-37.66,143.83,,b695aa53-1443-4029-8404-f93e5b381d72,-37.6,144.94,VIC,Craigieburn,debit,authorized,309a60a9dbd248b981193764b03f95c5,SALES-POS,30-40,2018,10,9,15,14,Tuesday,14 days,109918.186
ACC-3879258709,40,38.21,202153.32,1.0,CUS-527400765,2018-10-09,Natasha,F,-37.66,143.83,,d582810b-04c5-4fec-9016-ab0ee3c27e01,-37.84,144.69,VIC,Tarneit,debit,authorized,a526af8eea06438b8e751b5ac94fcf90,SALES-POS,30-40,2018,10,9,17,55,Tuesday,14 days,109918.186
ACC-3879258709,40,29.0,202124.32,,CUS-527400765,2018-10-09,Natasha,F,-37.66,143.83,,,,,,,debit,posted,b6aa82bbbc0948f181154d4e74e430c7,PAYMENT,30-40,2018,10,9,18,0,Tuesday,14 days,109918.186
ACC-3879258709,40,41.0,202083.32,,CUS-527400765,2018-10-11,Natasha,F,-37.66,143.83,,,,,,,debit,posted,89d1262bbec7478d8764a72757777ec0,PHONE BANK,30-40,2018,10,11,12,0,Thursday,14 days,109918.186
ACC-3879258709,40,17.6,202065.72,1.0,CUS-527400765,2018-10-11,Natasha,F,-37.66,143.83,,3eab8fdf-9c9c-4ca7-bebe-d5df55fedbab,-37.66,144.88,VIC,Greenvale,debit,authorized,db5f8d52ae2748a697d7fd2f4a28a5e3,POS,30-40,2018,10,11,14,23,Thursday,14 days,109918.186
ACC-3879258709,40,21.0,202044.72,,CUS-527400765,2018-10-11,Natasha,F,-37.66,143.83,,,,,,,debit,posted,8f1fbb789abe4735950029fdf5e8e738,PAYMENT,30-40,2018,10,11,18,0,Thursday,14 days,109918.186
ACC-3879258709,40,43.01,202001.71,1.0,CUS-527400765,2018-10-12,Natasha,F,-37.66,143.83,,7c27c261-9d34-40e2-89d2-d32c5626712d,-27.42,153.03,QLD,Lutwyche,debit,authorized,e196f0a6f0264940844510a70608fa9a,POS,30-40,2018,10,12,10,44,Friday,14 days,109918.186
ACC-3879258709,40,15.0,201986.71,1.0,CUS-527400765,2018-10-13,Natasha,F,-37.66,143.83,,cdcef1bf-8c51-4c37-8986-efdb22d06bd8,-37.82,145,VIC,Richmond,debit,authorized,10aa7601c4dc48d89f1cfab3c79538c9,POS,30-40,2018,10,13,4,57,Saturday,14 days,109918.186
ACC-3879258709,40,15.73,201970.98,1.0,CUS-527400765,2018-10-13,Natasha,F,-37.66,143.83,,b5b469fb-774c-4bc8-97e0-23f0e8042869,-37.84,145.01,VIC,Toorak,debit,authorized,d27459ea65614d819ddca57c8c691081,SALES-POS,30-40,2018,10,13,8,29,Saturday,14 days,109918.186
ACC-3879258709,40,17.94,201953.04,0.0,CUS-527400765,2018-10-13,Natasha,F,-37.66,143.83,,ab172039-8566-4f8b-b5e7-7fb38e91dbff,-37.58,144.73,VIC,Sunbury,debit,authorized,6e806a98152a43c2abce9c6fb57ef622,POS,30-40,2018,10,13,11,6,Saturday,14 days,109918.186
ACC-3879258709,40,16.96,201936.08,1.0,CUS-527400765,2018-10-13,Natasha,F,-37.66,143.83,,7baf9be2-e6b7-465b-af92-a4313e361902,-37.8,144.96,VIC,Carlton,debit,authorized,f8d4c39289db43d9a017b928d8169669,POS,30-40,2018,10,13,17,35,Saturday,14 days,109918.186
ACC-3879258709,40,12.31,201923.77,1.0,CUS-527400765,2018-10-13,Natasha,F,-37.66,143.83,,b9d9cd38-eb94-41c8-b10c-8e286b4911fc,-37.78,144.96,VIC,Brunswick,debit,authorized,6a8f0c4a909d4d95a1180dbdd0380bba,POS,30-40,2018,10,13,20,7,Saturday,14 days,109918.186
ACC-3879258709,40,19.37,201904.4,1.0,CUS-527400765,2018-10-13,Natasha,F,-37.66,143.83,,3148f5c1-0e76-466e-9c35-bef02039f53c,-37.79,145.16,VIC,Doncaster East,debit,authorized,459c764adf9a46f799ef33d0660df867,SALES-POS,30-40,2018,10,13,21,40,Saturday,14 days,109918.186
ACC-3879258709,40,17.81,201886.59,1.0,CUS-527400765,2018-10-14,Natasha,F,-37.66,143.83,,340599d7-55b0-49a7-b725-c847bdc33feb,-37.49,144.59,VIC,Gisborne,debit,authorized,c595df80d81846a59e6fd5d88b0f6c64,SALES-POS,30-40,2018,10,14,7,48,Sunday,14 days,109918.186
ACC-3879258709,40,51.0,201835.59,,CUS-527400765,2018-10-15,Natasha,F,-37.66,143.83,,,,,,,debit,posted,05883672071a4bddb959a7a2e56b0674,INTER BANK,30-40,2018,10,15,8,0,Monday,14 days,109918.186
ACC-3879258709,40,127.0,205924.63,,CUS-527400765,2018-10-16,Natasha,F,-37.66,143.83,,,,,,,debit,posted,d505d593f8a24107a2ca6e654aa09269,INTER BANK,30-40,2018,10,16,16,0,Tuesday,14 days,109918.186
ACC-3879258709,40,29.0,205895.63,,CUS-527400765,2018-10-16,Natasha,F,-37.66,143.83,,,,,,,debit,posted,8399a896a79d413eab32df18d9272b5e,PAYMENT,30-40,2018,10,16,18,0,Tuesday,14 days,109918.186
ACC-3879258709,40,41.0,205854.63,,CUS-527400765,2018-10-18,Natasha,F,-37.66,143.83,,,,,,,debit,posted,ffb575047ba94dae952cecf9d722bc99,PHONE BANK,30-40,2018,10,18,12,0,Thursday,14 days,109918.186
ACC-3879258709,40,21.0,205833.63,,CUS-527400765,2018-10-18,Natasha,F,-37.66,143.83,,,,,,,debit,posted,0a6e49cae7f649bcaed99de2b006c24c,PAYMENT,30-40,2018,10,18,18,0,Thursday,14 days,109918.186
ACC-3879258709,40,169.0,205664.63,,CUS-527400765,2018-10-19,Natasha,F,-37.66,143.83,,,,,,,debit,posted,058c45abe9fb479bb725b3d2551c4c06,PAYMENT,30-40,2018,10,19,5,0,Friday,14 days,109918.186
ACC-3879258709,40,11.37,205653.26,1.0,CUS-527400765,2018-10-20,Natasha,F,-37.66,143.83,,18625e36-e8c7-4ca4-a0fc-9a4bb4f28bff,-37.67,145.16,VIC,Diamond Creek,debit,authorized,f3fb0bdf0b7047248c43c957ce187b42,SALES-POS,30-40,2018,10,20,11,16,Saturday,14 days,109918.186
ACC-3879258709,40,29.24,205624.02,1.0,CUS-527400765,2018-10-20,Natasha,F,-37.66,143.83,,257a6424-6bd6-4fca-96fc-8d31d902aff0,-37.6,145.1,VIC,Mernda,debit,authorized,3271055db3c94500899c1b2cccce4d9a,POS,30-40,2018,10,20,11,33,Saturday,14 days,109918.186
ACC-3879258709,40,51.45,205572.57,1.0,CUS-527400765,2018-10-21,Natasha,F,-37.66,143.83,,84e73232-245a-4d2c-b0d2-ee9a9b6771d4,-37.72,144.89,VIC,Airport West,debit,authorized,aefe5a68a0524b5f86a0fbbd547f216b,SALES-POS,30-40,2018,10,21,15,40,Sunday,14 days,109918.186
ACC-3879258709,40,41.28,205531.29,0.0,CUS-527400765,2018-10-21,Natasha,F,-37.66,143.83,,e58a6e08-d5dd-4146-9b9b-6aedd7e98905,-37.75,144.95,VIC,Brunswick West,debit,authorized,ec5e60a2a3f74fbdbd711445ff438ca6,SALES-POS,30-40,2018,10,21,17,35,Sunday,14 days,109918.186
ACC-3879258709,40,51.0,205480.29,,CUS-527400765,2018-10-22,Natasha,F,-37.66,143.83,,,,,,,debit,posted,cd736d35fab749ae8a39018bfafd72f1,INTER BANK,30-40,2018,10,22,8,0,Monday,14 days,109918.186
ACC-3879258709,40,29.0,205451.29,,CUS-527400765,2018-10-23,Natasha,F,-37.66,143.83,,,,,,,debit,posted,baa9b3f6331a4afea06e952a50d8045b,PAYMENT,30-40,2018,10,23,18,0,Tuesday,14 days,109918.186
ACC-3879258709,40,30.43,205420.86,1.0,CUS-527400765,2018-10-25,Natasha,F,-37.66,143.83,,80f556e8-cff2-4dad-bbb6-9f3f9672bb55,-33.89,151.21,NSW,Surry Hills,debit,authorized,1d1229d7c16149579cbb1828f95a8e46,POS,30-40,2018,10,25,8,43,Thursday,14 days,109918.186
ACC-3879258709,40,37.57,205383.29,1.0,CUS-527400765,2018-10-25,Natasha,F,-37.66,143.83,,01aa962e-70a1-4e8a-8df2-590e790a00d9,-37.76,145.06,VIC,Heidelberg,debit,authorized,a8ca0a26b3e7479b88358e31cbc52d86,SALES-POS,30-40,2018,10,25,9,36,Thursday,14 days,109918.186
ACC-3879258709,40,41.0,205342.29,,CUS-527400765,2018-10-25,Natasha,F,-37.66,143.83,,,,,,,debit,posted,646fa1884aa94ecbaaee2be8257229a2,PHONE BANK,30-40,2018,10,25,12,0,Thursday,14 days,109918.186
ACC-3879258709,40,21.0,205321.29,,CUS-527400765,2018-10-25,Natasha,F,-37.66,143.83,,,,,,,debit,posted,53996dad03eb45ada3daddbf47a65e8d,PAYMENT,30-40,2018,10,25,18,0,Thursday,14 days,109918.186
ACC-3879258709,40,143.57,205177.72,1.0,CUS-527400765,2018-10-25,Natasha,F,-37.66,143.83,,2f3bc0c3-93fd-41a4-a1cc-5ad551adbecc,-33.87,151.2,NSW,Sydney,debit,authorized,c6d730cf7cda4f3f8f0ae2881ca15a61,POS,30-40,2018,10,25,23,51,Thursday,14 days,109918.186
ACC-3879258709,40,12.23,205165.49,0.0,CUS-527400765,2018-10-26,Natasha,F,-37.66,143.83,,80e53a6b-a952-4d9b-972d-a0ab82735076,-37.85,145.15,VIC,Burwood East,debit,authorized,f8a2cb5068ab433c97ea214d6740bed9,POS,30-40,2018,10,26,1,26,Friday,14 days,109918.186
ACC-3879258709,40,41.98,205123.51,1.0,CUS-527400765,2018-10-26,Natasha,F,-37.66,143.83,,39bb33a5-e996-426c-830e-f600717033c4,-37.66,145.08,VIC,Mill Park,debit,authorized,a5412a7c7d244117bcc5bc30df73a08b,POS,30-40,2018,10,26,15,21,Friday,14 days,109918.186
ACC-3879258709,40,20.45,205103.06,1.0,CUS-527400765,2018-10-26,Natasha,F,-37.66,143.83,,3c9e69c6-a0fd-4cd4-bc2d-664843715b05,-37.68,144.92,VIC,Broadmeadows,debit,authorized,662d7428fde8429b9ff1502b2a11392b,SALES-POS,30-40,2018,10,26,19,29,Friday,14 days,109918.186
ACC-3879258709,40,181.0,204922.06,,CUS-527400765,2018-10-28,Natasha,F,-37.66,143.83,,,,,,,debit,posted,ce1574346c2949089e26cb7631e38a95,PAYMENT,30-40,2018,10,28,23,0,Sunday,14 days,109918.186
ACC-3879258709,40,161.0,204761.06,,CUS-527400765,2018-10-28,Natasha,F,-37.66,143.83,,,,,,,debit,posted,bffe42ec57044664abb77b7f699eabcd,PAYMENT,30-40,2018,10,28,23,0,Sunday,14 days,109918.186
ACC-3879258709,40,51.0,204710.06,,CUS-527400765,2018-10-29,Natasha,F,-37.66,143.83,,,,,,,debit,posted,02f23e2385ec4fd1ba0c37e8b6e55956,INTER BANK,30-40,2018,10,29,8,0,Monday,14 days,109918.186
ACC-3879258709,40,31.15,208894.95,1.0,CUS-527400765,2018-10-29,Natasha,F,-37.66,143.83,,afe3809f-76b3-4959-8a78-d620910b8762,-37.83,144.99,VIC,Richmond,debit,authorized,e0cba35ed9bd4813ab207b929b95c6bf,SALES-POS,30-40,2018,10,29,15,54,Monday,14 days,109918.186
ACC-3879258709,40,26.51,208868.44,1.0,CUS-527400765,2018-10-30,Natasha,F,-37.66,143.83,,ae373432-0f87-44d6-9966-6ddaf7ee2785,-37.84,145.01,VIC,Toorak,debit,authorized,d8e85bb991a141099bc3af8b255304ca,POS,30-40,2018,10,30,10,35,Tuesday,14 days,109918.186
ACC-3879258709,40,29.0,208839.44,,CUS-527400765,2018-10-30,Natasha,F,-37.66,143.83,,,,,,,debit,posted,b8ffb20b44b846d68082924bd7980286,PAYMENT,30-40,2018,10,30,18,0,Tuesday,14 days,109918.186
ACC-3879258709,40,20.23,208819.21,1.0,CUS-527400765,2018-10-31,Natasha,F,-37.66,143.83,,7b69c603-686d-46c9-9d1c-e27a693e638b,-37.54,144.94,VIC,Donnybrook,debit,authorized,cbf674ede96b4c7786c330d0eaa0839b,SALES-POS,30-40,2018,10,31,8,8,Wednesday,14 days,109918.186
ACC-2249586092,19,3.28,4172.16,1.0,CUS-443776336,2018-08-01,Edward,M,-32.07,115.98,,7cdb62b5-6632-4d1d-8e28-a4d26f5cbb74,-32.11,133.67,SA,Ceduna,debit,authorized,519228444b164ae2b61bc1e2bca47283,POS,<20,2018,8,1,12,15,Wednesday,7 days,51650.107
ACC-2249586092,19,13.75,4158.41,1.0,CUS-443776336,2018-08-02,Edward,M,-32.07,115.98,,8f7da23e-78da-47df-a17a-adc84a3d9b09,-32.07,115.82,WA,Kardinya,debit,authorized,677537138318437d933675a81abe82e4,SALES-POS,<20,2018,8,2,13,0,Thursday,7 days,51650.107
ACC-2249586092,19,26.45,4131.96,0.0,CUS-443776336,2018-08-03,Edward,M,-32.07,115.98,,3cdfed25-1a9b-4ca7-88d0-9f9b55468aed,-31.97,116.06,WA,Kalamunda,debit,authorized,38317408e21740a4bd2b36281d2c64e0,POS,<20,2018,8,3,19,44,Friday,7 days,51650.107
ACC-2249586092,19,7.34,4124.62,0.0,CUS-443776336,2018-08-04,Edward,M,-32.07,115.98,,38bc8b72-3917-4e2c-b6ff-605dc71e90f1,-32.08,115.77,WA,Hamilton Hill,debit,authorized,58d9911705834543a147e23fa5f27427,POS,<20,2018,8,4,21,10,Saturday,7 days,51650.107
ACC-2249586092,19,15.09,4109.53,1.0,CUS-443776336,2018-08-05,Edward,M,-32.07,115.98,,3d184a6d-e776-457e-a21a-597d20e80794,-31.76,116.01,WA,The Vines,debit,authorized,5556540b5bca4fca812a95264d6c2a01,POS,<20,2018,8,5,4,28,Sunday,7 days,51650.107
ACC-2249586092,19,37.0,4063.28,,CUS-443776336,2018-08-05,Edward,M,-32.07,115.98,,,,,,,debit,posted,5c4ec96272614034bddd64a0c004b2e0,PAYMENT,<20,2018,8,5,12,0,Sunday,7 days,51650.107
ACC-2249586092,19,9.25,4100.28,1.0,CUS-443776336,2018-08-05,Edward,M,-32.07,115.98,,e8232990-ff4b-4844-a311-b6cd4e435de8,-31.94,152.47,NSW,Glenthorne,debit,authorized,d560e8662d12436e9b49c7d9e4e70eb6,SALES-POS,<20,2018,8,5,12,28,Sunday,7 days,51650.107
ACC-2249586092,19,31.0,5022.83,,CUS-443776336,2018-08-06,Edward,M,-32.07,115.98,,,,,,,debit,posted,dc22505cd75b412988589ebf39a7810b,PAYMENT,<20,2018,8,6,22,0,Monday,7 days,51650.107
ACC-2249586092,19,727.84,4294.99,1.0,CUS-443776336,2018-08-08,Edward,M,-32.07,115.98,,79d69c85-2e85-45fc-a4ae-537ec4b232bc,-32.03,117.67,WA,Pantapin,debit,authorized,a573c2d0852447aba24a41c89de730b4,POS,<20,2018,8,8,21,18,Wednesday,7 days,51650.107
ACC-2249586092,19,8.72,4286.27,1.0,CUS-443776336,2018-08-08,Edward,M,-32.07,115.98,,1cc4e7aa-8d69-42eb-a045-63fd99e7b5d0,-31.87,115.93,WA,Beechboro,debit,authorized,e6b52a0d5e0546c89facd7c6bcfb123c,POS,<20,2018,8,8,22,31,Wednesday,7 days,51650.107
ACC-2249586092,19,60.38,4225.89,0.0,CUS-443776336,2018-08-09,Edward,M,-32.07,115.98,,c58a3f2e-9497-4b01-89f6-69df34f7a557,-32.1,115.81,WA,Bibra Lake,debit,authorized,933494df7e8b4509b0c3d04a860a5d50,SALES-POS,<20,2018,8,9,10,27,Thursday,7 days,51650.107
ACC-2249586092,19,11.92,4213.97,1.0,CUS-443776336,2018-08-09,Edward,M,-32.07,115.98,,15166bc3-359c-42cc-8161-e17d276b050a,-31.96,115.93,WA,Perth,debit,authorized,ade1e7bc58a74487a12af49134546c46,POS,<20,2018,8,9,14,11,Thursday,7 days,51650.107
ACC-2249586092,19,9.39,4204.58,1.0,CUS-443776336,2018-08-09,Edward,M,-32.07,115.98,,4c90fdf3-5b7d-4fdc-b734-8bd894ed6a89,-32.12,133.67,SA,Ceduna,debit,authorized,4147cb8a7db8414194d01e79ec145064,SALES-POS,<20,2018,8,9,15,55,Thursday,7 days,51650.107
ACC-2249586092,19,5.08,4199.5,1.0,CUS-443776336,2018-08-09,Edward,M,-32.07,115.98,,6f6848ab-1b4d-429a-a201-0a30830b0e33,-31.99,115.75,WA,Cottesloe,debit,authorized,1747c8c9bce04807b17d811520c79432,POS,<20,2018,8,9,21,18,Thursday,7 days,51650.107
ACC-2249586092,19,15.73,4183.77,1.0,CUS-443776336,2018-08-09,Edward,M,-32.07,115.98,,bcf73fb5-0ccd-42b7-8140-15d125625f91,-32.02,115.83,WA,Ardross,debit,authorized,1e0e76ae17c247109dcbd8b77770d2b1,SALES-POS,<20,2018,8,9,23,15,Thursday,7 days,51650.107
ACC-2249586092,19,12.87,4170.9,1.0,CUS-443776336,2018-08-10,Edward,M,-32.07,115.98,,e41622a4-37f4-47a4-805d-3bcfd60a905e,-32.02,115.94,WA,Cannington,debit,authorized,0545bd5a83914c54b64e750ad4336a8b,POS,<20,2018,8,10,9,8,Friday,7 days,51650.107
ACC-2249586092,19,3.15,4167.75,1.0,CUS-443776336,2018-08-10,Edward,M,-32.07,115.98,,0573359a-48af-4d38-a1a0-00d115cb2654,-31.91,152.46,NSW,Taree,debit,authorized,85f8d20cc6c240ccbefd914b3d5e5124,SALES-POS,<20,2018,8,10,12,56,Friday,7 days,51650.107
ACC-2249586092,19,9.21,4158.54,1.0,CUS-443776336,2018-08-10,Edward,M,-32.07,115.98,,01a1edb2-3ed1-4743-961a-53249ee0b92e,-32.14,115.79,WA,Beeliar,debit,authorized,a305cc48b461418e9056fad8053500c2,POS,<20,2018,8,10,23,15,Friday,7 days,51650.107
ACC-2249586092,19,13.9,4144.64,1.0,CUS-443776336,2018-08-11,Edward,M,-32.07,115.98,,6c84c219-96ea-4c6f-9de5-0a28bcaec62f,-32.01,152.47,NSW,Rainbow Flat,debit,authorized,0060f28a2ba44d6f8c0a0a9496d63335,POS,<20,2018,8,11,9,11,Saturday,7 days,51650.107
ACC-2249586092,19,10.83,4133.81,1.0,CUS-443776336,2018-08-11,Edward,M,-32.07,115.98,,f27c034d-70c3-4d77-af93-aaa894522ed8,-31.78,115.97,WA,Ellenbrook,debit,authorized,ba6bcbee5de041d98a337e5659c54bce,POS,<20,2018,8,11,10,37,Saturday,7 days,51650.107
ACC-2249586092,19,37.0,4096.81,,CUS-443776336,2018-08-12,Edward,M,-32.07,115.98,,,,,,,debit,posted,da8a6e6a5dc24d71a64a3586dce204bb,PAYMENT,<20,2018,8,12,12,0,Sunday,7 days,51650.107
ACC-2249586092,19,31.0,5056.36,,CUS-443776336,2018-08-13,Edward,M,-32.07,115.98,,,,,,,debit,posted,ba923cb7c967490bbc21e028d846ff3e,PAYMENT,<20,2018,8,13,22,0,Monday,7 days,51650.107
ACC-2249586092,19,1.52,5054.84,0.0,CUS-443776336,2018-08-14,Edward,M,-32.07,115.98,,bd19a059-abcb-4c59-83f4-ca0a07c93d4d,-33.93,151.19,NSW,Mascot,debit,authorized,baae4f8d96ab454d8224fb3efae374ab,SALES-POS,<20,2018,8,14,11,37,Tuesday,7 days,51650.107
ACC-2249586092,19,15.94,5038.9,1.0,CUS-443776336,2018-08-15,Edward,M,-32.07,115.98,,d60f76ae-00eb-42a8-bc8c-86e25f707aed,-32.08,115.81,WA,Coolbellup,debit,authorized,17e1c07084bd42f18f479e3081e5bc71,SALES-POS,<20,2018,8,15,13,38,Wednesday,7 days,51650.107
ACC-2249586092,19,10.86,4994.31,1.0,CUS-443776336,2018-08-17,Edward,M,-32.07,115.98,,cd049966-32f3-49df-8a55-1f9809d05e80,-31.77,116.03,WA,Upper Swan,debit,authorized,83bb2b24163c4ed69bab7f1e81d2ddcb,SALES-POS,<20,2018,8,17,15,57,Friday,7 days,51650.107
ACC-2249586092,19,18.0,4976.31,1.0,CUS-443776336,2018-08-17,Edward,M,-32.07,115.98,,eeda9bcd-4ada-449a-8851-150fd704c328,-31.77,115.77,WA,Beldon,debit,authorized,2780d7def0204cbc986bb752b482b8c7,POS,<20,2018,8,17,21,10,Friday,7 days,51650.107
ACC-2249586092,19,17.0,4959.31,1.0,CUS-443776336,2018-08-18,Edward,M,-32.07,115.98,,cebc217a-60a9-4a09-9c52-3852108f5c2d,-31.9,115.8,WA,Innaloo,debit,authorized,9ee6fd211d084bfebd1ae1f64e0ae2e7,SALES-POS,<20,2018,8,18,8,53,Saturday,7 days,51650.107
ACC-2249586092,19,6.08,4953.23,0.0,CUS-443776336,2018-08-18,Edward,M,-32.07,115.98,,c8102c73-8f6a-4c5d-a452-797d9aaba5d4,-31.87,115.76,WA,Trigg,debit,authorized,053a5973b8704039bcdc18db535dcb85,SALES-POS,<20,2018,8,18,22,43,Saturday,7 days,51650.107
ACC-2249586092,19,14.61,4938.62,1.0,CUS-443776336,2018-08-19,Edward,M,-32.07,115.98,,6c84c219-96ea-4c6f-9de5-0a28bcaec62f,-32.01,152.47,NSW,Rainbow Flat,debit,authorized,3fa415e0d8de436d8763fcc15d351b6d,SALES-POS,<20,2018,8,19,8,23,Sunday,7 days,51650.107
ACC-2249586092,19,13.89,4924.73,1.0,CUS-443776336,2018-08-19,Edward,M,-32.07,115.98,,a7804b16-7fa6-4349-848a-41c72f5bf3f3,-31.89,115.84,WA,Tuart Hill,debit,authorized,addbf9e246b5459686b9ede7b499c81e,SALES-POS,<20,2018,8,19,11,10,Sunday,7 days,51650.107
ACC-2249586092,19,37.0,4887.73,,CUS-443776336,2018-08-19,Edward,M,-32.07,115.98,,,,,,,debit,posted,e018ebb84bd9440fa93b89ddfb12aad6,PAYMENT,<20,2018,8,19,12,0,Sunday,7 days,51650.107
ACC-2249586092,19,31.0,5847.28,,CUS-443776336,2018-08-20,Edward,M,-32.07,115.98,,,,,,,debit,posted,86c0487ab30a471ba54881a36d04afcf,PAYMENT,<20,2018,8,20,22,0,Monday,7 days,51650.107
ACC-2249586092,19,3.71,5843.57,0.0,CUS-443776336,2018-08-22,Edward,M,-32.07,115.98,,94b47426-4004-400b-b52e-a6918431670d,-32.05,115.81,WA,Myaree,debit,authorized,fcd7f22571c143c9b14f5b29ad3cd134,POS,<20,2018,8,22,9,45,Wednesday,7 days,51650.107
ACC-2249586092,19,5.83,5837.74,1.0,CUS-443776336,2018-08-22,Edward,M,-32.07,115.98,,20946f54-d601-4554-87d9-4b607b1ee2e6,-32.07,115.75,WA,South Fremantle,debit,authorized,7b079e6176f74183a3c48e33b21f66a3,POS,<20,2018,8,22,10,39,Wednesday,7 days,51650.107
ACC-2249586092,19,15.6,5822.14,1.0,CUS-443776336,2018-08-22,Edward,M,-32.07,115.98,,d4a13396-46d8-4741-ab3d-68e8211c0813,-31.88,115.78,WA,Karrinyup,debit,authorized,bf655c004ee2482da933d4e483a5b0ff,SALES-POS,<20,2018,8,22,14,20,Wednesday,7 days,51650.107
ACC-2249586092,19,8.5,5813.64,1.0,CUS-443776336,2018-08-22,Edward,M,-32.07,115.98,,3e78f1c7-deb3-415e-bc4f-a99d3bb79eb3,-31.78,115.99,WA,Aveley,debit,authorized,d836448068934a4095d48b518b9c9cfe,SALES-POS,<20,2018,8,22,19,35,Wednesday,7 days,51650.107
ACC-2249586092,19,18.13,5795.51,1.0,CUS-443776336,2018-08-23,Edward,M,-32.07,115.98,,419a0f39-0dbc-44c0-8d4f-17c5956e090c,-31.99,116.06,WA,Lesmurdie,debit,authorized,bedcdbbca7c54c7ba3096b216344aebd,POS,<20,2018,8,23,7,51,Thursday,7 days,51650.107
ACC-2249586092,19,8.88,5786.63,1.0,CUS-443776336,2018-08-23,Edward,M,-32.07,115.98,,ab3c0402-2b3d-404c-92ec-38d0eb3da29b,-31.88,115.94,WA,Beechboro,debit,authorized,c2cb9aba50b04f57b5b9df5756ef65a8,SALES-POS,<20,2018,8,23,8,17,Thursday,7 days,51650.107
ACC-2249586092,19,6.0,5780.63,1.0,CUS-443776336,2018-08-24,Edward,M,-32.07,115.98,,f56c4edc-1ea9-42b5-964f-14bd1da1777a,-31.97,151.91,NSW,Barrington,debit,authorized,ebd4ebdc03494eb78b3fe6cfd278ba91,POS,<20,2018,8,24,17,59,Friday,7 days,51650.107
ACC-2249586092,19,31.11,5749.52,0.0,CUS-443776336,2018-08-25,Edward,M,-32.07,115.98,,10b09c30-c78c-4316-b9dc-cfc4725c06d4,-31.94,115.86,WA,Perth,debit,authorized,e94bd8e4d22d482f8f910707bcf5e3b1,SALES-POS,<20,2018,8,25,7,22,Saturday,7 days,51650.107
ACC-2249586092,19,22.86,5726.66,0.0,CUS-443776336,2018-08-25,Edward,M,-32.07,115.98,,f5446956-20a9-4c2f-8df8-3d93ce458ccf,-32.13,133.67,SA,Ceduna,debit,authorized,1471d177103c49369e054b2a6b89d10a,SALES-POS,<20,2018,8,25,15,15,Saturday,7 days,51650.107
ACC-2249586092,19,8.7,5717.96,1.0,CUS-443776336,2018-08-25,Edward,M,-32.07,115.98,,c1186f92-1fa9-4e07-bebc-50cb972af694,-31.89,116.01,WA,Midland,debit,authorized,fa2cc11fad7441fba1bd233cda51887c,POS,<20,2018,8,25,15,48,Saturday,7 days,51650.107
ACC-2249586092,19,31.27,5686.69,1.0,CUS-443776336,2018-08-25,Edward,M,-32.07,115.98,,a4ca23f4-58ac-4a54-b853-b0fc1b77ea51,-31.77,115.77,WA,Joondalup,debit,authorized,e9278bea375142928d5ad06d0e699827,POS,<20,2018,8,25,19,55,Saturday,7 days,51650.107
ACC-2249586092,19,8.67,5678.02,1.0,CUS-443776336,2018-08-25,Edward,M,-32.07,115.98,,4c90fdf3-5b7d-4fdc-b734-8bd894ed6a89,-32.12,133.67,SA,Ceduna,debit,authorized,e419544932b74aedbef046dc98613ed2,SALES-POS,<20,2018,8,25,23,28,Saturday,7 days,51650.107
ACC-2249586092,19,22.34,5655.68,1.0,CUS-443776336,2018-08-26,Edward,M,-32.07,115.98,,f5446956-20a9-4c2f-8df8-3d93ce458ccf,-32.13,133.67,SA,Ceduna,debit,authorized,a84b081a08e74544947fefd857b3a9e3,SALES-POS,<20,2018,8,26,10,19,Sunday,7 days,51650.107
ACC-2249586092,19,37.0,5618.68,,CUS-443776336,2018-08-26,Edward,M,-32.07,115.98,,,,,,,debit,posted,f5fbdb3ba4c445c3995da7222ddff4e4,PAYMENT,<20,2018,8,26,12,0,Sunday,7 days,51650.107
ACC-2249586092,19,31.0,6578.23,,CUS-443776336,2018-08-27,Edward,M,-32.07,115.98,,,,,,,debit,posted,871eec65bf4f419c889b11ea82efd325,PAYMENT,<20,2018,8,27,22,0,Monday,7 days,51650.107
ACC-2249586092,19,15.45,6562.78,1.0,CUS-443776336,2018-08-28,Edward,M,-32.07,115.98,,6c84c219-96ea-4c6f-9de5-0a28bcaec62f,-32.01,152.47,NSW,Rainbow Flat,debit,authorized,a639c197980248aa9e812f98252a9727,SALES-POS,<20,2018,8,28,9,20,Tuesday,7 days,51650.107
ACC-2249586092,19,3.86,6558.92,1.0,CUS-443776336,2018-08-28,Edward,M,-32.07,115.98,,21496c3f-0761-4e48-8d58-c0ab87743aeb,-32.07,152.54,NSW,Hallidays Point,debit,authorized,23e793f5f6614f68bc8d4a463cf9b094,SALES-POS,<20,2018,8,28,10,11,Tuesday,7 days,51650.107
ACC-2249586092,19,7.93,6550.99,1.0,CUS-443776336,2018-08-28,Edward,M,-32.07,115.98,,10f3a3be-4aae-4d79-84e5-ca7ef05fe3ae,-31.8,115.75,WA,Hillarys,debit,authorized,d43446660b9e4d199b2bc32e6de63616,SALES-POS,<20,2018,8,28,20,1,Tuesday,7 days,51650.107
ACC-2249586092,19,3.14,6547.85,1.0,CUS-443776336,2018-08-30,Edward,M,-32.07,115.98,,1eae0e40-42e0-44c8-9c71-8dad9d2f8d59,-32.11,115.78,WA,Spearwood,debit,authorized,10b5fec6a99440c3bbf145a9cf474847,SALES-POS,<20,2018,8,30,19,57,Thursday,7 days,51650.107
ACC-2249586092,19,7.49,6540.36,1.0,CUS-443776336,2018-08-30,Edward,M,-32.07,115.98,,2e022ece-4bcb-4390-8f00-cc29b633af3f,-31.87,115.83,WA,Balcatta,debit,authorized,3152bbb5e13f410296e8821bba331000,SALES-POS,<20,2018,8,30,23,23,Thursday,7 days,51650.107
ACC-2249586092,19,6.18,6534.18,0.0,CUS-443776336,2018-08-30,Edward,M,-32.07,115.98,,294193ff-d76e-445f-b240-dea59df2caf8,-31.94,141.47,NSW,Broken Hill,debit,authorized,d868e30df2bb4cacaa818baf515ff147,SALES-POS,<20,2018,8,30,23,56,Thursday,7 days,51650.107
ACC-2249586092,19,51.51,6482.67,1.0,CUS-443776336,2018-08-31,Edward,M,-32.07,115.98,,0c4bd181-32b2-4b81-8cbc-5f17b0ea5a20,-33.87,151.2,NSW,Sydney,debit,authorized,899ff0dfa46e4b8ba64f44f1c11338ef,SALES-POS,<20,2018,8,31,15,59,Friday,7 days,51650.107
ACC-2249586092,19,12.11,6470.56,1.0,CUS-443776336,2018-08-31,Edward,M,-32.07,115.98,,2150c863-93fd-4de5-a6c6-4f703c42948b,-32.09,115.94,WA,Southern River,debit,authorized,9026e78c701d4bb7af7bbf82e2b0a672,SALES-POS,<20,2018,8,31,19,22,Friday,7 days,51650.107
ACC-2249586092,19,10.29,6460.27,1.0,CUS-443776336,2018-09-01,Edward,M,-32.07,115.98,,a684e8da-788b-48e2-8e9e-68dcca90266d,-31.89,116,WA,Midland,debit,authorized,a6c0764ecae64d0396784c7cbe4913e8,SALES-POS,<20,2018,9,1,10,27,Saturday,7 days,51650.107
ACC-2249586092,19,3.45,6456.82,1.0,CUS-443776336,2018-09-01,Edward,M,-32.07,115.98,,84812265-9b6e-4c7c-a438-d89ce74c9e61,-32.08,152.54,NSW,Black Head,debit,authorized,e807e1609f4d4b8498dd687a39354903,POS,<20,2018,9,1,19,28,Saturday,7 days,51650.107
ACC-2249586092,19,94.88,6361.94,1.0,CUS-443776336,2018-09-01,Edward,M,-32.07,115.98,,6bbcd84f-2bd6-466b-9084-d0998fe887b2,-37.8,144.99,VIC,Collingwood,debit,authorized,fcdc0fdc3da64900acaa73457df42599,SALES-POS,<20,2018,9,1,21,13,Saturday,7 days,51650.107
ACC-2249586092,19,9.98,6351.96,1.0,CUS-443776336,2018-09-02,Edward,M,-32.07,115.98,,71e68b5c-d855-40e1-844e-decd9f93fb97,-32.13,115.86,WA,Success,debit,authorized,82d9b81d9a1f4122aef597e72b15c4f1,SALES-POS,<20,2018,9,2,11,30,Sunday,7 days,51650.107
ACC-2249586092,19,37.0,6314.96,,CUS-443776336,2018-09-02,Edward,M,-32.07,115.98,,,,,,,debit,posted,a0afbb1dfd9845c4a24dbbd75eb2146c,PAYMENT,<20,2018,9,2,12,0,Sunday,7 days,51650.107
ACC-2249586092,19,23.46,6291.5,1.0,CUS-443776336,2018-09-02,Edward,M,-32.07,115.98,,9223d7eb-268f-41d4-a975-3378517186e6,-31.95,115.82,WA,Subiaco,debit,authorized,78fbac4643184bdb8d8bd23af0c87c97,SALES-POS,<20,2018,9,2,13,21,Sunday,7 days,51650.107
ACC-2249586092,19,11.43,6280.07,1.0,CUS-443776336,2018-09-02,Edward,M,-32.07,115.98,,4a168885-e50f-45d8-a2cc-acb19023406b,-31.97,115.88,WA,Victoria Park,debit,authorized,a503d2513e4a4e858d08a10232cf1928,SALES-POS,<20,2018,9,2,23,18,Sunday,7 days,51650.107
ACC-2249586092,19,16.33,6263.74,0.0,CUS-443776336,2018-09-03,Edward,M,-32.07,115.98,,a92e16c3-14a3-4d19-b4e9-19ccd297e4f8,-31.95,141.45,NSW,Broken Hill,debit,authorized,a1afc93ab46a405e962f3ac490979f0e,POS,<20,2018,9,3,9,23,Monday,7 days,51650.107
ACC-2249586092,19,31.0,7223.29,,CUS-443776336,2018-09-03,Edward,M,-32.07,115.98,,,,,,,debit,posted,702e8ebad90e43848c0075c322f11ed8,PAYMENT,<20,2018,9,3,22,0,Monday,7 days,51650.107
ACC-2249586092,19,11.12,7212.17,1.0,CUS-443776336,2018-09-05,Edward,M,-32.07,115.98,,cf24ed6a-ce3e-475e-bf02-c46fa8977fab,-31.89,116.01,WA,Midland,debit,authorized,55ab0e03b66744f8ad75ad12559464c2,POS,<20,2018,9,5,15,7,Wednesday,7 days,51650.107
ACC-2249586092,19,5.52,7206.65,1.0,CUS-443776336,2018-09-05,Edward,M,-32.07,115.98,,7cdb62b5-6632-4d1d-8e28-a4d26f5cbb74,-32.11,133.67,SA,Ceduna,debit,authorized,ce58ba20849f4f0c8682ba8bd91d5a92,SALES-POS,<20,2018,9,5,16,57,Wednesday,7 days,51650.107
ACC-2249586092,19,4.91,7201.74,1.0,CUS-443776336,2018-09-05,Edward,M,-32.07,115.98,,0c8bb295-f131-4d05-ae12-1ad946e582d3,-32.05,115.98,WA,Maddington,debit,authorized,2eca3eecad9f4b7d950950fce05a4ce0,POS,<20,2018,9,5,20,42,Wednesday,7 days,51650.107
ACC-2249586092,19,12.99,7188.75,1.0,CUS-443776336,2018-09-07,Edward,M,-32.07,115.98,,b4f2b65f-632d-4d1c-87c7-3f23526b0d15,-31.97,116.05,WA,Kalamunda,debit,authorized,09c22f1f799840d780c0f7d938303387,SALES-POS,<20,2018,9,7,14,5,Friday,7 days,51650.107
ACC-2249586092,19,13.33,7175.42,1.0,CUS-443776336,2018-09-07,Edward,M,-32.07,115.98,,fd71cbe9-0658-47c8-b05c-93f162148da8,-31.87,115.86,WA,Mirrabooka,debit,authorized,b18b68e043474fbfb40578e3898d6761,POS,<20,2018,9,7,15,30,Friday,7 days,51650.107
ACC-2249586092,19,23.95,7151.47,1.0,CUS-443776336,2018-09-08,Edward,M,-32.07,115.98,,f5446956-20a9-4c2f-8df8-3d93ce458ccf,-32.13,133.67,SA,Ceduna,debit,authorized,c64a6acc42184a318da0e4dcc47a096c,SALES-POS,<20,2018,9,8,15,42,Saturday,7 days,51650.107
ACC-2249586092,19,7.81,7143.66,0.0,CUS-443776336,2018-09-08,Edward,M,-32.07,115.98,,6738d671-5dbc-4016-a941-9bbb15bdbff8,-31.86,115.88,WA,Malaga,debit,authorized,1925348574d8406f9bf28bb5095dc6b9,POS,<20,2018,9,8,16,39,Saturday,7 days,51650.107
ACC-2249586092,19,190.28,6953.38,1.0,CUS-443776336,2018-09-08,Edward,M,-32.07,115.98,,7d4ab535-cd61-47b7-88d6-cbf9102c2487,-32.12,133.67,SA,Ceduna,debit,authorized,69e35b4f799b419891b7b9a7e50d6230,SALES-POS,<20,2018,9,8,17,31,Saturday,7 days,51650.107
ACC-2249586092,19,37.0,6916.38,,CUS-443776336,2018-09-09,Edward,M,-32.07,115.98,,,,,,,debit,posted,ecaaaeeb327d4713acdd4cc9092b4a8b,PAYMENT,<20,2018,9,9,12,0,Sunday,7 days,51650.107
ACC-2249586092,19,7.24,6909.14,1.0,CUS-443776336,2018-09-09,Edward,M,-32.07,115.98,,177a2bfe-d1a4-469f-971c-c9c48c165a43,-31.97,116.06,WA,Kalamunda,debit,authorized,01b460fe89a44846b7293bc2a4cd7bfb,POS,<20,2018,9,9,13,33,Sunday,7 days,51650.107
ACC-2249586092,19,10.5,6898.64,1.0,CUS-443776336,2018-09-09,Edward,M,-32.07,115.98,,b5ff0ecb-d8d0-4cb4-aedc-c09ff19431ba,-31.98,115.91,WA,East Victoria Park,debit,authorized,6aa190598cc3433bb58b86a3d8a75457,POS,<20,2018,9,9,21,4,Sunday,7 days,51650.107
ACC-2249586092,19,6.02,6892.62,1.0,CUS-443776336,2018-09-10,Edward,M,-32.07,115.98,,d06b5e6d-e48c-402c-a1d7-b01531f76c99,-31.95,115.85,WA,Perth,debit,authorized,9ea35f4f887f4885b7e1d1df38df7149,SALES-POS,<20,2018,9,10,9,44,Monday,7 days,51650.107
ACC-2249586092,19,6.08,6886.54,1.0,CUS-443776336,2018-09-10,Edward,M,-32.07,115.98,,af248048-a034-42dd-b9ae-5d6fd544bfda,-32.04,150.87,NSW,Scone,debit,authorized,ec3891c38ee440a08d132e89c2f05de0,SALES-POS,<20,2018,9,10,10,58,Monday,7 days,51650.107
ACC-2249586092,19,2.41,6884.13,1.0,CUS-443776336,2018-09-10,Edward,M,-32.07,115.98,,03f4de0d-d78b-421a-8a53-30a0d03479eb,-31.8,115.98,WA,Aveley,debit,authorized,abd33c5149824ba4966cde97c5fa3521,SALES-POS,<20,2018,9,10,12,58,Monday,7 days,51650.107
ACC-2249586092,19,31.0,7843.68,,CUS-443776336,2018-09-10,Edward,M,-32.07,115.98,,,,,,,debit,posted,e76541047d314ff2813c55d1e2bc6394,PAYMENT,<20,2018,9,10,22,0,Monday,7 days,51650.107
ACC-2249586092,19,10.56,7833.12,1.0,CUS-443776336,2018-09-11,Edward,M,-32.07,115.98,,099f9893-7926-4cf6-b2b0-110b2767d6f3,-31.98,115.9,WA,East Victoria Park,debit,authorized,0bf340e91be4478c8066accc79766d6b,SALES-POS,<20,2018,9,11,17,15,Tuesday,7 days,51650.107
ACC-2249586092,19,15.36,7817.76,1.0,CUS-443776336,2018-09-11,Edward,M,-32.07,115.98,,a657dff1-c0a1-464c-b8c9-d8d32fd205af,-32.04,115.9,WA,Parkwood,debit,authorized,a41e529f573d442a9f3fa6b3a50d34a1,POS,<20,2018,9,11,18,49,Tuesday,7 days,51650.107
ACC-2249586092,19,16.24,7801.52,1.0,CUS-443776336,2018-09-12,Edward,M,-32.07,115.98,,baeaedd8-8da3-4499-8138-8832efc13057,-31.89,115.94,WA,Kiara,debit,authorized,4142d662eb4e4d3c93b152f4f2b318fc,POS,<20,2018,9,12,11,56,Wednesday,7 days,51650.107
ACC-2249586092,19,8.17,7793.35,1.0,CUS-443776336,2018-09-12,Edward,M,-32.07,115.98,,5e1fd3fa-2b3f-4719-84be-92a1345b0b0a,-31.75,115.76,WA,Joondalup,debit,authorized,ba9d277f108a439aabcaa6b8f8f75e08,POS,<20,2018,9,12,15,48,Wednesday,7 days,51650.107
ACC-2249586092,19,18.61,7774.74,1.0,CUS-443776336,2018-09-14,Edward,M,-32.07,115.98,,7a696b6f-7586-4d4d-a2c6-e32904de84dd,-32.13,133.67,SA,Ceduna,debit,authorized,868486b2583e4b54a23cb762d52d0daf,POS,<20,2018,9,14,11,52,Friday,7 days,51650.107
ACC-2249586092,19,13.36,7761.38,0.0,CUS-443776336,2018-09-15,Edward,M,-32.07,115.98,,80117b77-2727-4831-8510-aa90942868a0,-31.9,115.8,WA,Innaloo,debit,authorized,76fe2a8e830d4d5f9068a08071d8ea38,SALES-POS,<20,2018,9,15,9,19,Saturday,7 days,51650.107
ACC-2249586092,19,7.37,7754.01,1.0,CUS-443776336,2018-09-15,Edward,M,-32.07,115.98,,256eb126-d47d-44bd-8696-e324950ca522,-32.11,133.67,SA,Ceduna,debit,authorized,e1a16e0e0d95436c973940f4189d4999,POS,<20,2018,9,15,19,49,Saturday,7 days,51650.107
ACC-2249586092,19,25.55,7728.46,1.0,CUS-443776336,2018-09-15,Edward,M,-32.07,115.98,,e957b3e1-e8d7-49a4-98a9-e5feba8b1a74,-33.89,151.25,NSW,Bondi Junction,debit,authorized,b7175eb9763b412aba3110f7ea186a7e,SALES-POS,<20,2018,9,15,21,59,Saturday,7 days,51650.107
ACC-2249586092,19,9.41,7719.05,1.0,CUS-443776336,2018-09-16,Edward,M,-32.07,115.98,,4cde9948-295b-4058-ae6f-9f76161698dc,-31.9,115.8,WA,Innaloo,debit,authorized,dec9c5598f2c4c03a5ef71b22616d1fe,POS,<20,2018,9,16,7,15,Sunday,7 days,51650.107
ACC-2249586092,19,7.36,7711.69,1.0,CUS-443776336,2018-09-16,Edward,M,-32.07,115.98,,67abf1d1-db18-4663-ac92-a381f3c4e634,-32.04,115.79,WA,Palmyra,debit,authorized,a7e94b1eaf5146fc92fa46ae71398f2a,POS,<20,2018,9,16,9,20,Sunday,7 days,51650.107
ACC-2249586092,19,16.01,7695.68,1.0,CUS-443776336,2018-09-16,Edward,M,-32.07,115.98,,2d10fce1-fa78-445d-8667-02ed679481bf,-31.89,116.01,WA,Midland,debit,authorized,4694c5dd6bd944978b98c5c923cfd086,POS,<20,2018,9,16,10,17,Sunday,7 days,51650.107
ACC-2249586092,19,12.35,7683.33,1.0,CUS-443776336,2018-09-16,Edward,M,-32.07,115.98,,f27c034d-70c3-4d77-af93-aaa894522ed8,-31.78,115.97,WA,Ellenbrook,debit,authorized,277f6869e82646cb90e821cd9dddfabc,POS,<20,2018,9,16,10,55,Sunday,7 days,51650.107
ACC-2249586092,19,14.78,7668.55,1.0,CUS-443776336,2018-09-16,Edward,M,-32.07,115.98,,0d206b8c-57aa-4003-9d08-047f6588f43d,-31.9,115.76,WA,Scarborough,debit,authorized,3e26dec98d80423ebcdcf73cecf7df04,SALES-POS,<20,2018,9,16,11,49,Sunday,7 days,51650.107
ACC-2249586092,19,37.0,7631.55,,CUS-443776336,2018-09-16,Edward,M,-32.07,115.98,,,,,,,debit,posted,9cfcd26c508b4c56a7d5985bcdb5188b,PAYMENT,<20,2018,9,16,12,0,Sunday,7 days,51650.107
ACC-2249586092,19,4.87,7626.68,1.0,CUS-443776336,2018-09-16,Edward,M,-32.07,115.98,,37bde927-5d7e-4cc4-81a1-0495d9f1e034,-31.65,152.8,NSW,Laurieton,debit,authorized,aeeb5127f8584d8ea6b3f91685c5465e,POS,<20,2018,9,16,19,25,Sunday,7 days,51650.107
ACC-2249586092,19,31.0,8586.23,,CUS-443776336,2018-09-17,Edward,M,-32.07,115.98,,,,,,,debit,posted,a771ebbb7a744ba8bdba369890e478aa,PAYMENT,<20,2018,9,17,22,0,Monday,7 days,51650.107
ACC-2249586092,19,9.54,8576.69,0.0,CUS-443776336,2018-09-18,Edward,M,-32.07,115.98,,d09979db-ed1b-4221-acca-34a33fdc4dcf,-32.02,115.94,WA,Cannington,debit,authorized,d3611f61e0e3479dab776cce5cf47fe3,POS,<20,2018,9,18,10,46,Tuesday,7 days,51650.107
ACC-2249586092,19,9.75,8566.94,1.0,CUS-443776336,2018-09-20,Edward,M,-32.07,115.98,,877c3184-2b92-448b-9b90-fc1e328a5a03,-31.87,115.84,WA,Westminster,debit,authorized,c6f8135b1c5d4f42bd09ef14629577f6,SALES-POS,<20,2018,9,20,9,57,Thursday,7 days,51650.107
ACC-2249586092,19,47.8,8519.14,1.0,CUS-443776336,2018-09-21,Edward,M,-32.07,115.98,,32903f6b-7d4e-42d6-a195-b70c71645d6d,-31.9,115.9,WA,Morley,debit,authorized,b403ca2bc713479e9ae67b8b126ada96,SALES-POS,<20,2018,9,21,20,25,Friday,7 days,51650.107
ACC-2249586092,19,7.61,8511.53,0.0,CUS-443776336,2018-09-21,Edward,M,-32.07,115.98,,42d41c86-bbae-4a5a-a838-a7ae397f17ec,-32.07,115.75,WA,South Fremantle,debit,authorized,e8d14dbb15e1455389bc6cc512d13a4e,SALES-POS,<20,2018,9,21,21,40,Friday,7 days,51650.107
ACC-2249586092,19,37.0,8474.53,,CUS-443776336,2018-09-23,Edward,M,-32.07,115.98,,,,,,,debit,posted,44d176450f8a405c98c8ab17ac5c9ee1,PAYMENT,<20,2018,9,23,12,0,Sunday,7 days,51650.107
ACC-2249586092,19,31.0,9434.08,,CUS-443776336,2018-09-24,Edward,M,-32.07,115.98,,,,,,,debit,posted,1aed7ebd3dc14fdd87abb2d5326edbca,PAYMENT,<20,2018,9,24,22,0,Monday,7 days,51650.107
ACC-2249586092,19,37.0,9397.08,,CUS-443776336,2018-09-30,Edward,M,-32.07,115.98,,,,,,,debit,posted,e2d2ee88e8bd4e16934baa431de7e025,PAYMENT,<20,2018,9,30,12,0,Sunday,7 days,51650.107
ACC-2249586092,19,18.79,10368.84,1.0,CUS-443776336,2018-10-01,Edward,M,-32.07,115.98,,1cd50a6b-6654-4371-b16d-30db7e692030,-31.89,115.76,WA,Scarborough,debit,authorized,cae017ec488e493c8ee0e79d13ec82e8,SALES-POS,<20,2018,10,1,17,8,Monday,7 days,51650.107
ACC-2249586092,19,31.0,10337.84,,CUS-443776336,2018-10-01,Edward,M,-32.07,115.98,,,,,,,debit,posted,e852299c6e334e57b5b90d665fb0e855,PAYMENT,<20,2018,10,1,22,0,Monday,7 days,51650.107
ACC-2249586092,19,17.92,10319.92,1.0,CUS-443776336,2018-10-02,Edward,M,-32.07,115.98,,641b16cf-f933-45da-a71b-c4565a2aa4e9,-31.87,115.83,WA,Balcatta,debit,authorized,14c801227a8641ec80a5a5f535c48021,POS,<20,2018,10,2,12,10,Tuesday,7 days,51650.107
ACC-2249586092,19,89.74,10230.18,1.0,CUS-443776336,2018-10-02,Edward,M,-32.07,115.98,,e0aa6ccc-c4be-4c4a-b429-8c6047bf297f,-31.87,115.8,WA,Stirling,debit,authorized,1d19ebbda40e460a94435d94aae551bf,SALES-POS,<20,2018,10,2,19,32,Tuesday,7 days,51650.107
ACC-2249586092,19,17.64,10212.54,1.0,CUS-443776336,2018-10-02,Edward,M,-32.07,115.98,,83215e0e-e1c9-469b-80bb-17d33b8d190a,-32.05,115.93,WA,Langford,debit,authorized,aa9c85f4254d42f2a6d286e8e2c60132,POS,<20,2018,10,2,22,1,Tuesday,7 days,51650.107
ACC-2249586092,19,43.9,10168.64,1.0,CUS-443776336,2018-10-03,Edward,M,-32.07,115.98,,f951df7c-92b7-444c-959b-e227f5bb6735,-33.85,151.05,NSW,Lidcombe,debit,authorized,267f51324fd74ad38cda3d4b6f10286a,SALES-POS,<20,2018,10,3,8,19,Wednesday,7 days,51650.107
ACC-2249586092,19,9.34,10159.3,1.0,CUS-443776336,2018-10-03,Edward,M,-32.07,115.98,,e5297726-cda0-45a8-9d19-60344d080d7f,-31.98,115.8,WA,Nedlands,debit,authorized,362d4f8788ea493a983970d935cf2f76,POS,<20,2018,10,3,14,31,Wednesday,7 days,51650.107
ACC-2249586092,19,9.57,10149.73,0.0,CUS-443776336,2018-10-03,Edward,M,-32.07,115.98,,174192c8-c07d-461a-8d53-3062fe5151f5,-33.86,151.21,NSW,Sydney,debit,authorized,bc894d342d8e41378c7a31548225e73f,POS,<20,2018,10,3,15,23,Wednesday,7 days,51650.107
ACC-2249586092,19,15.79,10133.94,1.0,CUS-443776336,2018-10-03,Edward,M,-32.07,115.98,,a7804b16-7fa6-4349-848a-41c72f5bf3f3,-31.89,115.84,WA,Tuart Hill,debit,authorized,6c20f2e967914e3bb2f3a12fb32a342c,SALES-POS,<20,2018,10,3,15,41,Wednesday,7 days,51650.107
ACC-2249586092,19,10.99,10122.95,0.0,CUS-443776336,2018-10-04,Edward,M,-32.07,115.98,,e3dd02c2-6015-49de-906b-10a7816e8e32,-32.08,115.86,WA,Leeming,debit,authorized,a134db76658d4ae79434b92c96aa1e18,SALES-POS,<20,2018,10,4,9,26,Thursday,7 days,51650.107
ACC-2249586092,19,12.13,10110.82,1.0,CUS-443776336,2018-10-04,Edward,M,-32.07,115.98,,943d2447-b9b3-4d66-aff8-a2c111be7594,-32.06,115.75,WA,Fremantle,debit,authorized,26c03eed1397402da697bb1493bd7782,POS,<20,2018,10,4,11,46,Thursday,7 days,51650.107
ACC-2249586092,19,190.82,9920.0,1.0,CUS-443776336,2018-10-05,Edward,M,-32.07,115.98,,7d4ab535-cd61-47b7-88d6-cbf9102c2487,-32.12,133.67,SA,Ceduna,debit,authorized,50b8901bf3cc4d549cf93fbf8386af60,SALES-POS,<20,2018,10,5,16,50,Friday,7 days,51650.107
ACC-2249586092,19,38.54,9881.46,0.0,CUS-443776336,2018-10-06,Edward,M,-32.07,115.98,,0ef8a903-b583-41c2-953e-746aefc07cda,-31.95,115.86,WA,Perth,debit,authorized,bc81063d5aa94f5d84f154bdb13547ea,SALES-POS,<20,2018,10,6,1,48,Saturday,7 days,51650.107
ACC-2249586092,19,58.9,9822.56,1.0,CUS-443776336,2018-10-06,Edward,M,-32.07,115.98,,7c0ed0d1-0976-4859-9793-49e2083165a5,-31.95,141.47,NSW,Broken Hill,debit,authorized,35f18c4dfb4441a2b9f4a2361db66e7c,POS,<20,2018,10,6,9,10,Saturday,7 days,51650.107
ACC-2249586092,19,9.39,9813.17,0.0,CUS-443776336,2018-10-06,Edward,M,-32.07,115.98,,6819a43a-7439-4c9d-9178-347066d0eaf7,-31.92,115.89,WA,Inglewood,debit,authorized,64e2ef6e899d49ccb9f25559914cdf6a,SALES-POS,<20,2018,10,6,12,36,Saturday,7 days,51650.107
ACC-2249586092,19,37.0,9776.17,,CUS-443776336,2018-10-07,Edward,M,-32.07,115.98,,,,,,,debit,posted,f8db556e90ed452696f7d59ba1fd0ef9,PAYMENT,<20,2018,10,7,12,0,Sunday,7 days,51650.107
ACC-2249586092,19,31.0,10735.72,,CUS-443776336,2018-10-08,Edward,M,-32.07,115.98,,,,,,,debit,posted,98bf01d46fb34c43ad4db4a32d8cbf92,PAYMENT,<20,2018,10,8,22,0,Monday,7 days,51650.107
ACC-2249586092,19,23.18,10712.54,1.0,CUS-443776336,2018-10-09,Edward,M,-32.07,115.98,,7ea4144d-c0c4-41c3-91a6-b4eb02051a2a,-32.1,115.8,WA,Bibra Lake,debit,authorized,171b0f39b93a44998427804811e4df11,SALES-POS,<20,2018,10,9,17,36,Tuesday,7 days,51650.107
ACC-2249586092,19,61.17,10651.37,1.0,CUS-443776336,2018-10-09,Edward,M,-32.07,115.98,,95acff5e-45de-453d-9fa3-fd055412b58c,-31.87,115.86,WA,Mirrabooka,debit,authorized,6264d24f63484275984417393a3367bc,SALES-POS,<20,2018,10,9,19,17,Tuesday,7 days,51650.107
ACC-2249586092,19,22.12,10629.25,1.0,CUS-443776336,2018-10-13,Edward,M,-32.07,115.98,,20b15d3d-0122-4861-b452-a6be606f4a48,-34.93,138.6,SA,Adelaide,debit,authorized,7e9774cc1611481b99d9a5c8366ca60c,SALES-POS,<20,2018,10,13,22,52,Saturday,7 days,51650.107
ACC-2249586092,19,18.26,10610.99,1.0,CUS-443776336,2018-10-14,Edward,M,-32.07,115.98,,1ea473e9-35af-4c45-997c-b4e15ebddec8,-31.87,115.77,WA,Karrinyup,debit,authorized,b84b83a3a69342159c6cd06cb8f3d59a,SALES-POS,<20,2018,10,14,4,0,Sunday,7 days,51650.107
ACC-2249586092,19,37.0,10568.37,,CUS-443776336,2018-10-14,Edward,M,-32.07,115.98,,,,,,,debit,posted,ebbbe70e6f094a25a1a9605c96a3be00,PAYMENT,<20,2018,10,14,12,0,Sunday,7 days,51650.107
ACC-2249586092,19,5.62,10605.37,1.0,CUS-443776336,2018-10-14,Edward,M,-32.07,115.98,,79d19617-a0e2-4300-8e32-d100b1a677d0,-31.96,115.9,WA,Victoria Park,debit,authorized,157f398ca6d144b988771b4487b20f81,POS,<20,2018,10,14,12,29,Sunday,7 days,51650.107
ACC-2249586092,19,3.08,10565.29,1.0,CUS-443776336,2018-10-14,Edward,M,-32.07,115.98,,0fc42183-ae5c-43ba-ac06-7ba2e1b063d8,-32.06,115.88,WA,Willetton,debit,authorized,3efd3fb475464a51b8fb5b3341b524c5,POS,<20,2018,10,14,16,48,Sunday,7 days,51650.107
ACC-2249586092,19,31.0,11524.84,,CUS-443776336,2018-10-15,Edward,M,-32.07,115.98,,,,,,,debit,posted,b900a821768c49d7a7197d822ce92cde,PAYMENT,<20,2018,10,15,22,0,Monday,7 days,51650.107
ACC-2249586092,19,17.54,11507.3,1.0,CUS-443776336,2018-10-17,Edward,M,-32.07,115.98,,80cb0710-5597-44ba-a71c-b72ac6f2a723,-31.83,115.83,WA,Girrawheen,debit,authorized,578cc27e962e4d9ba332a10be98136f6,SALES-POS,<20,2018,10,17,12,23,Wednesday,7 days,51650.107
ACC-2249586092,19,14.1,11493.2,1.0,CUS-443776336,2018-10-17,Edward,M,-32.07,115.98,,ecb14c3a-4640-4c8e-9ed4-96ecc4dd82da,-31.89,115.76,WA,Scarborough,debit,authorized,130e554babb744cc95c0bce4d8d7044b,POS,<20,2018,10,17,14,4,Wednesday,7 days,51650.107
ACC-2249586092,19,7.26,11485.94,1.0,CUS-443776336,2018-10-18,Edward,M,-32.07,115.98,,cc425889-1174-4769-995d-a6377454401d,-31.87,115.95,WA,Beechboro,debit,authorized,069091d36fb244d89fc0e4a89f4b947f,SALES-POS,<20,2018,10,18,13,19,Thursday,7 days,51650.107
ACC-2249586092,19,37.0,11448.94,,CUS-443776336,2018-10-21,Edward,M,-32.07,115.98,,,,,,,debit,posted,37324ea0b88f472a84084b302d6984aa,PAYMENT,<20,2018,10,21,12,0,Sunday,7 days,51650.107
ACC-2249586092,19,31.0,12408.49,,CUS-443776336,2018-10-22,Edward,M,-32.07,115.98,,,,,,,debit,posted,39f4954870064edb9cf87b24021522ea,PAYMENT,<20,2018,10,22,22,0,Monday,7 days,51650.107
ACC-2249586092,19,17.05,12391.44,1.0,CUS-443776336,2018-10-23,Edward,M,-32.07,115.98,,1830374b-8ebf-475e-b329-7e76ddab2e73,-31.79,115.82,WA,Wangara,debit,authorized,77cf10326ff246aa8434e485d492585d,POS,<20,2018,10,23,10,22,Tuesday,7 days,51650.107
ACC-2249586092,19,31.86,12359.58,0.0,CUS-443776336,2018-10-23,Edward,M,-32.07,115.98,,aa2f5168-8ddd-4f07-963e-25a9eacd8729,-31.89,115.94,WA,Kiara,debit,authorized,46c405cba9da4c37b000cdcef3165f0c,POS,<20,2018,10,23,10,48,Tuesday,7 days,51650.107
ACC-2249586092,19,15.33,12344.25,1.0,CUS-443776336,2018-10-23,Edward,M,-32.07,115.98,,35f860db-ab81-4d83-827f-216d5eb95ce7,-31.9,115.85,WA,Yokine,debit,authorized,4874fa5e8efb4a279c01ef885e34f65c,POS,<20,2018,10,23,20,1,Tuesday,7 days,51650.107
ACC-2249586092,19,11.0,12333.25,0.0,CUS-443776336,2018-10-24,Edward,M,-32.07,115.98,,b96a0f57-98d5-46c7-b3ab-93e88dc8ad54,-31.88,115.81,WA,Stirling,debit,authorized,1e878988f14a45709d7ed1a76bcf2ec3,SALES-POS,<20,2018,10,24,8,27,Wednesday,7 days,51650.107
ACC-2249586092,19,14.37,12318.88,1.0,CUS-443776336,2018-10-24,Edward,M,-32.07,115.98,,3f143907-c5f5-488c-8787-03f135e1ea1f,-32.02,115.83,WA,Ardross,debit,authorized,fa671bf4a0834680abd2d431d7585903,SALES-POS,<20,2018,10,24,9,12,Wednesday,7 days,51650.107
ACC-2249586092,19,7.17,12311.71,1.0,CUS-443776336,2018-10-24,Edward,M,-32.07,115.98,,294193ff-d76e-445f-b240-dea59df2caf8,-31.94,141.47,NSW,Broken Hill,debit,authorized,de48e45e5f0d440ea227707c4ac937c0,POS,<20,2018,10,24,10,28,Wednesday,7 days,51650.107
ACC-2249586092,19,19.7,12292.01,0.0,CUS-443776336,2018-10-24,Edward,M,-32.07,115.98,,7e2d1c13-5e8b-479a-9654-a927787c2688,-31.86,115.81,WA,Balcatta,debit,authorized,bf7011fc243942eba8133ed92b854c94,POS,<20,2018,10,24,14,11,Wednesday,7 days,51650.107
ACC-2249586092,19,43.89,12248.12,1.0,CUS-443776336,2018-10-25,Edward,M,-32.07,115.98,,b35c0649-12ba-428b-a82d-09ad6bb11bdb,-31.78,115.97,WA,Ellenbrook,debit,authorized,88ebb920f1334e87afed8292b6208cb3,SALES-POS,<20,2018,10,25,20,22,Thursday,7 days,51650.107
ACC-2249586092,19,8.32,12239.8,1.0,CUS-443776336,2018-10-26,Edward,M,-32.07,115.98,,d64a5790-6114-4e1c-9e76-71e9f06677a5,-31.8,115.75,WA,Hillarys,debit,authorized,776d39ce265a466faf8f3794ff7761f0,SALES-POS,<20,2018,10,26,8,23,Friday,7 days,51650.107
ACC-2249586092,19,6.13,12233.67,1.0,CUS-443776336,2018-10-26,Edward,M,-32.07,115.98,,6cf56f91-9c53-4cfa-b945-000628ec0508,-32.07,115.83,WA,Murdoch,debit,authorized,8becdf479d5c4fc9aadcb5658b407b81,POS,<20,2018,10,26,8,49,Friday,7 days,51650.107
ACC-2249586092,19,4.72,12228.95,1.0,CUS-443776336,2018-10-26,Edward,M,-32.07,115.98,,7cdb62b5-6632-4d1d-8e28-a4d26f5cbb74,-32.11,133.67,SA,Ceduna,debit,authorized,d8dd1acc2408461d97896148946af4c3,SALES-POS,<20,2018,10,26,11,30,Friday,7 days,51650.107
ACC-2249586092,19,67.52,12161.43,1.0,CUS-443776336,2018-10-28,Edward,M,-32.07,115.98,,4f640c8c-498f-49ea-902b-cc8837e95db2,-31.87,115.86,WA,Mirrabooka,debit,authorized,e46437c74cad4b82a752e9aa2a666ef0,SALES-POS,<20,2018,10,28,11,5,Sunday,7 days,51650.107
ACC-2249586092,19,37.0,12124.43,,CUS-443776336,2018-10-28,Edward,M,-32.07,115.98,,,,,,,debit,posted,b1461c24eb4c4506a5e593dd0cb90b2b,PAYMENT,<20,2018,10,28,12,0,Sunday,7 days,51650.107
ACC-2249586092,19,19.18,12105.25,1.0,CUS-443776336,2018-10-28,Edward,M,-32.07,115.98,,7e2d1c13-5e8b-479a-9654-a927787c2688,-31.86,115.81,WA,Balcatta,debit,authorized,fd0cedcb3e544310b14b3aed43f8eeb5,POS,<20,2018,10,28,23,33,Sunday,7 days,51650.107
ACC-2249586092,19,15.64,12089.61,1.0,CUS-443776336,2018-10-29,Edward,M,-32.07,115.98,,46ec1865-cb79-4866-9189-fb757a232542,-31.95,115.86,WA,Perth,debit,authorized,b874c76b771f4d8eae4d9a152191846e,SALES-POS,<20,2018,10,29,8,55,Monday,7 days,51650.107
ACC-2249586092,19,10.15,12079.46,1.0,CUS-443776336,2018-10-29,Edward,M,-32.07,115.98,,db77dc41-4916-4739-bbd4-3136a68658fc,-32.07,116,WA,Gosnells,debit,authorized,440b265f3f474f088ef12bae8ce79317,SALES-POS,<20,2018,10,29,9,23,Monday,7 days,51650.107
ACC-2249586092,19,31.0,13039.01,,CUS-443776336,2018-10-29,Edward,M,-32.07,115.98,,,,,,,debit,posted,f647c16cde8e426d80e719017f731188,PAYMENT,<20,2018,10,29,22,0,Monday,7 days,51650.107
ACC-2249586092,19,13.69,13025.32,1.0,CUS-443776336,2018-10-30,Edward,M,-32.07,115.98,,e04a7611-573b-4a2b-a954-febef3fb597e,-32.12,133.69,SA,Ceduna,debit,authorized,3895b2fc36d040bda9687406181a45fa,SALES-POS,<20,2018,10,30,14,49,Tuesday,7 days,51650.107
ACC-2249586092,19,5.55,13019.77,1.0,CUS-443776336,2018-10-30,Edward,M,-32.07,115.98,,66a228da-1366-4c8c-927f-e42cab6fae5c,-32.07,116,WA,Gosnells,debit,authorized,b12f6f97adf141aaa708ac4a09609418,POS,<20,2018,10,30,22,41,Tuesday,7 days,51650.107
ACC-2249586092,19,9.56,13010.21,1.0,CUS-443776336,2018-10-31,Edward,M,-32.07,115.98,,37696c79-2d3e-42ef-87a6-644fce3ef0d4,-31.92,115.84,WA,Mount Hawthorn,debit,authorized,def044b8ab3b4c23a5b7d84659eebf55,POS,<20,2018,10,31,2,43,Wednesday,7 days,51650.107
ACC-2249586092,19,3.86,13006.35,0.0,CUS-443776336,2018-10-31,Edward,M,-32.07,115.98,,7aa87a90-c8b9-45e7-931b-76a55f2cfdad,-31.99,115.86,WA,South Perth,debit,authorized,725c4caf9c4c4d97829f1caa2033ed45,SALES-POS,<20,2018,10,31,8,18,Wednesday,7 days,51650.107
ACC-2249586092,19,5.42,13000.93,1.0,CUS-443776336,2018-10-31,Edward,M,-32.07,115.98,,e2ca89a0-af6b-4977-aec5-4775622aba6f,-31.87,115.86,WA,Mirrabooka,debit,authorized,e132fa94bd36443cbe846d4cba2ce1d2,POS,<20,2018,10,31,11,12,Wednesday,7 days,51650.107
ACC-2249586092,19,13.62,12987.31,1.0,CUS-443776336,2018-10-31,Edward,M,-32.07,115.98,,d026c669-4edd-4361-b370-a959d86ffb95,-32.13,115.86,WA,Success,debit,authorized,da2482e976824547b51357a8f9b76fde,SALES-POS,<20,2018,10,31,15,30,Wednesday,7 days,51650.107
ACC-2249586092,19,13.66,12973.65,1.0,CUS-443776336,2018-10-31,Edward,M,-32.07,115.98,,84fc0377-d8e7-4ebb-b93d-9ce1a2f9fb63,-31.83,115.74,WA,Hillarys,debit,authorized,c371b48d831649e8a5d2e8cee1136103,POS,<20,2018,10,31,17,8,Wednesday,7 days,51650.107
ACC-2249586092,19,9.9,12963.75,0.0,CUS-443776336,2018-10-31,Edward,M,-32.07,115.98,,23eccb68-684e-4321-b95b-dc307517c836,-31.93,115.9,WA,Maylands,debit,authorized,9c33934bede248ada7bd4126be6a167e,SALES-POS,<20,2018,10,31,19,18,Wednesday,7 days,51650.107
ACC-3827517394,28,33.45,30163.44,1.0,CUS-2663907001,2018-08-01,Craig,M,-33.89,151.12,,94f323d7-ffeb-4b35-9c10-e5670d9b7bd8,-33.9,150.99,NSW,Bass Hill,debit,authorized,bdcb34e0a5d9423089deb9a6e85e32a5,POS,20-30,2018,8,1,12,50,Wednesday,14 days,105713.646
ACC-3827517394,28,32.67,30130.77,1.0,CUS-2663907001,2018-08-02,Craig,M,-33.89,151.12,,9ff90027-5ca7-4c4a-908f-02dbcc9b699e,-33.84,151.21,NSW,Lavender Bay,debit,authorized,ae418fa9e8a344d0a86787ecdd6f9e64,POS,20-30,2018,8,2,14,27,Thursday,14 days,105713.646
ACC-3827517394,28,28.71,30102.06,1.0,CUS-2663907001,2018-08-02,Craig,M,-33.89,151.12,,f508fb74-e9e5-4f0a-bf9f-10b00516b565,-33.94,150.94,NSW,Moorebank,debit,authorized,c7bd2e1a58074decabca6bd12487e9cc,SALES-POS,20-30,2018,8,2,19,33,Thursday,14 days,105713.646
ACC-3827517394,28,45.55,30056.51,1.0,CUS-2663907001,2018-08-02,Craig,M,-33.89,151.12,,588b8957-66d1-42be-a1ac-5ecb44c2230f,-33.75,151.07,NSW,Beecroft,debit,authorized,931abdfe4c2d4aafb3c2774e6f941520,SALES-POS,20-30,2018,8,2,22,36,Thursday,14 days,105713.646
ACC-3827517394,28,124.0,29932.51,,CUS-2663907001,2018-08-03,Craig,M,-33.89,151.12,,,,,,,debit,posted,dd2eed0290054b02b837d1c3540555bf,PAYMENT,20-30,2018,8,3,4,0,Friday,14 days,105713.646
ACC-3827517394,28,65.0,29867.51,,CUS-2663907001,2018-08-03,Craig,M,-33.89,151.12,,,,,,,debit,posted,1d07bae94381414a81bf22684943673f,PAYMENT,20-30,2018,8,3,5,0,Friday,14 days,105713.646
ACC-3827517394,28,43.0,29824.51,,CUS-2663907001,2018-08-03,Craig,M,-33.89,151.12,,,,,,,debit,posted,f7e4fb6b55e34eb68052b1850b33d323,PAYMENT,20-30,2018,8,3,16,0,Friday,14 days,105713.646
ACC-3827517394,28,26.13,29798.38,1.0,CUS-2663907001,2018-08-03,Craig,M,-33.89,151.12,,51a20e13-c7c9-49dd-90f8-721fceb4869d,-33.97,150.81,NSW,Leppington,debit,authorized,eb934bdd460449f78969302679952aad,POS,20-30,2018,8,3,17,37,Friday,14 days,105713.646
ACC-3827517394,28,12.98,29785.4,1.0,CUS-2663907001,2018-08-03,Craig,M,-33.89,151.12,,3bd6a59a-b049-4f8c-8ba0-c4285f8f5319,-37.81,144.97,VIC,Melbourne,debit,authorized,7fdcbef291214e6e956a9e91bdedaf89,SALES-POS,20-30,2018,8,3,21,57,Friday,14 days,105713.646
ACC-3827517394,28,15.35,29770.05,1.0,CUS-2663907001,2018-08-04,Craig,M,-33.89,151.12,,1827d393-4034-4c80-88a5-1cd6ac9deddd,-33.76,150.99,NSW,Baulkham Hills,debit,authorized,b5677909a32a4c37af9df7ef7d29cced,POS,20-30,2018,8,4,3,51,Saturday,14 days,105713.646
ACC-3827517394,28,28.0,29742.05,,CUS-2663907001,2018-08-05,Craig,M,-33.89,151.12,,,,,,,debit,posted,eeaa81b0448640de8fd283a8a58c1a60,PAYMENT,20-30,2018,8,5,11,0,Sunday,14 days,105713.646
ACC-3827517394,28,80.0,29662.05,,CUS-2663907001,2018-08-05,Craig,M,-33.89,151.12,,,,,,,debit,posted,e089144f1347470e852942beb5a64ce6,PAYMENT,20-30,2018,8,5,23,0,Sunday,14 days,105713.646
ACC-3827517394,28,20.0,29642.05,,CUS-2663907001,2018-08-06,Craig,M,-33.89,151.12,,,,,,,debit,posted,834842e7036940489d2bd94c552121ef,PAYMENT,20-30,2018,8,6,14,0,Monday,14 days,105713.646
ACC-3827517394,28,12.66,29629.39,1.0,CUS-2663907001,2018-08-06,Craig,M,-33.89,151.12,,145ebb98-1574-4fea-8869-e4b7e0ce02f8,-33.87,150.92,NSW,Fairfield West,debit,authorized,2eb9f3af45ed4c55acb5755472996c58,SALES-POS,20-30,2018,8,6,16,47,Monday,14 days,105713.646
ACC-3827517394,28,128.0,29501.39,,CUS-2663907001,2018-08-06,Craig,M,-33.89,151.12,,,,,,,debit,posted,c6c4dbbc5efe40658415ca5f8c58acac,PAYMENT,20-30,2018,8,6,17,0,Monday,14 days,105713.646
ACC-3827517394,28,30.0,29471.39,,CUS-2663907001,2018-08-07,Craig,M,-33.89,151.12,,,,,,,debit,posted,6e3a8dfc597245269e7904f25fae8536,PAYMENT,20-30,2018,8,7,4,0,Tuesday,14 days,105713.646
ACC-3827517394,28,29.0,29442.39,,CUS-2663907001,2018-08-07,Craig,M,-33.89,151.12,,,,,,,debit,posted,99607fc9460344399a7a1a290ba3fee5,INTER BANK,20-30,2018,8,7,9,0,Tuesday,14 days,105713.646
ACC-3827517394,28,158.0,29284.39,,CUS-2663907001,2018-08-08,Craig,M,-33.89,151.12,,,,,,,debit,posted,7af36f1d2a374540af3b01a73c1d938e,PAYMENT,20-30,2018,8,8,17,0,Wednesday,14 days,105713.646
ACC-3827517394,28,148.0,29136.39,,CUS-2663907001,2018-08-09,Craig,M,-33.89,151.12,,,,,,,debit,posted,bb5e21335bb54c87b958529beb455590,PAYMENT,20-30,2018,8,9,12,0,Thursday,14 days,105713.646
ACC-3827517394,28,65.0,29071.39,,CUS-2663907001,2018-08-10,Craig,M,-33.89,151.12,,,,,,,debit,posted,d044700081d241c299586b3d06391ed2,PAYMENT,20-30,2018,8,10,5,0,Friday,14 days,105713.646
ACC-3827517394,28,43.0,29028.39,,CUS-2663907001,2018-08-10,Craig,M,-33.89,151.12,,,,,,,debit,posted,3e890a0f657f4c29a6842748c6f9a37f,PAYMENT,20-30,2018,8,10,16,0,Friday,14 days,105713.646
ACC-3827517394,28,28.0,29000.39,,CUS-2663907001,2018-08-12,Craig,M,-33.89,151.12,,,,,,,debit,posted,e4977d4685594d7f96d9dd314841c1fe,PAYMENT,20-30,2018,8,12,11,0,Sunday,14 days,105713.646
ACC-3827517394,28,20.0,28980.39,,CUS-2663907001,2018-08-13,Craig,M,-33.89,151.12,,,,,,,debit,posted,433253ecf2ce4610aaccd34f6fcd31b4,PAYMENT,20-30,2018,8,13,14,0,Monday,14 days,105713.646
ACC-3827517394,28,30.0,33005.16,,CUS-2663907001,2018-08-14,Craig,M,-33.89,151.12,,,,,,,debit,posted,deffcc48929449c0b1a78babfa3e23ea,PAYMENT,20-30,2018,8,14,4,0,Tuesday,14 days,105713.646
ACC-3827517394,28,29.0,32976.16,,CUS-2663907001,2018-08-14,Craig,M,-33.89,151.12,,,,,,,debit,posted,ef70be433e9c43478600647e00a655c4,INTER BANK,20-30,2018,8,14,9,0,Tuesday,14 days,105713.646
ACC-3827517394,28,65.0,32911.16,,CUS-2663907001,2018-08-17,Craig,M,-33.89,151.12,,,,,,,debit,posted,0d73bb10ab8e44cc85e376ed54ad7366,PAYMENT,20-30,2018,8,17,5,0,Friday,14 days,105713.646
ACC-3827517394,28,43.0,32868.16,,CUS-2663907001,2018-08-17,Craig,M,-33.89,151.12,,,,,,,debit,posted,e11ccc37f8d04357b7a104bce86746bc,PAYMENT,20-30,2018,8,17,16,0,Friday,14 days,105713.646
ACC-3827517394,28,83.0,32785.16,,CUS-2663907001,2018-08-17,Craig,M,-33.89,151.12,,,,,,,debit,posted,c3d199e8de114353b6d1b0341833c053,PAYMENT,20-30,2018,8,17,17,0,Friday,14 days,105713.646
ACC-3827517394,28,28.0,32757.16,,CUS-2663907001,2018-08-19,Craig,M,-33.89,151.12,,,,,,,debit,posted,35a51afb51e1417f97bc919c83aa2f7e,PAYMENT,20-30,2018,8,19,11,0,Sunday,14 days,105713.646
ACC-3827517394,28,20.0,32737.16,,CUS-2663907001,2018-08-20,Craig,M,-33.89,151.12,,,,,,,debit,posted,73901b44ee684cdd8a3868ecfb9e3bda,PAYMENT,20-30,2018,8,20,14,0,Monday,14 days,105713.646
ACC-3827517394,28,30.0,32707.16,,CUS-2663907001,2018-08-21,Craig,M,-33.89,151.12,,,,,,,debit,posted,5c89ea77c64349898c5a6786e1d838ed,PAYMENT,20-30,2018,8,21,4,0,Tuesday,14 days,105713.646
ACC-3827517394,28,29.0,32678.16,,CUS-2663907001,2018-08-21,Craig,M,-33.89,151.12,,,,,,,debit,posted,8a7971a2e4da4c72ba0c95d44ed2d6ce,INTER BANK,20-30,2018,8,21,9,0,Tuesday,14 days,105713.646
ACC-3827517394,28,65.0,32613.16,,CUS-2663907001,2018-08-24,Craig,M,-33.89,151.12,,,,,,,debit,posted,05ab725a0ed84a97bb4429ffe2795d61,PAYMENT,20-30,2018,8,24,5,0,Friday,14 days,105713.646
ACC-3827517394,28,43.0,32570.16,,CUS-2663907001,2018-08-24,Craig,M,-33.89,151.12,,,,,,,debit,posted,8b88b0dd652b4e538d6eac9a2bad8141,PAYMENT,20-30,2018,8,24,16,0,Friday,14 days,105713.646
ACC-3827517394,28,28.0,32542.16,,CUS-2663907001,2018-08-26,Craig,M,-33.89,151.12,,,,,,,debit,posted,fdf0e08f4dd64c6da4df351dd0818a36,PAYMENT,20-30,2018,8,26,11,0,Sunday,14 days,105713.646
ACC-3827517394,28,20.0,32522.16,,CUS-2663907001,2018-08-27,Craig,M,-33.89,151.12,,,,,,,debit,posted,df04612bd2f84f7092169bc3039ad26f,PAYMENT,20-30,2018,8,27,14,0,Monday,14 days,105713.646
ACC-3827517394,28,30.0,36546.93,,CUS-2663907001,2018-08-28,Craig,M,-33.89,151.12,,,,,,,debit,posted,10fca34506b24415bba4ea03792150be,PAYMENT,20-30,2018,8,28,4,0,Tuesday,14 days,105713.646
ACC-3827517394,28,29.0,36517.93,,CUS-2663907001,2018-08-28,Craig,M,-33.89,151.12,,,,,,,debit,posted,90fedccb06eb4423941f953667a6edaa,INTER BANK,20-30,2018,8,28,9,0,Tuesday,14 days,105713.646
ACC-3827517394,28,65.0,36452.93,,CUS-2663907001,2018-08-31,Craig,M,-33.89,151.12,,,,,,,debit,posted,9e37487ec90f47a68fadc7b0d384f6c5,PAYMENT,20-30,2018,8,31,5,0,Friday,14 days,105713.646
ACC-3827517394,28,43.0,36409.93,,CUS-2663907001,2018-08-31,Craig,M,-33.89,151.12,,,,,,,debit,posted,2d91b48aaeec4b748cfb5c5a175499d3,PAYMENT,20-30,2018,8,31,16,0,Friday,14 days,105713.646
ACC-3827517394,28,28.0,36381.93,,CUS-2663907001,2018-09-02,Craig,M,-33.89,151.12,,,,,,,debit,posted,fdbca1f0cf9d4f1fb332b941168a19c5,PAYMENT,20-30,2018,9,2,11,0,Sunday,14 days,105713.646
ACC-3827517394,28,124.0,36257.93,,CUS-2663907001,2018-09-03,Craig,M,-33.89,151.12,,,,,,,debit,posted,f91f09d7f5e644589071a6dfdeb8f1aa,PAYMENT,20-30,2018,9,3,4,0,Monday,14 days,105713.646
ACC-3827517394,28,20.0,36237.93,,CUS-2663907001,2018-09-03,Craig,M,-33.89,151.12,,,,,,,debit,posted,8508847de9334ca9bf546735bc37b150,PAYMENT,20-30,2018,9,3,14,0,Monday,14 days,105713.646
ACC-3827517394,28,30.0,36207.93,,CUS-2663907001,2018-09-04,Craig,M,-33.89,151.12,,,,,,,debit,posted,de61e14a3e2049f8aad6838b83ab49d0,PAYMENT,20-30,2018,9,4,4,0,Tuesday,14 days,105713.646
ACC-3827517394,28,29.0,36178.93,,CUS-2663907001,2018-09-04,Craig,M,-33.89,151.12,,,,,,,debit,posted,7977145690f544c9a9f0f766ce5b09ed,INTER BANK,20-30,2018,9,4,9,0,Tuesday,14 days,105713.646
ACC-3827517394,28,80.0,36098.93,,CUS-2663907001,2018-09-05,Craig,M,-33.89,151.12,,,,,,,debit,posted,1801cba5bac144a09b3f6d83f5aff24f,PAYMENT,20-30,2018,9,5,23,0,Wednesday,14 days,105713.646
ACC-3827517394,28,128.0,35970.93,,CUS-2663907001,2018-09-06,Craig,M,-33.89,151.12,,,,,,,debit,posted,f4bbf1d831074d8f8bcbb50bbf047ef7,PAYMENT,20-30,2018,9,6,17,0,Thursday,14 days,105713.646
ACC-3827517394,28,65.0,35905.93,,CUS-2663907001,2018-09-07,Craig,M,-33.89,151.12,,,,,,,debit,posted,aa10313134e74e1a91a48f2acc64afed,PAYMENT,20-30,2018,9,7,5,0,Friday,14 days,105713.646
ACC-3827517394,28,43.0,35862.93,,CUS-2663907001,2018-09-07,Craig,M,-33.89,151.12,,,,,,,debit,posted,28bfce731ec34d0499ae2e0f9cb47444,PAYMENT,20-30,2018,9,7,16,0,Friday,14 days,105713.646
ACC-3827517394,28,158.0,35704.93,,CUS-2663907001,2018-09-08,Craig,M,-33.89,151.12,,,,,,,debit,posted,42def094cba24b0e94ea01721acd6a75,PAYMENT,20-30,2018,9,8,17,0,Saturday,14 days,105713.646
ACC-3827517394,28,28.0,35676.93,,CUS-2663907001,2018-09-09,Craig,M,-33.89,151.12,,,,,,,debit,posted,9025d81b4251489d86db8b9ae07a183f,PAYMENT,20-30,2018,9,9,11,0,Sunday,14 days,105713.646
ACC-3827517394,28,148.0,35528.93,,CUS-2663907001,2018-09-09,Craig,M,-33.89,151.12,,,,,,,debit,posted,8f5aee00c10745f1900e2b26648edf52,PAYMENT,20-30,2018,9,9,12,0,Sunday,14 days,105713.646
ACC-3827517394,28,20.0,35508.93,,CUS-2663907001,2018-09-10,Craig,M,-33.89,151.12,,,,,,,debit,posted,f47c97a55ec54c74a5a627f3d7309cdc,PAYMENT,20-30,2018,9,10,14,0,Monday,14 days,105713.646
ACC-3827517394,28,30.0,39533.7,,CUS-2663907001,2018-09-11,Craig,M,-33.89,151.12,,,,,,,debit,posted,ca206b2048694798ae1bcaee9bffe079,PAYMENT,20-30,2018,9,11,4,0,Tuesday,14 days,105713.646
ACC-3827517394,28,29.0,39504.7,,CUS-2663907001,2018-09-11,Craig,M,-33.89,151.12,,,,,,,debit,posted,572827f93aa744cfa5b94b213aee8166,INTER BANK,20-30,2018,9,11,9,0,Tuesday,14 days,105713.646
ACC-3827517394,28,367.97,39136.73,0.0,CUS-2663907001,2018-09-13,Craig,M,-33.89,151.12,,0734a330-077f-4317-8d28-120f632d6358,-33.89,151.25,NSW,Bondi Junction,debit,authorized,05d024479b664d27a33daaf8f17fe3ff,SALES-POS,20-30,2018,9,13,12,23,Thursday,14 days,105713.646
ACC-3827517394,28,65.0,39071.73,,CUS-2663907001,2018-09-14,Craig,M,-33.89,151.12,,,,,,,debit,posted,d224d1c63e854ec7bc52fde751ca89e8,PAYMENT,20-30,2018,9,14,5,0,Friday,14 days,105713.646
ACC-3827517394,28,43.0,39028.73,,CUS-2663907001,2018-09-14,Craig,M,-33.89,151.12,,,,,,,debit,posted,6a362439ca6443368653e84dc5595528,PAYMENT,20-30,2018,9,14,16,0,Friday,14 days,105713.646
ACC-3827517394,28,25.25,39003.48,1.0,CUS-2663907001,2018-09-15,Craig,M,-33.89,151.12,,0b4b5cb5-ced8-443e-b4ff-b472bdf7fe88,-33.75,151.28,NSW,Dee Why,debit,authorized,91c48444dab14d2caef6e97a0e6c8f36,POS,20-30,2018,9,15,22,51,Saturday,14 days,105713.646
ACC-3827517394,28,28.0,38975.48,,CUS-2663907001,2018-09-16,Craig,M,-33.89,151.12,,,,,,,debit,posted,1a1c45ac77d94c5583e5c2267df9cd9e,PAYMENT,20-30,2018,9,16,11,0,Sunday,14 days,105713.646
ACC-3827517394,28,100.98,38874.5,1.0,CUS-2663907001,2018-09-16,Craig,M,-33.89,151.12,,a7362ad4-39ad-40ed-a2c8-646ae8b1568d,-37.83,144.95,VIC,South Melbourne,debit,authorized,1dcdc19bec79469686e5fecc3b3b9004,POS,20-30,2018,9,16,15,18,Sunday,14 days,105713.646
ACC-3827517394,28,52.24,38822.26,1.0,CUS-2663907001,2018-09-16,Craig,M,-33.89,151.12,,23abf7ff-db5f-494a-8ce3-6e9ff91bb015,-33.86,151.21,NSW,The Rocks,debit,authorized,6819be3294a443ed8ffbfeee442b9d5c,SALES-POS,20-30,2018,9,16,20,34,Sunday,14 days,105713.646
ACC-3827517394,28,33.19,38789.07,1.0,CUS-2663907001,2018-09-17,Craig,M,-33.89,151.12,,6b781c0f-f842-48cb-832d-84dcabfa85d9,-33.91,151.08,NSW,Belmore,debit,authorized,140a89baaa384c3ca8638f928d9aa5d5,SALES-POS,20-30,2018,9,17,13,21,Monday,14 days,105713.646
ACC-3827517394,28,20.0,38769.07,,CUS-2663907001,2018-09-17,Craig,M,-33.89,151.12,,,,,,,debit,posted,ea93bec8e45445228a8de2a3853cdc6e,PAYMENT,20-30,2018,9,17,14,0,Monday,14 days,105713.646
ACC-3827517394,28,40.64,38728.43,1.0,CUS-2663907001,2018-09-17,Craig,M,-33.89,151.12,,b9bf4b14-deb0-460e-b1eb-24fb03b09176,-33.89,151.16,NSW,Leichhardt,debit,authorized,59196be69c474b7796c106242a14f4ee,SALES-POS,20-30,2018,9,17,15,41,Monday,14 days,105713.646
ACC-3827517394,28,83.0,38645.43,,CUS-2663907001,2018-09-17,Craig,M,-33.89,151.12,,,,,,,debit,posted,2f0397d5d8ec41d7b6ff10d8d811521c,PAYMENT,20-30,2018,9,17,17,0,Monday,14 days,105713.646
ACC-3827517394,28,30.0,38615.43,,CUS-2663907001,2018-09-18,Craig,M,-33.89,151.12,,,,,,,debit,posted,fb934310117b4f648e6ded458cad072c,PAYMENT,20-30,2018,9,18,4,0,Tuesday,14 days,105713.646
ACC-3827517394,28,29.0,38586.43,,CUS-2663907001,2018-09-18,Craig,M,-33.89,151.12,,,,,,,debit,posted,e4c60a3160b848768c70551248b052bf,INTER BANK,20-30,2018,9,18,9,0,Tuesday,14 days,105713.646
ACC-3827517394,28,65.0,38521.43,,CUS-2663907001,2018-09-21,Craig,M,-33.89,151.12,,,,,,,debit,posted,ff3ef44dd1e04007b7c9dfdb76d47ac1,PAYMENT,20-30,2018,9,21,5,0,Friday,14 days,105713.646
ACC-3827517394,28,43.0,38478.43,,CUS-2663907001,2018-09-21,Craig,M,-33.89,151.12,,,,,,,debit,posted,85c477c615664ddfba7dd28caad64f57,PAYMENT,20-30,2018,9,21,16,0,Friday,14 days,105713.646
ACC-3827517394,28,28.0,38450.43,,CUS-2663907001,2018-09-23,Craig,M,-33.89,151.12,,,,,,,debit,posted,3ab41c6b27064834a765dc54a3bc51bc,PAYMENT,20-30,2018,9,23,11,0,Sunday,14 days,105713.646
ACC-3827517394,28,59.94,38390.49,0.0,CUS-2663907001,2018-09-24,Craig,M,-33.89,151.12,,0f7b7046-3b3e-426c-b6d7-1ad40cd20136,-33.89,151.27,NSW,Bondi Beach,debit,authorized,51bb926817fc424f8c1912577f7af024,POS,20-30,2018,9,24,10,30,Monday,14 days,105713.646
ACC-3827517394,28,20.0,38370.49,,CUS-2663907001,2018-09-24,Craig,M,-33.89,151.12,,,,,,,debit,posted,cb43003f699a4d8dba12b94849bace02,PAYMENT,20-30,2018,9,24,14,0,Monday,14 days,105713.646
ACC-3827517394,28,30.0,42395.26,,CUS-2663907001,2018-09-25,Craig,M,-33.89,151.12,,,,,,,debit,posted,2c2582ebb79443edabdf20365d349735,PAYMENT,20-30,2018,9,25,4,0,Tuesday,14 days,105713.646
ACC-3827517394,28,29.0,42366.26,,CUS-2663907001,2018-09-25,Craig,M,-33.89,151.12,,,,,,,debit,posted,1bb9db8161884120b7fba6d9a6349016,INTER BANK,20-30,2018,9,25,9,0,Tuesday,14 days,105713.646
ACC-3827517394,28,15.43,42350.83,1.0,CUS-2663907001,2018-09-26,Craig,M,-33.89,151.12,,e597c518-a64e-4091-a7a2-0bf8bc8e7159,-33.96,116.14,WA,Bridgetown,debit,authorized,8ea260c17ec149239157403c765d26a6,SALES-POS,20-30,2018,9,26,0,57,Wednesday,14 days,105713.646
ACC-3827517394,28,10.13,42340.7,1.0,CUS-2663907001,2018-09-27,Craig,M,-33.89,151.12,,e4926391-0c44-4a02-9c75-84ec852b07d3,-33.94,151.22,NSW,Eastgardens,debit,authorized,1c28bc96e1b04c6d9b7443c9614ee09f,SALES-POS,20-30,2018,9,27,13,8,Thursday,14 days,105713.646
ACC-3827517394,28,13.7,42327.0,1.0,CUS-2663907001,2018-09-27,Craig,M,-33.89,151.12,,a4290b89-c491-4c39-97fe-f2ca8b33a0ba,-33.75,151.29,NSW,Dee Why,debit,authorized,125ba29ab9bb4643b344d71444419c55,SALES-POS,20-30,2018,9,27,16,38,Thursday,14 days,105713.646
ACC-3827517394,28,12.19,42314.81,1.0,CUS-2663907001,2018-09-27,Craig,M,-33.89,151.12,,773e8382-8a90-4328-8d3e-38377a91d0a1,-33.94,151.17,NSW,Mascot,debit,authorized,52a752faf191498fadec7450bbd772de,SALES-POS,20-30,2018,9,27,22,51,Thursday,14 days,105713.646
ACC-3827517394,28,65.0,42249.81,,CUS-2663907001,2018-09-28,Craig,M,-33.89,151.12,,,,,,,debit,posted,28b32bdd5206429da79e331efa6fcd4c,PAYMENT,20-30,2018,9,28,5,0,Friday,14 days,105713.646
ACC-3827517394,28,16.91,42232.9,1.0,CUS-2663907001,2018-09-28,Craig,M,-33.89,151.12,,b321f2b6-4936-4b53-881e-4f1852acd67c,-33.82,151.19,NSW,Artarmon,debit,authorized,9d87c591d40a449da1ec1b2416f8c8af,POS,20-30,2018,9,28,9,30,Friday,14 days,105713.646
ACC-3827517394,28,43.0,42189.9,,CUS-2663907001,2018-09-28,Craig,M,-33.89,151.12,,,,,,,debit,posted,1cc05af223ba47f1a8f3de9ae7b75888,PAYMENT,20-30,2018,9,28,16,0,Friday,14 days,105713.646
ACC-3827517394,28,39.01,42150.89,1.0,CUS-2663907001,2018-09-28,Craig,M,-33.89,151.12,,7b804a37-65d8-4ccd-b30a-e51bbfe8595f,-33.81,151.15,NSW,Lane Cove West,debit,authorized,f2d0eb8ee78f4c7f8df20300174e964f,SALES-POS,20-30,2018,9,28,21,22,Friday,14 days,105713.646
ACC-3827517394,28,48.12,42102.77,1.0,CUS-2663907001,2018-09-28,Craig,M,-33.89,151.12,,1436f75c-c5a5-4d98-8d62-dca05f37ddbc,-33.83,151.24,NSW,Mosman,debit,authorized,6f497a3e3e3a4cdf90bf372390703d66,POS,20-30,2018,9,28,22,23,Friday,14 days,105713.646
ACC-3827517394,28,9.3,42093.47,1.0,CUS-2663907001,2018-09-28,Craig,M,-33.89,151.12,,8213e3af-7b48-4dde-8541-a1f7a0e5030d,-33.97,151.11,NSW,Hurstville,debit,authorized,6b68652e1a8b4d8a910cbec79c13ff14,POS,20-30,2018,9,28,23,8,Friday,14 days,105713.646
ACC-3827517394,28,9.69,42083.78,0.0,CUS-2663907001,2018-09-29,Craig,M,-33.89,151.12,,0f28e5da-0266-480b-8c72-c6e743128a95,-33.8,151.18,NSW,Chatswood,debit,authorized,d35925c9f5964730aa04d5de37816365,SALES-POS,20-30,2018,9,29,2,47,Saturday,14 days,105713.646
ACC-3827517394,28,102.62,41981.16,1.0,CUS-2663907001,2018-09-29,Craig,M,-33.89,151.12,,273287b0-7afc-4b7c-a0b4-ad68746be75b,-34.03,138.69,SA,Auburn,debit,authorized,06d1204629724ec380fb4643a79ba868,SALES-POS,20-30,2018,9,29,21,7,Saturday,14 days,105713.646
ACC-3827517394,28,28.0,41953.16,,CUS-2663907001,2018-09-30,Craig,M,-33.89,151.12,,,,,,,debit,posted,e1cfb2d281eb4271a0ad9df181ff6e21,PAYMENT,20-30,2018,9,30,11,0,Sunday,14 days,105713.646
ACC-3827517394,28,45.34,41907.82,1.0,CUS-2663907001,2018-10-01,Craig,M,-33.89,151.12,,c9dfa914-365a-4484-a67c-5e5566f3ed2b,-33.87,151.21,NSW,Sydney,debit,authorized,0d6278e691724e01876c4956c4537083,SALES-POS,20-30,2018,10,1,8,57,Monday,14 days,105713.646
ACC-3827517394,28,20.0,41887.82,,CUS-2663907001,2018-10-01,Craig,M,-33.89,151.12,,,,,,,debit,posted,1967e3a2acd34eed8b83bf2b073cf2f6,PAYMENT,20-30,2018,10,1,14,0,Monday,14 days,105713.646
ACC-3827517394,28,30.0,41857.82,,CUS-2663907001,2018-10-02,Craig,M,-33.89,151.12,,,,,,,debit,posted,b788a30e60354817a69af094d48a98c4,PAYMENT,20-30,2018,10,2,4,0,Tuesday,14 days,105713.646
ACC-3827517394,28,29.0,41828.82,,CUS-2663907001,2018-10-02,Craig,M,-33.89,151.12,,,,,,,debit,posted,fe07a390d9c24571b40b05a015a3875d,INTER BANK,20-30,2018,10,2,9,0,Tuesday,14 days,105713.646
ACC-3827517394,28,124.0,41704.82,,CUS-2663907001,2018-10-03,Craig,M,-33.89,151.12,,,,,,,debit,posted,bbab9e6c35294eb69c8ded7a5551d712,PAYMENT,20-30,2018,10,3,4,0,Wednesday,14 days,105713.646
ACC-3827517394,28,34.85,41669.97,1.0,CUS-2663907001,2018-10-03,Craig,M,-33.89,151.12,,a7c7db24-c090-411c-b5df-92eaff28c02d,-33.79,151.2,NSW,Chatswood,debit,authorized,6e3aff3cd1794f42a8c83e5f4cb67108,SALES-POS,20-30,2018,10,3,8,3,Wednesday,14 days,105713.646
ACC-3827517394,28,48.99,41620.98,1.0,CUS-2663907001,2018-10-03,Craig,M,-33.89,151.12,,e3a92a7a-0c39-4461-8899-25fb8a3843c2,-33.88,151.19,NSW,Ultimo,debit,authorized,87d91a5754d74597a8f27b1f8a84b027,POS,20-30,2018,10,3,9,1,Wednesday,14 days,105713.646
ACC-3827517394,28,17.85,41603.13,0.0,CUS-2663907001,2018-10-03,Craig,M,-33.89,151.12,,9d3c52cd-6479-45c6-b550-c99c23112624,-33.96,137.71,SA,Kadina,debit,authorized,4fcc75a34463489aafebe706baa3eb92,POS,20-30,2018,10,3,9,27,Wednesday,14 days,105713.646
ACC-3827517394,28,62.46,41540.67,1.0,CUS-2663907001,2018-10-03,Craig,M,-33.89,151.12,,206bca44-7810-4825-b7b5-e9cb33f06367,-33.75,151.24,NSW,Beacon Hill,debit,authorized,e5e5c58211524ddfbe8e19d309d03e76,SALES-POS,20-30,2018,10,3,14,2,Wednesday,14 days,105713.646
ACC-3827517394,28,17.32,41523.35,1.0,CUS-2663907001,2018-10-04,Craig,M,-33.89,151.12,,c7ff0b62-ec5e-4ebc-acb6-05224240d17d,-33.74,151.21,NSW,Belrose,debit,authorized,94e26ddbc5e94b19a968ed4f36e35c49,SALES-POS,20-30,2018,10,4,9,30,Thursday,14 days,105713.646
ACC-3827517394,28,6.95,41516.4,1.0,CUS-2663907001,2018-10-04,Craig,M,-33.89,151.12,,5e00d5c7-4d83-4c44-8195-c338fc304edf,-33.88,151.22,NSW,Surry Hills,debit,authorized,fe77a89ca79e493bb89b851974d48a79,POS,20-30,2018,10,4,23,26,Thursday,14 days,105713.646
ACC-3827517394,28,19.41,41496.99,1.0,CUS-2663907001,2018-10-05,Craig,M,-33.89,151.12,,0802ca3e-f173-4d5f-9018-a5c4989abbb8,-33.83,151.2,NSW,Crows Nest,debit,authorized,669a72c71892407581c5e3ddaa623467,SALES-POS,20-30,2018,10,5,4,18,Friday,14 days,105713.646
ACC-3827517394,28,65.0,41431.99,,CUS-2663907001,2018-10-05,Craig,M,-33.89,151.12,,,,,,,debit,posted,44beadb1329f4c4dac826f8d75aff7f3,PAYMENT,20-30,2018,10,5,5,0,Friday,14 days,105713.646
ACC-3827517394,28,43.0,41388.99,,CUS-2663907001,2018-10-05,Craig,M,-33.89,151.12,,,,,,,debit,posted,8c1df2a8adf54ec9b5ba61882f557a44,PAYMENT,20-30,2018,10,5,16,0,Friday,14 days,105713.646
ACC-3827517394,28,80.0,41308.99,,CUS-2663907001,2018-10-05,Craig,M,-33.89,151.12,,,,,,,debit,posted,97549f99d2104d15bde7235a114316c6,PAYMENT,20-30,2018,10,5,23,0,Friday,14 days,105713.646
ACC-3827517394,28,128.0,41180.99,,CUS-2663907001,2018-10-06,Craig,M,-33.89,151.12,,,,,,,debit,posted,291056ba17f9450d945f8a8d40cc8139,PAYMENT,20-30,2018,10,6,17,0,Saturday,14 days,105713.646
ACC-3827517394,28,28.0,41152.99,,CUS-2663907001,2018-10-07,Craig,M,-33.89,151.12,,,,,,,debit,posted,8068aa1433d045619174b1397ce72571,PAYMENT,20-30,2018,10,7,11,0,Sunday,14 days,105713.646
ACC-3827517394,28,20.0,41132.99,,CUS-2663907001,2018-10-08,Craig,M,-33.89,151.12,,,,,,,debit,posted,448512e3afbb4c959cca7d457f1d5647,PAYMENT,20-30,2018,10,8,14,0,Monday,14 days,105713.646
ACC-3827517394,28,158.0,45029.76,,CUS-2663907001,2018-10-08,Craig,M,-33.89,151.12,,,,,,,debit,posted,13c74a2c8fb441d78e55930e8125a124,PAYMENT,20-30,2018,10,8,17,0,Monday,14 days,105713.646
ACC-3827517394,28,30.0,44999.76,,CUS-2663907001,2018-10-09,Craig,M,-33.89,151.12,,,,,,,debit,posted,8881e6ea428847d7a6f88eaae2c6818d,PAYMENT,20-30,2018,10,9,4,0,Tuesday,14 days,105713.646
ACC-3827517394,28,29.0,44970.76,,CUS-2663907001,2018-10-09,Craig,M,-33.89,151.12,,,,,,,debit,posted,1d0f5ab1423d42fa900485ee721a4b2c,INTER BANK,20-30,2018,10,9,9,0,Tuesday,14 days,105713.646
ACC-3827517394,28,148.0,44822.76,,CUS-2663907001,2018-10-09,Craig,M,-33.89,151.12,,,,,,,debit,posted,d8acaa70ac7f4c568d5d8ae1965647ba,PAYMENT,20-30,2018,10,9,12,0,Tuesday,14 days,105713.646
ACC-3827517394,28,20.6,44802.16,1.0,CUS-2663907001,2018-10-10,Craig,M,-33.89,151.12,,142d45ab-8d51-47d2-87ad-cb2bbf7e23fc,-33.95,115.07,WA,Margaret River,debit,authorized,9bffb153e62345859fbeeaabf52fe058,SALES-POS,20-30,2018,10,10,9,23,Wednesday,14 days,105713.646
ACC-3827517394,28,38.91,44763.25,0.0,CUS-2663907001,2018-10-10,Craig,M,-33.89,151.12,,176a01ec-0cd5-4763-88e5-563d120ed7ad,-27.47,153.02,QLD,Brisbane City,debit,authorized,bb837bb14c8042d4ab0a36c6b4731806,POS,20-30,2018,10,10,11,1,Wednesday,14 days,105713.646
ACC-3827517394,28,14.65,44748.6,1.0,CUS-2663907001,2018-10-10,Craig,M,-33.89,151.12,,40ad329f-8756-4c30-97dd-6520bcae8a9b,-33.91,150.92,NSW,Liverpool,debit,authorized,e987cf45de4b430b8f27b15d6b374f36,POS,20-30,2018,10,10,11,13,Wednesday,14 days,105713.646
ACC-3827517394,28,65.0,44683.6,,CUS-2663907001,2018-10-12,Craig,M,-33.89,151.12,,,,,,,debit,posted,03a4c5a20cc543ba92b11be8d5f2478b,PAYMENT,20-30,2018,10,12,5,0,Friday,14 days,105713.646
ACC-3827517394,28,32.02,44651.58,0.0,CUS-2663907001,2018-10-12,Craig,M,-33.89,151.12,,21603b4d-9cda-4f32-9447-29155866c545,-33.68,151.3,NSW,Mona Vale,debit,authorized,23a5d2d167724716b8098d0b98ae5e0f,SALES-POS,20-30,2018,10,12,13,18,Friday,14 days,105713.646
ACC-3827517394,28,43.0,44608.58,,CUS-2663907001,2018-10-12,Craig,M,-33.89,151.12,,,,,,,debit,posted,866157feb7914d39844b05a0d6ce228e,PAYMENT,20-30,2018,10,12,16,0,Friday,14 days,105713.646
ACC-3827517394,28,34.99,44573.59,1.0,CUS-2663907001,2018-10-13,Craig,M,-33.89,151.12,,ac6123d5-7a69-4fd0-836f-d9a76a8c42e9,-33.82,151.24,NSW,Mosman,debit,authorized,0a1e915dd9c84e5f9fd0281d1f9062e6,SALES-POS,20-30,2018,10,13,3,7,Saturday,14 days,105713.646
ACC-3827517394,28,7.79,44565.8,1.0,CUS-2663907001,2018-10-14,Craig,M,-33.89,151.12,,fb24053d-5522-4646-bdc7-71130114e96c,-33.8,151.18,NSW,Chatswood,debit,authorized,b817f17a77ac4353999e47463c97f5a5,POS,20-30,2018,10,14,4,31,Sunday,14 days,105713.646
ACC-3827517394,28,21.03,44544.77,1.0,CUS-2663907001,2018-10-14,Craig,M,-33.89,151.12,,f60c5da7-4777-45fd-a7cc-a7e875124a61,-33.91,151.11,NSW,Canterbury,debit,authorized,c37f2d1c19a04d5e8adeabb85f736fe4,POS,20-30,2018,10,14,9,58,Sunday,14 days,105713.646
ACC-3827517394,28,28.0,44501.42,,CUS-2663907001,2018-10-14,Craig,M,-33.89,151.12,,,,,,,debit,posted,e15bd2fe0b8d4f5196aea5de5f231c00,PAYMENT,20-30,2018,10,14,11,0,Sunday,14 days,105713.646
ACC-3827517394,28,15.35,44529.42,1.0,CUS-2663907001,2018-10-14,Craig,M,-33.89,151.12,,073720e7-ba74-49ce-b6a4-ac273edf39e0,-33.77,150.62,NSW,Glenbrook,debit,authorized,9b11c7c5240c477a8e35ec91876bbe46,SALES-POS,20-30,2018,10,14,11,58,Sunday,14 days,105713.646
ACC-3827517394,28,172.47,44328.95,1.0,CUS-2663907001,2018-10-14,Craig,M,-33.89,151.12,,2b8b566b-c2dc-4d09-adac-7a0d60e6729c,-33.8,150.98,NSW,Westmead,debit,authorized,b1d740835f024cf9aa75a9d89d2a47d3,SALES-POS,20-30,2018,10,14,15,5,Sunday,14 days,105713.646
ACC-3827517394,28,28.45,44300.5,1.0,CUS-2663907001,2018-10-14,Craig,M,-33.89,151.12,,ea4860ef-a70b-4db6-aa69-99fcaa697db8,-33.81,151.09,NSW,West Ryde,debit,authorized,77ca4907368e4e6c9da2a114312a4d18,SALES-POS,20-30,2018,10,14,15,14,Sunday,14 days,105713.646
ACC-3827517394,28,23.68,44276.82,1.0,CUS-2663907001,2018-10-14,Craig,M,-33.89,151.12,,176c6ba1-335b-40a6-9598-7584bc0b1e17,-33.67,149.78,NSW,Mayfield,debit,authorized,d468ee96a12940be9d8664529042b719,SALES-POS,20-30,2018,10,14,21,25,Sunday,14 days,105713.646
ACC-3827517394,28,9.46,44267.36,0.0,CUS-2663907001,2018-10-14,Craig,M,-33.89,151.12,,18799c68-dbe9-48d1-a398-91faf098eecb,-33.87,151.21,NSW,Sydney,debit,authorized,8f3cc16ab07f4450b9bfc2b7246684ff,SALES-POS,20-30,2018,10,14,21,42,Sunday,14 days,105713.646
ACC-3827517394,28,20.0,44247.36,,CUS-2663907001,2018-10-15,Craig,M,-33.89,151.12,,,,,,,debit,posted,a4437cf8f19343dda151d284e3ba8132,PAYMENT,20-30,2018,10,15,14,0,Monday,14 days,105713.646
ACC-3827517394,28,30.0,44217.36,,CUS-2663907001,2018-10-16,Craig,M,-33.89,151.12,,,,,,,debit,posted,64fa8337fe4a4b3a860a97e3216a6255,PAYMENT,20-30,2018,10,16,4,0,Tuesday,14 days,105713.646
ACC-3827517394,28,29.0,44156.05,,CUS-2663907001,2018-10-16,Craig,M,-33.89,151.12,,,,,,,debit,posted,834d669ae9834405844b868659d72ebb,INTER BANK,20-30,2018,10,16,9,0,Tuesday,14 days,105713.646
ACC-3827517394,28,19.38,44197.98,1.0,CUS-2663907001,2018-10-16,Craig,M,-33.89,151.12,,de440092-1855-4457-9f2f-746d3a78dfcd,-33.93,137.63,SA,Wallaroo,debit,authorized,3268e9165ac94a0fa3abbaf8cb8e648c,POS,20-30,2018,10,16,9,51,Tuesday,14 days,105713.646
ACC-3827517394,28,12.93,44185.05,1.0,CUS-2663907001,2018-10-16,Craig,M,-33.89,151.12,,55a2dec8-0dad-4af2-86cc-c430c8a1906d,-33.9,151.2,NSW,Alexandria,debit,authorized,c8f8ef9a05d54fe8a9efe21b2ac36625,SALES-POS,20-30,2018,10,16,9,57,Tuesday,14 days,105713.646
ACC-3827517394,28,22.64,44133.41,0.0,CUS-2663907001,2018-10-16,Craig,M,-33.89,151.12,,9057689e-9b2a-41e0-8e05-a3084a5fd52a,-33.8,151.1,NSW,Ryde,debit,authorized,9af25b6cda294c41885f33ec33ceaafa,SALES-POS,20-30,2018,10,16,10,24,Tuesday,14 days,105713.646
ACC-3827517394,28,126.47,44006.94,0.0,CUS-2663907001,2018-10-16,Craig,M,-33.89,151.12,,9d51aada-0f7e-4664-aa5d-6119a888f759,-33.87,151.21,NSW,Sydney,debit,authorized,66275b4077d542628b4ea493ae06d743,SALES-POS,20-30,2018,10,16,22,33,Tuesday,14 days,105713.646
ACC-3827517394,28,31.49,43975.45,1.0,CUS-2663907001,2018-10-17,Craig,M,-33.89,151.12,,fd00ae18-d442-4dcc-8717-52651cb54198,-33.92,150.92,NSW,Liverpool,debit,authorized,adcf90c52f0a4725a7fd71367caebfcc,SALES-POS,20-30,2018,10,17,8,4,Wednesday,14 days,105713.646
ACC-3827517394,28,83.0,43892.45,,CUS-2663907001,2018-10-17,Craig,M,-33.89,151.12,,,,,,,debit,posted,bf9e318ecdab4c4b8e71b8be0f815e01,PAYMENT,20-30,2018,10,17,17,0,Wednesday,14 days,105713.646
ACC-3827517394,28,17.68,43874.77,1.0,CUS-2663907001,2018-10-18,Craig,M,-33.89,151.12,,dce0853b-745e-42f2-9e54-359e2aa99fdd,-33.76,150.99,NSW,Baulkham Hills,debit,authorized,0046e875766d41d0b13fa616a1701a4e,POS,20-30,2018,10,18,21,0,Thursday,14 days,105713.646
ACC-3827517394,28,86.21,43788.56,0.0,CUS-2663907001,2018-10-18,Craig,M,-33.89,151.12,,068795d4-3dcc-4929-bdae-82c2d4adf0f0,-33.83,150.99,NSW,Merrylands,debit,authorized,7148935a81e24cc8b4f4bc70a28111ee,SALES-POS,20-30,2018,10,18,21,15,Thursday,14 days,105713.646
ACC-3827517394,28,65.0,43723.56,,CUS-2663907001,2018-10-19,Craig,M,-33.89,151.12,,,,,,,debit,posted,435499437f68471fb4171cafe169739b,PAYMENT,20-30,2018,10,19,5,0,Friday,14 days,105713.646
ACC-3827517394,28,43.0,43680.56,,CUS-2663907001,2018-10-19,Craig,M,-33.89,151.12,,,,,,,debit,posted,6e63695f607d4d9cb5cabf8f3d14ecb2,PAYMENT,20-30,2018,10,19,16,0,Friday,14 days,105713.646
ACC-3827517394,28,7.18,43673.38,1.0,CUS-2663907001,2018-10-19,Craig,M,-33.89,151.12,,a538e8f1-1059-42cd-9701-aebd1a6fc122,-33.8,151.18,NSW,Chatswood,debit,authorized,f0d0804402df406fa5ae2be19daf7bc4,POS,20-30,2018,10,19,21,18,Friday,14 days,105713.646
ACC-3827517394,28,30.03,43643.35,1.0,CUS-2663907001,2018-10-19,Craig,M,-33.89,151.12,,2376c9a0-24dc-4ae8-8e18-fdda3764f731,-33.79,150.67,NSW,Glenmore Park,debit,authorized,b10c04729fd848b5a85938b54e7095e0,SALES-POS,20-30,2018,10,19,22,17,Friday,14 days,105713.646
ACC-3827517394,28,36.97,43606.38,0.0,CUS-2663907001,2018-10-20,Craig,M,-33.89,151.12,,9b5aca21-07d3-44ee-9aa5-c6453401e129,-33.82,150.97,NSW,South Wentworthville,debit,authorized,6ec3a1bbba354dff86f9d84dcae6af17,POS,20-30,2018,10,20,12,11,Saturday,14 days,105713.646
ACC-3827517394,28,28.0,43578.38,,CUS-2663907001,2018-10-21,Craig,M,-33.89,151.12,,,,,,,debit,posted,7f87bc91159b441f869e49e271d355c4,PAYMENT,20-30,2018,10,21,11,0,Sunday,14 days,105713.646
ACC-3827517394,28,20.0,43558.38,,CUS-2663907001,2018-10-22,Craig,M,-33.89,151.12,,,,,,,debit,posted,4c38192290414d45ab2c2cf5d24f845d,PAYMENT,20-30,2018,10,22,14,0,Monday,14 days,105713.646
ACC-3827517394,28,30.0,47583.15,,CUS-2663907001,2018-10-23,Craig,M,-33.89,151.12,,,,,,,debit,posted,12c09a928d5f499d851ee28dd845c1f9,PAYMENT,20-30,2018,10,23,4,0,Tuesday,14 days,105713.646
ACC-3827517394,28,29.0,47554.15,,CUS-2663907001,2018-10-23,Craig,M,-33.89,151.12,,,,,,,debit,posted,b6f40b47eaa24d2394ea46ae54e914d9,INTER BANK,20-30,2018,10,23,9,0,Tuesday,14 days,105713.646
ACC-3827517394,28,16.84,47537.31,1.0,CUS-2663907001,2018-10-25,Craig,M,-33.89,151.12,,41e36ec1-b35f-4cc5-b928-117a0682c972,-33.82,151.2,NSW,Naremburn,debit,authorized,673bc5beebfb4dfe819c343fb0ccb586,POS,20-30,2018,10,25,0,57,Thursday,14 days,105713.646
ACC-3827517394,28,18.09,47519.22,1.0,CUS-2663907001,2018-10-25,Craig,M,-33.89,151.12,,27446105-6402-4bad-b9f0-6da3d21f0dcd,-33.77,151.08,NSW,Epping,debit,authorized,f183feb9cbf84e95a4390ae6a21975f9,SALES-POS,20-30,2018,10,25,11,21,Thursday,14 days,105713.646
ACC-3827517394,28,28.22,47491.0,1.0,CUS-2663907001,2018-10-25,Craig,M,-33.89,151.12,,50e08532-0ad3-406b-96a9-4ce7a34f68fb,-33.76,150.65,NSW,Leonay,debit,authorized,cf2390c5f08948629af515857b4f82bf,POS,20-30,2018,10,25,15,27,Thursday,14 days,105713.646
ACC-3827517394,28,9.63,47481.37,1.0,CUS-2663907001,2018-10-25,Craig,M,-33.89,151.12,,2d6a19c0-bc02-44a9-9014-aaf637d16225,-33.8,151.29,NSW,Manly,debit,authorized,a3bb68d53cba42ebb3fac8dfa2240120,POS,20-30,2018,10,25,22,14,Thursday,14 days,105713.646
ACC-3827517394,28,65.0,47416.37,,CUS-2663907001,2018-10-26,Craig,M,-33.89,151.12,,,,,,,debit,posted,da932df56a6b4a4ca045902419097281,PAYMENT,20-30,2018,10,26,5,0,Friday,14 days,105713.646
ACC-3827517394,28,43.0,47373.37,,CUS-2663907001,2018-10-26,Craig,M,-33.89,151.12,,,,,,,debit,posted,8ca86336b1bc4ae187dfb910c148945b,PAYMENT,20-30,2018,10,26,16,0,Friday,14 days,105713.646
ACC-3827517394,28,25.49,47347.88,0.0,CUS-2663907001,2018-10-28,Craig,M,-33.89,151.12,,82965a93-df96-4421-a27a-73365b039917,-33.76,150.94,NSW,Kings Langley,debit,authorized,b41c20dc163f4a85839cd3fc5fec4e1a,SALES-POS,20-30,2018,10,28,1,54,Sunday,14 days,105713.646
ACC-3827517394,28,1771.0,45576.88,,CUS-2663907001,2018-10-28,Craig,M,-33.89,151.12,,,,,,,debit,posted,8320463ece3242dd9ebea654563adfe6,INTER BANK,20-30,2018,10,28,5,0,Sunday,14 days,105713.646
ACC-3827517394,28,28.0,45548.88,,CUS-2663907001,2018-10-28,Craig,M,-33.89,151.12,,,,,,,debit,posted,fc79ec03d2134770be02d055420ff8dd,PAYMENT,20-30,2018,10,28,11,0,Sunday,14 days,105713.646
ACC-3827517394,28,20.0,45528.88,,CUS-2663907001,2018-10-29,Craig,M,-33.89,151.12,,,,,,,debit,posted,b625f414658a401793a654ab4944bcb1,PAYMENT,20-30,2018,10,29,14,0,Monday,14 days,105713.646
ACC-3827517394,28,31.35,45497.53,1.0,CUS-2663907001,2018-10-29,Craig,M,-33.89,151.12,,18191d23-55d6-4bb5-b9ad-e169bcf961e3,-33.9,151.24,NSW,Randwick,debit,authorized,11d32bd0f84a49e799fded2a9fce22ff,SALES-POS,20-30,2018,10,29,23,48,Monday,14 days,105713.646
ACC-3827517394,28,30.0,45467.53,,CUS-2663907001,2018-10-30,Craig,M,-33.89,151.12,,,,,,,debit,posted,511f2773967d4a4dadb9696aca1e3142,PAYMENT,20-30,2018,10,30,4,0,Tuesday,14 days,105713.646
ACC-3827517394,28,29.0,45438.53,,CUS-2663907001,2018-10-30,Craig,M,-33.89,151.12,,,,,,,debit,posted,e8816e7b9ba948e9ade2a90219e118c4,INTER BANK,20-30,2018,10,30,9,0,Tuesday,14 days,105713.646
ACC-3827517394,28,43.96,45394.57,1.0,CUS-2663907001,2018-10-31,Craig,M,-33.89,151.12,,e5975ab4-08f7-4725-a369-24cc0e35ed6e,-33.74,150.92,NSW,Kings Park,debit,authorized,2fdd4681827343f6af2e6519644a684a,POS,20-30,2018,10,31,23,34,Wednesday,14 days,105713.646
ACC-958000567,34,22.25,486.68,1.0,CUS-4142663097,2018-08-01,Sandra,F,-12.37,130.90,,73c0924f-dc35-4ab1-8136-2b5775cf4280,-12.44,130.84,NT,Stuart Park,debit,authorized,c9ff96e92ff4416383ce3cba52c211f4,POS,30-40,2018,8,1,14,19,Wednesday,14 days,91709.118
ACC-958000567,34,168.0,300.09,,CUS-4142663097,2018-08-01,Sandra,F,-12.37,130.90,,,,,,,debit,posted,dab9c8d9c4024e3eb4dfd3c86f1e3578,PAYMENT,30-40,2018,8,1,17,0,Wednesday,14 days,91709.118
ACC-958000567,34,18.59,468.09,1.0,CUS-4142663097,2018-08-01,Sandra,F,-12.37,130.90,,383aeeda-a0da-442e-b018-70389e109700,-12.47,130.98,NT,Yarrawonga,debit,authorized,450bda471a7649898a3b13e4fad158db,SALES-POS,30-40,2018,8,1,17,57,Wednesday,14 days,91709.118
ACC-958000567,34,37.0,263.09,,CUS-4142663097,2018-08-02,Sandra,F,-12.37,130.90,,,,,,,debit,posted,803db35e91a44c09897f34c7e062d3f1,PAYMENT,30-40,2018,8,2,17,0,Thursday,14 days,91709.118
ACC-958000567,34,17.0,246.09,,CUS-4142663097,2018-08-04,Sandra,F,-12.37,130.90,,,,,,,debit,posted,168afd2e0af24652901d326fad6b9ada,PAYMENT,30-40,2018,8,4,18,0,Saturday,14 days,91709.118
ACC-958000567,34,17.75,228.34,1.0,CUS-4142663097,2018-08-06,Sandra,F,-12.37,130.90,,3733e177-91d1-4ad8-85a5-c82cb013c30a,-12.46,130.84,NT,Darwin City,debit,authorized,f020d0d0b999449c9be1ba866f52d338,POS,30-40,2018,8,6,9,19,Monday,14 days,91709.118
ACC-958000567,34,20.0,208.34,,CUS-4142663097,2018-08-07,Sandra,F,-12.37,130.90,,,,,,,debit,posted,3c3abc127e0a4be2930cda19b7341dfd,PAYMENT,30-40,2018,8,7,5,0,Tuesday,14 days,91709.118
ACC-958000567,34,134.0,3591.95,,CUS-4142663097,2018-08-08,Sandra,F,-12.37,130.90,,,,,,,debit,posted,da78e4626e65432593ee0db958fa2e1e,PAYMENT,30-40,2018,8,8,9,0,Wednesday,14 days,91709.118
ACC-958000567,34,388.0,3203.95,,CUS-4142663097,2018-08-08,Sandra,F,-12.37,130.90,,,,,,,debit,posted,a303c87223c84f36bf139f240e682505,PAYMENT,30-40,2018,8,8,11,0,Wednesday,14 days,91709.118
ACC-958000567,34,53.52,3150.43,0.0,CUS-4142663097,2018-08-08,Sandra,F,-12.37,130.90,,b288ac70-e73e-4cf7-a7a8-6eb003a221c0,-12.51,131.01,NT,Zuccoli,debit,authorized,09c0b5b26eed412e8e904a02a4bbd833,POS,30-40,2018,8,8,14,53,Wednesday,14 days,91709.118
ACC-958000567,34,37.0,3113.43,,CUS-4142663097,2018-08-09,Sandra,F,-12.37,130.90,,,,,,,debit,posted,461e41167a434a19b06cf29d851c1887,PAYMENT,30-40,2018,8,9,17,0,Thursday,14 days,91709.118
ACC-958000567,34,28.91,3084.52,0.0,CUS-4142663097,2018-08-10,Sandra,F,-12.37,130.90,,2b4c4504-09a4-4055-b52d-d410a85c4a78,-12.47,130.99,NT,Yarrawonga,debit,authorized,1ced53edb58e4dce86b24f29d7df2693,SALES-POS,30-40,2018,8,10,4,45,Friday,14 days,91709.118
ACC-958000567,34,13.67,3070.85,1.0,CUS-4142663097,2018-08-11,Sandra,F,-12.37,130.90,,d4f3292b-5c68-4f47-9e0c-2661ab143e88,-12.4,130.86,NT,Eaton,debit,authorized,a06e65f7ad554b99b1d036fc00879191,POS,30-40,2018,8,11,9,19,Saturday,14 days,91709.118
ACC-958000567,34,43.31,3027.54,1.0,CUS-4142663097,2018-08-11,Sandra,F,-12.37,130.90,,39d8e31d-aa6c-443e-b9de-9f0031c33578,-33.86,151.19,NSW,Pyrmont,debit,authorized,3d40c5c6a7254c6dab6b4ffe449794c0,POS,30-40,2018,8,11,12,27,Saturday,14 days,91709.118
ACC-958000567,34,17.0,3010.54,,CUS-4142663097,2018-08-11,Sandra,F,-12.37,130.90,,,,,,,debit,posted,80c1fe7f28be4c859e7decba9a9b3385,PAYMENT,30-40,2018,8,11,18,0,Saturday,14 days,91709.118
ACC-958000567,34,33.73,2976.81,0.0,CUS-4142663097,2018-08-11,Sandra,F,-12.37,130.90,,bf3bc19d-ccf4-4117-af76-f1375d2a6e1b,-12.4,130.9,NT,Marrara,debit,authorized,e2450357fc994d9691b33f7b79050296,POS,30-40,2018,8,11,19,52,Saturday,14 days,91709.118
ACC-958000567,34,167.0,2809.81,,CUS-4142663097,2018-08-11,Sandra,F,-12.37,130.90,,,,,,,debit,posted,6913aa761ed945be8657be82295ee981,PAYMENT,30-40,2018,8,11,22,0,Saturday,14 days,91709.118
ACC-958000567,34,10.84,2798.97,0.0,CUS-4142663097,2018-08-12,Sandra,F,-12.37,130.90,,9bed3107-0e9d-472f-ae9b-6805f268a591,-33.73,151.08,NSW,Thornleigh,debit,authorized,1015f2ab68bd4a3080f6fc5a1ec90704,SALES-POS,30-40,2018,8,12,1,55,Sunday,14 days,91709.118
ACC-958000567,34,20.0,2778.97,,CUS-4142663097,2018-08-14,Sandra,F,-12.37,130.90,,,,,,,debit,posted,0a0ee5dd8bae4c16b8580e3c648f96b0,PAYMENT,30-40,2018,8,14,5,0,Tuesday,14 days,91709.118
ACC-958000567,34,110.0,2383.08,,CUS-4142663097,2018-08-17,Sandra,F,-12.37,130.90,,,,,,,debit,posted,d0be858b97054646851d535242f65c60,INTER BANK,30-40,2018,8,17,15,0,Friday,14 days,91709.118
ACC-958000567,34,30.22,2352.86,1.0,CUS-4142663097,2018-08-18,Sandra,F,-12.37,130.90,,d2ebeccc-21f5-4709-a684-a5dc6ae25e8f,-12.45,130.97,NT,Holtze,debit,authorized,adbca2b6280c45e68c91de44541ce4d8,SALES-POS,30-40,2018,8,18,12,8,Saturday,14 days,91709.118
ACC-958000567,34,17.0,2335.86,,CUS-4142663097,2018-08-18,Sandra,F,-12.37,130.90,,,,,,,debit,posted,124fefa9f7f34b31b61b12b223017780,PAYMENT,30-40,2018,8,18,18,0,Saturday,14 days,91709.118
ACC-958000567,34,17.81,2318.05,1.0,CUS-4142663097,2018-08-20,Sandra,F,-12.37,130.90,,512ead5e-8685-4c6f-825c-2441cd95892d,-12.5,130.99,NT,Bakewell,debit,authorized,470cbeaa19344116a5fb6b8d321c78ba,SALES-POS,30-40,2018,8,20,15,59,Monday,14 days,91709.118
ACC-958000567,34,77.76,2240.29,1.0,CUS-4142663097,2018-08-20,Sandra,F,-12.37,130.90,,123b7812-cc1f-4377-8166-d4eec932305a,-33.86,151.2,NSW,Sydney,debit,authorized,57187876dd5746329dfb3c196abdc451,POS,30-40,2018,8,20,22,4,Monday,14 days,91709.118
ACC-958000567,34,20.0,2220.29,,CUS-4142663097,2018-08-21,Sandra,F,-12.37,130.90,,,,,,,debit,posted,c5bfbd4670ca425aa5307ee968b8ef83,PAYMENT,30-40,2018,8,21,5,0,Tuesday,14 days,91709.118
ACC-958000567,34,28.82,5709.08,1.0,CUS-4142663097,2018-08-21,Sandra,F,-12.37,130.90,,c4e46e6b-75d5-4ccc-9b36-cc8e8375f08e,-12.5,130.99,NT,Bakewell,debit,authorized,892826799ad04e58822dae25a4868e31,SALES-POS,30-40,2018,8,21,22,49,Tuesday,14 days,91709.118
ACC-958000567,34,19.5,5689.58,1.0,CUS-4142663097,2018-08-22,Sandra,F,-12.37,130.90,,8bcca9c1-e1e8-4d3c-961f-3d9b4c3e4e86,-12.39,130.86,NT,Millner,debit,authorized,6840563e7d924612afb73a204c9751f7,POS,30-40,2018,8,22,21,15,Wednesday,14 days,91709.118
ACC-958000567,34,124.43,5565.15,0.0,CUS-4142663097,2018-08-23,Sandra,F,-12.37,130.90,,b4ef8c0b-d288-4542-8be9-c310d56e2dff,-12.5,131.04,NT,Howard Springs,debit,authorized,c10b9f6e9592445ba114c24a88e5d0af,POS,30-40,2018,8,23,10,24,Thursday,14 days,91709.118
ACC-958000567,34,37.0,5528.15,,CUS-4142663097,2018-08-23,Sandra,F,-12.37,130.90,,,,,,,debit,posted,f39f084c610f4e2a8fcab938285118ff,PAYMENT,30-40,2018,8,23,17,0,Thursday,14 days,91709.118
ACC-958000567,34,39.71,5488.44,1.0,CUS-4142663097,2018-08-25,Sandra,F,-12.37,130.90,,dda21f62-8924-49ad-a804-2e3390414d15,-37.84,144.97,VIC,Melbourne,debit,authorized,49b7e3d118264e7aa9534e5dd3a807d7,POS,30-40,2018,8,25,17,36,Saturday,14 days,91709.118
ACC-958000567,34,17.0,5471.44,,CUS-4142663097,2018-08-25,Sandra,F,-12.37,130.90,,,,,,,debit,posted,596215264aad496f80da667870b5d865,PAYMENT,30-40,2018,8,25,18,0,Saturday,14 days,91709.118
ACC-958000567,34,56.79,5414.65,1.0,CUS-4142663097,2018-08-25,Sandra,F,-12.37,130.90,,ade44fed-cf6d-4c45-8141-790dadb96d8b,-33.87,151.21,NSW,Sydney,debit,authorized,4b06ef3cfe5d47448250b2ab823e2386,SALES-POS,30-40,2018,8,25,21,14,Saturday,14 days,91709.118
ACC-958000567,34,15.26,5399.39,0.0,CUS-4142663097,2018-08-26,Sandra,F,-12.37,130.90,,61334d6d-b25d-4c6c-9145-029b9a988c70,-12.48,130.99,NT,Palmerston City,debit,authorized,a2186fc327924e86845c473b7377ccfd,POS,30-40,2018,8,26,14,14,Sunday,14 days,91709.118
ACC-958000567,34,25.1,5374.29,1.0,CUS-4142663097,2018-08-26,Sandra,F,-12.37,130.90,,ff7652a0-7d92-41bf-afbc-0f1bb6c5cde2,-12.5,130.99,NT,Bakewell,debit,authorized,e5ae5075582d4cf4920524ea9f32a3be,POS,30-40,2018,8,26,22,42,Sunday,14 days,91709.118
ACC-958000567,34,152.0,5222.29,,CUS-4142663097,2018-08-27,Sandra,F,-12.37,130.90,,,,,,,debit,posted,ac62eae455e8492c9a20375c4702c9db,INTER BANK,30-40,2018,8,27,21,0,Monday,14 days,91709.118
ACC-958000567,34,20.0,5202.29,,CUS-4142663097,2018-08-28,Sandra,F,-12.37,130.90,,,,,,,debit,posted,41b9064f1337441da6d090f533c7fa7f,PAYMENT,30-40,2018,8,28,5,0,Tuesday,14 days,91709.118
ACC-958000567,34,195.03,5007.26,0.0,CUS-4142663097,2018-08-29,Sandra,F,-12.37,130.90,,441fb5fc-693f-4898-a0e9-ac8ea1bbfbd4,-12.39,130.78,NT,Darwin City,debit,authorized,5e25769ef18a4dee80b5e24038c000ec,SALES-POS,30-40,2018,8,29,1,55,Wednesday,14 days,91709.118
ACC-958000567,34,111.29,4895.97,1.0,CUS-4142663097,2018-08-29,Sandra,F,-12.37,130.90,,c50f2e29-5fb5-4ac5-a2ea-1ae575443069,-33.88,151.21,NSW,Haymarket,debit,authorized,08e70342338f41d2943ecb673c8dd08e,POS,30-40,2018,8,29,8,11,Wednesday,14 days,91709.118
ACC-958000567,34,22.34,4873.63,1.0,CUS-4142663097,2018-08-29,Sandra,F,-12.37,130.90,,acca7ddf-189d-4f37-a5f6-2425359f2270,-12.4,130.86,NT,Coconut Grove,debit,authorized,69d77e4251c24b7bb0778785512c3c91,POS,30-40,2018,8,29,15,55,Wednesday,14 days,91709.118
ACC-958000567,34,18.68,4854.95,1.0,CUS-4142663097,2018-08-29,Sandra,F,-12.37,130.90,,012fee56-7727-4955-921a-f0369663dc65,-12.46,130.84,NT,Darwin City,debit,authorized,f3f528ceee214b40953a832f8afbeb44,POS,30-40,2018,8,29,16,53,Wednesday,14 days,91709.118
ACC-958000567,34,125.24,4729.71,0.0,CUS-4142663097,2018-08-30,Sandra,F,-12.37,130.90,,b4ef8c0b-d288-4542-8be9-c310d56e2dff,-12.5,131.04,NT,Howard Springs,debit,authorized,1d598f8eb14e40c0a07da0109a9e9e41,SALES-POS,30-40,2018,8,30,9,35,Thursday,14 days,91709.118
ACC-958000567,34,15.12,4714.59,0.0,CUS-4142663097,2018-08-30,Sandra,F,-12.37,130.90,,61334d6d-b25d-4c6c-9145-029b9a988c70,-12.48,130.99,NT,Palmerston City,debit,authorized,52413edab17043248f3652d7ffc94214,POS,30-40,2018,8,30,14,36,Thursday,14 days,91709.118
ACC-958000567,34,37.0,4677.59,,CUS-4142663097,2018-08-30,Sandra,F,-12.37,130.90,,,,,,,debit,posted,2a63ef9b09db42da8dfa3f7e81fda4d5,PAYMENT,30-40,2018,8,30,17,0,Thursday,14 days,91709.118
ACC-958000567,34,24.45,4653.14,1.0,CUS-4142663097,2018-08-31,Sandra,F,-12.37,130.90,,9a245a63-48f8-48ef-830e-cf3421d030e9,-12.47,130.84,NT,Darwin City,debit,authorized,4718781e53bf4bf2b0866303c51cb7f8,POS,30-40,2018,8,31,16,45,Friday,14 days,91709.118
ACC-958000567,34,13.44,4639.7,1.0,CUS-4142663097,2018-08-31,Sandra,F,-12.37,130.90,,281346a6-a8aa-4180-a14b-1408c707e55e,-12.33,134.93,NT,Ramingining,debit,authorized,0b5f6af339c742e1846266aedc4a35db,POS,30-40,2018,8,31,17,9,Friday,14 days,91709.118
ACC-958000567,34,24.3,4615.4,0.0,CUS-4142663097,2018-08-31,Sandra,F,-12.37,130.90,,73c0924f-dc35-4ab1-8136-2b5775cf4280,-12.44,130.84,NT,Stuart Park,debit,authorized,1ad3ae9b83574198b617821e04d5b941,POS,30-40,2018,8,31,19,45,Friday,14 days,91709.118
ACC-958000567,34,11.82,4603.58,0.0,CUS-4142663097,2018-08-31,Sandra,F,-12.37,130.90,,281346a6-a8aa-4180-a14b-1408c707e55e,-12.33,134.93,NT,Ramingining,debit,authorized,b471637414c44007aa5dc0432110d60b,POS,30-40,2018,8,31,21,49,Friday,14 days,91709.118
ACC-958000567,34,5.96,4597.62,1.0,CUS-4142663097,2018-09-01,Sandra,F,-12.37,130.90,,ece151d2-3e52-4c95-b47c-38cc75b4a517,-33.84,151.21,NSW,North Sydney,debit,authorized,bef9406f7d9a47e58c344093ff4b11d0,POS,30-40,2018,9,1,4,20,Saturday,14 days,91709.118
ACC-958000567,34,58.19,4539.43,0.0,CUS-4142663097,2018-09-01,Sandra,F,-12.37,130.90,,ade44fed-cf6d-4c45-8141-790dadb96d8b,-33.87,151.21,NSW,Sydney,debit,authorized,5818677875b142dd988111e4420c5a68,POS,30-40,2018,9,1,11,55,Saturday,14 days,91709.118
ACC-958000567,34,14.7,4524.73,1.0,CUS-4142663097,2018-09-01,Sandra,F,-12.37,130.90,,5218e5e3-8971-47bc-986a-0428a0fc7a04,-12.48,130.99,NT,Palmerston City,debit,authorized,0689f97adc234d6e955f471e8abb52bc,SALES-POS,30-40,2018,9,1,12,55,Saturday,14 days,91709.118
ACC-958000567,34,168.0,4356.73,,CUS-4142663097,2018-09-01,Sandra,F,-12.37,130.90,,,,,,,debit,posted,fbd1d58bd55e4cb69b3b693dfe832e2d,PAYMENT,30-40,2018,9,1,17,0,Saturday,14 days,91709.118
ACC-958000567,34,17.0,4259.66,,CUS-4142663097,2018-09-01,Sandra,F,-12.37,130.90,,,,,,,debit,posted,4d7bf32d7c7849c2ba1046ab37a9942e,PAYMENT,30-40,2018,9,1,18,0,Saturday,14 days,91709.118
ACC-958000567,34,80.07,4276.66,1.0,CUS-4142663097,2018-09-01,Sandra,F,-12.37,130.90,,d78bc180-93c4-4358-a9c3-0ac1845763f2,-25.24,130.99,NT,Yulara,debit,authorized,ae3b9ea5999a4dbcaf2b4b3711998cb0,POS,30-40,2018,9,1,18,54,Saturday,14 days,91709.118
ACC-958000567,34,38.05,4221.61,1.0,CUS-4142663097,2018-09-01,Sandra,F,-12.37,130.90,,d6d6bb87-b92b-4ee5-99cf-aeb4f7b60c6f,-13.05,131.02,NT,Batchelor,debit,authorized,0f0da5591fb84f2e9016d9393bf435fb,SALES-POS,30-40,2018,9,1,20,13,Saturday,14 days,91709.118
ACC-958000567,34,15.39,4206.22,1.0,CUS-4142663097,2018-09-01,Sandra,F,-12.37,130.90,,da5df8d1-1e08-4749-ba78-6e1b6f305877,-12.46,130.84,NT,Darwin City,debit,authorized,fd9df69e90c045aa84d3509c5692fb36,SALES-POS,30-40,2018,9,1,21,53,Saturday,14 days,91709.118
ACC-958000567,34,21.56,4184.66,1.0,CUS-4142663097,2018-09-02,Sandra,F,-12.37,130.90,,869c5966-86e4-476f-9795-38b0b9908a66,-12.46,130.84,NT,Darwin,debit,authorized,0be87db38aba458f816702fee2a8e0f5,POS,30-40,2018,9,2,4,42,Sunday,14 days,91709.118
ACC-958000567,34,38.12,4146.54,1.0,CUS-4142663097,2018-09-02,Sandra,F,-12.37,130.90,,f26401e1-93c1-4dc9-92e2-79cd25e902e2,-33.77,151.26,NSW,Brookvale,debit,authorized,6167d8f02607490c86ed4edf55c7bbe4,POS,30-40,2018,9,2,9,55,Sunday,14 days,91709.118
ACC-958000567,34,65.95,4080.59,1.0,CUS-4142663097,2018-09-03,Sandra,F,-12.37,130.90,,3350174a-e801-4a9f-b8b8-aea6f075d792,-12.41,130.86,NT,Ludmilla,debit,authorized,26f189adb25145d8b47786aab392ab15,SALES-POS,30-40,2018,9,3,13,54,Monday,14 days,91709.118
ACC-958000567,34,20.0,4060.59,,CUS-4142663097,2018-09-04,Sandra,F,-12.37,130.90,,,,,,,debit,posted,a1ebf68593bc4b5e9d5d92e42a1ffc47,PAYMENT,30-40,2018,9,4,5,0,Tuesday,14 days,91709.118
ACC-958000567,34,60.3,7517.9,1.0,CUS-4142663097,2018-09-05,Sandra,F,-12.37,130.90,,8420f84b-ac16-498e-be44-f3b2e01c1637,-12.44,130.98,NT,Shoal Bay,debit,authorized,752d5e7df25d4bf6bbe57c612dcf65dd,SALES-POS,30-40,2018,9,5,14,50,Wednesday,14 days,91709.118
ACC-958000567,34,26.63,7491.27,1.0,CUS-4142663097,2018-09-06,Sandra,F,-12.37,130.90,,8689dbf3-5fc5-4fe4-aa1f-fd8416219660,-12.46,130.84,NT,Darwin,debit,authorized,35282e27d1ac43f08d61b658834f2d34,SALES-POS,30-40,2018,9,6,2,15,Thursday,14 days,91709.118
ACC-958000567,34,18.61,7472.66,0.0,CUS-4142663097,2018-09-06,Sandra,F,-12.37,130.90,,512ead5e-8685-4c6f-825c-2441cd95892d,-12.5,130.99,NT,Bakewell,debit,authorized,8c464e8de1804645aa5036381f7c8923,POS,30-40,2018,9,6,14,12,Thursday,14 days,91709.118
ACC-958000567,34,37.0,7401.24,,CUS-4142663097,2018-09-06,Sandra,F,-12.37,130.90,,,,,,,debit,posted,9905d25ef58d4481b1df31dce57815d1,PAYMENT,30-40,2018,9,6,17,0,Thursday,14 days,91709.118
ACC-958000567,34,34.42,7438.24,1.0,CUS-4142663097,2018-09-06,Sandra,F,-12.37,130.90,,2336d81e-6b27-42ab-bed7-3ed51e7b436c,-31.91,115.81,WA,Osborne Park,debit,authorized,87069dfc774c42eaa04379450152915c,SALES-POS,30-40,2018,9,6,17,37,Thursday,14 days,91709.118
ACC-958000567,34,133.95,7267.29,1.0,CUS-4142663097,2018-09-07,Sandra,F,-12.37,130.90,,dd6626dc-54e0-40bf-9a39-08f6cb2fe9d3,-31.95,115.84,WA,West Perth,debit,authorized,78b3524ccb9e4a469e1096513a617088,SALES-POS,30-40,2018,9,7,17,29,Friday,14 days,91709.118
ACC-958000567,34,31.57,7235.72,1.0,CUS-4142663097,2018-09-07,Sandra,F,-12.37,130.90,,d1ac359e-415c-42a7-abae-8d2bcce24af0,-12.42,130.84,NT,Fannie Bay,debit,authorized,cdb38b74f1034e89a918b566c2c511c6,POS,30-40,2018,9,7,18,47,Friday,14 days,91709.118
ACC-958000567,34,134.0,7101.72,,CUS-4142663097,2018-09-08,Sandra,F,-12.37,130.90,,,,,,,debit,posted,01c209bb50534b6793cb7c690fe26ba4,PAYMENT,30-40,2018,9,8,9,0,Saturday,14 days,91709.118
ACC-958000567,34,17.0,7084.72,,CUS-4142663097,2018-09-08,Sandra,F,-12.37,130.90,,,,,,,debit,posted,92105dd40b6c4f03b02425d3048f4c17,PAYMENT,30-40,2018,9,8,18,0,Saturday,14 days,91709.118
ACC-958000567,34,15.6,7069.12,1.0,CUS-4142663097,2018-09-09,Sandra,F,-12.37,130.90,,d29084f7-cff3-46ec-ba04-0f0b1ca58a73,-12.45,130.84,NT,Darwin City,debit,authorized,e7e7c2a0241a46f1995596df965df711,SALES-POS,30-40,2018,9,9,12,53,Sunday,14 days,91709.118
ACC-958000567,34,11.86,7057.26,1.0,CUS-4142663097,2018-09-09,Sandra,F,-12.37,130.90,,6669df80-8d32-43ab-96ba-fab667395d0e,-12.46,130.84,NT,Darwin,debit,authorized,460367aae2644ac58e8e59388be386df,POS,30-40,2018,9,9,15,23,Sunday,14 days,91709.118
ACC-958000567,34,17.34,7039.92,1.0,CUS-4142663097,2018-09-09,Sandra,F,-12.37,130.90,,abfb1480-94a5-403f-9648-7285a196c9ac,-12.45,130.84,NT,Stuart Park,debit,authorized,5aaf58a9bfd144bab626b9e1a52bcb49,SALES-POS,30-40,2018,9,9,21,36,Sunday,14 days,91709.118
ACC-958000567,34,14.69,7025.23,1.0,CUS-4142663097,2018-09-10,Sandra,F,-12.37,130.90,,c837dd7a-aada-4633-b5e8-137a7327c441,-12.38,130.88,NT,Casuarina,debit,authorized,8c9e983cf8054a5c9b223ed98447377d,SALES-POS,30-40,2018,9,10,20,36,Monday,14 days,91709.118
ACC-958000567,34,19.55,7005.68,1.0,CUS-4142663097,2018-09-10,Sandra,F,-12.37,130.90,,eda99bd7-a23d-42a0-bdb9-b4528e0122d0,-12.42,130.84,NT,Fannie Bay,debit,authorized,dfc6d02043114ad480f4cb0db9b99630,SALES-POS,30-40,2018,9,10,22,49,Monday,14 days,91709.118
ACC-958000567,34,20.0,6985.68,,CUS-4142663097,2018-09-11,Sandra,F,-12.37,130.90,,,,,,,debit,posted,875285edab0d4a9a9bd89efe8e932ce9,PAYMENT,30-40,2018,9,11,5,0,Tuesday,14 days,91709.118
ACC-958000567,34,167.0,6818.68,,CUS-4142663097,2018-09-11,Sandra,F,-12.37,130.90,,,,,,,debit,posted,a3d6bd9c81d7446cb090c274fe70cbe4,PAYMENT,30-40,2018,9,11,22,0,Tuesday,14 days,91709.118
ACC-958000567,34,32.41,6786.27,1.0,CUS-4142663097,2018-09-12,Sandra,F,-12.37,130.90,,d71960ad-dff5-49b4-9095-5ec05a0c54a8,-12.47,130.85,NT,Darwin City,debit,authorized,a0cf703ea69c4a79826ceca78b7fc375,POS,30-40,2018,9,12,0,6,Wednesday,14 days,91709.118
ACC-958000567,34,149.05,6637.22,0.0,CUS-4142663097,2018-09-12,Sandra,F,-12.37,130.90,,f126f15e-30c2-456f-8b10-a28f9762e41d,-27.47,153.02,QLD,Brisbane City,debit,authorized,7701482f9171448f850b1d1827145f4b,POS,30-40,2018,9,12,9,10,Wednesday,14 days,91709.118
ACC-958000567,34,1282.84,5354.38,1.0,CUS-4142663097,2018-09-12,Sandra,F,-12.37,130.90,,5689d17d-5202-4ad5-9333-2505f051c5dd,-12.44,130.84,NT,Parap,debit,authorized,5468e6766dca47cbbe74c3b62c46f252,SALES-POS,30-40,2018,9,12,10,11,Wednesday,14 days,91709.118
ACC-958000567,34,37.0,5305.69,,CUS-4142663097,2018-09-13,Sandra,F,-12.37,130.90,,,,,,,debit,posted,874760e455bd4c49a9aa69f61d3e1016,PAYMENT,30-40,2018,9,13,17,0,Thursday,14 days,91709.118
ACC-958000567,34,11.69,5342.69,1.0,CUS-4142663097,2018-09-13,Sandra,F,-12.37,130.90,,7e044743-4610-4772-985f-7ed4d59a5c87,-12.38,130.88,NT,Casuarina,debit,authorized,114f3cd82d734e259c9ad4652f33eff1,SALES-POS,30-40,2018,9,13,17,18,Thursday,14 days,91709.118
ACC-958000567,34,87.09,5218.6,0.0,CUS-4142663097,2018-09-14,Sandra,F,-12.37,130.90,,223a3a53-05bd-4cc1-b690-0408106b9cb7,-12.39,130.86,NT,Millner,debit,authorized,49615107e087431483627f0fc2229c1e,SALES-POS,30-40,2018,9,14,14,21,Friday,14 days,91709.118
ACC-958000567,34,10.85,5207.75,1.0,CUS-4142663097,2018-09-15,Sandra,F,-12.37,130.90,,3fbc2fcc-15cb-49f0-bdaf-1d5cf1218138,-33.8,151.14,NSW,North Ryde,debit,authorized,b8c3ba1fa41f42058f2dcc94ba216067,POS,30-40,2018,9,15,14,39,Saturday,14 days,91709.118
ACC-958000567,34,17.0,5190.75,,CUS-4142663097,2018-09-15,Sandra,F,-12.37,130.90,,,,,,,debit,posted,ff1552609ffc49c2ae83932aee252123,PAYMENT,30-40,2018,9,15,18,0,Saturday,14 days,91709.118
ACC-958000567,34,6.51,5184.24,1.0,CUS-4142663097,2018-09-16,Sandra,F,-12.37,130.90,,e8d4f481-f132-4585-bbc2-c242d9780165,-12.39,130.85,NT,Coconut Grove,debit,authorized,76673e6623c841f58536da6d1c17b746,POS,30-40,2018,9,16,21,15,Sunday,14 days,91709.118
ACC-958000567,34,110.0,5074.24,,CUS-4142663097,2018-09-17,Sandra,F,-12.37,130.90,,,,,,,debit,posted,c404c522fc5a421994febdb851dd9801,INTER BANK,30-40,2018,9,17,15,0,Monday,14 days,91709.118
ACC-958000567,34,20.0,5054.24,,CUS-4142663097,2018-09-18,Sandra,F,-12.37,130.90,,,,,,,debit,posted,50f771b7b1cf41e1b53a163087134bec,PAYMENT,30-40,2018,9,18,5,0,Tuesday,14 days,91709.118
ACC-958000567,34,8.3,8563.55,1.0,CUS-4142663097,2018-09-19,Sandra,F,-12.37,130.90,,7f200fca-0af9-471c-a81a-6704489e8f3a,-12.36,130.9,NT,Muirhead,debit,authorized,bec18282d46e44ff9961104539f1166e,POS,30-40,2018,9,19,9,23,Wednesday,14 days,91709.118
ACC-958000567,34,13.28,8550.27,1.0,CUS-4142663097,2018-09-19,Sandra,F,-12.37,130.90,,ed0a9483-d142-44b0-a5d4-4aa2a8daaab1,-12.46,130.84,NT,Darwin City,debit,authorized,4d0d9be867fc4668ab3322e3c392bf77,POS,30-40,2018,9,19,13,29,Wednesday,14 days,91709.118
ACC-958000567,34,38.81,8511.46,1.0,CUS-4142663097,2018-09-19,Sandra,F,-12.37,130.90,,d6d6bb87-b92b-4ee5-99cf-aeb4f7b60c6f,-13.05,131.02,NT,Batchelor,debit,authorized,d3c46e3e8b534969964654567b42a658,SALES-POS,30-40,2018,9,19,15,1,Wednesday,14 days,91709.118
ACC-958000567,34,41.36,8470.1,1.0,CUS-4142663097,2018-09-19,Sandra,F,-12.37,130.90,,4af9af34-b5de-4063-bd48-664840bbaea2,-12.45,130.97,NT,Holtze,debit,authorized,64cce5fccfbc471292cb8c5ea0ab5465,SALES-POS,30-40,2018,9,19,15,59,Wednesday,14 days,91709.118
ACC-958000567,34,17.7,8452.4,1.0,CUS-4142663097,2018-09-20,Sandra,F,-12.37,130.90,,e545d8ee-0293-4479-87fc-32837ea47c60,-12.46,130.84,NT,Darwin City,debit,authorized,2cfae9e773084e9c81bcccaf095bc0b8,POS,30-40,2018,9,20,12,43,Thursday,14 days,91709.118
ACC-958000567,34,123.48,8328.92,1.0,CUS-4142663097,2018-09-20,Sandra,F,-12.37,130.90,,5fbffac4-fc71-45e3-86ef-e287258e1610,-12.47,130.98,NT,Yarrawonga,debit,authorized,5219ccd0d7734b92aee872bcd7605262,SALES-POS,30-40,2018,9,20,16,27,Thursday,14 days,91709.118
ACC-958000567,34,37.0,8291.92,,CUS-4142663097,2018-09-20,Sandra,F,-12.37,130.90,,,,,,,debit,posted,ca83ab3e33e34ad3a083bab5eea5b3ef,PAYMENT,30-40,2018,9,20,17,0,Thursday,14 days,91709.118
ACC-958000567,34,31.88,8260.04,1.0,CUS-4142663097,2018-09-20,Sandra,F,-12.37,130.90,,2fa9e975-6e09-4152-baad-6e3f3c762b98,-12.47,130.85,NT,Darwin City,debit,authorized,e83d9a177aae496292e9a2db2977e10e,SALES-POS,30-40,2018,9,20,18,7,Thursday,14 days,91709.118
ACC-958000567,34,17.0,8243.04,,CUS-4142663097,2018-09-22,Sandra,F,-12.37,130.90,,,,,,,debit,posted,5ed94f1b4eda4e0aaa4a54f35f624f4b,PAYMENT,30-40,2018,9,22,18,0,Saturday,14 days,91709.118
ACC-958000567,34,17.76,8225.28,0.0,CUS-4142663097,2018-09-23,Sandra,F,-12.37,130.90,,c4d6e945-af74-4562-a295-79b8b4a1d2b7,-31.95,115.85,WA,West Perth,debit,authorized,d834e22e4f8a4e07b7b4e18838da41bb,POS,30-40,2018,9,23,10,10,Sunday,14 days,91709.118
ACC-958000567,34,40.88,8184.4,1.0,CUS-4142663097,2018-09-23,Sandra,F,-12.37,130.90,,30676f44-8e14-4efa-94e1-2869fefa12ce,-12.43,130.87,NT,Winnellie,debit,authorized,84c695bbb61a452c8a3ad5710d7d0815,POS,30-40,2018,9,23,10,47,Sunday,14 days,91709.118
ACC-958000567,34,32.82,8151.58,1.0,CUS-4142663097,2018-09-23,Sandra,F,-12.37,130.90,,bf84ad0b-121c-4225-a10e-34e8facf9190,-12.37,130.88,NT,Casuarina,debit,authorized,f411bd1ed4d2477c80a2c33479e418cf,SALES-POS,30-40,2018,9,23,21,21,Sunday,14 days,91709.118
ACC-958000567,34,20.0,8131.58,,CUS-4142663097,2018-09-25,Sandra,F,-12.37,130.90,,,,,,,debit,posted,b396e2d8ed7f44efaa63af1fc3b6f74a,PAYMENT,30-40,2018,9,25,5,0,Tuesday,14 days,91709.118
ACC-958000567,34,51.97,8079.61,1.0,CUS-4142663097,2018-09-26,Sandra,F,-12.37,130.90,,0be68ac2-b725-4f65-815c-7362b5435768,-12.45,130.84,NT,Stuart Park,debit,authorized,d63ddf0638414e8581bbe84bb0929b90,POS,30-40,2018,9,26,0,9,Wednesday,14 days,91709.118
ACC-958000567,34,22.65,8056.96,1.0,CUS-4142663097,2018-09-26,Sandra,F,-12.37,130.90,,92c50260-32d3-4519-84be-37ec90dc4f4b,-12.52,131.04,NT,Coolalinga,debit,authorized,066f17f862db4439b532afe37bcbba85,SALES-POS,30-40,2018,9,26,15,50,Wednesday,14 days,91709.118
ACC-958000567,34,12.19,8044.77,1.0,CUS-4142663097,2018-09-26,Sandra,F,-12.37,130.90,,281346a6-a8aa-4180-a14b-1408c707e55e,-12.33,134.93,NT,Ramingining,debit,authorized,fe7fbb77ce474e2fa133599b1d3fbc8a,POS,30-40,2018,9,26,18,38,Wednesday,14 days,91709.118
ACC-958000567,34,13.52,8031.25,1.0,CUS-4142663097,2018-09-27,Sandra,F,-12.37,130.90,,358e6a17-3f2d-4023-803d-b63b201c583e,-12.41,130.88,NT,Eaton,debit,authorized,2ee436df96764997bb32234d896eb905,POS,30-40,2018,9,27,0,24,Thursday,14 days,91709.118
ACC-958000567,34,58.19,7973.06,1.0,CUS-4142663097,2018-09-27,Sandra,F,-12.37,130.90,,e3956228-a9fc-4fae-b2ef-9cab5926c660,-37.75,145.02,VIC,Preston,debit,authorized,fad473ccb4694b768da99fdf7d8631dd,SALES-POS,30-40,2018,9,27,13,46,Thursday,14 days,91709.118
ACC-958000567,34,37.0,7936.06,,CUS-4142663097,2018-09-27,Sandra,F,-12.37,130.90,,,,,,,debit,posted,8bb50c68c34148a3a282b740dd358a16,PAYMENT,30-40,2018,9,27,17,0,Thursday,14 days,91709.118
ACC-958000567,34,152.0,7784.06,,CUS-4142663097,2018-09-27,Sandra,F,-12.37,130.90,,,,,,,debit,posted,cb9c9af9888a48c5af842d002b38d092,INTER BANK,30-40,2018,9,27,21,0,Thursday,14 days,91709.118
ACC-958000567,34,81.38,7702.68,1.0,CUS-4142663097,2018-09-28,Sandra,F,-12.37,130.90,,07c602fb-fa6c-45ae-805b-11b83c1b789a,-12.37,130.88,NT,Casuarina,debit,authorized,c3ade6a6cfca4f9b99444927ea4d9c17,POS,30-40,2018,9,28,13,56,Friday,14 days,91709.118
ACC-958000567,34,12.52,7690.16,1.0,CUS-4142663097,2018-09-28,Sandra,F,-12.37,130.90,,281346a6-a8aa-4180-a14b-1408c707e55e,-12.33,134.93,NT,Ramingining,debit,authorized,014faeb0bdbb4637ac246c29613cf82d,POS,30-40,2018,9,28,19,0,Friday,14 days,91709.118
ACC-958000567,34,33.17,7656.99,0.0,CUS-4142663097,2018-09-29,Sandra,F,-12.37,130.90,,9486fbc4-9381-42c2-ae1c-414b3324a556,-12.4,130.91,NT,Karama,debit,authorized,7abcfb63275845d7bde0c86f01b47e64,POS,30-40,2018,9,29,8,19,Saturday,14 days,91709.118
ACC-958000567,34,114.62,7542.37,0.0,CUS-4142663097,2018-09-29,Sandra,F,-12.37,130.90,,a79490f1-8469-4eec-9ad0-0a4726f48781,-33.88,151.21,NSW,Haymarket,debit,authorized,5115051294a6434db9158d7404b445dd,POS,30-40,2018,9,29,9,5,Saturday,14 days,91709.118
ACC-958000567,34,94.8,7447.57,1.0,CUS-4142663097,2018-09-29,Sandra,F,-12.37,130.90,,20350a17-ead5-464b-bea9-5cbf33362de2,-37.9,145.09,VIC,Oakleigh,debit,authorized,9669b22d328e4cb2879da5bd72aa496d,POS,30-40,2018,9,29,15,41,Saturday,14 days,91709.118
ACC-958000567,34,17.0,7430.57,,CUS-4142663097,2018-09-29,Sandra,F,-12.37,130.90,,,,,,,debit,posted,4f98c162b3fd4ce9919daba69d7daa22,PAYMENT,30-40,2018,9,29,18,0,Saturday,14 days,91709.118
ACC-958000567,34,51.4,7379.17,0.0,CUS-4142663097,2018-09-30,Sandra,F,-12.37,130.90,,6f931528-3e0b-454b-ab7c-898c916b33a2,-12.43,130.84,NT,Parap,debit,authorized,ea174da30e584b5dac321679fc9e55d3,SALES-POS,30-40,2018,9,30,7,52,Sunday,14 days,91709.118
ACC-958000567,34,21.63,7357.54,0.0,CUS-4142663097,2018-09-30,Sandra,F,-12.37,130.90,,f7f1a4c4-9947-47f5-a461-2fed2ca3324c,-37.82,144.96,VIC,Melbourne,debit,authorized,d128ee3f5260497db7fb5d95a54797d4,SALES-POS,30-40,2018,9,30,9,27,Sunday,14 days,91709.118
ACC-958000567,34,1285.09,6072.45,0.0,CUS-4142663097,2018-09-30,Sandra,F,-12.37,130.90,,5689d17d-5202-4ad5-9333-2505f051c5dd,-12.44,130.84,NT,Parap,debit,authorized,fdb27b89c3824cf99eb8ca6672f9fe72,SALES-POS,30-40,2018,9,30,10,55,Sunday,14 days,91709.118
ACC-958000567,34,10.65,6061.8,0.0,CUS-4142663097,2018-10-01,Sandra,F,-12.37,130.90,,4179a6ae-b81c-4c3f-82bb-e9868d7d1437,-27.9,153.32,QLD,Helensvale,debit,authorized,404d08614d8a4dfa991bcfaec12ee79d,POS,30-40,2018,10,1,2,9,Monday,14 days,91709.118
ACC-958000567,34,168.0,5893.8,,CUS-4142663097,2018-10-01,Sandra,F,-12.37,130.90,,,,,,,debit,posted,37539242f2b0419fb0387523103c54d8,PAYMENT,30-40,2018,10,1,17,0,Monday,14 days,91709.118
ACC-958000567,34,20.0,5873.8,,CUS-4142663097,2018-10-02,Sandra,F,-12.37,130.90,,,,,,,debit,posted,c355e3abf5884bf1876498d6ee17ef3e,PAYMENT,30-40,2018,10,2,5,0,Tuesday,14 days,91709.118
ACC-958000567,34,54.43,9336.98,1.0,CUS-4142663097,2018-10-02,Sandra,F,-12.37,130.90,,49a50684-a31d-496f-aa68-c82557c9a430,-33.89,151.2,NSW,Chippendale,debit,authorized,800bbb9946a047efa90271b37b90f9ba,SALES-POS,30-40,2018,10,2,21,35,Tuesday,14 days,91709.118
ACC-958000567,34,61.86,9275.12,1.0,CUS-4142663097,2018-10-03,Sandra,F,-12.37,130.90,,e41588f5-21f9-4949-807d-f08781ec112a,-12.46,130.84,NT,Darwin City,debit,authorized,450a33cf5a5a40ed83c8fd2100016679,SALES-POS,30-40,2018,10,3,9,35,Wednesday,14 days,91709.118
ACC-958000567,34,32.99,9242.13,0.0,CUS-4142663097,2018-10-04,Sandra,F,-12.37,130.90,,9486fbc4-9381-42c2-ae1c-414b3324a556,-12.4,130.91,NT,Karama,debit,authorized,5b8979e7f11e49ae88824d9b2c514104,SALES-POS,30-40,2018,10,4,9,58,Thursday,14 days,91709.118
ACC-958000567,34,26.69,9215.44,1.0,CUS-4142663097,2018-10-04,Sandra,F,-12.37,130.90,,942c4adc-fc28-40ef-974e-5b8c1035b3a5,-12.39,130.85,NT,Nightcliff,debit,authorized,a52a577f18dd403eb061ae828dcfc711,POS,30-40,2018,10,4,16,22,Thursday,14 days,91709.118
ACC-958000567,34,37.0,9144.84,,CUS-4142663097,2018-10-04,Sandra,F,-12.37,130.90,,,,,,,debit,posted,1a2a39ea4233477a96ffef49bd4b6383,PAYMENT,30-40,2018,10,4,17,0,Thursday,14 days,91709.118
ACC-958000567,34,33.6,9181.84,1.0,CUS-4142663097,2018-10-04,Sandra,F,-12.37,130.90,,6856ef23-bfd9-458f-9005-1acf06755d9f,-12.46,130.93,NT,Berrimah,debit,authorized,e1e4c63097e64f4cb9fe738b5532daa4,SALES-POS,30-40,2018,10,4,17,29,Thursday,14 days,91709.118
ACC-958000567,34,31.87,9112.97,1.0,CUS-4142663097,2018-10-05,Sandra,F,-12.37,130.90,,bb869fe8-5100-4936-93b3-e33b8de77413,-33.84,151.21,NSW,North Sydney,debit,authorized,73d5e771b91b43a99c4460d893788ecb,POS,30-40,2018,10,5,1,5,Friday,14 days,91709.118
ACC-958000567,34,16.06,9096.91,0.0,CUS-4142663097,2018-10-05,Sandra,F,-12.37,130.90,,5faaf308-69bb-422c-ad86-b0a84473e5a8,-27.46,153.11,QLD,Murarrie,debit,authorized,b2738388704f4551b219f405d78e7d90,SALES-POS,30-40,2018,10,5,7,21,Friday,14 days,91709.118
ACC-958000567,34,22.62,9074.29,1.0,CUS-4142663097,2018-10-05,Sandra,F,-12.37,130.90,,1a7853e5-fc00-4c80-83cd-d2c90eed8b66,-12.43,130.84,NT,Parap,debit,authorized,b7d2ad2b9a6743498b396a5656855723,POS,30-40,2018,10,5,9,2,Friday,14 days,91709.118
ACC-958000567,34,13.97,9060.32,1.0,CUS-4142663097,2018-10-05,Sandra,F,-12.37,130.90,,358e6a17-3f2d-4023-803d-b63b201c583e,-12.41,130.88,NT,Eaton,debit,authorized,c6268072ed764d0b89e23806277d20fd,SALES-POS,30-40,2018,10,5,9,49,Friday,14 days,91709.118
ACC-958000567,34,20.53,9039.79,0.0,CUS-4142663097,2018-10-05,Sandra,F,-12.37,130.90,,5f45caa4-a7f0-4fe9-9745-0b0c7e45fe5a,-12.52,131.04,NT,Coolalinga,debit,authorized,b970b96b42a34c1795015b7f18bdd11a,POS,30-40,2018,10,5,13,12,Friday,14 days,91709.118
ACC-958000567,34,18.84,9020.95,0.0,CUS-4142663097,2018-10-05,Sandra,F,-12.37,130.90,,a0fdbc59-e005-456a-afbc-ac7bc6311338,-12.36,130.88,NT,Tiwi,debit,authorized,b47538b5289c4cb68b7a7612104bc174,POS,30-40,2018,10,5,21,57,Friday,14 days,91709.118
ACC-958000567,34,17.0,9003.95,,CUS-4142663097,2018-10-06,Sandra,F,-12.37,130.90,,,,,,,debit,posted,da03243e13b54ae883a55fca227e5c75,PAYMENT,30-40,2018,10,6,18,0,Saturday,14 days,91709.118
ACC-958000567,34,134.0,8869.95,,CUS-4142663097,2018-10-08,Sandra,F,-12.37,130.90,,,,,,,debit,posted,4d949b5165d34cb29c1bb6b73a77c4c1,PAYMENT,30-40,2018,10,8,9,0,Monday,14 days,91709.118
ACC-958000567,34,20.0,8849.95,,CUS-4142663097,2018-10-09,Sandra,F,-12.37,130.90,,,,,,,debit,posted,cd075f8a774449f593a0dbaab565db7f,PAYMENT,30-40,2018,10,9,5,0,Tuesday,14 days,91709.118
ACC-958000567,34,27.43,8822.52,0.0,CUS-4142663097,2018-10-11,Sandra,F,-12.37,130.90,,876775f5-2f53-4f93-bf37-799b9ad4ec85,-12.47,130.84,NT,Darwin City,debit,authorized,8f632f45086d47918703de4ee94ed18a,SALES-POS,30-40,2018,10,11,7,45,Thursday,14 days,91709.118
ACC-958000567,34,54.36,8768.16,1.0,CUS-4142663097,2018-10-11,Sandra,F,-12.37,130.90,,cd98e1d5-4138-4f47-9045-4de8919aed99,-12.44,130.92,NT,Berrimah,debit,authorized,37c845721fb94c749058ae961e3f76a1,POS,30-40,2018,10,11,11,14,Thursday,14 days,91709.118
ACC-958000567,34,14.93,8753.23,1.0,CUS-4142663097,2018-10-11,Sandra,F,-12.37,130.90,,3669658d-5250-4451-af85-70723de3794f,-12.4,130.91,NT,Karama,debit,authorized,df48408f571f47fda10c1109f091dde7,SALES-POS,30-40,2018,10,11,14,43,Thursday,14 days,91709.118
ACC-958000567,34,41.37,8711.86,0.0,CUS-4142663097,2018-10-11,Sandra,F,-12.37,130.90,,4af9af34-b5de-4063-bd48-664840bbaea2,-12.45,130.97,NT,Holtze,debit,authorized,3a51fddd93a849f9a3bfa628ef3d1dc7,POS,30-40,2018,10,11,15,10,Thursday,14 days,91709.118
ACC-958000567,34,8.44,8703.42,1.0,CUS-4142663097,2018-10-11,Sandra,F,-12.37,130.90,,dabb2aa4-31fa-4f27-9ed9-ca87e5966428,-12.46,130.84,NT,Darwin City,debit,authorized,b9fdfdc1940e46ff81b0f1f5c06ff0ff,POS,30-40,2018,10,11,15,17,Thursday,14 days,91709.118
ACC-958000567,34,37.0,8666.42,,CUS-4142663097,2018-10-11,Sandra,F,-12.37,130.90,,,,,,,debit,posted,95e5de586cca45de8fbbfe6f683a0e97,PAYMENT,30-40,2018,10,11,17,0,Thursday,14 days,91709.118
ACC-958000567,34,167.0,8499.42,,CUS-4142663097,2018-10-11,Sandra,F,-12.37,130.90,,,,,,,debit,posted,0c6c26044f874bb48f051b640c5b84f6,PAYMENT,30-40,2018,10,11,22,0,Thursday,14 days,91709.118
ACC-958000567,34,58.78,8440.64,1.0,CUS-4142663097,2018-10-13,Sandra,F,-12.37,130.90,,fe257a32-9aaf-4689-a309-23d952424071,-37.82,144.96,VIC,Melbourne,debit,authorized,8f1f3089d76c45398812ea3feebcc970,POS,30-40,2018,10,13,15,2,Saturday,14 days,91709.118
ACC-958000567,34,17.0,8423.64,,CUS-4142663097,2018-10-13,Sandra,F,-12.37,130.90,,,,,,,debit,posted,d2f3166c0fba44a0b1fe6575872174ba,PAYMENT,30-40,2018,10,13,18,0,Saturday,14 days,91709.118
ACC-958000567,34,42.17,8381.47,1.0,CUS-4142663097,2018-10-13,Sandra,F,-12.37,130.90,,17f91531-5815-4314-9c84-544e54325088,-12.4,130.91,NT,North Lakes,debit,authorized,da583a3218124036834d2a12e3515239,SALES-POS,30-40,2018,10,13,21,10,Saturday,14 days,91709.118
ACC-958000567,34,18.24,8363.23,1.0,CUS-4142663097,2018-10-14,Sandra,F,-12.37,130.90,,5941cc0a-79e8-452f-a976-c4e9d2723ff9,-12.46,130.84,NT,Darwin City,debit,authorized,d953afad3807449da57da27a8c67074e,POS,30-40,2018,10,14,2,33,Sunday,14 days,91709.118
ACC-958000567,34,20.0,8343.23,,CUS-4142663097,2018-10-16,Sandra,F,-12.37,130.90,,,,,,,debit,posted,33803c843e4a48e9978b204bac83c75d,PAYMENT,30-40,2018,10,16,5,0,Tuesday,14 days,91709.118
ACC-958000567,34,33.1,11827.74,1.0,CUS-4142663097,2018-10-17,Sandra,F,-12.37,130.90,,d1ac359e-415c-42a7-abae-8d2bcce24af0,-12.42,130.84,NT,Fannie Bay,debit,authorized,1c4f31fd82de4b57a16ed94b677a851a,SALES-POS,30-40,2018,10,17,13,36,Wednesday,14 days,91709.118
ACC-958000567,34,110.0,11717.74,,CUS-4142663097,2018-10-17,Sandra,F,-12.37,130.90,,,,,,,debit,posted,0fb70f433f084c8d82e820459c464ec6,INTER BANK,30-40,2018,10,17,15,0,Wednesday,14 days,91709.118
ACC-958000567,34,12.89,11704.85,1.0,CUS-4142663097,2018-10-17,Sandra,F,-12.37,130.90,,b7754c43-4b42-4854-8357-586cfdb5d6bd,-12.37,130.88,NT,Casuarina,debit,authorized,df67414d6d344a8a8c254026c7863424,SALES-POS,30-40,2018,10,17,19,52,Wednesday,14 days,91709.118
ACC-958000567,34,37.0,11667.85,,CUS-4142663097,2018-10-18,Sandra,F,-12.37,130.90,,,,,,,debit,posted,e470c01067414da78eaee4b7f0bf5032,PAYMENT,30-40,2018,10,18,17,0,Thursday,14 days,91709.118
ACC-958000567,34,17.0,11650.85,,CUS-4142663097,2018-10-20,Sandra,F,-12.37,130.90,,,,,,,debit,posted,6103ab0b462d404fa0865fd966bc5494,PAYMENT,30-40,2018,10,20,18,0,Saturday,14 days,91709.118
ACC-958000567,34,45.0,11605.85,1.0,CUS-4142663097,2018-10-22,Sandra,F,-12.37,130.90,,8f3cf4a8-e240-4fa7-9a9d-fda6e0f5ad41,-12.47,130.84,NT,Darwin,debit,authorized,05f2cc00ef484ca1a6cfd44f0d7c8ba3,SALES-POS,30-40,2018,10,22,9,17,Monday,14 days,91709.118
ACC-958000567,34,28.31,11577.54,1.0,CUS-4142663097,2018-10-22,Sandra,F,-12.37,130.90,,a1393fa3-196b-4b47-bc66-91e287c25733,-33.84,151.21,NSW,North Sydney,debit,authorized,ef7502bf9fd64290a873e17c926fb10c,SALES-POS,30-40,2018,10,22,9,55,Monday,14 days,91709.118
ACC-958000567,34,32.01,11545.53,1.0,CUS-4142663097,2018-10-22,Sandra,F,-12.37,130.90,,d1ac359e-415c-42a7-abae-8d2bcce24af0,-12.42,130.84,NT,Fannie Bay,debit,authorized,ff79cab1eefd437496893390020c36cd,POS,30-40,2018,10,22,21,48,Monday,14 days,91709.118
ACC-958000567,34,20.0,11525.53,,CUS-4142663097,2018-10-23,Sandra,F,-12.37,130.90,,,,,,,debit,posted,d4204902ee554b82804f7325dbca3824,PAYMENT,30-40,2018,10,23,5,0,Tuesday,14 days,91709.118
ACC-958000567,34,23.75,11501.78,1.0,CUS-4142663097,2018-10-24,Sandra,F,-12.37,130.90,,73c0924f-dc35-4ab1-8136-2b5775cf4280,-12.44,130.84,NT,Stuart Park,debit,authorized,396b33969f47458cac536467d0293707,SALES-POS,30-40,2018,10,24,9,31,Wednesday,14 days,91709.118
ACC-958000567,34,1266.0,10235.78,,CUS-4142663097,2018-10-24,Sandra,F,-12.37,130.90,,,,,,,debit,posted,41002c92afa248a994dee3972c951b2a,PAYMENT,30-40,2018,10,24,17,0,Wednesday,14 days,91709.118
ACC-958000567,34,60.62,10175.16,1.0,CUS-4142663097,2018-10-25,Sandra,F,-12.37,130.90,,8420f84b-ac16-498e-be44-f3b2e01c1637,-12.44,130.98,NT,Shoal Bay,debit,authorized,045b441ff4064eb2961bf417ef89850b,POS,30-40,2018,10,25,0,9,Thursday,14 days,91709.118
ACC-958000567,34,11.44,10163.72,1.0,CUS-4142663097,2018-10-25,Sandra,F,-12.37,130.90,,281346a6-a8aa-4180-a14b-1408c707e55e,-12.33,134.93,NT,Ramingining,debit,authorized,2985e36b69cd4365ba803622e02dfc23,SALES-POS,30-40,2018,10,25,9,27,Thursday,14 days,91709.118
ACC-958000567,34,481.0,9682.72,1.0,CUS-4142663097,2018-10-25,Sandra,F,-12.37,130.90,,880922a8-b065-4a7b-942f-db523006e273,-12.4,130.85,NT,Coconut Grove,debit,authorized,33d649945b474bd9ae7f870c034d3e60,POS,30-40,2018,10,25,15,13,Thursday,14 days,91709.118
ACC-958000567,34,37.0,9645.72,,CUS-4142663097,2018-10-25,Sandra,F,-12.37,130.90,,,,,,,debit,posted,167b6712f0d548f7a31a2758d200af81,PAYMENT,30-40,2018,10,25,17,0,Thursday,14 days,91709.118
ACC-958000567,34,33.23,9612.49,1.0,CUS-4142663097,2018-10-27,Sandra,F,-12.37,130.90,,f08135b7-cdce-430a-a14c-6a488968e831,-12.5,130.99,NT,Bakewell,debit,authorized,fa927f24e4374a72bbe36464fc341487,SALES-POS,30-40,2018,10,27,16,37,Saturday,14 days,91709.118
ACC-958000567,34,17.0,9595.49,,CUS-4142663097,2018-10-27,Sandra,F,-12.37,130.90,,,,,,,debit,posted,72fe4feb3b4542cd88eb2b35008d595f,PAYMENT,30-40,2018,10,27,18,0,Saturday,14 days,91709.118
ACC-958000567,34,152.0,9443.49,,CUS-4142663097,2018-10-27,Sandra,F,-12.37,130.90,,,,,,,debit,posted,c8da3da2a4b445ab80a22662e8cf5079,INTER BANK,30-40,2018,10,27,21,0,Saturday,14 days,91709.118
ACC-958000567,34,20.0,9423.49,,CUS-4142663097,2018-10-30,Sandra,F,-12.37,130.90,,,,,,,debit,posted,47b694fd2ba64e2496ed06ee9ef2b1c2,PAYMENT,30-40,2018,10,30,5,0,Tuesday,14 days,91709.118
ACC-958000567,34,12.28,12928.82,1.0,CUS-4142663097,2018-10-31,Sandra,F,-12.37,130.90,,281346a6-a8aa-4180-a14b-1408c707e55e,-12.33,134.93,NT,Ramingining,debit,authorized,84d3282c41c7447cb9dee3eb6c958b25,POS,30-40,2018,10,31,9,1,Wednesday,14 days,91709.118
ACC-958000567,34,13.84,12914.98,1.0,CUS-4142663097,2018-10-31,Sandra,F,-12.37,130.90,,ebbc3b11-03fc-43a2-92cc-92f650c1de2a,-12.48,130.99,NT,Palmerston City,debit,authorized,07bff68b5c5e4df5a695e5e2b3fb8ecf,SALES-POS,30-40,2018,10,31,9,30,Wednesday,14 days,91709.118
ACC-958000567,34,33.65,12881.33,1.0,CUS-4142663097,2018-10-31,Sandra,F,-12.37,130.90,,d1ac359e-415c-42a7-abae-8d2bcce24af0,-12.42,130.84,NT,Fannie Bay,debit,authorized,61e5c01049104f8393e3623d20293e06,POS,30-40,2018,10,31,11,44,Wednesday,14 days,91709.118
ACC-2305712452,18,36.0,86.91,,CUS-1842679196,2018-08-01,Debra,F,-34.89,138.61,,,,,,,debit,posted,caff6e7621094e3585454db87edfd984,PAYMENT,<20,2018,8,1,15,0,Wednesday,7 days,39697.921
ACC-2305712452,18,9.7,77.21,1.0,CUS-1842679196,2018-08-04,Debra,F,-34.89,138.61,,236f3828-3ed5-4d88-af13-9f6ec9571e38,-34.93,138.65,SA,Leabrook,debit,authorized,e45986fc5cdb4356b6d093ac8b000b89,POS,<20,2018,8,4,15,30,Saturday,7 days,39697.921
ACC-2305712452,18,13.52,63.69,1.0,CUS-1842679196,2018-08-05,Debra,F,-34.89,138.61,,bfbb283f-f5a2-4b5b-b1e3-9e5edc057ae3,-33.8,151.18,NSW,Chatswood,debit,authorized,2b6d9675ea7f44a2ab4b49db0d26dce4,SALES-POS,<20,2018,8,5,2,31,Sunday,7 days,39697.921
ACC-2305712452,18,32.32,31.37,1.0,CUS-1842679196,2018-08-07,Debra,F,-34.89,138.61,,b88cd541-59bf-4bb6-be5a-8a7e000dd472,-27.4,153.01,QLD,Stafford Heights,debit,authorized,4c7c2f6b6b594aa5a999cb7fb0b9014e,SALES-POS,<20,2018,8,7,11,41,Tuesday,7 days,39697.921
ACC-2305712452,18,36.0,756.7,,CUS-1842679196,2018-08-08,Debra,F,-34.89,138.61,,,,,,,debit,posted,32a34fb31e7c4cf3bc8e099c6b097f8f,PAYMENT,<20,2018,8,8,15,0,Wednesday,7 days,39697.921
ACC-2305712452,18,14.74,741.96,1.0,CUS-1842679196,2018-08-08,Debra,F,-34.89,138.61,,3f1fe000-0009-4526-905b-8b96a64f8bd9,-34.88,138.55,SA,Kilkenny,debit,authorized,9052d6d4a2d4417ebe575ac170fa820b,SALES-POS,<20,2018,8,8,18,4,Wednesday,7 days,39697.921
ACC-2305712452,18,10.6,731.36,1.0,CUS-1842679196,2018-08-09,Debra,F,-34.89,138.61,,d425e815-9a0a-4a4a-b9b7-9394dc05f22c,-35.03,117.88,WA,Albany,debit,authorized,130716aa689a463eb3d80ed295c4436b,SALES-POS,<20,2018,8,9,22,12,Thursday,7 days,39697.921
ACC-2305712452,18,7.21,724.15,1.0,CUS-1842679196,2018-08-10,Debra,F,-34.89,138.61,,4ebc6c77-466d-4bc1-84cb-79098be0f2df,-28.12,153.47,QLD,Palm Beach,debit,authorized,1e9266cd0493481f99f3686a5d1f64d5,SALES-POS,<20,2018,8,10,11,22,Friday,7 days,39697.921
ACC-2305712452,18,10.35,713.8,0.0,CUS-1842679196,2018-08-11,Debra,F,-34.89,138.61,,7fbd6363-a171-4ce6-ad92-c59fd7991396,-33.86,151.06,NSW,Lidcombe,debit,authorized,48d61863e26740d5bc37a4490c588bc5,SALES-POS,<20,2018,8,11,21,33,Saturday,7 days,39697.921
ACC-2305712452,18,11.57,702.23,1.0,CUS-1842679196,2018-08-12,Debra,F,-34.89,138.61,,78ab2b76-4131-40df-89f1-aba4574144db,-35.3,149.13,ACT,Parkes,debit,authorized,3f2e27b21e994763844ebee819dcd4d5,SALES-POS,<20,2018,8,12,10,54,Sunday,7 days,39697.921
ACC-2305712452,18,18.41,683.82,1.0,CUS-1842679196,2018-08-13,Debra,F,-34.89,138.61,,8338b188-add5-4e2d-aa6c-4c17fd4f158f,-34.88,138.49,SA,West Lakes,debit,authorized,247afa681d1e44f9b259b7dbb7c0dc59,SALES-POS,<20,2018,8,13,17,4,Monday,7 days,39697.921
ACC-2305712452,18,113.24,570.58,1.0,CUS-1842679196,2018-08-14,Debra,F,-34.89,138.61,,41704e57-9232-45e2-92a3-985dd62e356c,-12.46,130.84,NT,Darwin City,debit,authorized,594ca2dde0eb49478795c381e897e0fd,POS,<20,2018,8,14,10,12,Tuesday,7 days,39697.921
ACC-2305712452,18,39.31,1292.6,1.0,CUS-1842679196,2018-08-15,Debra,F,-34.89,138.61,,631c424b-3610-478b-bc31-b60b7b5248f0,-35.12,147.34,NSW,Wagga Wagga,debit,authorized,75f99904f5f24fc29a71f172075c76db,SALES-POS,<20,2018,8,15,11,34,Wednesday,7 days,39697.921
ACC-2305712452,18,36.0,1256.6,,CUS-1842679196,2018-08-15,Debra,F,-34.89,138.61,,,,,,,debit,posted,329c198d3e574f3480833ea9b1c6ae57,PAYMENT,<20,2018,8,15,15,0,Wednesday,7 days,39697.921
ACC-2305712452,18,36.0,1962.5,,CUS-1842679196,2018-08-22,Debra,F,-34.89,138.61,,,,,,,debit,posted,eb97b5dc73a24ff1864ec27260502503,PAYMENT,<20,2018,8,22,15,0,Wednesday,7 days,39697.921
ACC-2305712452,18,19.43,1998.5,1.0,CUS-1842679196,2018-08-22,Debra,F,-34.89,138.61,,cb30f6ec-72d1-41f9-bac8-5fe28a48f093,-34.83,148.91,NSW,Yass,debit,authorized,295aac34908a4095854e136973971d55,POS,<20,2018,8,22,15,36,Wednesday,7 days,39697.921
ACC-2305712452,18,18.75,1943.75,1.0,CUS-1842679196,2018-08-23,Debra,F,-34.89,138.61,,c8968173-48a5-43ad-8e3c-77d2cdfc2cc8,-35.03,138.53,SA,Seacliff Park,debit,authorized,0db95a46b11741c28e967f1cf6d87e01,SALES-POS,<20,2018,8,23,9,12,Thursday,7 days,39697.921
ACC-2305712452,18,9.04,1934.71,1.0,CUS-1842679196,2018-08-23,Debra,F,-34.89,138.61,,d6da0a73-531c-4df4-9afa-90c883149a9f,-35.01,148.11,NSW,Gundagai,debit,authorized,239ac3bd262f4226990e6444d090dd3a,SALES-POS,<20,2018,8,23,14,42,Thursday,7 days,39697.921
ACC-2305712452,18,11.2,1923.51,1.0,CUS-1842679196,2018-08-24,Debra,F,-34.89,138.61,,1bdf91d8-337a-4680-ad23-0331a00d0049,-34.85,138.59,SA,Gepps Cross,debit,authorized,aaba405e776142a7a714451266648a4f,SALES-POS,<20,2018,8,24,2,16,Friday,7 days,39697.921
ACC-2305712452,18,10.94,1912.57,1.0,CUS-1842679196,2018-08-24,Debra,F,-34.89,138.61,,ae11d0cd-21cf-4a14-97c4-f8df838cc3cd,-33.87,151.21,NSW,Sydney,debit,authorized,7ace0532fb674b00b8384577da5757aa,POS,<20,2018,8,24,19,21,Friday,7 days,39697.921
ACC-2305712452,18,11.45,1901.12,1.0,CUS-1842679196,2018-08-25,Debra,F,-34.89,138.61,,dc872b13-dbd9-4110-9a67-74245155a0b5,-35.3,148.22,NSW,Tumut,debit,authorized,0012da372ef14fafbe7ff8efc0f3e410,POS,<20,2018,8,25,5,8,Saturday,7 days,39697.921
ACC-2305712452,18,16.37,1884.75,0.0,CUS-1842679196,2018-08-26,Debra,F,-34.89,138.61,,ecaa4bd8-21f7-4a11-bb2c-37c431071a6f,-34.82,138.7,SA,Redwood Park,debit,authorized,4819253c1ebc4bdc93a2534e3ea86fe2,POS,<20,2018,8,26,21,24,Sunday,7 days,39697.921
ACC-2305712452,18,154.0,2492.08,,CUS-1842679196,2018-08-28,Debra,F,-34.89,138.61,,,,,,,debit,posted,3758f745c6cf402d8e97a6ba15f8f508,INTER BANK,<20,2018,8,28,20,0,Tuesday,7 days,39697.921
ACC-2305712452,18,10.95,2481.13,1.0,CUS-1842679196,2018-08-28,Debra,F,-34.89,138.61,,b4c27693-1e47-4b0c-b8ec-f2e142f578a2,-35.32,149.16,ACT,Fyshwick,debit,authorized,5a3c0e8939a943bfa3fe53e6e0eaf509,POS,<20,2018,8,28,21,59,Tuesday,7 days,39697.921
ACC-2305712452,18,8.35,2472.78,1.0,CUS-1842679196,2018-08-29,Debra,F,-34.89,138.61,,15f959c2-f0c5-4ed1-afcd-9a7aa54d423b,-34.83,138.69,SA,Modbury,debit,authorized,382d9e18df9b483f97e54e5b6375ec46,POS,<20,2018,8,29,9,17,Wednesday,7 days,39697.921
ACC-2305712452,18,36.0,2436.78,,CUS-1842679196,2018-08-29,Debra,F,-34.89,138.61,,,,,,,debit,posted,2d3c59d3fa1b494ca3d3e543091e0b02,PAYMENT,<20,2018,8,29,15,0,Wednesday,7 days,39697.921
ACC-2305712452,18,4.85,2431.93,1.0,CUS-1842679196,2018-08-30,Debra,F,-34.89,138.61,,3bc7d519-5040-4e67-8530-9b5a69ffc918,-34.85,150.74,NSW,Shoalhaven Heads,debit,authorized,45470a1958bb4bd2bbf6388ee8830e5d,POS,<20,2018,8,30,9,54,Thursday,7 days,39697.921
ACC-2305712452,18,23.01,2408.92,1.0,CUS-1842679196,2018-08-31,Debra,F,-34.89,138.61,,5f956c3e-cc5f-4860-b4e4-d6a2b3943758,-35.24,149.08,ACT,Bruce,debit,authorized,cd2f426caae84b3190468ff8aada8e86,POS,<20,2018,8,31,9,30,Friday,7 days,39697.921
ACC-2305712452,18,18.04,2390.88,1.0,CUS-1842679196,2018-08-31,Debra,F,-34.89,138.61,,ae05bf40-b7dc-41a1-8ac1-61c0e8608760,-34.85,138.66,SA,Gilles Plains,debit,authorized,03a5e32154914752a4316fa6663633b6,SALES-POS,<20,2018,8,31,21,19,Friday,7 days,39697.921
ACC-2305712452,18,14.13,2376.75,1.0,CUS-1842679196,2018-09-03,Debra,F,-34.89,138.61,,fc9f21ad-a8f1-4bc0-8527-c1bf4bda82d5,-34.98,138.61,SA,Torrens Park,debit,authorized,5ff184b744f54356ae5e5445415c5554,POS,<20,2018,9,3,11,14,Monday,7 days,39697.921
ACC-2305712452,18,23.03,2353.72,1.0,CUS-1842679196,2018-09-03,Debra,F,-34.89,138.61,,ee12b64a-f1e8-4ec7-96ca-0995b0fb15be,-34.96,138.55,SA,Plympton,debit,authorized,a22a1c3f471d4e4ea558b93ef5fb258d,POS,<20,2018,9,3,18,41,Monday,7 days,39697.921
ACC-2305712452,18,31.94,3083.11,0.0,CUS-1842679196,2018-09-05,Debra,F,-34.89,138.61,,4eba8302-2476-4d07-95fa-d6042fe46ad1,-35.02,117.88,WA,Albany,debit,authorized,94d8b72760824eddb7bd0538fcd12251,POS,<20,2018,9,5,6,17,Wednesday,7 days,39697.921
ACC-2305712452,18,36.0,3047.11,,CUS-1842679196,2018-09-05,Debra,F,-34.89,138.61,,,,,,,debit,posted,e0276bdbce774882a26c82125e691f1d,PAYMENT,<20,2018,9,5,15,0,Wednesday,7 days,39697.921
ACC-2305712452,18,17.99,3029.12,0.0,CUS-1842679196,2018-09-08,Debra,F,-34.89,138.61,,8927cdaf-73bc-49c2-ad75-0ebfbe983053,-34.84,148.91,NSW,Yass,debit,authorized,6c20dd442c6b427ba1e89f00c994f285,POS,<20,2018,9,8,5,46,Saturday,7 days,39697.921
ACC-2305712452,18,33.21,2995.91,1.0,CUS-1842679196,2018-09-08,Debra,F,-34.89,138.61,,11a16b9d-dfeb-4bbc-b738-dec4f646741d,-35.24,149.06,ACT,Belconnen,debit,authorized,e22f697a486e4681a465f1215d127c8c,POS,<20,2018,9,8,21,38,Saturday,7 days,39697.921
ACC-2305712452,18,7.53,2988.38,1.0,CUS-1842679196,2018-09-10,Debra,F,-34.89,138.61,,ddf5dd29-9d98-42b9-aef1-5d1815930291,-35.35,149.09,ACT,Canberra,debit,authorized,cdcaf5c2c21c4f689d5bda6cdac19ae9,SALES-POS,<20,2018,9,10,11,45,Monday,7 days,39697.921
ACC-2305712452,18,36.0,3713.71,,CUS-1842679196,2018-09-12,Debra,F,-34.89,138.61,,,,,,,debit,posted,71300ca65d924e57b63ccf0c01003633,PAYMENT,<20,2018,9,12,15,0,Wednesday,7 days,39697.921
ACC-2305712452,18,83.76,3629.95,0.0,CUS-1842679196,2018-09-13,Debra,F,-34.89,138.61,,a43ea02a-4dfd-4be4-a7b6-5438df923271,-33.86,151.21,NSW,Sydney,debit,authorized,5d8137f507c148878d0801fab79c7ce7,SALES-POS,<20,2018,9,13,22,9,Thursday,7 days,39697.921
ACC-2305712452,18,37.07,3592.88,1.0,CUS-1842679196,2018-09-14,Debra,F,-34.89,138.61,,5dd18868-b3f2-460b-a111-89bbaeef642f,-34.93,138.6,SA,Adelaide,debit,authorized,bd6e9bad9da24b2eaeed4e4faf377feb,POS,<20,2018,9,14,8,59,Friday,7 days,39697.921
ACC-2305712452,18,36.0,4318.21,,CUS-1842679196,2018-09-19,Debra,F,-34.89,138.61,,,,,,,debit,posted,e6bc862c037242c596f62741ac9abfda,PAYMENT,<20,2018,9,19,15,0,Wednesday,7 days,39697.921
ACC-2305712452,18,18.11,4300.1,1.0,CUS-1842679196,2018-09-21,Debra,F,-34.89,138.61,,3066388c-cb19-4379-90a2-19e36a06c167,-34.91,138.61,SA,North Adelaide,debit,authorized,c105ace764b74e949b9e823fd5ec1a85,SALES-POS,<20,2018,9,21,21,54,Friday,7 days,39697.921
ACC-2305712452,18,16.79,4283.31,1.0,CUS-1842679196,2018-09-22,Debra,F,-34.89,138.61,,dbf64945-4826-4200-aa53-973fce7c9b9c,-34.96,138.62,SA,Highgate,debit,authorized,b70344bff7194d4c93762d5b2aac6dc5,POS,<20,2018,9,22,15,38,Saturday,7 days,39697.921
ACC-2305712452,18,4.5,4278.81,0.0,CUS-1842679196,2018-09-22,Debra,F,-34.89,138.61,,b51c5167-4500-430e-b4f1-8b2877529495,-35.24,149.08,ACT,Bruce,debit,authorized,9c4a754d3bd4475184a7c5e7b09f7998,POS,<20,2018,9,22,21,24,Saturday,7 days,39697.921
ACC-2305712452,18,20.06,4258.75,1.0,CUS-1842679196,2018-09-22,Debra,F,-34.89,138.61,,f01cc8b4-1328-4501-8958-21e97b518510,-35.01,117.87,WA,Mount Melville,debit,authorized,7a697c55428a49c39d9487977358652d,POS,<20,2018,9,22,22,42,Saturday,7 days,39697.921
ACC-2305712452,18,13.05,4245.7,1.0,CUS-1842679196,2018-09-23,Debra,F,-34.89,138.61,,37d0ebc9-7c9c-498c-b33e-83ab3a1f52c4,-34.86,138.52,SA,Alberton,debit,authorized,adff4ed583bf484e92c759c3a1ecc4da,SALES-POS,<20,2018,9,23,13,0,Sunday,7 days,39697.921
ACC-2305712452,18,15.38,4230.32,0.0,CUS-1842679196,2018-09-24,Debra,F,-34.89,138.61,,3659e494-5ea3-4570-a2fc-1e365b78bb0e,-34.91,138.56,SA,Torrensville,debit,authorized,608100ee95a24c83932b296827378a42,POS,<20,2018,9,24,11,26,Monday,7 days,39697.921
ACC-2305712452,18,36.0,4955.65,,CUS-1842679196,2018-09-26,Debra,F,-34.89,138.61,,,,,,,debit,posted,175c5afbeb0e4e62a56efa46f08a40a8,PAYMENT,<20,2018,9,26,15,0,Wednesday,7 days,39697.921
ACC-2305712452,18,154.0,4801.65,,CUS-1842679196,2018-09-28,Debra,F,-34.89,138.61,,,,,,,debit,posted,2d89b4c45aad460aa94e929dc23204c5,INTER BANK,<20,2018,9,28,20,0,Friday,7 days,39697.921
ACC-2305712452,18,17.34,4784.31,1.0,CUS-1842679196,2018-09-30,Debra,F,-34.89,138.61,,cb30f6ec-72d1-41f9-bac8-5fe28a48f093,-34.83,148.91,NSW,Yass,debit,authorized,a64291497fab4fe8a75cc8e9ea4b62c6,POS,<20,2018,9,30,15,29,Sunday,7 days,39697.921
ACC-2305712452,18,19.71,4764.6,1.0,CUS-1842679196,2018-09-30,Debra,F,-34.89,138.61,,22c763cf-e537-4c5d-9e05-82ba6c02db48,-34.88,138.49,SA,Westlakes,debit,authorized,2f3df394514045249ec4c772f4f3f8c6,POS,<20,2018,9,30,23,45,Sunday,7 days,39697.921
ACC-2305712452,18,10.68,5515.25,1.0,CUS-1842679196,2018-10-02,Debra,F,-34.89,138.61,,719abfcf-2c7b-4496-a777-228d30ff3ce9,-35.32,149.15,ACT,Fyshwick,debit,authorized,d8ffab840db8412499f2333da2f0bbdd,SALES-POS,<20,2018,10,2,19,9,Tuesday,7 days,39697.921
ACC-2305712452,18,13.94,5501.31,1.0,CUS-1842679196,2018-10-03,Debra,F,-34.89,138.61,,480fbc21-d150-4332-b961-22590e70de9b,-34.84,150.6,NSW,Bomaderry,debit,authorized,4b868b211ce9443cb2d4963fa042dd69,POS,<20,2018,10,3,4,44,Wednesday,7 days,39697.921
ACC-2305712452,18,36.0,5465.31,,CUS-1842679196,2018-10-03,Debra,F,-34.89,138.61,,,,,,,debit,posted,f9be723f77034067952661aff8de8319,PAYMENT,<20,2018,10,3,15,0,Wednesday,7 days,39697.921
ACC-2305712452,18,13.24,5452.07,1.0,CUS-1842679196,2018-10-04,Debra,F,-34.89,138.61,,f33d4e5c-df52-4c47-8013-e8e47fe2418b,-34.92,138.6,SA,Adelaide,debit,authorized,a2258614c78b405090ace954613d1d11,SALES-POS,<20,2018,10,4,12,22,Thursday,7 days,39697.921
ACC-2305712452,18,6.4,5445.67,0.0,CUS-1842679196,2018-10-04,Debra,F,-34.89,138.61,,61bd7354-f2de-4839-a4db-896e7edcd333,-35.03,117.88,WA,Albany,debit,authorized,3882349c1cb6442c91ea2a5ac8b14b3f,POS,<20,2018,10,4,19,5,Thursday,7 days,39697.921
ACC-2305712452,18,21.52,5424.15,0.0,CUS-1842679196,2018-10-05,Debra,F,-34.89,138.61,,fec61b5d-c9b6-4b36-8c12-1e0f021cc218,-35.02,138.52,SA,Brighton,debit,authorized,5a7ea42e13e3451e9d539e4bbc8eee59,POS,<20,2018,10,5,21,7,Friday,7 days,39697.921
ACC-2305712452,18,11.18,5412.97,1.0,CUS-1842679196,2018-10-07,Debra,F,-34.89,138.61,,4fb0f897-887a-48f7-957c-879282c43406,-34.92,138.61,SA,Adelaide,debit,authorized,62493a3ccf694495b9688201d0df776e,SALES-POS,<20,2018,10,7,10,34,Sunday,7 days,39697.921
ACC-2305712452,18,36.0,6138.3,,CUS-1842679196,2018-10-10,Debra,F,-34.89,138.61,,,,,,,debit,posted,d38d88baeda14a5eaf8a18021df19382,PAYMENT,<20,2018,10,10,15,0,Wednesday,7 days,39697.921
ACC-2305712452,18,27.02,6111.28,0.0,CUS-1842679196,2018-10-10,Debra,F,-34.89,138.61,,b4fa5883-2b2f-4fdc-be9c-356e59123095,-34.93,138.59,SA,Adelaide,debit,authorized,3e01e090cb6541a48aaeaf172635993b,POS,<20,2018,10,10,17,18,Wednesday,7 days,39697.921
ACC-2305712452,18,88.29,6022.99,1.0,CUS-1842679196,2018-10-11,Debra,F,-34.89,138.61,,202453f5-0691-418b-9164-0ccab8209fe3,-27.31,152.99,QLD,Strathpine,debit,authorized,52b0671095764373a909c3f0993984f2,POS,<20,2018,10,11,9,50,Thursday,7 days,39697.921
ACC-2305712452,18,6.91,6016.08,1.0,CUS-1842679196,2018-10-11,Debra,F,-34.89,138.61,,bb52b1f0-8c01-4b32-b372-466aa3538d2a,-34.86,138.6,SA,Enfield,debit,authorized,b2128a5a8c584cbd8030eb4d5301c108,POS,<20,2018,10,11,15,24,Thursday,7 days,39697.921
ACC-2305712452,18,39.4,5976.68,1.0,CUS-1842679196,2018-10-12,Debra,F,-34.89,138.61,,d745e2a5-f129-47a4-b733-db2f94124359,-34.97,149.03,NSW,Murrumbateman,debit,authorized,632cb430263649e9b141d08831c70bfd,POS,<20,2018,10,12,8,52,Friday,7 days,39697.921
ACC-2305712452,18,9.77,5966.91,1.0,CUS-1842679196,2018-10-12,Debra,F,-34.89,138.61,,a0425cc0-94f4-438f-ae14-cfe12422e792,-34.94,138.51,SA,West Beach,debit,authorized,649f2d6f6b0241b9a15c8d7e7c119b1d,POS,<20,2018,10,12,11,36,Friday,7 days,39697.921
ACC-2305712452,18,8.43,5958.48,1.0,CUS-1842679196,2018-10-12,Debra,F,-34.89,138.61,,5381634d-265b-49f6-8725-64d5477b21e1,-34.91,138.6,SA,North Adelaide,debit,authorized,f5f25382bb4647fda4134cd9f5133a9e,SALES-POS,<20,2018,10,12,17,56,Friday,7 days,39697.921
ACC-2305712452,18,25.53,5932.95,0.0,CUS-1842679196,2018-10-13,Debra,F,-34.89,138.61,,181e7b16-a5db-4137-8e80-177b221278be,-35.32,149.14,ACT,Griffith,debit,authorized,4cd47985b4684c3696d7b41061dbfd26,SALES-POS,<20,2018,10,13,9,38,Saturday,7 days,39697.921
ACC-2305712452,18,26.25,5906.7,1.0,CUS-1842679196,2018-10-13,Debra,F,-34.89,138.61,,ab523591-340e-4293-ae1e-da2cb9d08dd4,-35.02,117.89,WA,Mira Mar,debit,authorized,14a89162915444dd9468f9d328d3ec37,POS,<20,2018,10,13,12,40,Saturday,7 days,39697.921
ACC-2305712452,18,10.93,5895.77,0.0,CUS-1842679196,2018-10-14,Debra,F,-34.89,138.61,,d6da0a73-531c-4df4-9afa-90c883149a9f,-35.01,148.11,NSW,Gundagai,debit,authorized,53030c7015d548a2b09b09e312d1293b,SALES-POS,<20,2018,10,14,20,16,Sunday,7 days,39697.921
ACC-2305712452,18,17.41,6639.69,1.0,CUS-1842679196,2018-10-17,Debra,F,-34.89,138.61,,050d47c5-3c1a-49dc-a531-c1905cda6aa3,-34.92,138.6,SA,Adelaide,debit,authorized,3526434f51a747858bfcee5fb60c0d00,SALES-POS,<20,2018,10,17,11,41,Wednesday,7 days,39697.921
ACC-2305712452,18,36.0,6603.69,,CUS-1842679196,2018-10-17,Debra,F,-34.89,138.61,,,,,,,debit,posted,af2fa924e7844863b3b79a3e9fea471e,PAYMENT,<20,2018,10,17,15,0,Wednesday,7 days,39697.921
ACC-2305712452,18,140.69,6463.0,1.0,CUS-1842679196,2018-10-18,Debra,F,-34.89,138.61,,b903fafe-2b7d-4d31-8bcc-59dfe22748ae,-35.31,149.13,ACT,Barton,debit,authorized,196b29eb08e045cc91c1738e3cba3dc8,POS,<20,2018,10,18,9,14,Thursday,7 days,39697.921
ACC-2305712452,18,21.65,6441.35,1.0,CUS-1842679196,2018-10-18,Debra,F,-34.89,138.61,,f71f393b-604b-4d4e-a6e1-1267069e22da,-34.87,150.6,NSW,Nowra,debit,authorized,d48725c3f5b54422a0ecbe3d378c3dc4,SALES-POS,<20,2018,10,18,11,5,Thursday,7 days,39697.921
ACC-2305712452,18,42.29,6399.06,1.0,CUS-1842679196,2018-10-18,Debra,F,-34.89,138.61,,7ed7f9e4-5e2b-40bd-b81c-4e0acd6546bc,-34.83,148.91,NSW,Yass,debit,authorized,62eadfb38ffc46d7b804cd79d96720e0,POS,<20,2018,10,18,15,46,Thursday,7 days,39697.921
ACC-2305712452,18,28.38,6370.68,1.0,CUS-1842679196,2018-10-18,Debra,F,-34.89,138.61,,f68ed3be-3303-40af-a2e3-fcd48d13c139,-35.1,138.53,SA,Reynella,debit,authorized,19fe37826a9a436d91d71d7336cef28d,SALES-POS,<20,2018,10,18,19,42,Thursday,7 days,39697.921
ACC-2305712452,18,16.7,6353.98,1.0,CUS-1842679196,2018-10-18,Debra,F,-34.89,138.61,,40c4b236-8739-4a8d-8f48-5c330d670d4c,-34.84,138.5,SA,Birkenhead,debit,authorized,513c694417304d77a7dce2380567ff0f,SALES-POS,<20,2018,10,18,21,31,Thursday,7 days,39697.921
ACC-2305712452,18,52.43,6301.55,1.0,CUS-1842679196,2018-10-19,Debra,F,-34.89,138.61,,02dc8434-5ba7-40ee-b1c5-5771560e0c1d,-34.87,150.59,NSW,Nowra North,debit,authorized,d5711c7cd81e4227b515d84954df1796,POS,<20,2018,10,19,19,9,Friday,7 days,39697.921
ACC-2305712452,18,16.05,6285.5,1.0,CUS-1842679196,2018-10-21,Debra,F,-34.89,138.61,,900a7524-eff2-42b5-930b-ef1f516130e2,-34.89,138.59,SA,Prospect,debit,authorized,4ec78bc4604a47f48c126abd52a100b7,POS,<20,2018,10,21,17,45,Sunday,7 days,39697.921
ACC-2305712452,18,7.95,6277.55,1.0,CUS-1842679196,2018-10-22,Debra,F,-34.89,138.61,,61bd7354-f2de-4839-a4db-896e7edcd333,-35.03,117.88,WA,Albany,debit,authorized,0e3435cd89bd46ad93224837ebc65904,POS,<20,2018,10,22,9,13,Monday,7 days,39697.921
ACC-2305712452,18,16.53,6261.02,1.0,CUS-1842679196,2018-10-23,Debra,F,-34.89,138.61,,a0c40ba9-0cc6-49b1-8bdf-743091136426,-35.03,117.88,WA,Albany,debit,authorized,fb294b937b5b44ebbaf4987c919461b7,POS,<20,2018,10,23,13,55,Tuesday,7 days,39697.921
ACC-2305712452,18,35.93,6986.42,0.0,CUS-1842679196,2018-10-23,Debra,F,-34.89,138.61,,83c94359-a845-4aec-8e1f-f1be9d80efb4,-34.93,138.6,SA,Adelaide,debit,authorized,0b5b7a7f8d854803b175cdadaaac72ec,SALES-POS,<20,2018,10,23,21,49,Tuesday,7 days,39697.921
ACC-2305712452,18,36.0,6950.42,,CUS-1842679196,2018-10-24,Debra,F,-34.89,138.61,,,,,,,debit,posted,ce42cf60c74d4696b9e7c2d9a953b37e,PAYMENT,<20,2018,10,24,15,0,Wednesday,7 days,39697.921
ACC-2305712452,18,25.2,6925.22,1.0,CUS-1842679196,2018-10-27,Debra,F,-34.89,138.61,,0a0b9723-63c1-4ac5-b679-7299fa3758bb,-35.03,117.88,WA,Albany,debit,authorized,77a639599f7d4e11bfc4a49121d747e0,POS,<20,2018,10,27,20,21,Saturday,7 days,39697.921
ACC-2305712452,18,9.33,6915.89,1.0,CUS-1842679196,2018-10-28,Debra,F,-34.89,138.61,,4037d19c-7877-499f-8e4b-7192c9b4f794,-34.92,138.6,SA,Adelaide,debit,authorized,130bfb2b84774942ab10b5866857e36c,SALES-POS,<20,2018,10,28,7,9,Sunday,7 days,39697.921
ACC-2305712452,18,154.0,6754.11,,CUS-1842679196,2018-10-28,Debra,F,-34.89,138.61,,,,,,,debit,posted,ad9ede7337a94cf18ab717c823a0eeaf,INTER BANK,<20,2018,10,28,20,0,Sunday,7 days,39697.921
ACC-2305712452,18,7.78,6908.11,1.0,CUS-1842679196,2018-10-28,Debra,F,-34.89,138.61,,61bd7354-f2de-4839-a4db-896e7edcd333,-35.03,117.88,WA,Albany,debit,authorized,9c52bf114ff94d42ba5adc7457eee121,POS,<20,2018,10,28,20,8,Sunday,7 days,39697.921
ACC-2305712452,18,36.0,7479.44,,CUS-1842679196,2018-10-31,Debra,F,-34.89,138.61,,,,,,,debit,posted,8df8d45d391847e2bff21a00cddad8dd,PAYMENT,<20,2018,10,31,15,0,Wednesday,7 days,39697.921
ACC-38923874,38,35.0,28453.87,,CUS-3249305314,2018-08-01,Ryan,M,-33.90,151.27,,,,,,,debit,posted,e383af7f43bb4c8480def9709a689e98,PAYMENT,30-40,2018,8,1,15,0,Wednesday,7 days,98078.107
ACC-38923874,38,16.74,30318.08,0.0,CUS-3249305314,2018-08-04,Ryan,M,-33.90,151.27,,439114e2-5884-4f53-98ba-137837e1de64,-33.92,150.93,NSW,Liverpool Bc,debit,authorized,43f882f39932408f85893070b4e37f23,SALES-POS,30-40,2018,8,4,14,24,Saturday,7 days,98078.107
ACC-38923874,38,71.0,30247.08,,CUS-3249305314,2018-08-05,Ryan,M,-33.90,151.27,,,,,,,debit,posted,434beaff26754ed8a8d302168cbda004,PAYMENT,30-40,2018,8,5,5,0,Sunday,7 days,98078.107
ACC-38923874,38,33.31,30213.77,1.0,CUS-3249305314,2018-08-05,Ryan,M,-33.90,151.27,,96ff13d8-b5ce-4a71-9eb4-86a75a56a46d,-33.92,150.92,NSW,Liverpool,debit,authorized,42e0a4a1b9fd40299356982e29d57ffa,POS,30-40,2018,8,5,15,27,Sunday,7 days,98078.107
ACC-38923874,38,185.0,30028.77,,CUS-3249305314,2018-08-06,Ryan,M,-33.90,151.27,,,,,,,debit,posted,663042d6a5ba48c2b4e90c3b583c652b,PAYMENT,30-40,2018,8,6,2,0,Monday,7 days,98078.107
ACC-38923874,38,42.0,29986.77,,CUS-3249305314,2018-08-06,Ryan,M,-33.90,151.27,,,,,,,debit,posted,f0f62db4c2794d73a1ff84071a7e84a7,PAYMENT,30-40,2018,8,6,11,0,Monday,7 days,98078.107
ACC-38923874,38,17.44,29969.33,0.0,CUS-3249305314,2018-08-06,Ryan,M,-33.90,151.27,,d3e3b875-f7bb-4cf7-8c37-da652056cb3e,-33.77,150.91,NSW,Blacktown,debit,authorized,ee979c6c4d41412dbea16cb310207fc2,SALES-POS,30-40,2018,8,6,20,23,Monday,7 days,98078.107
ACC-38923874,38,134.0,29835.33,,CUS-3249305314,2018-08-06,Ryan,M,-33.90,151.27,,,,,,,debit,posted,a8b35957bdcc4b98b703207b4260fde3,PAYMENT,30-40,2018,8,6,22,0,Monday,7 days,98078.107
ACC-38923874,38,29.0,29806.33,,CUS-3249305314,2018-08-07,Ryan,M,-33.90,151.27,,,,,,,debit,posted,cb07e45d82f94b3687518a93ada0d423,INTER BANK,30-40,2018,8,7,18,0,Tuesday,7 days,98078.107
ACC-38923874,38,35.0,29771.33,,CUS-3249305314,2018-08-08,Ryan,M,-33.90,151.27,,,,,,,debit,posted,f7e0e624563549cd9cba90ac28b626ca,PAYMENT,30-40,2018,8,8,15,0,Wednesday,7 days,98078.107
ACC-38923874,38,28.31,29743.02,1.0,CUS-3249305314,2018-08-09,Ryan,M,-33.90,151.27,,174192c8-c07d-461a-8d53-3062fe5151f5,-33.86,151.21,NSW,Sydney,debit,authorized,af236f0381144ede997169edb877e8fc,SALES-POS,30-40,2018,8,9,18,8,Thursday,7 days,98078.107
ACC-38923874,38,23.13,29719.89,1.0,CUS-3249305314,2018-08-10,Ryan,M,-33.90,151.27,,c87911c3-8c90-4514-9766-a848e3146700,-33.71,151.15,NSW,North Turramurra,debit,authorized,c4e337b1fd4c4eadb3cfac22e1baed6c,POS,30-40,2018,8,10,0,3,Friday,7 days,98078.107
ACC-38923874,38,15.45,31585.39,0.0,CUS-3249305314,2018-08-10,Ryan,M,-33.90,151.27,,4c46f1b0-3f1a-4daf-bf2c-2d0e1bab55ca,-33.92,151.03,NSW,Bankstown,debit,authorized,5c83257c40114b5f9fdbb8c3fa827506,POS,30-40,2018,8,10,15,25,Friday,7 days,98078.107
ACC-38923874,38,42.0,31543.39,,CUS-3249305314,2018-08-13,Ryan,M,-33.90,151.27,,,,,,,debit,posted,ff93be94555d4c8186b587bcf6374547,PAYMENT,30-40,2018,8,13,11,0,Monday,7 days,98078.107
ACC-38923874,38,29.0,31514.39,,CUS-3249305314,2018-08-14,Ryan,M,-33.90,151.27,,,,,,,debit,posted,2efe1d116adb44bfadd4c2034fdc839a,INTER BANK,30-40,2018,8,14,18,0,Tuesday,7 days,98078.107
ACC-38923874,38,35.0,31479.39,,CUS-3249305314,2018-08-15,Ryan,M,-33.90,151.27,,,,,,,debit,posted,e97a317cba6f44d49c2b4a0a0e284e0b,PAYMENT,30-40,2018,8,15,15,0,Wednesday,7 days,98078.107
ACC-38923874,38,80.0,33158.34,,CUS-3249305314,2018-08-19,Ryan,M,-33.90,151.27,,,,,,,debit,posted,24051f1720bf48bfa2148ec7c4a059d0,PAYMENT,30-40,2018,8,19,13,0,Sunday,7 days,98078.107
ACC-38923874,38,42.0,33116.34,,CUS-3249305314,2018-08-20,Ryan,M,-33.90,151.27,,,,,,,debit,posted,bbb757ba909d4ad68d50f3c24ccff387,PAYMENT,30-40,2018,8,20,11,0,Monday,7 days,98078.107
ACC-38923874,38,29.0,33087.34,,CUS-3249305314,2018-08-21,Ryan,M,-33.90,151.27,,,,,,,debit,posted,9d1a7dfca2b547da8d39ea4bcfb446c5,INTER BANK,30-40,2018,8,21,18,0,Tuesday,7 days,98078.107
ACC-38923874,38,35.0,33052.34,,CUS-3249305314,2018-08-22,Ryan,M,-33.90,151.27,,,,,,,debit,posted,abbcdbe3b13b4a58b7c6b09f331e86b1,PAYMENT,30-40,2018,8,22,15,0,Wednesday,7 days,98078.107
ACC-38923874,38,150.0,34783.29,,CUS-3249305314,2018-08-26,Ryan,M,-33.90,151.27,,,,,,,debit,posted,317a21de4a16432ba6ddbd64e53dd2d3,INTER BANK,30-40,2018,8,26,9,0,Sunday,7 days,98078.107
ACC-38923874,38,42.0,34741.29,,CUS-3249305314,2018-08-27,Ryan,M,-33.90,151.27,,,,,,,debit,posted,e4a95177f18143f6ac9c298c2c0668d6,PAYMENT,30-40,2018,8,27,11,0,Monday,7 days,98078.107
ACC-38923874,38,29.0,34712.29,,CUS-3249305314,2018-08-28,Ryan,M,-33.90,151.27,,,,,,,debit,posted,647ff38841764d22acc1b63727c9567a,INTER BANK,30-40,2018,8,28,18,0,Tuesday,7 days,98078.107
ACC-38923874,38,35.0,34677.29,,CUS-3249305314,2018-08-29,Ryan,M,-33.90,151.27,,,,,,,debit,posted,1bbea99896914495b8198a9317bca425,PAYMENT,30-40,2018,8,29,15,0,Wednesday,7 days,98078.107
ACC-38923874,38,22.46,36535.78,1.0,CUS-3249305314,2018-09-02,Ryan,M,-33.90,151.27,,05341afb-03ea-4331-8d4b-1b519af2784d,-33.9,151.18,NSW,Newtown,debit,authorized,55fc103a375548b7ac4fb2f43d1ff052,SALES-POS,30-40,2018,9,2,21,35,Sunday,7 days,98078.107
ACC-38923874,38,24.6,36511.18,0.0,CUS-3249305314,2018-09-03,Ryan,M,-33.90,151.27,,8e83c95f-f8d1-44c1-8cc1-a06fc34b5482,-27.5,153.03,QLD,Annerley,debit,authorized,ba1951ae9cea417b8ccadad3511b17eb,SALES-POS,30-40,2018,9,3,9,27,Monday,7 days,98078.107
ACC-38923874,38,42.0,36469.18,,CUS-3249305314,2018-09-03,Ryan,M,-33.90,151.27,,,,,,,debit,posted,b5260505d0644b1cb9a4741f62b4738e,PAYMENT,30-40,2018,9,3,11,0,Monday,7 days,98078.107
ACC-38923874,38,16.59,36452.59,1.0,CUS-3249305314,2018-09-04,Ryan,M,-33.90,151.27,,67b82577-3155-4818-890f-6ec0ce126de7,-33.74,151.21,NSW,Belrose,debit,authorized,d8d8906db178464dba25f5161a2c4474,POS,30-40,2018,9,4,2,29,Tuesday,7 days,98078.107
ACC-38923874,38,29.0,36423.59,,CUS-3249305314,2018-09-04,Ryan,M,-33.90,151.27,,,,,,,debit,posted,f5dabfc910c741659fee9c0fe4489105,INTER BANK,30-40,2018,9,4,18,0,Tuesday,7 days,98078.107
ACC-38923874,38,71.0,36352.59,,CUS-3249305314,2018-09-05,Ryan,M,-33.90,151.27,,,,,,,debit,posted,48eb3222b16e40e784f9c01fa6806076,PAYMENT,30-40,2018,9,5,5,0,Wednesday,7 days,98078.107
ACC-38923874,38,35.0,36317.59,,CUS-3249305314,2018-09-05,Ryan,M,-33.90,151.27,,,,,,,debit,posted,744670d14683462e974b1c7f402f8974,PAYMENT,30-40,2018,9,5,15,0,Wednesday,7 days,98078.107
ACC-38923874,38,185.0,36132.59,,CUS-3249305314,2018-09-06,Ryan,M,-33.90,151.27,,,,,,,debit,posted,87bee037e37340a38328df8d25cd60a0,PAYMENT,30-40,2018,9,6,2,0,Thursday,7 days,98078.107
ACC-38923874,38,134.0,35998.59,,CUS-3249305314,2018-09-06,Ryan,M,-33.90,151.27,,,,,,,debit,posted,8208eefd556249c4ae908282c37d6342,PAYMENT,30-40,2018,9,6,22,0,Thursday,7 days,98078.107
ACC-38923874,38,27.38,37852.16,1.0,CUS-3249305314,2018-09-08,Ryan,M,-33.90,151.27,,de440092-1855-4457-9f2f-746d3a78dfcd,-33.93,137.63,SA,Wallaroo,debit,authorized,798af3d90cd84d9aa9f5b261e703b312,POS,30-40,2018,9,8,21,28,Saturday,7 days,98078.107
ACC-38923874,38,42.0,37810.16,,CUS-3249305314,2018-09-10,Ryan,M,-33.90,151.27,,,,,,,debit,posted,f1b06cc7ccb54b2e83f733020626fba6,PAYMENT,30-40,2018,9,10,11,0,Monday,7 days,98078.107
ACC-38923874,38,29.0,37781.16,,CUS-3249305314,2018-09-11,Ryan,M,-33.90,151.27,,,,,,,debit,posted,236324c89794420fbe3f7ad90457db65,INTER BANK,30-40,2018,9,11,18,0,Tuesday,7 days,98078.107
ACC-38923874,38,35.0,37746.16,,CUS-3249305314,2018-09-12,Ryan,M,-33.90,151.27,,,,,,,debit,posted,3a67010415ab45efa916c64c7e90cc13,PAYMENT,30-40,2018,9,12,15,0,Wednesday,7 days,98078.107
ACC-38923874,38,35.8,37710.36,1.0,CUS-3249305314,2018-09-14,Ryan,M,-33.90,151.27,,0f3c6ed7-12f4-4af7-b65e-1463a245d122,-33.92,151.04,NSW,Bankstown,debit,authorized,a56b6d194c2c43809d7f5f4833974a3d,SALES-POS,30-40,2018,9,14,1,54,Friday,7 days,98078.107
ACC-38923874,38,122.0,39469.31,,CUS-3249305314,2018-09-16,Ryan,M,-33.90,151.27,,,,,,,debit,posted,296fec00fa504539a76dbeaca0e55620,PAYMENT,30-40,2018,9,16,16,0,Sunday,7 days,98078.107
ACC-38923874,38,42.0,39427.31,,CUS-3249305314,2018-09-17,Ryan,M,-33.90,151.27,,,,,,,debit,posted,ba5e540d68284b7a95ecf95a941ba04e,PAYMENT,30-40,2018,9,17,11,0,Monday,7 days,98078.107
ACC-38923874,38,29.0,39398.31,,CUS-3249305314,2018-09-18,Ryan,M,-33.90,151.27,,,,,,,debit,posted,2361be1e8a1949febf5e974ba0e115cb,INTER BANK,30-40,2018,9,18,18,0,Tuesday,7 days,98078.107
ACC-38923874,38,58.51,39339.8,1.0,CUS-3249305314,2018-09-19,Ryan,M,-33.90,151.27,,d2372bc1-5983-4d93-8759-489362ab5377,-33.96,137.72,SA,Kadina,debit,authorized,2f3f17b5a87a456db7d496df169c7b83,POS,30-40,2018,9,19,8,11,Wednesday,7 days,98078.107
ACC-38923874,38,64.67,39275.13,0.0,CUS-3249305314,2018-09-19,Ryan,M,-33.90,151.27,,fe257a32-9aaf-4689-a309-23d952424071,-37.82,144.96,VIC,Melbourne,debit,authorized,45b4c864e2c748c5857f4c779fbcdf46,POS,30-40,2018,9,19,8,19,Wednesday,7 days,98078.107
ACC-38923874,38,80.0,39195.13,,CUS-3249305314,2018-09-19,Ryan,M,-33.90,151.27,,,,,,,debit,posted,7e67d8874fcf448089351f5772c7b843,PAYMENT,30-40,2018,9,19,13,0,Wednesday,7 days,98078.107
ACC-38923874,38,35.0,39160.13,,CUS-3249305314,2018-09-19,Ryan,M,-33.90,151.27,,,,,,,debit,posted,d289c2fe3e854e67a37337879a856b78,PAYMENT,30-40,2018,9,19,15,0,Wednesday,7 days,98078.107
ACC-38923874,38,93.62,39066.51,0.0,CUS-3249305314,2018-09-21,Ryan,M,-33.90,151.27,,f2691787-4a31-451d-9a4d-dceb639ae983,-33.92,151.2,NSW,Alexandria,debit,authorized,e8a268780f4146e986843c89a24d9f00,POS,30-40,2018,9,21,11,50,Friday,7 days,98078.107
ACC-38923874,38,28.13,40919.33,1.0,CUS-3249305314,2018-09-21,Ryan,M,-33.90,151.27,,cbe9c88e-3052-4e1a-8978-47f261274f00,-33.89,150.86,NSW,Bonnyrigg,debit,authorized,ee4222d567c448978f13e32a1037b79c,SALES-POS,30-40,2018,9,21,16,30,Friday,7 days,98078.107
ACC-38923874,38,42.92,40876.41,1.0,CUS-3249305314,2018-09-22,Ryan,M,-33.90,151.27,,210eb5c0-b0ed-4e45-b810-4db04879c6c6,-33.76,150.66,NSW,Emu Plains,debit,authorized,171a0e63c2574c48bba8ba6f945f14ec,SALES-POS,30-40,2018,9,22,21,40,Saturday,7 days,98078.107
ACC-38923874,38,42.0,40834.41,,CUS-3249305314,2018-09-24,Ryan,M,-33.90,151.27,,,,,,,debit,posted,67ffd484334846d98b26370c30a052a1,PAYMENT,30-40,2018,9,24,11,0,Monday,7 days,98078.107
ACC-38923874,38,29.0,40805.41,,CUS-3249305314,2018-09-25,Ryan,M,-33.90,151.27,,,,,,,debit,posted,b0a091a3447d4e6a84d26edb4148fa19,INTER BANK,30-40,2018,9,25,18,0,Tuesday,7 days,98078.107
ACC-38923874,38,150.0,40655.41,,CUS-3249305314,2018-09-26,Ryan,M,-33.90,151.27,,,,,,,debit,posted,976cdc1b4397481dbf601f54a7a0aaba,INTER BANK,30-40,2018,9,26,9,0,Wednesday,7 days,98078.107
ACC-38923874,38,35.0,40620.41,,CUS-3249305314,2018-09-26,Ryan,M,-33.90,151.27,,,,,,,debit,posted,e62c0c72bf7043049abebbe680aada4c,PAYMENT,30-40,2018,9,26,15,0,Wednesday,7 days,98078.107
ACC-38923874,38,42.0,42459.36,,CUS-3249305314,2018-10-01,Ryan,M,-33.90,151.27,,,,,,,debit,posted,fb8d68d647424a05a5253d92ad8775d7,PAYMENT,30-40,2018,10,1,11,0,Monday,7 days,98078.107
ACC-38923874,38,29.0,42430.36,,CUS-3249305314,2018-10-02,Ryan,M,-33.90,151.27,,,,,,,debit,posted,025fc69b2ba947aa8086282e76f8ffe5,INTER BANK,30-40,2018,10,2,18,0,Tuesday,7 days,98078.107
ACC-38923874,38,35.0,42395.36,,CUS-3249305314,2018-10-03,Ryan,M,-33.90,151.27,,,,,,,debit,posted,1fd43bdce0eb4d3281e0b96a0c0ec5b5,PAYMENT,30-40,2018,10,3,15,0,Wednesday,7 days,98078.107
ACC-38923874,38,71.0,42324.36,,CUS-3249305314,2018-10-05,Ryan,M,-33.90,151.27,,,,,,,debit,posted,e74968a17c31493a8741da02898791b5,PAYMENT,30-40,2018,10,5,5,0,Friday,7 days,98078.107
ACC-38923874,38,185.0,44020.31,,CUS-3249305314,2018-10-06,Ryan,M,-33.90,151.27,,,,,,,debit,posted,c5d752b0307c458c8d14813aa9414bee,PAYMENT,30-40,2018,10,6,2,0,Saturday,7 days,98078.107
ACC-38923874,38,134.0,43886.31,,CUS-3249305314,2018-10-06,Ryan,M,-33.90,151.27,,,,,,,debit,posted,470ccdcf92dc460eb0bf4e49dbc27832,PAYMENT,30-40,2018,10,6,22,0,Saturday,7 days,98078.107
ACC-38923874,38,121.59,43764.72,1.0,CUS-3249305314,2018-10-07,Ryan,M,-33.90,151.27,,f4cfc3c1-9926-47ad-b094-d912f325ae3f,-33.87,151.21,NSW,Sydney,debit,authorized,4e2fdf2938484c0ca1ba151c32198f03,SALES-POS,30-40,2018,10,7,22,22,Sunday,7 days,98078.107
ACC-38923874,38,42.0,43722.72,,CUS-3249305314,2018-10-08,Ryan,M,-33.90,151.27,,,,,,,debit,posted,b4189383fe124325bec534a1fd9a8fe5,PAYMENT,30-40,2018,10,8,11,0,Monday,7 days,98078.107
ACC-38923874,38,29.0,43693.72,,CUS-3249305314,2018-10-09,Ryan,M,-33.90,151.27,,,,,,,debit,posted,8caed2ad6f6f4d33a0024b686efb0a8d,INTER BANK,30-40,2018,10,9,18,0,Tuesday,7 days,98078.107
ACC-38923874,38,35.0,43658.72,,CUS-3249305314,2018-10-10,Ryan,M,-33.90,151.27,,,,,,,debit,posted,8baea1bc4cea4f389ed8ef81e6067ff9,PAYMENT,30-40,2018,10,10,15,0,Wednesday,7 days,98078.107
ACC-38923874,38,1981.0,43558.67,,CUS-3249305314,2018-10-13,Ryan,M,-33.90,151.27,,,,,,,debit,posted,dbad97d9f6844a10a60190709b1a4db9,PAYMENT,30-40,2018,10,13,9,0,Saturday,7 days,98078.107
ACC-38923874,38,39.0,43519.67,1.0,CUS-3249305314,2018-10-13,Ryan,M,-33.90,151.27,,ac62ecb6-25a5-4f34-8f2a-38b989b57519,-33.91,151.24,NSW,Randwick,debit,authorized,c42a94535e344fddb1d2d352b99305a7,SALES-POS,30-40,2018,10,13,23,9,Saturday,7 days,98078.107
ACC-38923874,38,14.58,43505.09,1.0,CUS-3249305314,2018-10-14,Ryan,M,-33.90,151.27,,40bfb01f-ccf8-4e3a-9565-17e99d51890c,-33.93,151.15,NSW,Wolli Creek,debit,authorized,9a77fc023dc4445d9464b24130af3b3f,POS,30-40,2018,10,14,16,16,Sunday,7 days,98078.107
ACC-38923874,38,21.0,43484.09,1.0,CUS-3249305314,2018-10-14,Ryan,M,-33.90,151.27,,f1f8c97e-620b-4343-aefe-0ef649f50ae5,-33.81,151,NSW,Parramatta,debit,authorized,f866edfa42654286b843523ded417ecf,POS,30-40,2018,10,14,22,16,Sunday,7 days,98078.107
ACC-38923874,38,42.0,43442.09,,CUS-3249305314,2018-10-15,Ryan,M,-33.90,151.27,,,,,,,debit,posted,154d6728ed3f49378d5c6889f6bd7a56,PAYMENT,30-40,2018,10,15,11,0,Monday,7 days,98078.107
ACC-38923874,38,122.0,43320.09,,CUS-3249305314,2018-10-16,Ryan,M,-33.90,151.27,,,,,,,debit,posted,80f66b9e58c941eb8edd783620952883,PAYMENT,30-40,2018,10,16,16,0,Tuesday,7 days,98078.107
ACC-38923874,38,29.0,43291.09,,CUS-3249305314,2018-10-16,Ryan,M,-33.90,151.27,,,,,,,debit,posted,f6a2d48637f5418cbafd9682eec80b94,INTER BANK,30-40,2018,10,16,18,0,Tuesday,7 days,98078.107
ACC-38923874,38,174.63,43116.46,0.0,CUS-3249305314,2018-10-17,Ryan,M,-33.90,151.27,,86be90e3-7f20-41d1-8ea4-249270e45431,-33.75,150.69,NSW,Penrith,debit,authorized,4bec5e9ef8fe4fdfb0bba4714007b76c,SALES-POS,30-40,2018,10,17,11,11,Wednesday,7 days,98078.107
ACC-38923874,38,35.0,43081.46,,CUS-3249305314,2018-10-17,Ryan,M,-33.90,151.27,,,,,,,debit,posted,c5a1bc39b2ef4ab6b4f5666f123184bc,PAYMENT,30-40,2018,10,17,15,0,Wednesday,7 days,98078.107
ACC-38923874,38,1178.89,41902.57,1.0,CUS-3249305314,2018-10-19,Ryan,M,-33.90,151.27,,209d811a-8c93-4461-b334-5f62fffc53d8,-33.83,151.2,NSW,North Sydney,debit,authorized,69ec0238d1f44676ac3298b7414323ec,POS,30-40,2018,10,19,9,3,Friday,7 days,98078.107
ACC-38923874,38,80.0,43703.52,,CUS-3249305314,2018-10-19,Ryan,M,-33.90,151.27,,,,,,,debit,posted,191abfaccd2644e89fc1c90780e3d54d,PAYMENT,30-40,2018,10,19,13,0,Friday,7 days,98078.107
ACC-38923874,38,26.88,43676.64,0.0,CUS-3249305314,2018-10-19,Ryan,M,-33.90,151.27,,4a42fde5-3611-42e0-a201-782c6762866b,-33.82,151,NSW,Parramatta,debit,authorized,6c5d95fe95be4ba09ba94b336653593d,POS,30-40,2018,10,19,14,59,Friday,7 days,98078.107
ACC-38923874,38,37.5,43639.14,0.0,CUS-3249305314,2018-10-19,Ryan,M,-33.90,151.27,,2f1e660e-07cf-4d46-8a06-14accd78203b,-33.79,150.97,NSW,Old Toongabbie,debit,authorized,f002e4ab94d74cc0b0aced5b197a853d,POS,30-40,2018,10,19,18,11,Friday,7 days,98078.107
ACC-38923874,38,48.08,43591.06,1.0,CUS-3249305314,2018-10-21,Ryan,M,-33.90,151.27,,26731ba8-e9ac-4898-9747-6374079c8510,-33.78,150.92,NSW,Blacktown,debit,authorized,41ad579c9b344c76bd97747be347ac26,SALES-POS,30-40,2018,10,21,21,50,Sunday,7 days,98078.107
ACC-38923874,38,42.0,43549.06,,CUS-3249305314,2018-10-22,Ryan,M,-33.90,151.27,,,,,,,debit,posted,5d049e43a1494267a1baa89a627af3b7,PAYMENT,30-40,2018,10,22,11,0,Monday,7 days,98078.107
ACC-38923874,38,29.0,43520.06,,CUS-3249305314,2018-10-23,Ryan,M,-33.90,151.27,,,,,,,debit,posted,c04daa1f34b44d3581e24ce7d4b36c03,INTER BANK,30-40,2018,10,23,18,0,Tuesday,7 days,98078.107
ACC-38923874,38,56.53,43463.53,0.0,CUS-3249305314,2018-10-24,Ryan,M,-33.90,151.27,,6205d718-e3fd-478f-b553-5d465e11fab9,-33.79,151.08,NSW,Eastwood,debit,authorized,10167b59b80d483ea2456c356baec36d,SALES-POS,30-40,2018,10,24,11,56,Wednesday,7 days,98078.107
ACC-38923874,38,54.89,43408.64,1.0,CUS-3249305314,2018-10-24,Ryan,M,-33.90,151.27,,3716e385-33dd-4645-bd4d-6a6e42dcf6eb,-33.65,115.35,WA,Busselton,debit,authorized,0419eb68e0214923a342cde75283e81f,SALES-POS,30-40,2018,10,24,14,40,Wednesday,7 days,98078.107
ACC-38923874,38,35.0,43344.96,,CUS-3249305314,2018-10-24,Ryan,M,-33.90,151.27,,,,,,,debit,posted,cec7a582521f4c7d90078a2f64a69838,PAYMENT,30-40,2018,10,24,15,0,Wednesday,7 days,98078.107
ACC-38923874,38,28.68,43379.96,1.0,CUS-3249305314,2018-10-24,Ryan,M,-33.90,151.27,,b9b05a84-937a-4e0e-90d9-8358e3b23129,-33.72,151.12,NSW,Wahroonga,debit,authorized,af1fe01b9f27450c810538987692b3d7,POS,30-40,2018,10,24,15,19,Wednesday,7 days,98078.107
ACC-38923874,38,20.6,43324.36,1.0,CUS-3249305314,2018-10-25,Ryan,M,-33.90,151.27,,6b25bf92-b5f4-4238-9d2e-b816b48f4dd9,-33.79,150.79,NSW,Saint Clair,debit,authorized,a4321f290a724314a6957bd806a76306,POS,30-40,2018,10,25,14,46,Thursday,7 days,98078.107
ACC-38923874,38,23.29,43301.07,1.0,CUS-3249305314,2018-10-26,Ryan,M,-33.90,151.27,,8658d9bd-bbcd-4c43-be31-3b21f9072cef,-33.73,151.16,NSW,Saint Ives,debit,authorized,899163a13ec6461882467087371af0d0,SALES-POS,30-40,2018,10,26,2,24,Friday,7 days,98078.107
ACC-38923874,38,150.0,43151.07,,CUS-3249305314,2018-10-26,Ryan,M,-33.90,151.27,,,,,,,debit,posted,1b7b0206f89e494f99874457df1364d9,INTER BANK,30-40,2018,10,26,9,0,Friday,7 days,98078.107
ACC-38923874,38,55.95,44976.07,0.0,CUS-3249305314,2018-10-27,Ryan,M,-33.90,151.27,,d7effe6e-ecfb-464b-aab6-6bb1390ffe97,-33.8,151.18,NSW,Chatswood,debit,authorized,68d6dd64d61441a99bfdb637ea99bdd0,POS,30-40,2018,10,27,15,51,Saturday,7 days,98078.107
ACC-38923874,38,42.0,44934.07,,CUS-3249305314,2018-10-29,Ryan,M,-33.90,151.27,,,,,,,debit,posted,cbe2dbfbb681463697e18a33603baf0e,PAYMENT,30-40,2018,10,29,11,0,Monday,7 days,98078.107
ACC-38923874,38,29.0,44905.07,,CUS-3249305314,2018-10-30,Ryan,M,-33.90,151.27,,,,,,,debit,posted,31a8751a4f2b4bd7ad6a7f5b081acc4f,INTER BANK,30-40,2018,10,30,18,0,Tuesday,7 days,98078.107
ACC-38923874,38,35.0,44870.07,,CUS-3249305314,2018-10-31,Ryan,M,-33.90,151.27,,,,,,,debit,posted,ea0245731c044340ae835ff27a63656f,PAYMENT,30-40,2018,10,31,15,0,Wednesday,7 days,98078.107
ACC-819621312,30,5.29,86.3,0.0,CUS-1271030853,2018-08-01,Michele,F,-37.85,145.04,,0bf7d15e-20d0-4246-8e99-59c3dd1a2dcb,-37.86,144.99,VIC,Windsor,debit,authorized,6cf7fafedd0b4a30bc1b00023cbee2d7,POS,20-30,2018,8,1,15,2,Wednesday,7 days,60389.25
ACC-819621312,30,8.18,1236.27,1.0,CUS-1271030853,2018-08-02,Michele,F,-37.85,145.04,,5d98c351-be27-43c5-abe7-3a21e423baf6,-33.87,151.21,NSW,Sydney,debit,authorized,68594c8522694231827a7ea235f11c7c,SALES-POS,20-30,2018,8,2,15,36,Thursday,7 days,60389.25
ACC-819621312,30,168.0,1068.27,,CUS-1271030853,2018-08-03,Michele,F,-37.85,145.04,,,,,,,debit,posted,52fcf47679ee45ed85e6e03fd417ce56,INTER BANK,20-30,2018,8,3,12,0,Friday,7 days,60389.25
ACC-819621312,30,66.0,1002.27,,CUS-1271030853,2018-08-06,Michele,F,-37.85,145.04,,,,,,,debit,posted,c3782a711dfe49c380faca5129da1c02,PAYMENT,20-30,2018,8,6,4,0,Monday,7 days,60389.25
ACC-819621312,30,55.0,947.27,,CUS-1271030853,2018-08-06,Michele,F,-37.85,145.04,,,,,,,debit,posted,72c588e9a22743d99a482de0dc2abd4e,INTER BANK,20-30,2018,8,6,15,0,Monday,7 days,60389.25
ACC-819621312,30,154.0,793.27,,CUS-1271030853,2018-08-07,Michele,F,-37.85,145.04,,,,,,,debit,posted,9ac4ebc9efe5472fb5615e8fdf1055c2,PAYMENT,20-30,2018,8,7,17,0,Tuesday,7 days,60389.25
ACC-819621312,30,9.85,1941.57,1.0,CUS-1271030853,2018-08-09,Michele,F,-37.85,145.04,,d5efc41e-bf89-4763-8a23-30c21cb91e80,-37.81,145.23,VIC,Ringwood,debit,authorized,685ac817b285414cb1a701704121c86b,POS,20-30,2018,8,9,19,49,Thursday,7 days,60389.25
ACC-819621312,30,109.0,1832.57,,CUS-1271030853,2018-08-11,Michele,F,-37.85,145.04,,,,,,,debit,posted,99b81b790efe423cb7bab48e338ea5c8,PAYMENT,20-30,2018,8,11,9,0,Saturday,7 days,60389.25
ACC-819621312,30,66.0,1766.57,,CUS-1271030853,2018-08-13,Michele,F,-37.85,145.04,,,,,,,debit,posted,aa33d7ebf9ee42a4a37e238c4ea0bf50,PAYMENT,20-30,2018,8,13,4,0,Monday,7 days,60389.25
ACC-819621312,30,55.0,1711.57,,CUS-1271030853,2018-08-13,Michele,F,-37.85,145.04,,,,,,,debit,posted,137c7fc4392b418c8945779def0b997a,INTER BANK,20-30,2018,8,13,15,0,Monday,7 days,60389.25
ACC-819621312,30,98.0,2771.72,,CUS-1271030853,2018-08-17,Michele,F,-37.85,145.04,,,,,,,debit,posted,4a9f070ac58649cda31e022f94607d34,PAYMENT,20-30,2018,8,17,19,0,Friday,7 days,60389.25
ACC-819621312,30,43.62,2728.1,1.0,CUS-1271030853,2018-08-18,Michele,F,-37.85,145.04,,eff3a2d0-61ab-45af-9b7f-9b304f2e87ee,-37.84,145.27,VIC,Bayswater,debit,authorized,6a4776983a8e480580dd3acbc2ba44ac,POS,20-30,2018,8,18,9,14,Saturday,7 days,60389.25
ACC-819621312,30,16.69,2711.41,1.0,CUS-1271030853,2018-08-19,Michele,F,-37.85,145.04,,e3567b45-cf99-414e-a58f-db379644d8c6,-37.76,145.17,VIC,Doncaster East,debit,authorized,38785516312648c6a6a5f0a77123e218,POS,20-30,2018,8,19,6,48,Sunday,7 days,60389.25
ACC-819621312,30,66.0,2645.41,,CUS-1271030853,2018-08-20,Michele,F,-37.85,145.04,,,,,,,debit,posted,f26f1306eb9c4824b73c78da83abe980,PAYMENT,20-30,2018,8,20,4,0,Monday,7 days,60389.25
ACC-819621312,30,55.0,2572.02,,CUS-1271030853,2018-08-20,Michele,F,-37.85,145.04,,,,,,,debit,posted,d537917f7dd54a17a44dfa1aff35e00f,INTER BANK,20-30,2018,8,20,15,0,Monday,7 days,60389.25
ACC-819621312,30,18.39,2627.02,1.0,CUS-1271030853,2018-08-20,Michele,F,-37.85,145.04,,b17bef65-59e5-47d2-a29d-de0eee07b72e,-37.76,144.97,VIC,Brunswick East,debit,authorized,9cb6248584f94777b2d9be8718705890,SALES-POS,20-30,2018,8,20,15,19,Monday,7 days,60389.25
ACC-819621312,30,36.1,2535.92,1.0,CUS-1271030853,2018-08-20,Michele,F,-37.85,145.04,,1c849f6f-931e-49c8-8f0d-bed47330e96f,-37.81,144.96,VIC,Melbourne,debit,authorized,1cef85c8c3044d9ebfc34b9eab7edcb8,SALES-POS,20-30,2018,8,20,16,57,Monday,7 days,60389.25
ACC-819621312,30,20.96,2514.96,1.0,CUS-1271030853,2018-08-20,Michele,F,-37.85,145.04,,95d71275-b1b2-4af3-b7bb-5b4bcc6ea68d,-37.77,144.96,VIC,Brunswick,debit,authorized,af33b1e83cca478185b623f058dc7ded,POS,20-30,2018,8,20,23,9,Monday,7 days,60389.25
ACC-819621312,30,35.43,2479.53,1.0,CUS-1271030853,2018-08-21,Michele,F,-37.85,145.04,,0faf23a9-d9b1-4861-9852-bb5f49635b09,-37.9,145.06,VIC,Murrumbeena,debit,authorized,7fee02ff12374a16b1493ab4552db46d,SALES-POS,20-30,2018,8,21,9,14,Tuesday,7 days,60389.25
ACC-819621312,30,9.28,2470.25,1.0,CUS-1271030853,2018-08-21,Michele,F,-37.85,145.04,,8930bc3c-194c-41d2-9ead-70f04b3d37ea,-37.8,144.96,VIC,Parkville,debit,authorized,cf0e72012fa24d4f8dc2ced876ee859b,POS,20-30,2018,8,21,9,47,Tuesday,7 days,60389.25
ACC-819621312,30,58.1,2412.15,1.0,CUS-1271030853,2018-08-21,Michele,F,-37.85,145.04,,4cd67a3e-2cac-4d3f-91c9-fc45b6c4483f,-37.82,147.63,VIC,Bairnsdale,debit,authorized,98983f56b4824850a7553aab403e9655,SALES-POS,20-30,2018,8,21,12,33,Tuesday,7 days,60389.25
ACC-819621312,30,10.77,2401.38,1.0,CUS-1271030853,2018-08-21,Michele,F,-37.85,145.04,,c9680ddd-2fd7-423e-92de-ff7d2fef56ba,-37.84,144.69,VIC,Tarneit,debit,authorized,dde09218717a4fb68d85d4ced30dcb83,SALES-POS,20-30,2018,8,21,19,54,Tuesday,7 days,60389.25
ACC-819621312,30,25.8,2375.58,1.0,CUS-1271030853,2018-08-22,Michele,F,-37.85,145.04,,bf62cfa9-b1fd-4b74-bc94-5faed6a1b9de,-37.74,145.03,VIC,Preston,debit,authorized,49f98ee903934642acd49788ebf9dfc2,POS,20-30,2018,8,22,11,56,Wednesday,7 days,60389.25
ACC-819621312,30,66.0,3467.73,,CUS-1271030853,2018-08-27,Michele,F,-37.85,145.04,,,,,,,debit,posted,89356e213dd54fcfa981d500da2a16be,PAYMENT,20-30,2018,8,27,4,0,Monday,7 days,60389.25
ACC-819621312,30,55.0,3412.73,,CUS-1271030853,2018-08-27,Michele,F,-37.85,145.04,,,,,,,debit,posted,a3abe04a8df544bba641e5c59d2729a5,INTER BANK,20-30,2018,8,27,15,0,Monday,7 days,60389.25
ACC-819621312,30,33.2,3379.53,0.0,CUS-1271030853,2018-08-29,Michele,F,-37.85,145.04,,47914b27-cb1b-40b2-87c0-14a614c023cb,-37.87,145.24,VIC,Wantirna South,debit,authorized,c0d54d39a92d4c3f8f610892a3179581,SALES-POS,20-30,2018,8,29,11,58,Wednesday,7 days,60389.25
ACC-819621312,30,18.01,4519.67,1.0,CUS-1271030853,2018-08-31,Michele,F,-37.85,145.04,,82858de0-5a6d-4b2a-a1a2-8d902328336d,-37.91,145.1,VIC,Huntingdale,debit,authorized,8c763454f7cf4a7585ece491da3d5eb5,POS,20-30,2018,8,31,15,34,Friday,7 days,60389.25
ACC-819621312,30,118.3,4401.37,1.0,CUS-1271030853,2018-08-31,Michele,F,-37.85,145.04,,a4e65e35-4a97-4406-9e56-48a831ef9d91,-37.77,144.89,VIC,Maribyrnong,debit,authorized,dcddc0a070964e97a8fa33989f05f34e,POS,20-30,2018,8,31,20,5,Friday,7 days,60389.25
ACC-819621312,30,24.27,4377.1,1.0,CUS-1271030853,2018-08-31,Michele,F,-37.85,145.04,,d5887d53-1850-4274-8348-c5751e7148ac,-37.85,140.79,SA,Mt Gambier,debit,authorized,fb13c37126df419895ecbb67370cb3c8,SALES-POS,20-30,2018,8,31,20,50,Friday,7 days,60389.25
ACC-819621312,30,18.11,4358.99,0.0,CUS-1271030853,2018-08-31,Michele,F,-37.85,145.04,,a89086cf-e639-43bc-8039-eb0b46ae7fd2,-37.81,144.96,VIC,Melbourne,debit,authorized,12630b9cdabd4bf6b51aeee94fadfecb,POS,20-30,2018,8,31,21,54,Friday,7 days,60389.25
ACC-819621312,30,27.46,4331.53,0.0,CUS-1271030853,2018-09-01,Michele,F,-37.85,145.04,,229b2f27-a417-48ee-b121-526b156558d6,-38.03,145.11,VIC,Edithvale,debit,authorized,0328899508d84fdd90bf3abd26a5f58c,SALES-POS,20-30,2018,9,1,2,57,Saturday,7 days,60389.25
ACC-819621312,30,78.73,4252.8,1.0,CUS-1271030853,2018-09-01,Michele,F,-37.85,145.04,,a8d4ae96-b786-474a-b65c-12b76a2bab55,-37.79,144.97,VIC,Carlton North,debit,authorized,981cedc5fb184e438c06ea8dbc90f0c0,POS,20-30,2018,9,1,8,57,Saturday,7 days,60389.25
ACC-819621312,30,57.77,4195.03,1.0,CUS-1271030853,2018-09-01,Michele,F,-37.85,145.04,,5d2fe9e6-efb6-44e5-be25-85ac9bb7a4bf,-37.76,144.9,VIC,Aberfeldie,debit,authorized,deb6b4940f904f1d88099730e83bac96,POS,20-30,2018,9,1,9,46,Saturday,7 days,60389.25
ACC-819621312,30,26.56,4168.47,0.0,CUS-1271030853,2018-09-02,Michele,F,-37.85,145.04,,375fd692-ea5d-43f5-bfc4-1eec96af7cee,-37.76,144.75,VIC,Ravenhall,debit,authorized,a4f00fc46f7e44deaa6840d55a1415a2,SALES-POS,20-30,2018,9,2,9,15,Sunday,7 days,60389.25
ACC-819621312,30,20.83,4147.64,1.0,CUS-1271030853,2018-09-02,Michele,F,-37.85,145.04,,84570b8f-77c1-4a6c-b4fc-fb7ac8c1205f,-37.87,144.99,VIC,Saint Kilda East,debit,authorized,d8412c6091a84d6089f6091f529bc3b5,POS,20-30,2018,9,2,10,21,Sunday,7 days,60389.25
ACC-819621312,30,13.44,4134.2,1.0,CUS-1271030853,2018-09-02,Michele,F,-37.85,145.04,,05360bfc-bb3f-4995-8712-b1887fff73a1,-37.89,145.08,VIC,Chadstone,debit,authorized,79e46de6216145128f3a0cfc5d784583,SALES-POS,20-30,2018,9,2,19,58,Sunday,7 days,60389.25
ACC-819621312,30,66.0,4068.2,,CUS-1271030853,2018-09-03,Michele,F,-37.85,145.04,,,,,,,debit,posted,e35662c92cb3444088e35b34c646fa49,PAYMENT,20-30,2018,9,3,4,0,Monday,7 days,60389.25
ACC-819621312,30,25.8,4042.4,1.0,CUS-1271030853,2018-09-03,Michele,F,-37.85,145.04,,9482865d-8e79-444d-8d25-36469faaba54,-37.85,145.38,VIC,Olinda,debit,authorized,5fe2b033ff3b4e27b3db32e7c3d71e62,SALES-POS,20-30,2018,9,3,9,9,Monday,7 days,60389.25
ACC-819621312,30,168.0,3874.4,,CUS-1271030853,2018-09-03,Michele,F,-37.85,145.04,,,,,,,debit,posted,196c39062b4c4d9a916801e8e83a9ff0,INTER BANK,20-30,2018,9,3,12,0,Monday,7 days,60389.25
ACC-819621312,30,55.0,3819.4,,CUS-1271030853,2018-09-03,Michele,F,-37.85,145.04,,,,,,,debit,posted,f9462f0cd69e4fd98e9384eb737c30ca,INTER BANK,20-30,2018,9,3,15,0,Monday,7 days,60389.25
ACC-819621312,30,13.15,4964.4,1.0,CUS-1271030853,2018-09-05,Michele,F,-37.85,145.04,,50565326-4b71-4946-aa6b-ff3f418114f9,-37.81,145.12,VIC,Box Hill,debit,authorized,a60097bb8574428bab28eafa16adc043,SALES-POS,20-30,2018,9,5,23,35,Wednesday,7 days,60389.25
ACC-819621312,30,154.0,4810.4,,CUS-1271030853,2018-09-07,Michele,F,-37.85,145.04,,,,,,,debit,posted,0e78e1b65f734ef3a5870bea344954af,PAYMENT,20-30,2018,9,7,17,0,Friday,7 days,60389.25
ACC-819621312,30,66.0,4744.4,,CUS-1271030853,2018-09-10,Michele,F,-37.85,145.04,,,,,,,debit,posted,bd9ec20bf8c94a47a1a00719c77f0abf,PAYMENT,20-30,2018,9,10,4,0,Monday,7 days,60389.25
ACC-819621312,30,55.0,4689.4,,CUS-1271030853,2018-09-10,Michele,F,-37.85,145.04,,,,,,,debit,posted,74f34cb0d8ac4ae9bd9a919f9efca6e7,INTER BANK,20-30,2018,9,10,15,0,Monday,7 days,60389.25
ACC-819621312,30,109.0,4580.4,,CUS-1271030853,2018-09-11,Michele,F,-37.85,145.04,,,,,,,debit,posted,f9fafcd339784b0285883f43b4d4a620,PAYMENT,20-30,2018,9,11,9,0,Tuesday,7 days,60389.25
ACC-819621312,30,66.0,5672.55,,CUS-1271030853,2018-09-17,Michele,F,-37.85,145.04,,,,,,,debit,posted,80082983295a45138fbe821320a8a414,PAYMENT,20-30,2018,9,17,4,0,Monday,7 days,60389.25
ACC-819621312,30,55.0,5617.55,,CUS-1271030853,2018-09-17,Michele,F,-37.85,145.04,,,,,,,debit,posted,b59a18c0e43a4c89b66ebc58e5744572,INTER BANK,20-30,2018,9,17,15,0,Monday,7 days,60389.25
ACC-819621312,30,98.0,5519.55,,CUS-1271030853,2018-09-17,Michele,F,-37.85,145.04,,,,,,,debit,posted,1a7379bc32584bf38df3780d6db84b06,PAYMENT,20-30,2018,9,17,19,0,Monday,7 days,60389.25
ACC-819621312,30,24.83,5494.72,1.0,CUS-1271030853,2018-09-17,Michele,F,-37.85,145.04,,b64b1423-0992-4942-b955-5785b81c1cd6,-37.8,145.32,VIC,Kilsyth,debit,authorized,376a1f669c044f5ba6f917a12309da3d,POS,20-30,2018,9,17,21,44,Monday,7 days,60389.25
ACC-819621312,30,65.49,5429.23,0.0,CUS-1271030853,2018-09-18,Michele,F,-37.85,145.04,,2d3f9099-eb95-48d7-8e34-ef4c4f1e492b,-37.83,144.99,VIC,Cremorne,debit,authorized,952564f747404e85ad35428f52850ed2,POS,20-30,2018,9,18,10,9,Tuesday,7 days,60389.25
ACC-819621312,30,34.75,5394.48,1.0,CUS-1271030853,2018-09-19,Michele,F,-37.85,145.04,,e2286df2-81db-4396-9078-5ef1e4073831,-37.7,145.06,VIC,Kingsbury,debit,authorized,36984a3a8a1f4a928e6c7223efe523ee,POS,20-30,2018,9,19,9,33,Wednesday,7 days,60389.25
ACC-819621312,30,20.12,5374.36,1.0,CUS-1271030853,2018-09-19,Michele,F,-37.85,145.04,,d6a3deff-35b5-45a7-a536-30891f40cfc7,-37.81,144.96,VIC,Melbourne,debit,authorized,6df2a1768ad447e2b31cad550ad96adc,SALES-POS,20-30,2018,9,19,9,39,Wednesday,7 days,60389.25
ACC-819621312,30,12.37,5361.99,1.0,CUS-1271030853,2018-09-19,Michele,F,-37.85,145.04,,934890a0-37c4-4745-be2f-271aa98c235a,-37.88,144.73,VIC,Point Cook,debit,authorized,ddbe83c550da4c16a50b3d66fc3c6894,SALES-POS,20-30,2018,9,19,10,9,Wednesday,7 days,60389.25
ACC-819621312,30,38.27,5323.72,1.0,CUS-1271030853,2018-09-19,Michele,F,-37.85,145.04,,f0eafe9c-a6de-4e93-8841-593cf4e67ff3,-37.89,145.16,VIC,Glen Waverley,debit,authorized,39b0976faf114dcb8a988988a5ee699a,POS,20-30,2018,9,19,12,50,Wednesday,7 days,60389.25
ACC-819621312,30,10.28,6471.59,1.0,CUS-1271030853,2018-09-21,Michele,F,-37.85,145.04,,0a142703-a518-46ac-b854-a98a334f9b27,-37.88,147.99,VIC,Lakes Entrance,debit,authorized,b6ff6756ae71459382a6ffe14eaf63cf,POS,20-30,2018,9,21,9,32,Friday,7 days,60389.25
ACC-819621312,30,66.0,6405.59,,CUS-1271030853,2018-09-24,Michele,F,-37.85,145.04,,,,,,,debit,posted,413bcc93838b41a9ac45d3d35a199aef,PAYMENT,20-30,2018,9,24,4,0,Monday,7 days,60389.25
ACC-819621312,30,55.0,6350.59,,CUS-1271030853,2018-09-24,Michele,F,-37.85,145.04,,,,,,,debit,posted,966529033b43420e8ef7dec118b86f7e,INTER BANK,20-30,2018,9,24,15,0,Monday,7 days,60389.25
ACC-819621312,30,31.19,6319.4,1.0,CUS-1271030853,2018-09-26,Michele,F,-37.85,145.04,,ba2a7a5c-8689-4aa0-af00-b28a19222844,-37.88,145.3,VIC,Ferntree Gully,debit,authorized,1cbe25de2fd342719847806a3728703a,SALES-POS,20-30,2018,9,26,13,47,Wednesday,7 days,60389.25
ACC-819621312,30,13.44,6305.96,1.0,CUS-1271030853,2018-09-26,Michele,F,-37.85,145.04,,1a48ffe9-8e3c-4ff1-969e-fff37762269a,-37.83,147.63,VIC,Bairnsdale,debit,authorized,2289a9ae12fe4918a60ef49e4c39994b,SALES-POS,20-30,2018,9,26,14,12,Wednesday,7 days,60389.25
ACC-819621312,30,36.95,6269.01,1.0,CUS-1271030853,2018-09-26,Michele,F,-37.85,145.04,,e8d3e859-db04-4b1b-9e7c-0ae39f23ca67,-37.78,145.16,VIC,Doncaster East,debit,authorized,25aab9b82bdb4a27aae009cbb98cbebb,SALES-POS,20-30,2018,9,26,14,51,Wednesday,7 days,60389.25
ACC-819621312,30,17.31,6251.7,1.0,CUS-1271030853,2018-09-26,Michele,F,-37.85,145.04,,411c9c49-f7c0-478f-9d65-7f62c35e655f,-37.82,145.04,VIC,Hawthorn,debit,authorized,e7c51a3c0d0f44cdbeab55622d88ed48,POS,20-30,2018,9,26,17,4,Wednesday,7 days,60389.25
ACC-819621312,30,20.98,7388.87,1.0,CUS-1271030853,2018-09-26,Michele,F,-37.85,145.04,,928682c2-0f98-4964-ac68-1215a8cc14c6,-37.82,145.15,VIC,Blackburn,debit,authorized,9bfd2dce55fa444c846106674f6889eb,POS,20-30,2018,9,26,23,23,Wednesday,7 days,60389.25
ACC-819621312,30,52.24,7336.63,1.0,CUS-1271030853,2018-09-27,Michele,F,-37.85,145.04,,82f7e5ee-3023-4f07-8567-cdc7cb2add27,-37.89,145.29,VIC,Ferntree Gully,debit,authorized,fb3d873d385d46429e8adde7c678f8ad,SALES-POS,20-30,2018,9,27,1,26,Thursday,7 days,60389.25
ACC-819621312,30,13.44,7323.19,0.0,CUS-1271030853,2018-09-27,Michele,F,-37.85,145.04,,81fe1636-2edb-4a2f-ae93-3d375027047b,-37.76,145.31,VIC,Chirnside Park,debit,authorized,a2aae6cc444346c4977ef5d6021fc898,POS,20-30,2018,9,27,12,14,Thursday,7 days,60389.25
ACC-819621312,30,62.91,7260.28,1.0,CUS-1271030853,2018-09-27,Michele,F,-37.85,145.04,,e6389142-a34c-4515-b2bf-1adb67d12aee,-37.89,145,VIC,Elsternwick,debit,authorized,52d2c60e6260433ba4525f978ac18e94,POS,20-30,2018,9,27,12,32,Thursday,7 days,60389.25
ACC-819621312,30,31.7,7228.58,1.0,CUS-1271030853,2018-09-29,Michele,F,-37.85,145.04,,57de149c-95cb-4fc4-89b1-c64249e6aee1,-37.83,144.96,VIC,South Melbourne,debit,authorized,b729f3ba02ff44de8ad0b7ee9dd5826a,POS,20-30,2018,9,29,15,30,Saturday,7 days,60389.25
ACC-819621312,30,18.06,7210.52,1.0,CUS-1271030853,2018-09-29,Michele,F,-37.85,145.04,,d84f95ea-8b57-4ed5-a1c9-77f0176d5170,-37.79,144.99,VIC,Collingwood,debit,authorized,67a68a0011a94469a67f5fbe56429a40,POS,20-30,2018,9,29,18,28,Saturday,7 days,60389.25
ACC-819621312,30,17.0,7193.52,1.0,CUS-1271030853,2018-09-29,Michele,F,-37.85,145.04,,238774cb-e57c-4054-815a-be7606a52038,-37.83,140.78,SA,Mount Gambier,debit,authorized,03bfbeeea6cf4411b593976f51289b83,SALES-POS,20-30,2018,9,29,19,46,Saturday,7 days,60389.25
ACC-819621312,30,23.56,7169.96,1.0,CUS-1271030853,2018-09-30,Michele,F,-37.85,145.04,,03ae6833-0686-486b-ad5e-506357c9ad7b,-37.82,144.82,VIC,Laverton North,debit,authorized,151d7030c00c42298e833714f1e952d3,POS,20-30,2018,9,30,14,16,Sunday,7 days,60389.25
ACC-819621312,30,66.0,7103.96,,CUS-1271030853,2018-10-01,Michele,F,-37.85,145.04,,,,,,,debit,posted,19743614099a4d6d9a63b1b4ad5d3f5c,PAYMENT,20-30,2018,10,1,4,0,Monday,7 days,60389.25
ACC-819621312,30,37.08,7066.88,1.0,CUS-1271030853,2018-10-01,Michele,F,-37.85,145.04,,2d154558-1365-4551-9df7-6b05aa0b41b4,-37.84,145,VIC,South Yarra,debit,authorized,65f145967b714fb7bd2cab62fd8c308d,SALES-POS,20-30,2018,10,1,8,13,Monday,7 days,60389.25
ACC-819621312,30,55.0,7011.88,,CUS-1271030853,2018-10-01,Michele,F,-37.85,145.04,,,,,,,debit,posted,ff35cc1fbeff4443b9658253bc82ffe1,INTER BANK,20-30,2018,10,1,15,0,Monday,7 days,60389.25
ACC-819621312,30,30.6,6981.28,1.0,CUS-1271030853,2018-10-03,Michele,F,-37.85,145.04,,056d9919-d67e-4899-b1be-4abd384d5f7c,-37.82,145.19,VIC,Mitcham,debit,authorized,f31ea76a7ec64173a7996dfe8d58dfb4,SALES-POS,20-30,2018,10,3,9,12,Wednesday,7 days,60389.25
ACC-819621312,30,168.0,6813.28,,CUS-1271030853,2018-10-03,Michele,F,-37.85,145.04,,,,,,,debit,posted,72262fa2323141458035e882c03f0856,INTER BANK,20-30,2018,10,3,12,0,Wednesday,7 days,60389.25
ACC-819621312,30,154.0,7817.43,,CUS-1271030853,2018-10-07,Michele,F,-37.85,145.04,,,,,,,debit,posted,2f5973b501894799b03d3ff6f24da6dd,PAYMENT,20-30,2018,10,7,17,0,Sunday,7 days,60389.25
ACC-819621312,30,66.0,7751.43,,CUS-1271030853,2018-10-08,Michele,F,-37.85,145.04,,,,,,,debit,posted,f125408378f4452ba0b294a3d743bc4a,PAYMENT,20-30,2018,10,8,4,0,Monday,7 days,60389.25
ACC-819621312,30,55.0,7696.43,,CUS-1271030853,2018-10-08,Michele,F,-37.85,145.04,,,,,,,debit,posted,de7703ac8a6b4ceda4518f335770db50,INTER BANK,20-30,2018,10,8,15,0,Monday,7 days,60389.25
ACC-819621312,30,109.0,8733.77,,CUS-1271030853,2018-10-11,Michele,F,-37.85,145.04,,,,,,,debit,posted,08fd002bfc9f41cf94db575cd75ccb6d,PAYMENT,20-30,2018,10,11,9,0,Thursday,7 days,60389.25
ACC-819621312,30,11.81,8842.77,1.0,CUS-1271030853,2018-10-11,Michele,F,-37.85,145.04,,55fa9dc2-3d4c-4a1d-b1b4-f0121496b4e4,-37.84,144.67,VIC,Tarneit,debit,authorized,2334114356864cba8298ce5f8f8ec481,SALES-POS,20-30,2018,10,11,9,36,Thursday,7 days,60389.25
ACC-819621312,30,15.03,8718.74,0.0,CUS-1271030853,2018-10-13,Michele,F,-37.85,145.04,,de97b8b9-1816-4f66-ba7e-3df5e621e634,-37.81,144.96,VIC,Melbourne,debit,authorized,c86319c87e9649f0a0e6a959f8053b77,SALES-POS,20-30,2018,10,13,15,49,Saturday,7 days,60389.25
ACC-819621312,30,33.45,8685.29,1.0,CUS-1271030853,2018-10-14,Michele,F,-37.85,145.04,,4f448c60-c35f-4fac-ab36-22a162787b90,-37.68,144.58,VIC,Melton,debit,authorized,556d6678bc8647d1998e62e39b2cadb9,SALES-POS,20-30,2018,10,14,10,8,Sunday,7 days,60389.25
ACC-819621312,30,22.23,8663.06,0.0,CUS-1271030853,2018-10-15,Michele,F,-37.85,145.04,,9dea0355-5d72-4ef1-b495-439fe3dd64ce,-37.9,144.66,VIC,Werribee,debit,authorized,228b57ae970848919d0d23e50c30b39b,POS,20-30,2018,10,15,1,21,Monday,7 days,60389.25
ACC-819621312,30,66.0,8597.06,,CUS-1271030853,2018-10-15,Michele,F,-37.85,145.04,,,,,,,debit,posted,afaf6c3a376246afb87dcc310752d53a,PAYMENT,20-30,2018,10,15,4,0,Monday,7 days,60389.25
ACC-819621312,30,45.06,8552.0,1.0,CUS-1271030853,2018-10-15,Michele,F,-37.85,145.04,,9d50c611-15be-4907-a853-c3589c97b53e,-37.81,144.96,VIC,Melbourne,debit,authorized,c305df889a9f4cd98c7032cb17c4471f,SALES-POS,20-30,2018,10,15,8,46,Monday,7 days,60389.25
ACC-819621312,30,271.77,8280.23,1.0,CUS-1271030853,2018-10-15,Michele,F,-37.85,145.04,,472684b3-c854-4b94-bfce-5a807d1c2fd5,-37.75,144.99,VIC,Preston,debit,authorized,eb3c892a96924e8b8621f5c70d27246a,POS,20-30,2018,10,15,9,22,Monday,7 days,60389.25
ACC-819621312,30,55.74,8224.49,1.0,CUS-1271030853,2018-10-15,Michele,F,-37.85,145.04,,bd689db4-6bf3-452b-90e4-8ea880fe6055,-37.97,145.09,VIC,Moorabbin Airport,debit,authorized,217c25d4cdfb43e8a600ab85a8eaf57b,SALES-POS,20-30,2018,10,15,10,57,Monday,7 days,60389.25
ACC-819621312,30,55.0,8169.49,,CUS-1271030853,2018-10-15,Michele,F,-37.85,145.04,,,,,,,debit,posted,fe21450384484dd1be8bc27b7b169c3b,INTER BANK,20-30,2018,10,15,15,0,Monday,7 days,60389.25
ACC-819621312,30,98.0,9229.64,,CUS-1271030853,2018-10-17,Michele,F,-37.85,145.04,,,,,,,debit,posted,7b748faac191481a9d0b24886ff64f07,PAYMENT,20-30,2018,10,17,19,0,Wednesday,7 days,60389.25
ACC-819621312,30,25.74,9203.9,1.0,CUS-1271030853,2018-10-19,Michele,F,-37.85,145.04,,c3eb7d47-28a1-42c1-9a27-d1f01e9c696f,-37.78,144.91,VIC,Ascot Vale,debit,authorized,2ff89a655b3f49648dce5da81f38148e,SALES-POS,20-30,2018,10,19,11,41,Friday,7 days,60389.25
ACC-819621312,30,13.61,9190.29,1.0,CUS-1271030853,2018-10-19,Michele,F,-37.85,145.04,,0b90bfd8-f29a-4398-b479-b9b438189819,-38.02,145.31,VIC,Narre Warren,debit,authorized,06f8bbfc3cf54ccd8bcccee9bada5e22,SALES-POS,20-30,2018,10,19,13,10,Friday,7 days,60389.25
ACC-819621312,30,7.5,9182.79,1.0,CUS-1271030853,2018-10-19,Michele,F,-37.85,145.04,,24a7ddf4-bed9-4b6a-a7f6-50e76cb2a34b,-37.77,144.92,VIC,Moonee Ponds,debit,authorized,4f1a28346f814ad09f0046401993e42b,SALES-POS,20-30,2018,10,19,20,24,Friday,7 days,60389.25
ACC-819621312,30,12.69,9170.1,1.0,CUS-1271030853,2018-10-20,Michele,F,-37.85,145.04,,ab0a69ee-1395-4637-80b3-9be763c1080f,-37.89,145.28,VIC,Ferntree Gully,debit,authorized,7e2ae8ab5c72464688da1e5660914605,POS,20-30,2018,10,20,15,24,Saturday,7 days,60389.25
ACC-819621312,30,25.87,9144.23,1.0,CUS-1271030853,2018-10-21,Michele,F,-37.85,145.04,,0506581e-580e-461c-a49e-8db72058b808,-37.79,145.28,VIC,Croydon,debit,authorized,7304a6874ef84073a2356155e2c6a67d,POS,20-30,2018,10,21,3,37,Sunday,7 days,60389.25
ACC-819621312,30,7081.09,2063.14,1.0,CUS-1271030853,2018-10-21,Michele,F,-37.85,145.04,,af835ef4-60b7-4283-9d9a-5d0a8ab9cd6f,-27.48,153.02,QLD,South Brisbane,debit,authorized,2a882afd1d1c4eb28c3b5ccba14e240d,POS,20-30,2018,10,21,14,49,Sunday,7 days,60389.25
ACC-819621312,30,66.0,1997.14,,CUS-1271030853,2018-10-22,Michele,F,-37.85,145.04,,,,,,,debit,posted,b1cc3b74596948b2b08e560f963f2122,PAYMENT,20-30,2018,10,22,4,0,Monday,7 days,60389.25
ACC-819621312,30,2.57,1994.57,1.0,CUS-1271030853,2018-10-22,Michele,F,-37.85,145.04,,55a53c13-6560-4e2f-9ad2-2944650a7ac9,-37.72,145.01,VIC,Reservoir,debit,authorized,c4d187b7630449c7ac7f701d2b449b48,POS,20-30,2018,10,22,9,24,Monday,7 days,60389.25
ACC-819621312,30,55.0,1939.57,,CUS-1271030853,2018-10-22,Michele,F,-37.85,145.04,,,,,,,debit,posted,e25b4df85f224641967c37b4efecf7ca,INTER BANK,20-30,2018,10,22,15,0,Monday,7 days,60389.25
ACC-819621312,30,66.0,3031.72,,CUS-1271030853,2018-10-29,Michele,F,-37.85,145.04,,,,,,,debit,posted,a7d1b700002c4a50ba83208a56fe3ef7,PAYMENT,20-30,2018,10,29,4,0,Monday,7 days,60389.25
ACC-819621312,30,55.0,2976.72,,CUS-1271030853,2018-10-29,Michele,F,-37.85,145.04,,,,,,,debit,posted,1d41cb3ce61b445d8e6dfd31620543aa,INTER BANK,20-30,2018,10,29,15,0,Monday,7 days,60389.25
ACC-819621312,30,4.74,2971.98,1.0,CUS-1271030853,2018-10-30,Michele,F,-37.85,145.04,,fd52d425-ba86-4cfb-b094-28e976e6d561,-37.82,144.95,VIC,Melbourne,debit,authorized,30b1e37340fa4faeaeab0db0df54952f,SALES-POS,20-30,2018,10,30,14,20,Tuesday,7 days,60389.25
ACC-819621312,30,14.16,2957.82,1.0,CUS-1271030853,2018-10-31,Michele,F,-37.85,145.04,,60c463dc-4a97-45bb-824e-264db608ab51,-38.04,145.34,VIC,Berwick,debit,authorized,29fc7d86256c45ad950f91bb414df150,SALES-POS,20-30,2018,10,31,2,8,Wednesday,7 days,60389.25
ACC-819621312,30,23.03,2934.79,1.0,CUS-1271030853,2018-10-31,Michele,F,-37.85,145.04,,bbde3dae-ae79-4b6b-bb03-4d91a7f98b3b,-37.81,147.63,VIC,Eastwood,debit,authorized,69a79f95a59849e98576baa917966b78,POS,20-30,2018,10,31,8,40,Wednesday,7 days,60389.25
ACC-819621312,30,652.93,2281.86,1.0,CUS-1271030853,2018-10-31,Michele,F,-37.85,145.04,,7b4deb71-0e46-4da6-b2fa-7c718273f157,-37.83,140.78,SA,Mount Gambier,debit,authorized,deea499dc5644025a0939e56983a7a13,SALES-POS,20-30,2018,10,31,15,53,Wednesday,7 days,60389.25
ACC-1973887809,26,16.03,713.56,1.0,CUS-1646621553,2018-08-01,Antonio,M,-31.90,115.78,,e3136489-2e9f-4490-a7a4-9b5a8355776c,-32.07,115.8,WA,O'connor,debit,authorized,fff1c10f94b74ad78176503e32accb90,SALES-POS,20-30,2018,8,1,15,27,Wednesday,7 days,57300.307
ACC-1973887809,26,16.1,697.46,1.0,CUS-1646621553,2018-08-01,Antonio,M,-31.90,115.78,,bedfaec0-2483-449c-9d0f-b8492469a4a2,-31.91,152.46,NSW,Taree,debit,authorized,aadd1e78dc7f49f3b349c52d7c0219ed,POS,20-30,2018,8,1,15,45,Wednesday,7 days,57300.307
ACC-1973887809,26,29.0,1767.37,,CUS-1646621553,2018-08-01,Antonio,M,-31.90,115.78,,,,,,,debit,posted,eda8b3879259416babb3a397d9c45e30,PAYMENT,20-30,2018,8,1,23,0,Wednesday,7 days,57300.307
ACC-1973887809,26,24.65,1742.72,1.0,CUS-1646621553,2018-08-02,Antonio,M,-31.90,115.78,,6612f628-3ffa-49c1-876f-8a380b650865,-32.05,115.75,WA,Fremantle,debit,authorized,daab798cdc824168917207d15ccaf825,POS,20-30,2018,8,2,11,40,Thursday,7 days,57300.307
ACC-1973887809,26,30.33,1712.39,1.0,CUS-1646621553,2018-08-02,Antonio,M,-31.90,115.78,,ebee4cb7-91db-43e1-aab7-730bbe227f29,-31.94,115.84,WA,Leederville,debit,authorized,61cb593714d74db9a4d0f8ec7422eb32,POS,20-30,2018,8,2,14,10,Thursday,7 days,57300.307
ACC-1973887809,26,48.8,1663.59,1.0,CUS-1646621553,2018-08-02,Antonio,M,-31.90,115.78,,305e042f-991a-4d4b-b267-394ae087c7f2,-31.98,115.78,WA,Claremont,debit,authorized,b7117939b9e4488ebb9e433058fe69a2,SALES-POS,20-30,2018,8,2,15,56,Thursday,7 days,57300.307
ACC-1973887809,26,1233.8,429.79,1.0,CUS-1646621553,2018-08-03,Antonio,M,-31.90,115.78,,d17bf82c-2b7c-4def-afa0-56c15b9aa8a3,-33.86,151.21,NSW,Sydney,debit,authorized,2e9b490e458e41c78c01ff3e3ae308c3,POS,20-30,2018,8,3,13,6,Friday,7 days,57300.307
ACC-1973887809,26,5.09,424.7,1.0,CUS-1646621553,2018-08-04,Antonio,M,-31.90,115.78,,a7c6ec83-1423-4978-83b4-3e3c35528bba,-31.76,150.84,NSW,Murrurundi,debit,authorized,2515baacbfb4447fac62c1d18615a93c,POS,20-30,2018,8,4,22,23,Saturday,7 days,57300.307
ACC-1973887809,26,16.46,408.24,1.0,CUS-1646621553,2018-08-04,Antonio,M,-31.90,115.78,,dec98c7f-de17-4533-bd06-f6e5acd537b6,-31.96,141.45,NSW,Broken Hill,debit,authorized,80c0b5cdee4149a3ad8d6285abd5c548,SALES-POS,20-30,2018,8,4,22,35,Saturday,7 days,57300.307
ACC-1973887809,26,11.77,396.47,1.0,CUS-1646621553,2018-08-07,Antonio,M,-31.90,115.78,,67afad6e-2016-4422-a7a9-07911af7cc78,-31.85,115.79,WA,Duncraig,debit,authorized,fa0e716ec4c9468ab786d0b85ad10dab,SALES-POS,20-30,2018,8,7,15,59,Tuesday,7 days,57300.307
ACC-1973887809,26,17.79,378.68,1.0,CUS-1646621553,2018-08-08,Antonio,M,-31.90,115.78,,a83f2b24-784d-4b24-bcd7-bc5f03b1f0e2,-31.72,115.74,WA,Kinross,debit,authorized,d7f4267c934d4ba8873ec47e8225320e,POS,20-30,2018,8,8,10,15,Wednesday,7 days,57300.307
ACC-1973887809,26,29.0,1448.59,,CUS-1646621553,2018-08-08,Antonio,M,-31.90,115.78,,,,,,,debit,posted,5420826e26264138bccceda345bf35e9,PAYMENT,20-30,2018,8,8,23,0,Wednesday,7 days,57300.307
ACC-1973887809,26,11.59,1437.0,1.0,CUS-1646621553,2018-08-09,Antonio,M,-31.90,115.78,,be73bd2e-9525-44c6-b67d-4edb05c92600,-31.97,115.81,WA,Nedlands,debit,authorized,a65e0b3498da4671857c24c208a3eb81,SALES-POS,20-30,2018,8,9,1,47,Thursday,7 days,57300.307
ACC-1973887809,26,36.31,1400.69,1.0,CUS-1646621553,2018-08-09,Antonio,M,-31.90,115.78,,06fc41b9-a4a1-4ed1-9bbf-4a67e32a7a7c,-31.95,115.91,WA,Rivervale,debit,authorized,13dec4f8b36e4cf981041bd9412779ed,SALES-POS,20-30,2018,8,9,9,51,Thursday,7 days,57300.307
ACC-1973887809,26,199.0,1201.69,,CUS-1646621553,2018-08-10,Antonio,M,-31.90,115.78,,,,,,,debit,posted,d5958dbb0754478ebf98e7d9b26bc195,PAYMENT,20-30,2018,8,10,18,0,Friday,7 days,57300.307
ACC-1973887809,26,16.03,1185.66,1.0,CUS-1646621553,2018-08-10,Antonio,M,-31.90,115.78,,9e913dbb-fb5f-46d6-838f-8a4cc8ece867,-32.13,115.87,WA,Jandakot,debit,authorized,d63bc6ea82094b7fad94419088cf604f,POS,20-30,2018,8,10,20,59,Friday,7 days,57300.307
ACC-1973887809,26,106.0,1079.66,,CUS-1646621553,2018-08-13,Antonio,M,-31.90,115.78,,,,,,,debit,posted,3a22f59911084bc1a6423fb6642b1711,PAYMENT,20-30,2018,8,13,19,0,Monday,7 days,57300.307
ACC-1973887809,26,29.0,2149.57,,CUS-1646621553,2018-08-15,Antonio,M,-31.90,115.78,,,,,,,debit,posted,0b2df3b4ba1549c39a87771aaf014311,PAYMENT,20-30,2018,8,15,23,0,Wednesday,7 days,57300.307
ACC-1973887809,26,71.06,2070.46,1.0,CUS-1646621553,2018-08-21,Antonio,M,-31.90,115.78,,550c0b83-5997-4ac2-b699-2e68d81b6655,-31.8,115.75,WA,Hillarys,debit,authorized,27c9069e5c114485b4c95941784a8731,SALES-POS,20-30,2018,8,21,23,48,Tuesday,7 days,57300.307
ACC-1973887809,26,25.04,2045.42,1.0,CUS-1646621553,2018-08-22,Antonio,M,-31.90,115.78,,948749e3-471e-4a8f-92ad-73e934b95ec4,-33.87,151.21,NSW,Sydney,debit,authorized,ecbf6f1a8ec447d8a1fa04b7bfd1cc40,SALES-POS,20-30,2018,8,22,14,58,Wednesday,7 days,57300.307
ACC-1973887809,26,29.0,3115.33,,CUS-1646621553,2018-08-22,Antonio,M,-31.90,115.78,,,,,,,debit,posted,58ef8584e37c42738831a76a1202afcf,PAYMENT,20-30,2018,8,22,23,0,Wednesday,7 days,57300.307
ACC-1973887809,26,18.11,3097.22,1.0,CUS-1646621553,2018-08-23,Antonio,M,-31.90,115.78,,4c106993-485e-4893-b7c4-02737bfe37da,-31.88,115.96,WA,Caversham,debit,authorized,77b21b2de6ca42e8b97dbb737ac44507,POS,20-30,2018,8,23,20,15,Thursday,7 days,57300.307
ACC-1973887809,26,83.2,3014.02,1.0,CUS-1646621553,2018-08-24,Antonio,M,-31.90,115.78,,f4cfc3c1-9926-47ad-b094-d912f325ae3f,-33.87,151.21,NSW,Sydney,debit,authorized,cf29ee4436ac4034bab61c9310c751c1,SALES-POS,20-30,2018,8,24,8,34,Friday,7 days,57300.307
ACC-1973887809,26,63.12,2950.9,1.0,CUS-1646621553,2018-08-24,Antonio,M,-31.90,115.78,,56a95a99-0036-4727-a604-b8afcad982b1,-31.67,115.72,WA,Merriwa,debit,authorized,0d1d0e525ebd4e32a12620b0a81864df,POS,20-30,2018,8,24,19,1,Friday,7 days,57300.307
ACC-1973887809,26,18.34,2932.56,0.0,CUS-1646621553,2018-08-24,Antonio,M,-31.90,115.78,,8fcacad6-0b36-4abd-8e22-2e5d812e2acc,-32.05,116,WA,Maddington,debit,authorized,d6c3e7616d6d42308efeb49b12f95a9b,SALES-POS,20-30,2018,8,24,21,9,Friday,7 days,57300.307
ACC-1973887809,26,9.73,2922.83,0.0,CUS-1646621553,2018-08-25,Antonio,M,-31.90,115.78,,618eb9ff-1bd1-4915-a1a9-58d6287fd9b3,-31.65,116.67,WA,Northam,debit,authorized,ccfb47f46c6b45879600101c0fa40a0b,POS,20-30,2018,8,25,8,44,Saturday,7 days,57300.307
ACC-1973887809,26,84.0,2838.83,,CUS-1646621553,2018-08-27,Antonio,M,-31.90,115.78,,,,,,,debit,posted,a84aef235ae8498ba45503d435f61bef,PAYMENT,20-30,2018,8,27,23,0,Monday,7 days,57300.307
ACC-1973887809,26,29.0,3908.74,,CUS-1646621553,2018-08-29,Antonio,M,-31.90,115.78,,,,,,,debit,posted,e3784796a1154cada4c65aeb5c7b3c5e,PAYMENT,20-30,2018,8,29,23,0,Wednesday,7 days,57300.307
ACC-1973887809,26,49.24,3859.5,1.0,CUS-1646621553,2018-08-30,Antonio,M,-31.90,115.78,,8caf462b-ee93-48b6-b57e-865cc10f3a18,-31.69,115.72,WA,Clarkson,debit,authorized,d9571a76d16042fdb92f689e26e2e21f,POS,20-30,2018,8,30,18,35,Thursday,7 days,57300.307
ACC-1973887809,26,46.55,3812.95,0.0,CUS-1646621553,2018-09-04,Antonio,M,-31.90,115.78,,58cd3120-ac03-4968-9c6d-0f3523469769,-31.97,152.58,NSW,Old Bar,debit,authorized,57c8bc6d17b245e29517a7d198ebe838,POS,20-30,2018,9,4,17,57,Tuesday,7 days,57300.307
ACC-1973887809,26,35.16,3777.79,1.0,CUS-1646621553,2018-09-04,Antonio,M,-31.90,115.78,,ab7309b7-ad87-4d24-bd87-111c70b56759,-37.84,144.97,VIC,Melbourne,debit,authorized,918b5e5743c744c58a2f4597672ff937,POS,20-30,2018,9,4,21,0,Tuesday,7 days,57300.307
ACC-1973887809,26,18.84,3758.95,1.0,CUS-1646621553,2018-09-05,Antonio,M,-31.90,115.78,,ca566103-e2ba-4a75-965b-e914f077fafc,-31.73,115.8,WA,Ashby,debit,authorized,464c54ae5ea54d898a7eb8ae4b3ad877,SALES-POS,20-30,2018,9,5,9,47,Wednesday,7 days,57300.307
ACC-1973887809,26,29.0,4828.86,,CUS-1646621553,2018-09-05,Antonio,M,-31.90,115.78,,,,,,,debit,posted,64400887c5794904be9e94c97c74e1ae,PAYMENT,20-30,2018,9,5,23,0,Wednesday,7 days,57300.307
ACC-1973887809,26,23.68,4805.18,1.0,CUS-1646621553,2018-09-06,Antonio,M,-31.90,115.78,,3f8515fb-933b-4665-9a46-36b05d66815a,-31.87,115.86,WA,Mirrabooka,debit,authorized,b3a03463277f4e96ad1ab7eaa68b14a8,SALES-POS,20-30,2018,9,6,8,37,Thursday,7 days,57300.307
ACC-1973887809,26,30.55,4774.63,1.0,CUS-1646621553,2018-09-06,Antonio,M,-31.90,115.78,,d58feb17-8efc-454c-9fcc-f4011f6a1e3a,-32.04,115.91,WA,Riverton,debit,authorized,307316fe88bd45e3bd8bb8632d889ad7,POS,20-30,2018,9,6,9,56,Thursday,7 days,57300.307
ACC-1973887809,26,199.0,4575.63,,CUS-1646621553,2018-09-10,Antonio,M,-31.90,115.78,,,,,,,debit,posted,e6f7e7d915064d5bb657eecdd1e9ddf0,PAYMENT,20-30,2018,9,10,18,0,Monday,7 days,57300.307
ACC-1973887809,26,29.0,5645.54,,CUS-1646621553,2018-09-12,Antonio,M,-31.90,115.78,,,,,,,debit,posted,3d45aefe595f4e01b5cead04f458a8b3,PAYMENT,20-30,2018,9,12,23,0,Wednesday,7 days,57300.307
ACC-1973887809,26,106.0,5539.54,,CUS-1646621553,2018-09-13,Antonio,M,-31.90,115.78,,,,,,,debit,posted,aaf8f39ac0954fc988be54b2fe6cc4fc,PAYMENT,20-30,2018,9,13,19,0,Thursday,7 days,57300.307
ACC-1973887809,26,29.0,6609.45,,CUS-1646621553,2018-09-19,Antonio,M,-31.90,115.78,,,,,,,debit,posted,87bb08b5808548d7b6243d811661f679,PAYMENT,20-30,2018,9,19,23,0,Wednesday,7 days,57300.307
ACC-1973887809,26,27.32,6582.13,0.0,CUS-1646621553,2018-09-21,Antonio,M,-31.90,115.78,,cc9bc423-e43a-46cb-abd0-00961d3d48e6,-31.85,115.79,WA,Duncraig,debit,authorized,a86543eb77d04eb397bd577579f2c224,SALES-POS,20-30,2018,9,21,8,57,Friday,7 days,57300.307
ACC-1973887809,26,33.31,6548.82,0.0,CUS-1646621553,2018-09-21,Antonio,M,-31.90,115.78,,8b7b82ac-e475-433a-8dfb-8649e0a02514,-31.74,115.77,WA,Joondalup,debit,authorized,c241e7352257427aab7d87a9e0422d48,POS,20-30,2018,9,21,19,43,Friday,7 days,57300.307
ACC-1973887809,26,21.23,6527.59,0.0,CUS-1646621553,2018-09-21,Antonio,M,-31.90,115.78,,e476a3a6-335b-4919-a14f-6264a6ca2b20,-31.94,115.87,WA,Mount Lawley,debit,authorized,947fab3e546a4e32aec8921b6d07f981,POS,20-30,2018,9,21,23,8,Friday,7 days,57300.307
ACC-1973887809,26,24.05,6503.54,1.0,CUS-1646621553,2018-09-22,Antonio,M,-31.90,115.78,,89c36d50-d37a-4b9e-8443-152ab3e77cc9,-31.95,141.47,NSW,Broken Hill,debit,authorized,e5f7b9ecbd8f42e3b0599b0d5f209f1b,SALES-POS,20-30,2018,9,22,3,7,Saturday,7 days,57300.307
ACC-1973887809,26,29.0,7573.45,,CUS-1646621553,2018-09-26,Antonio,M,-31.90,115.78,,,,,,,debit,posted,31720b0bb9f84ecca2e03f803bf5882c,PAYMENT,20-30,2018,9,26,23,0,Wednesday,7 days,57300.307
ACC-1973887809,26,84.0,7489.45,,CUS-1646621553,2018-09-27,Antonio,M,-31.90,115.78,,,,,,,debit,posted,9e709bc51cd844caabc224b258253adc,PAYMENT,20-30,2018,9,27,23,0,Thursday,7 days,57300.307
ACC-1973887809,26,19.74,7469.71,1.0,CUS-1646621553,2018-09-28,Antonio,M,-31.90,115.78,,c258f1f4-fec1-415a-91bc-564063061631,-31.94,115.81,WA,Wembley,debit,authorized,98481a3aa5204c899d384380cc80a05c,POS,20-30,2018,9,28,14,29,Friday,7 days,57300.307
ACC-1973887809,26,18.94,7450.77,1.0,CUS-1646621553,2018-09-29,Antonio,M,-31.90,115.78,,cb8073e5-4512-4756-8baa-daa04828045a,-31.79,115.82,WA,Wangara,debit,authorized,9f05c172d37a414a868fc713eb6e3cae,SALES-POS,20-30,2018,9,29,19,56,Saturday,7 days,57300.307
ACC-1973887809,26,26.0,7424.77,1.0,CUS-1646621553,2018-09-29,Antonio,M,-31.90,115.78,,5361dc44-57b7-4d42-abbb-1533e9e38e24,-31.77,115.77,WA,Beldon,debit,authorized,51801beee012408887b56925d35e8025,POS,20-30,2018,9,29,23,10,Saturday,7 days,57300.307
ACC-1973887809,26,76.28,7348.49,1.0,CUS-1646621553,2018-09-30,Antonio,M,-31.90,115.78,,4c843dbc-0934-4af5-bacb-9a813503bb6d,-28.1,153.42,QLD,Burleigh Heads,debit,authorized,19a7ade2498b478e9a0026fd9e248c10,SALES-POS,20-30,2018,9,30,1,46,Sunday,7 days,57300.307
ACC-1973887809,26,17.77,7330.72,1.0,CUS-1646621553,2018-09-30,Antonio,M,-31.90,115.78,,9f342cec-e5bd-472d-bee9-fa673c2bdf39,-32.07,152.54,NSW,Black Head,debit,authorized,c22167a233dd4d60b052f6452cbc86bc,SALES-POS,20-30,2018,9,30,16,16,Sunday,7 days,57300.307
ACC-1973887809,26,21.74,7308.98,1.0,CUS-1646621553,2018-10-01,Antonio,M,-31.90,115.78,,428f9cbe-9d7a-41b8-af5b-a9fa0cf63866,-31.79,132.23,SA,Coorabie,debit,authorized,0cddc5c53a6e4681ace11ba559f444ec,POS,20-30,2018,10,1,23,30,Monday,7 days,57300.307
ACC-1973887809,26,22.99,7285.99,0.0,CUS-1646621553,2018-10-02,Antonio,M,-31.90,115.78,,08656484-c355-4c63-bffc-3a89d8a9709b,-31.91,152.45,NSW,Taree,debit,authorized,6d3791f59b7f4e6eba142dc08f166168,SALES-POS,20-30,2018,10,2,0,29,Tuesday,7 days,57300.307
ACC-1973887809,26,1225.0,6060.99,,CUS-1646621553,2018-10-03,Antonio,M,-31.90,115.78,,,,,,,debit,posted,9c9d96587e224205bbd9d54cdbc2f3cc,PAYMENT,20-30,2018,10,3,3,0,Wednesday,7 days,57300.307
ACC-1973887809,26,29.0,7130.9,,CUS-1646621553,2018-10-03,Antonio,M,-31.90,115.78,,,,,,,debit,posted,460c23935cc64c8eb492048ebbff5713,PAYMENT,20-30,2018,10,3,23,0,Wednesday,7 days,57300.307
ACC-1973887809,26,9.28,7121.62,0.0,CUS-1646621553,2018-10-04,Antonio,M,-31.90,115.78,,d1e48030-c897-4e93-a7df-af25ff433496,-31.96,115.86,WA,Perth,debit,authorized,4ec0a97a03d24563b47f1ff25972135e,POS,20-30,2018,10,4,9,46,Thursday,7 days,57300.307
ACC-1973887809,26,19.52,7102.1,1.0,CUS-1646621553,2018-10-04,Antonio,M,-31.90,115.78,,0fe0a09e-ebe5-466c-ad0e-1836f560b9f1,-31.99,115.9,WA,East Victoria Park,debit,authorized,a53b3f4279484edab5fce854fe6b9986,POS,20-30,2018,10,4,14,29,Thursday,7 days,57300.307
ACC-1973887809,26,8.8,7093.3,1.0,CUS-1646621553,2018-10-04,Antonio,M,-31.90,115.78,,ee098a44-5d1d-4e28-a009-462b3ee33f84,-31.94,115.83,WA,Subiaco,debit,authorized,6dccf077ddc24495ac83a5bd2f451ace,SALES-POS,20-30,2018,10,4,15,9,Thursday,7 days,57300.307
ACC-1973887809,26,6.01,7087.29,1.0,CUS-1646621553,2018-10-04,Antonio,M,-31.90,115.78,,a7c6ec83-1423-4978-83b4-3e3c35528bba,-31.76,150.84,NSW,Murrurundi,debit,authorized,160a819c252c43e5a566711e67b42cbf,POS,20-30,2018,10,4,15,42,Thursday,7 days,57300.307
ACC-1973887809,26,28.23,7059.06,1.0,CUS-1646621553,2018-10-04,Antonio,M,-31.90,115.78,,89facb64-5037-43b8-bb7b-cd2a4eacd986,-32.01,115.92,WA,Cannington,debit,authorized,1e9557f02543458599a7b5ce61e2db60,SALES-POS,20-30,2018,10,4,20,4,Thursday,7 days,57300.307
ACC-1973887809,26,42.23,7016.83,1.0,CUS-1646621553,2018-10-05,Antonio,M,-31.90,115.78,,637958b7-c372-4c38-a893-c9717e4a6ac5,-31.84,115.81,WA,Warwick,debit,authorized,4646beb3740946a582ffdff7a24aae7f,POS,20-30,2018,10,5,21,26,Friday,7 days,57300.307
ACC-1973887809,26,19.15,6997.68,1.0,CUS-1646621553,2018-10-06,Antonio,M,-31.90,115.78,,9eead900-f871-4ecc-b545-9dd53a807abb,-31.93,115.87,WA,Mount Lawley,debit,authorized,1d2fe7c053724c1096768a19b5b7e68b,SALES-POS,20-30,2018,10,6,10,49,Saturday,7 days,57300.307
ACC-1973887809,26,23.07,6974.61,1.0,CUS-1646621553,2018-10-06,Antonio,M,-31.90,115.78,,037df7f6-f9a6-43d9-ac0b-2708f6bc712f,-31.89,115.9,WA,Morley,debit,authorized,1b0ccc9806084aa18927866fe3b764f7,POS,20-30,2018,10,6,17,35,Saturday,7 days,57300.307
ACC-1973887809,26,28.21,6946.4,0.0,CUS-1646621553,2018-10-06,Antonio,M,-31.90,115.78,,1442095a-d3ee-4536-9d80-2ddc67f4836a,-31.91,115.95,WA,Bassendean,debit,authorized,63bfa5ffb20f443daa2420f8033b2d6f,POS,20-30,2018,10,6,22,57,Saturday,7 days,57300.307
ACC-1973887809,26,55.89,6890.51,1.0,CUS-1646621553,2018-10-07,Antonio,M,-31.90,115.78,,faf8ddf3-25d6-4ee2-9254-158c65a13232,-31.87,115.86,WA,Mirrabooka,debit,authorized,26e4edf8b692446e8086490f89eefc56,POS,20-30,2018,10,7,4,42,Sunday,7 days,57300.307
ACC-1973887809,26,22.17,6868.34,1.0,CUS-1646621553,2018-10-07,Antonio,M,-31.90,115.78,,e238d83f-8459-452a-9872-e0233836a820,-32.03,115.79,WA,Bicton,debit,authorized,bfdc966a77c644ae96305b7962bc1ad9,SALES-POS,20-30,2018,10,7,11,24,Sunday,7 days,57300.307
ACC-1973887809,26,40.65,6827.69,0.0,CUS-1646621553,2018-10-07,Antonio,M,-31.90,115.78,,09458570-2ece-42b9-9ba6-8ef01f52fed1,-31.64,115.69,WA,Butler,debit,authorized,9d44fd6decc74ddb9bc7aaae744df197,POS,20-30,2018,10,7,14,6,Sunday,7 days,57300.307
ACC-1973887809,26,19.62,6808.07,1.0,CUS-1646621553,2018-10-07,Antonio,M,-31.90,115.78,,47e6975f-47eb-434d-b295-610454035b07,-31.74,115.74,WA,Currambine,debit,authorized,33147f3e31fe45da898c879faf2cf9e4,POS,20-30,2018,10,7,18,2,Sunday,7 days,57300.307
ACC-1973887809,26,10.47,6797.6,0.0,CUS-1646621553,2018-10-08,Antonio,M,-31.90,115.78,,5b425234-17d9-480c-8f4e-fdef1c476ab8,-31.8,115.75,WA,Hillarys,debit,authorized,8fcec5a89a9b48e49416f2134f71646b,SALES-POS,20-30,2018,10,8,10,6,Monday,7 days,57300.307
ACC-1973887809,26,23.64,6773.96,1.0,CUS-1646621553,2018-10-08,Antonio,M,-31.90,115.78,,c7e94263-6f0c-463e-bbbc-ccc1d1251034,-31.98,115.82,WA,Perth,debit,authorized,a08feae7f8e946968fbd556493acda69,SALES-POS,20-30,2018,10,8,12,21,Monday,7 days,57300.307
ACC-1973887809,26,27.26,6746.7,0.0,CUS-1646621553,2018-10-10,Antonio,M,-31.90,115.78,,b1c36e87-8132-4601-975b-df9c7e3b01b5,-32.28,115.73,WA,Rockingham,debit,authorized,1831170078294e7e8ddc9e2f0a76bb46,POS,20-30,2018,10,10,12,51,Wednesday,7 days,57300.307
ACC-1973887809,26,199.0,7646.61,,CUS-1646621553,2018-10-10,Antonio,M,-31.90,115.78,,,,,,,debit,posted,0776ec5925cc4b53a657db4ddaafca33,PAYMENT,20-30,2018,10,10,18,0,Wednesday,7 days,57300.307
ACC-1973887809,26,29.0,7617.61,,CUS-1646621553,2018-10-10,Antonio,M,-31.90,115.78,,,,,,,debit,posted,d87f316755554b2d816e7195538d3e15,PAYMENT,20-30,2018,10,10,23,0,Wednesday,7 days,57300.307
ACC-1973887809,26,30.18,7587.43,1.0,CUS-1646621553,2018-10-13,Antonio,M,-31.90,115.78,,728e9e20-c242-44fa-9da3-ac6ae8930cc7,-31.88,115.81,WA,Stirling,debit,authorized,400085bd108b492b93d1b31862345103,POS,20-30,2018,10,13,11,14,Saturday,7 days,57300.307
ACC-1973887809,26,106.0,7481.43,,CUS-1646621553,2018-10-13,Antonio,M,-31.90,115.78,,,,,,,debit,posted,e83879abeae3494eadbccac40ef1b5c5,PAYMENT,20-30,2018,10,13,19,0,Saturday,7 days,57300.307
ACC-1973887809,26,65.72,7415.71,1.0,CUS-1646621553,2018-10-13,Antonio,M,-31.90,115.78,,f7c2a095-4198-46b8-ad74-5eeba70e6766,-33.87,151.21,NSW,Sydney,debit,authorized,7a64ffa5f47e41b5b02d68a2ed67efdb,SALES-POS,20-30,2018,10,13,21,49,Saturday,7 days,57300.307
ACC-1973887809,26,6.37,7409.34,1.0,CUS-1646621553,2018-10-14,Antonio,M,-31.90,115.78,,fdb3eafd-8082-4657-8fdf-acaa5f3fded9,-31.99,116.01,WA,Forrestfield,debit,authorized,4d29586571df410f9d6c6b6175d43780,POS,20-30,2018,10,14,7,3,Sunday,7 days,57300.307
ACC-1973887809,26,24.22,7385.12,0.0,CUS-1646621553,2018-10-14,Antonio,M,-31.90,115.78,,710459ea-daa7-4bca-b763-33d53c09d8d6,-32.04,115.81,WA,Myaree,debit,authorized,39c9f7d9898745a9a15ac62002a15d52,POS,20-30,2018,10,14,9,40,Sunday,7 days,57300.307
ACC-1973887809,26,9.3,7375.82,1.0,CUS-1646621553,2018-10-15,Antonio,M,-31.90,115.78,,a76d2384-ac78-4b32-ab40-e961dbffbe68,-32.01,115.85,WA,Applecross,debit,authorized,7c35b5adc1644af38113a87d7a90341f,SALES-POS,20-30,2018,10,15,10,49,Monday,7 days,57300.307
ACC-1973887809,26,37.35,7338.47,1.0,CUS-1646621553,2018-10-15,Antonio,M,-31.90,115.78,,5337b0c4-38a4-4511-ab71-bd32cc61910e,-31.69,115.72,WA,Clarkson,debit,authorized,5005e2cc4d104381a179354c273b552e,SALES-POS,20-30,2018,10,15,21,34,Monday,7 days,57300.307
ACC-1973887809,26,5.45,7333.02,1.0,CUS-1646621553,2018-10-16,Antonio,M,-31.90,115.78,,f533b17f-77c7-4401-bbe7-831a2e8ef1fc,-31.74,115.76,WA,Joondalup,debit,authorized,8292778d93c24fe1bf18aae511fd7241,POS,20-30,2018,10,16,9,39,Tuesday,7 days,57300.307
ACC-1973887809,26,12.07,7320.95,0.0,CUS-1646621553,2018-10-16,Antonio,M,-31.90,115.78,,bd9d0f31-1f40-4a97-a4fd-f6af9852878f,-31.98,115.86,WA,South Perth,debit,authorized,51cac920ca09451ca1621d8e81a4045e,POS,20-30,2018,10,16,11,6,Tuesday,7 days,57300.307
ACC-1973887809,26,26.1,7294.85,1.0,CUS-1646621553,2018-10-17,Antonio,M,-31.90,115.78,,2d50d665-7ad1-452b-9a47-f7d45e69139f,-31.9,115.87,WA,Dianella,debit,authorized,09bd8c5564fe4d74a002f4d34943abb5,SALES-POS,20-30,2018,10,17,9,4,Wednesday,7 days,57300.307
ACC-1973887809,26,37.17,7257.68,0.0,CUS-1646621553,2018-10-17,Antonio,M,-31.90,115.78,,ae024401-3e47-48c7-973a-89f50714893d,-31.9,115.8,WA,Innaloo,debit,authorized,d450b05425bf425e97887ee4d1e4d8d3,SALES-POS,20-30,2018,10,17,15,57,Wednesday,7 days,57300.307
ACC-1973887809,26,484.3,7872.29,1.0,CUS-1646621553,2018-10-17,Antonio,M,-31.90,115.78,,7dee69cf-5736-4247-bccb-f9a0892ae760,-37.72,144.85,VIC,Keilor Park,debit,authorized,f6efd39b3dbb40e9ad90bb1d96a2e300,SALES-POS,20-30,2018,10,17,19,26,Wednesday,7 days,57300.307
ACC-1973887809,26,29.0,7843.29,,CUS-1646621553,2018-10-17,Antonio,M,-31.90,115.78,,,,,,,debit,posted,13b225b75e8248ffa2edaefb43afbce1,PAYMENT,20-30,2018,10,17,23,0,Wednesday,7 days,57300.307
ACC-1973887809,26,13.54,7829.75,1.0,CUS-1646621553,2018-10-18,Antonio,M,-31.90,115.78,,42d41c86-bbae-4a5a-a838-a7ae397f17ec,-32.07,115.75,WA,South Fremantle,debit,authorized,2d993fa8741f4084b1f24eacbfc3f5f9,POS,20-30,2018,10,18,14,32,Thursday,7 days,57300.307
ACC-1973887809,26,24.81,7804.94,1.0,CUS-1646621553,2018-10-19,Antonio,M,-31.90,115.78,,fea95815-da8b-422d-980b-fbc2d189ef36,-33.32,115.64,WA,Bunbury,debit,authorized,2f5d5ba95fbf4b8b84dae410f658f797,SALES-POS,20-30,2018,10,19,6,9,Friday,7 days,57300.307
ACC-1973887809,26,155.45,7649.49,0.0,CUS-1646621553,2018-10-19,Antonio,M,-31.90,115.78,,294d0299-6194-4e98-9236-c9579956d082,-33.86,151.21,NSW,Sydney,debit,authorized,e8acc8c6dfe24a6093c521519bd45cfa,POS,20-30,2018,10,19,11,58,Friday,7 days,57300.307
ACC-1973887809,26,49.54,7599.95,1.0,CUS-1646621553,2018-10-20,Antonio,M,-31.90,115.78,,e957b3e1-e8d7-49a4-98a9-e5feba8b1a74,-33.89,151.25,NSW,Bondi Junction,debit,authorized,11b217a464434f38b028a1e76c71faac,POS,20-30,2018,10,20,15,53,Saturday,7 days,57300.307
ACC-1973887809,26,7.79,7592.16,0.0,CUS-1646621553,2018-10-20,Antonio,M,-31.90,115.78,,b575b67e-2dea-4239-9270-d26fce82ed9c,-31.88,115.78,WA,Karrinyup,debit,authorized,e40cabdb58744b4dac10a03378af9211,POS,20-30,2018,10,20,19,2,Saturday,7 days,57300.307
ACC-1973887809,26,26.48,7565.68,1.0,CUS-1646621553,2018-10-20,Antonio,M,-31.90,115.78,,cebbf265-3b20-46f6-9ca5-6ce7fa174435,-31.95,115.85,WA,Perth,debit,authorized,3a025b5f051c42c8a3e181246adbedd2,SALES-POS,20-30,2018,10,20,22,9,Saturday,7 days,57300.307
ACC-1973887809,26,17.63,7548.05,0.0,CUS-1646621553,2018-10-21,Antonio,M,-31.90,115.78,,4ed24c8f-9362-44fb-99dd-eb5bd1eaddb5,-33.34,115.67,WA,Glen Iris,debit,authorized,dd54be52d9c74aaea3762c56d2faa658,POS,20-30,2018,10,21,20,40,Sunday,7 days,57300.307
ACC-1973887809,26,16.8,7531.25,1.0,CUS-1646621553,2018-10-21,Antonio,M,-31.90,115.78,,70ee15ee-54a0-4d05-8c7b-1c61170092e4,-31.65,115.7,WA,Jindalee,debit,authorized,6a576d4444104eae974e7de15f3ec670,POS,20-30,2018,10,21,21,32,Sunday,7 days,57300.307
ACC-1973887809,26,29.0,8601.16,,CUS-1646621553,2018-10-24,Antonio,M,-31.90,115.78,,,,,,,debit,posted,500b937aa5d846a9bf4dc16c85120083,PAYMENT,20-30,2018,10,24,23,0,Wednesday,7 days,57300.307
ACC-1973887809,26,66.85,8534.31,1.0,CUS-1646621553,2018-10-25,Antonio,M,-31.90,115.78,,d4caaefd-864d-4b52-8040-0139e86f4169,-31.78,115.97,WA,Wa,debit,authorized,a06e82b71c7f436bb2cd40c3d0b60108,SALES-POS,20-30,2018,10,25,11,2,Thursday,7 days,57300.307
ACC-1973887809,26,106.28,8428.03,1.0,CUS-1646621553,2018-10-26,Antonio,M,-31.90,115.78,,c1661c94-86be-4a14-b01c-8bb10fe4a1c1,-31.97,115.81,WA,Nedlands,debit,authorized,eb1aa100411d44d6be16b2ee40a2265d,POS,20-30,2018,10,26,8,4,Friday,7 days,57300.307
ACC-1973887809,26,84.0,8344.03,,CUS-1646621553,2018-10-27,Antonio,M,-31.90,115.78,,,,,,,debit,posted,24340fda4d6b4291a4a174856454f645,PAYMENT,20-30,2018,10,27,23,0,Saturday,7 days,57300.307
ACC-1973887809,26,27.55,8316.48,1.0,CUS-1646621553,2018-10-29,Antonio,M,-31.90,115.78,,55e05fa8-694e-4dd5-b47c-1ad7b6518903,-31.96,141.45,NSW,Broken Hill,debit,authorized,8cbf3041f5a14d79888ed5b4c8536abd,POS,20-30,2018,10,29,9,32,Monday,7 days,57300.307
ACC-1973887809,26,22.62,8293.86,0.0,CUS-1646621553,2018-10-29,Antonio,M,-31.90,115.78,,9afbd33c-0fbe-4568-bc09-fe66bcfe17cf,-31.97,116.06,WA,Kalamunda,debit,authorized,787b589d52cb430cb92767f44e17a87e,POS,20-30,2018,10,29,10,43,Monday,7 days,57300.307
ACC-1973887809,26,14.26,8279.6,1.0,CUS-1646621553,2018-10-29,Antonio,M,-31.90,115.78,,8605f821-ed94-42ce-ba47-d74b6884ffb0,-32.02,115.94,WA,Cannington,debit,authorized,1945077d5b944427b16d70ff1c42ade5,POS,20-30,2018,10,29,16,21,Monday,7 days,57300.307
ACC-1973887809,26,29.0,9349.51,,CUS-1646621553,2018-10-31,Antonio,M,-31.90,115.78,,,,,,,debit,posted,dda53e538c5b4d5aae2481be22e60440,PAYMENT,20-30,2018,10,31,23,0,Wednesday,7 days,57300.307
ACC-1516130869,21,32.41,143.4,1.0,CUS-325142416,2018-08-01,Jessica,F,-12.45,130.84,,e9d1bc97-2073-4ede-9665-ab400e8e7be6,-12.4,130.85,NT,Coconut Grove,debit,authorized,a9f8f0c8aefc4b7fbd8c659b703d08bc,POS,20-30,2018,8,1,15,33,Wednesday,14 days,60137.139
ACC-1516130869,21,39.0,104.4,,CUS-325142416,2018-08-02,Jessica,F,-12.45,130.84,,,,,,,debit,posted,2f49ddaa14f04e96a2d19dcc27b8d477,INTER BANK,20-30,2018,8,2,9,0,Thursday,14 days,60137.139
ACC-1516130869,21,8.15,96.25,1.0,CUS-325142416,2018-08-02,Jessica,F,-12.45,130.84,,a87b2691-41a6-445a-b802-60b2c91e17bf,-12.46,130.84,NT,Darwin City,debit,authorized,6b23f17580594c76a04a057c6416fe37,POS,20-30,2018,8,2,11,35,Thursday,14 days,60137.139
ACC-1516130869,21,24.7,71.55,1.0,CUS-325142416,2018-08-03,Jessica,F,-12.45,130.84,,79ee5753-36ec-46cb-bcee-9f5dceda5e2e,-12.47,130.98,NT,Yarrawonga,debit,authorized,ad699388e6b44571ba84299ddea29289,SALES-POS,20-30,2018,8,3,0,58,Friday,14 days,60137.139
ACC-1516130869,21,29.0,42.55,,CUS-325142416,2018-08-03,Jessica,F,-12.45,130.84,,,,,,,debit,posted,73d61d9be0804e38a21017650c254ad3,PAYMENT,20-30,2018,8,3,13,0,Friday,14 days,60137.139
ACC-1516130869,21,4.56,37.99,1.0,CUS-325142416,2018-08-03,Jessica,F,-12.45,130.84,,18005894-c5b8-4186-bf6f-eca6d2005a2e,-12.46,130.83,NT,Larrakeyah,debit,authorized,7c09e62089994d1db5faf480624f0323,POS,20-30,2018,8,3,19,35,Friday,14 days,60137.139
ACC-1516130869,21,18.65,19.34,1.0,CUS-325142416,2018-08-04,Jessica,F,-12.45,130.84,,4af9af34-b5de-4063-bd48-664840bbaea2,-12.45,130.97,NT,Holtze,debit,authorized,5cb2010209234fe98044822963f5cf24,SALES-POS,20-30,2018,8,4,23,56,Saturday,14 days,60137.139
ACC-1516130869,21,9.71,9.63,1.0,CUS-325142416,2018-08-07,Jessica,F,-12.45,130.84,,1e69bf15-b6f1-461f-b6a2-139014b24462,-12.47,130.98,NT,Yarrawonga,debit,authorized,6ee1bd93e0c64b76a1b41d585984a278,POS,20-30,2018,8,7,10,27,Tuesday,14 days,60137.139
ACC-1516130869,21,39.0,2277.26,,CUS-325142416,2018-08-09,Jessica,F,-12.45,130.84,,,,,,,debit,posted,a7d7b65861cc45ba89a2b63dc23a4d9b,INTER BANK,20-30,2018,8,9,9,0,Thursday,14 days,60137.139
ACC-1516130869,21,7.69,2269.57,1.0,CUS-325142416,2018-08-09,Jessica,F,-12.45,130.84,,8bcca9c1-e1e8-4d3c-961f-3d9b4c3e4e86,-12.39,130.86,NT,Millner,debit,authorized,b3faedfbb50c42029e30c3d1417f14b5,SALES-POS,20-30,2018,8,9,18,31,Thursday,14 days,60137.139
ACC-1516130869,21,29.0,2240.57,,CUS-325142416,2018-08-10,Jessica,F,-12.45,130.84,,,,,,,debit,posted,1c1399ff24c34befa196912049505c1d,PAYMENT,20-30,2018,8,10,13,0,Friday,14 days,60137.139
ACC-1516130869,21,23.46,2217.11,1.0,CUS-325142416,2018-08-11,Jessica,F,-12.45,130.84,,47681235-bdd7-48bc-9426-311f606178de,-12.4,130.86,NT,Coconut Grove,debit,authorized,6f4c351507f9431aa79dfe60a8a64891,POS,20-30,2018,8,11,20,35,Saturday,14 days,60137.139
ACC-1516130869,21,25.06,2192.05,1.0,CUS-325142416,2018-08-12,Jessica,F,-12.45,130.84,,0be68ac2-b725-4f65-815c-7362b5435768,-12.45,130.84,NT,Stuart Park,debit,authorized,5a0c5a274924471aa1cbb2d405e3983b,POS,20-30,2018,8,12,11,4,Sunday,14 days,60137.139
ACC-1516130869,21,27.15,2164.9,1.0,CUS-325142416,2018-08-12,Jessica,F,-12.45,130.84,,79ee5753-36ec-46cb-bcee-9f5dceda5e2e,-12.47,130.98,NT,Yarrawonga,debit,authorized,a1b93d01bb3e479eb1c74d7bd2eefdad,SALES-POS,20-30,2018,8,12,13,5,Sunday,14 days,60137.139
ACC-1516130869,21,13.58,2151.32,1.0,CUS-325142416,2018-08-12,Jessica,F,-12.45,130.84,,8689dbf3-5fc5-4fe4-aa1f-fd8416219660,-12.46,130.84,NT,Darwin,debit,authorized,b3cacbd55cd44579952402d5846b724b,SALES-POS,20-30,2018,8,12,21,59,Sunday,14 days,60137.139
ACC-1516130869,21,33.54,2117.78,1.0,CUS-325142416,2018-08-13,Jessica,F,-12.45,130.84,,3350174a-e801-4a9f-b8b8-aea6f075d792,-12.41,130.86,NT,Ludmilla,debit,authorized,0218710f42c0436cb7676ff753e76bed,SALES-POS,20-30,2018,8,13,9,49,Monday,14 days,60137.139
ACC-1516130869,21,7.53,2110.25,1.0,CUS-325142416,2018-08-13,Jessica,F,-12.45,130.84,,5941cc0a-79e8-452f-a976-c4e9d2723ff9,-12.46,130.84,NT,Darwin City,debit,authorized,e2d22f93f110468fae21adff4c8015b2,SALES-POS,20-30,2018,8,13,20,49,Monday,14 days,60137.139
ACC-1516130869,21,8.09,2102.16,1.0,CUS-325142416,2018-08-14,Jessica,F,-12.45,130.84,,b86174d0-b408-4142-80e6-8fabd82663b1,-12.41,130.86,NT,Ludmilla,debit,authorized,1a3a0218a06a460cb6c27432a3864992,POS,20-30,2018,8,14,9,52,Tuesday,14 days,60137.139
ACC-1516130869,21,15.78,2086.38,1.0,CUS-325142416,2018-08-15,Jessica,F,-12.45,130.84,,b3dcb937-e42f-4219-84ba-1c82495e97c3,-12.37,130.88,NT,Casuarina,debit,authorized,61bbb8b0e0dd4ab79bbdd2641318c4a4,POS,20-30,2018,8,15,2,41,Wednesday,14 days,60137.139
ACC-1516130869,21,14.27,2072.11,1.0,CUS-325142416,2018-08-15,Jessica,F,-12.45,130.84,,2b4c4504-09a4-4055-b52d-d410a85c4a78,-12.47,130.99,NT,Yarrawonga,debit,authorized,2015af3367d14846862e965375f0c12b,SALES-POS,20-30,2018,8,15,8,23,Wednesday,14 days,60137.139
ACC-1516130869,21,1.71,2070.4,0.0,CUS-325142416,2018-08-15,Jessica,F,-12.45,130.84,,f94d1922-da2c-4a2a-8c60-dcfb4362fa2a,-12.51,130.99,NT,Rosebery,debit,authorized,fc37eefa68054fd5b6711be6022b0dd9,POS,20-30,2018,8,15,9,29,Wednesday,14 days,60137.139
ACC-1516130869,21,7.24,2063.16,1.0,CUS-325142416,2018-08-15,Jessica,F,-12.45,130.84,,61334d6d-b25d-4c6c-9145-029b9a988c70,-12.48,130.99,NT,Palmerston City,debit,authorized,c1afa162fade4093b9baed75e233be08,POS,20-30,2018,8,15,11,27,Wednesday,14 days,60137.139
ACC-1516130869,21,29.0,1995.16,,CUS-325142416,2018-08-17,Jessica,F,-12.45,130.84,,,,,,,debit,posted,cd776b6766d2431c9511b64cd7d8255a,PAYMENT,20-30,2018,8,17,13,0,Friday,14 days,60137.139
ACC-1516130869,21,18.82,1976.34,1.0,CUS-325142416,2018-08-18,Jessica,F,-12.45,130.84,,7e27676f-257b-4ba0-8b42-3ce25f39d036,-12.39,130.85,NT,Nightcliff,debit,authorized,ce34191629e54c45b654558ab740be0f,SALES-POS,20-30,2018,8,18,1,53,Saturday,14 days,60137.139
ACC-1516130869,21,20.84,1955.5,1.0,CUS-325142416,2018-08-18,Jessica,F,-12.45,130.84,,d443739e-46ec-4c81-ace3-995c012ae13a,-12.42,130.84,NT,Fannie Bay,debit,authorized,bea77c2c5e03425a94ad95c7bd7580e3,POS,20-30,2018,8,18,12,25,Saturday,14 days,60137.139
ACC-1516130869,21,21.1,1934.4,1.0,CUS-325142416,2018-08-18,Jessica,F,-12.45,130.84,,8c13fbce-e577-4ee1-948c-fa67ae782728,-12.4,130.9,NT,Marrara,debit,authorized,6f83bf9be8554ac2963b42a3433c9164,SALES-POS,20-30,2018,8,18,17,39,Saturday,14 days,60137.139
ACC-1516130869,21,24.88,1909.52,1.0,CUS-325142416,2018-08-20,Jessica,F,-12.45,130.84,,288a3fe1-b668-49a9-aa6f-5d1bb8d4a662,-12.46,130.84,NT,Darwin City,debit,authorized,dda3511ef82c455e8ed1fe342aedcafd,POS,20-30,2018,8,20,19,59,Monday,14 days,60137.139
ACC-1516130869,21,21.6,1887.92,1.0,CUS-325142416,2018-08-20,Jessica,F,-12.45,130.84,,17f91531-5815-4314-9c84-544e54325088,-12.4,130.91,NT,North Lakes,debit,authorized,d808efd8c87b4c4c99c8a506881f23ef,POS,20-30,2018,8,20,22,36,Monday,14 days,60137.139
ACC-1516130869,21,10.83,1877.09,1.0,CUS-325142416,2018-08-21,Jessica,F,-12.45,130.84,,eda99bd7-a23d-42a0-bdb9-b4528e0122d0,-12.42,130.84,NT,Fannie Bay,debit,authorized,72fe6a6e231145b990aefc361cf4dc81,POS,20-30,2018,8,21,10,12,Tuesday,14 days,60137.139
ACC-1516130869,21,34.34,4149.38,1.0,CUS-325142416,2018-08-22,Jessica,F,-12.45,130.84,,e9d1bc97-2073-4ede-9665-ab400e8e7be6,-12.4,130.85,NT,Coconut Grove,debit,authorized,6b2d70130fe5424bb24eb46e35c4ee2a,POS,20-30,2018,8,22,18,8,Wednesday,14 days,60137.139
ACC-1516130869,21,7.78,4141.6,1.0,CUS-325142416,2018-08-22,Jessica,F,-12.45,130.84,,358e6a17-3f2d-4023-803d-b63b201c583e,-12.41,130.88,NT,Eaton,debit,authorized,f3640143ce48411eba1ee0a2dbe5e1a7,POS,20-30,2018,8,22,20,24,Wednesday,14 days,60137.139
ACC-1516130869,21,181.0,3960.6,,CUS-325142416,2018-08-23,Jessica,F,-12.45,130.84,,,,,,,debit,posted,d3cd2edafb94460b9ecfc7ba4b6cd3cd,PAYMENT,20-30,2018,8,23,3,0,Thursday,14 days,60137.139
ACC-1516130869,21,39.0,3904.86,,CUS-325142416,2018-08-23,Jessica,F,-12.45,130.84,,,,,,,debit,posted,5a8e8e86e49b41859bafcb5e12049917,INTER BANK,20-30,2018,8,23,9,0,Thursday,14 days,60137.139
ACC-1516130869,21,16.74,3943.86,1.0,CUS-325142416,2018-08-23,Jessica,F,-12.45,130.84,,d71960ad-dff5-49b4-9095-5ec05a0c54a8,-12.47,130.85,NT,Darwin City,debit,authorized,6c7610773ced4876ab838cba0d678023,POS,20-30,2018,8,23,9,2,Thursday,14 days,60137.139
ACC-1516130869,21,26.58,3878.28,1.0,CUS-325142416,2018-08-23,Jessica,F,-12.45,130.84,,cd98e1d5-4138-4f47-9045-4de8919aed99,-12.44,130.92,NT,Berrimah,debit,authorized,14b1d95db5124ba3a203301a4ecb1914,SALES-POS,20-30,2018,8,23,16,33,Thursday,14 days,60137.139
ACC-1516130869,21,13.5,3864.78,1.0,CUS-325142416,2018-08-24,Jessica,F,-12.45,130.84,,97140894-94e8-48b9-a697-4da98bc4b36d,-12.39,130.85,NT,Nightcliff,debit,authorized,bf759d5f37734bd6b90788f2e53031ac,POS,20-30,2018,8,24,1,30,Friday,14 days,60137.139
ACC-1516130869,21,2.46,3862.32,1.0,CUS-325142416,2018-08-24,Jessica,F,-12.45,130.84,,f0fee914-bebe-4182-bcb3-a75f58682bc1,-33.88,151.17,NSW,Annandale,debit,authorized,8019bbae04b44c679acb3a8fd25ecd2e,SALES-POS,20-30,2018,8,24,11,25,Friday,14 days,60137.139
ACC-1516130869,21,29.0,3833.32,,CUS-325142416,2018-08-24,Jessica,F,-12.45,130.84,,,,,,,debit,posted,0f56cb07a9864a26be071a8c6879ccbc,PAYMENT,20-30,2018,8,24,13,0,Friday,14 days,60137.139
ACC-1516130869,21,44.09,3789.23,0.0,CUS-325142416,2018-08-24,Jessica,F,-12.45,130.84,,bebf9c8f-f867-42fd-b8f1-35f960d40029,-27.96,153.36,QLD,Molendinar,debit,authorized,a26c36cf3a8a44c09240922e68e4bd7a,SALES-POS,20-30,2018,8,24,20,1,Friday,14 days,60137.139
ACC-1516130869,21,31.12,3758.11,0.0,CUS-325142416,2018-08-26,Jessica,F,-12.45,130.84,,8420f84b-ac16-498e-be44-f3b2e01c1637,-12.44,130.98,NT,Shoal Bay,debit,authorized,12c19f2a58e245e89ac31c954caf9f7a,SALES-POS,20-30,2018,8,26,23,15,Sunday,14 days,60137.139
ACC-1516130869,21,173.0,3585.11,,CUS-325142416,2018-08-28,Jessica,F,-12.45,130.84,,,,,,,debit,posted,3be56e2b32344143950cd04e4cd3b443,INTER BANK,20-30,2018,8,28,5,0,Tuesday,14 days,60137.139
ACC-1516130869,21,7.36,3577.75,1.0,CUS-325142416,2018-08-28,Jessica,F,-12.45,130.84,,358e6a17-3f2d-4023-803d-b63b201c583e,-12.41,130.88,NT,Eaton,debit,authorized,12e66e8a03df4f07a87ad825267abc99,POS,20-30,2018,8,28,11,26,Tuesday,14 days,60137.139
ACC-1516130869,21,8.17,3569.58,1.0,CUS-325142416,2018-08-28,Jessica,F,-12.45,130.84,,736423ea-fa57-4f17-a0c9-3df15d9e158f,-12.48,130.99,NT,Palmerston City,debit,authorized,12033d4cfe744ccda3843be1563d1bd7,POS,20-30,2018,8,28,14,53,Tuesday,14 days,60137.139
ACC-1516130869,21,15.06,3554.52,1.0,CUS-325142416,2018-08-28,Jessica,F,-12.45,130.84,,c4e46e6b-75d5-4ccc-9b36-cc8e8375f08e,-12.5,130.99,NT,Bakewell,debit,authorized,f5c60ca714154a3486af60170a8c12a3,SALES-POS,20-30,2018,8,28,15,46,Tuesday,14 days,60137.139
ACC-1516130869,21,10.47,3544.05,0.0,CUS-325142416,2018-08-29,Jessica,F,-12.45,130.84,,b65fbdcb-47f5-421b-9b42-c0057f43ab8a,-37.82,144.96,VIC,Melbourne,debit,authorized,b29f8d66cbf34d06874d23a1e756edd4,SALES-POS,20-30,2018,8,29,15,8,Wednesday,14 days,60137.139
ACC-1516130869,21,39.0,3505.05,,CUS-325142416,2018-08-30,Jessica,F,-12.45,130.84,,,,,,,debit,posted,9be66dcaa1e245f6a99d3ca71794906a,INTER BANK,20-30,2018,8,30,9,0,Thursday,14 days,60137.139
ACC-1516130869,21,26.61,3478.44,0.0,CUS-325142416,2018-08-30,Jessica,F,-12.45,130.84,,6f931528-3e0b-454b-ab7c-898c916b33a2,-12.43,130.84,NT,Parap,debit,authorized,f47c51aae6e14625bd6381c77094981d,POS,20-30,2018,8,30,16,20,Thursday,14 days,60137.139
ACC-1516130869,21,654.95,2823.49,1.0,CUS-325142416,2018-08-30,Jessica,F,-12.45,130.84,,5689d17d-5202-4ad5-9333-2505f051c5dd,-12.44,130.84,NT,Parap,debit,authorized,63b8d6af76a44e1c96a2aabdfec99632,POS,20-30,2018,8,30,18,59,Thursday,14 days,60137.139
ACC-1516130869,21,1552.0,1271.49,,CUS-325142416,2018-08-31,Jessica,F,-12.45,130.84,,,,,,,debit,posted,f4772436ce1947ae867d6795cccf5b33,INTER BANK,20-30,2018,8,31,2,0,Friday,14 days,60137.139
ACC-1516130869,21,9.04,1262.45,1.0,CUS-325142416,2018-08-31,Jessica,F,-12.45,130.84,,383aeeda-a0da-442e-b018-70389e109700,-12.47,130.98,NT,Yarrawonga,debit,authorized,bc8aaa4cdfc4463abaf707c7f9931366,POS,20-30,2018,8,31,8,37,Friday,14 days,60137.139
ACC-1516130869,21,13.13,1249.32,1.0,CUS-325142416,2018-08-31,Jessica,F,-12.45,130.84,,5ffbbe16-b16b-44fb-94c4-202bd885499e,-12.38,130.88,NT,Casuarina,debit,authorized,862cb634074145a1b3ff81962fbb4df2,POS,20-30,2018,8,31,8,47,Friday,14 days,60137.139
ACC-1516130869,21,13.29,1236.03,1.0,CUS-325142416,2018-08-31,Jessica,F,-12.45,130.84,,63821ef6-be41-48de-872a-fdd5cc4e29ea,-12.47,130.98,NT,Yarrawonga,debit,authorized,0abe4f92062549d0b3a492f9520af95c,POS,20-30,2018,8,31,11,35,Friday,14 days,60137.139
ACC-1516130869,21,29.0,1207.03,,CUS-325142416,2018-08-31,Jessica,F,-12.45,130.84,,,,,,,debit,posted,522759f1c859442f927113dbd020c63c,PAYMENT,20-30,2018,8,31,13,0,Friday,14 days,60137.139
ACC-1516130869,21,3.14,1203.89,0.0,CUS-325142416,2018-08-31,Jessica,F,-12.45,130.84,,dabb2aa4-31fa-4f27-9ed9-ca87e5966428,-12.46,130.84,NT,Darwin City,debit,authorized,f242975c40db4629a507543fcbb84ca6,POS,20-30,2018,8,31,15,10,Friday,14 days,60137.139
ACC-1516130869,21,10.03,1193.86,1.0,CUS-325142416,2018-08-31,Jessica,F,-12.45,130.84,,49927e3c-dc7a-416b-b860-9334ead4fe41,-12.46,130.97,NT,Holtze,debit,authorized,25afac99dbfe455eb4afa5f4d36c703e,SALES-POS,20-30,2018,8,31,16,57,Friday,14 days,60137.139
ACC-1516130869,21,31.75,1162.11,1.0,CUS-325142416,2018-09-01,Jessica,F,-12.45,130.84,,e41588f5-21f9-4949-807d-f08781ec112a,-12.46,130.84,NT,Darwin City,debit,authorized,9e8a3c1217b447bdaa8158591ecfec86,SALES-POS,20-30,2018,9,1,19,49,Saturday,14 days,60137.139
ACC-1516130869,21,12.84,1149.27,1.0,CUS-325142416,2018-09-02,Jessica,F,-12.45,130.84,,ff7652a0-7d92-41bf-afbc-0f1bb6c5cde2,-12.5,130.99,NT,Bakewell,debit,authorized,8e700d8c72ce40629a02fe8a116c9288,SALES-POS,20-30,2018,9,2,12,10,Sunday,14 days,60137.139
ACC-1516130869,21,7.84,1141.43,1.0,CUS-325142416,2018-09-02,Jessica,F,-12.45,130.84,,d4f3292b-5c68-4f47-9e0c-2661ab143e88,-12.4,130.86,NT,Eaton,debit,authorized,42dff2e9179742e6b68623522c0b44aa,SALES-POS,20-30,2018,9,2,18,35,Sunday,14 days,60137.139
ACC-1516130869,21,34.96,1106.47,1.0,CUS-325142416,2018-09-03,Jessica,F,-12.45,130.84,,4fec12c6-b31f-41aa-a1b1-9fa793452fa5,-26.65,153.09,QLD,Maroochydore,debit,authorized,ebf1c48a0cba4e548474bb95789351c2,SALES-POS,20-30,2018,9,3,8,46,Monday,14 days,60137.139
ACC-1516130869,21,39.52,1066.95,1.0,CUS-325142416,2018-09-03,Jessica,F,-12.45,130.84,,6d108ed0-8eb1-4dba-8da6-1f0ae968b908,-37.84,144.98,VIC,Melbourne,debit,authorized,0639f3e36b4349f0854599f321c2af76,POS,20-30,2018,9,3,11,38,Monday,14 days,60137.139
ACC-1516130869,21,15.44,1051.51,0.0,CUS-325142416,2018-09-04,Jessica,F,-12.45,130.84,,7f59e24e-1947-4325-8cfe-e534976e06d2,-12.38,130.88,NT,Casuarina,debit,authorized,4e7c02ff2fe84cda85ae855096f98c80,POS,20-30,2018,9,4,9,38,Tuesday,14 days,60137.139
ACC-1516130869,21,6.55,1044.96,1.0,CUS-325142416,2018-09-04,Jessica,F,-12.45,130.84,,7f424437-d396-4374-bdc1-53350e4387ba,-12.5,130.99,NT,Bakewell,debit,authorized,7b934a428e9748cd8ee1e217441a1898,SALES-POS,20-30,2018,9,4,14,18,Tuesday,14 days,60137.139
ACC-1516130869,21,25.69,3325.9,0.0,CUS-325142416,2018-09-05,Jessica,F,-12.45,130.84,,cd98e1d5-4138-4f47-9045-4de8919aed99,-12.44,130.92,NT,Berrimah,debit,authorized,92d0dcc54885493a8a45bba498fbb096,SALES-POS,20-30,2018,9,5,19,44,Wednesday,14 days,60137.139
ACC-1516130869,21,39.0,3273.34,,CUS-325142416,2018-09-06,Jessica,F,-12.45,130.84,,,,,,,debit,posted,4db9d32a26f84bc9b88b407a25f80e0b,INTER BANK,20-30,2018,9,6,9,0,Thursday,14 days,60137.139
ACC-1516130869,21,13.56,3312.34,1.0,CUS-325142416,2018-09-06,Jessica,F,-12.45,130.84,,c341d8bc-6ac7-43b1-9dfa-b34a48d0b01a,-12.48,130.99,NT,Palmerston City,debit,authorized,dfe52e4a938f4ad295094876e22d1311,POS,20-30,2018,9,6,9,18,Thursday,14 days,60137.139
ACC-1516130869,21,13.46,3259.88,0.0,CUS-325142416,2018-09-06,Jessica,F,-12.45,130.84,,951569e3-95d0-45e5-8cd7-4430b613a3ae,-12.46,130.84,NT,Darwin City,debit,authorized,cd21f9299133493a845064d26c48127f,SALES-POS,20-30,2018,9,6,10,4,Thursday,14 days,60137.139
ACC-1516130869,21,14.72,3245.16,1.0,CUS-325142416,2018-09-07,Jessica,F,-12.45,130.84,,94133b56-52a5-42cf-9109-dceafb25d2db,-12.37,130.88,NT,Casuarina,debit,authorized,ea399368e1894020aa76adb6272f7925,SALES-POS,20-30,2018,9,7,8,32,Friday,14 days,60137.139
ACC-1516130869,21,17.05,3228.11,1.0,CUS-325142416,2018-09-07,Jessica,F,-12.45,130.84,,bf3bc19d-ccf4-4117-af76-f1375d2a6e1b,-12.4,130.9,NT,Marrara,debit,authorized,03d2c253a82c495aa82db7607bf17062,POS,20-30,2018,9,7,11,41,Friday,14 days,60137.139
ACC-1516130869,21,29.0,3199.11,,CUS-325142416,2018-09-07,Jessica,F,-12.45,130.84,,,,,,,debit,posted,2e932ab8c3114f9db2c4a0f4220458f2,PAYMENT,20-30,2018,9,7,13,0,Friday,14 days,60137.139
ACC-1516130869,21,13.4,3185.71,1.0,CUS-325142416,2018-09-07,Jessica,F,-12.45,130.84,,7f59e24e-1947-4325-8cfe-e534976e06d2,-12.38,130.88,NT,Casuarina,debit,authorized,d4a96cb7b90b4edeb0d0510c35faee4b,SALES-POS,20-30,2018,9,7,19,42,Friday,14 days,60137.139
ACC-1516130869,21,15.35,3170.36,0.0,CUS-325142416,2018-09-08,Jessica,F,-12.45,130.84,,876775f5-2f53-4f93-bf37-799b9ad4ec85,-12.47,130.84,NT,Darwin City,debit,authorized,dfe279fc567746bbb02cf76d249a13dc,SALES-POS,20-30,2018,9,8,4,4,Saturday,14 days,60137.139
ACC-1516130869,21,10.18,3160.18,1.0,CUS-325142416,2018-09-09,Jessica,F,-12.45,130.84,,ea38a00c-0d8f-47a9-bf86-d597ae174d69,-12.5,130.98,NT,Gray,debit,authorized,fe9d77faff4f487d880c4271195e6e5b,SALES-POS,20-30,2018,9,9,21,49,Sunday,14 days,60137.139
ACC-1516130869,21,15.09,3145.09,1.0,CUS-325142416,2018-09-10,Jessica,F,-12.45,130.84,,11d9f6dc-b2eb-447d-aebf-807fc2ee55a6,-12.45,130.84,NT,Stuart Park,debit,authorized,dce28bc53fc44ffb97f51a9ae368ec59,SALES-POS,20-30,2018,9,10,9,14,Monday,14 days,60137.139
ACC-1516130869,21,17.76,3127.33,0.0,CUS-325142416,2018-09-10,Jessica,F,-12.45,130.84,,f08135b7-cdce-430a-a14c-6a488968e831,-12.5,130.99,NT,Bakewell,debit,authorized,eaa4efbbf5d648829379e56e2d015b25,SALES-POS,20-30,2018,9,10,13,22,Monday,14 days,60137.139
ACC-1516130869,21,12.86,3114.47,1.0,CUS-325142416,2018-09-11,Jessica,F,-12.45,130.84,,dc0465df-81f1-4b5d-a2bb-346bb6ea2c48,-12.38,130.85,NT,Nightcliff,debit,authorized,d45e4544a4004dd5b8d4df1e4dc06d00,POS,20-30,2018,9,11,9,32,Tuesday,14 days,60137.139
ACC-1516130869,21,11.58,3102.89,1.0,CUS-325142416,2018-09-11,Jessica,F,-12.45,130.84,,ff7652a0-7d92-41bf-afbc-0f1bb6c5cde2,-12.5,130.99,NT,Bakewell,debit,authorized,5e4a2fec3999479aacea05f11a01e2c3,SALES-POS,20-30,2018,9,11,15,54,Tuesday,14 days,60137.139
ACC-1516130869,21,13.7,3089.19,1.0,CUS-325142416,2018-09-11,Jessica,F,-12.45,130.84,,ff7652a0-7d92-41bf-afbc-0f1bb6c5cde2,-12.5,130.99,NT,Bakewell,debit,authorized,4fb315788f804f91b4f2f694a3573f85,POS,20-30,2018,9,11,19,34,Tuesday,14 days,60137.139
ACC-1516130869,21,13.08,3076.11,1.0,CUS-325142416,2018-09-12,Jessica,F,-12.45,130.84,,73c0924f-dc35-4ab1-8136-2b5775cf4280,-12.44,130.84,NT,Stuart Park,debit,authorized,247abdafcd4d40ec86676ee4a4c07cf3,SALES-POS,20-30,2018,9,12,12,48,Wednesday,14 days,60137.139
ACC-1516130869,21,9.85,3066.26,1.0,CUS-325142416,2018-09-12,Jessica,F,-12.45,130.84,,91a9cee4-ad61-49b8-a8cf-cf8a49c21ca7,-12.47,130.97,NT,Durack,debit,authorized,4788dfe1e2a64963b5c7af1bcb577738,POS,20-30,2018,9,12,14,51,Wednesday,14 days,60137.139
ACC-1516130869,21,12.28,3053.98,1.0,CUS-325142416,2018-09-12,Jessica,F,-12.45,130.84,,047e6a2d-97d2-4e23-9d61-89e5ac02587e,-12.46,130.84,NT,Darwin,debit,authorized,603bdcbdc6ea45eab294256be7ef1e7d,SALES-POS,20-30,2018,9,12,16,23,Wednesday,14 days,60137.139
ACC-1516130869,21,12.91,3041.07,0.0,CUS-325142416,2018-09-13,Jessica,F,-12.45,130.84,,c341d8bc-6ac7-43b1-9dfa-b34a48d0b01a,-12.48,130.99,NT,Palmerston City,debit,authorized,146db7d4662e4035801e4aca7347c5b5,SALES-POS,20-30,2018,9,13,1,59,Thursday,14 days,60137.139
ACC-1516130869,21,39.0,2957.26,,CUS-325142416,2018-09-13,Jessica,F,-12.45,130.84,,,,,,,debit,posted,a7b0b8294e0f447eba8fb9667aff6bf3,INTER BANK,20-30,2018,9,13,9,0,Thursday,14 days,60137.139
ACC-1516130869,21,27.84,3013.23,1.0,CUS-325142416,2018-09-13,Jessica,F,-12.45,130.84,,cb021e50-fc33-4d52-9d1c-e17b5c7b277b,-12.46,130.84,NT,Darwin,debit,authorized,bf7784c857114e40b816bea03388ef43,POS,20-30,2018,9,13,9,18,Thursday,14 days,60137.139
ACC-1516130869,21,16.97,2996.26,0.0,CUS-325142416,2018-09-13,Jessica,F,-12.45,130.84,,bf3bc19d-ccf4-4117-af76-f1375d2a6e1b,-12.4,130.9,NT,Marrara,debit,authorized,c9246114c19745b6b1fd7a07568a7bf1,SALES-POS,20-30,2018,9,13,9,30,Thursday,14 days,60137.139
ACC-1516130869,21,18.07,2939.19,1.0,CUS-325142416,2018-09-13,Jessica,F,-12.45,130.84,,d443739e-46ec-4c81-ace3-995c012ae13a,-12.42,130.84,NT,Fannie Bay,debit,authorized,ac3475ae74df4dd496cc2cefde7c7105,POS,20-30,2018,9,13,18,59,Thursday,14 days,60137.139
ACC-1516130869,21,3.67,2935.52,1.0,CUS-325142416,2018-09-13,Jessica,F,-12.45,130.84,,e7d6c699-7f92-44b6-a009-63f871f7509c,-12.46,130.84,NT,Darwin,debit,authorized,57bf380c686b42509fd3f70f4a093724,POS,20-30,2018,9,13,19,49,Thursday,14 days,60137.139
ACC-1516130869,21,29.0,2906.52,,CUS-325142416,2018-09-14,Jessica,F,-12.45,130.84,,,,,,,debit,posted,6875db09a0a84eac95095f223a6e0667,PAYMENT,20-30,2018,9,14,13,0,Friday,14 days,60137.139
ACC-1516130869,21,22.62,2883.9,1.0,CUS-325142416,2018-09-15,Jessica,F,-12.45,130.84,,4af9af34-b5de-4063-bd48-664840bbaea2,-12.45,130.97,NT,Holtze,debit,authorized,3ea4c3ad1835407e8a6d1c04f9afc80a,POS,20-30,2018,9,15,13,57,Saturday,14 days,60137.139
ACC-1516130869,21,65.07,2818.83,1.0,CUS-325142416,2018-09-15,Jessica,F,-12.45,130.84,,d66375c5-a27a-4f85-af07-1312dd3671ce,-12.46,130.84,NT,Darwin,debit,authorized,e3cfab45912b4da7bbc98fb19aae6cfb,POS,20-30,2018,9,15,15,6,Saturday,14 days,60137.139
ACC-1516130869,21,8.7,2810.13,0.0,CUS-325142416,2018-09-15,Jessica,F,-12.45,130.84,,ea38a00c-0d8f-47a9-bf86-d597ae174d69,-12.5,130.98,NT,Gray,debit,authorized,d9fec8689cf84c27bc5cacd34a590a65,POS,20-30,2018,9,15,22,25,Saturday,14 days,60137.139
ACC-1516130869,21,25.83,2784.3,1.0,CUS-325142416,2018-09-16,Jessica,F,-12.45,130.84,,b288ac70-e73e-4cf7-a7a8-6eb003a221c0,-12.51,131.01,NT,Zuccoli,debit,authorized,0457c80dc3eb442f9266ebcc3026e914,SALES-POS,20-30,2018,9,16,11,55,Sunday,14 days,60137.139
ACC-1516130869,21,8.19,2776.11,1.0,CUS-325142416,2018-09-16,Jessica,F,-12.45,130.84,,61334d6d-b25d-4c6c-9145-029b9a988c70,-12.48,130.99,NT,Palmerston City,debit,authorized,8d2f0dc62fb5455fb7edc74e628f0433,POS,20-30,2018,9,16,19,56,Sunday,14 days,60137.139
ACC-1516130869,21,31.1,2745.01,1.0,CUS-325142416,2018-09-16,Jessica,F,-12.45,130.84,,8420f84b-ac16-498e-be44-f3b2e01c1637,-12.44,130.98,NT,Shoal Bay,debit,authorized,84894b8059374873956dd0a6ccdc7810,SALES-POS,20-30,2018,9,16,22,27,Sunday,14 days,60137.139
ACC-1516130869,21,9.35,2735.66,1.0,CUS-325142416,2018-09-18,Jessica,F,-12.45,130.84,,520d1c8d-2f13-46a4-a256-134e2658a012,-12.44,130.84,NT,Alice Spring,debit,authorized,f8d9cc9455e44768aa5316d0a7af5b65,POS,20-30,2018,9,18,11,1,Tuesday,14 days,60137.139
ACC-1516130869,21,31.41,5010.88,1.0,CUS-325142416,2018-09-19,Jessica,F,-12.45,130.84,,8420f84b-ac16-498e-be44-f3b2e01c1637,-12.44,130.98,NT,Shoal Bay,debit,authorized,2de8f4adf6ce4e4c9628b4d4cf2e61df,POS,20-30,2018,9,19,22,30,Wednesday,14 days,60137.139
ACC-1516130869,21,10.13,5000.75,1.0,CUS-325142416,2018-09-20,Jessica,F,-12.45,130.84,,a073f521-2c74-4143-a402-ad36bcf49b62,-12.47,130.98,NT,Yarrawonga,debit,authorized,21557206491c4310ab2dae52dd998f5b,POS,20-30,2018,9,20,0,41,Thursday,14 days,60137.139
ACC-1516130869,21,11.5,4989.25,0.0,CUS-325142416,2018-09-20,Jessica,F,-12.45,130.84,,6fd957ea-4b2c-4ea3-bc54-032ee5c7c08f,-12.47,130.85,NT,Darwin City,debit,authorized,28f9274fe18749a28c1116ca553e69a4,SALES-POS,20-30,2018,9,20,6,41,Thursday,14 days,60137.139
ACC-1516130869,21,39.0,4950.25,,CUS-325142416,2018-09-20,Jessica,F,-12.45,130.84,,,,,,,debit,posted,05c3d88db6f64ead8b60d87e5a9c37ff,INTER BANK,20-30,2018,9,20,9,0,Thursday,14 days,60137.139
ACC-1516130869,21,8.87,4941.38,1.0,CUS-325142416,2018-09-20,Jessica,F,-12.45,130.84,,ea38a00c-0d8f-47a9-bf86-d597ae174d69,-12.5,130.98,NT,Gray,debit,authorized,9aa1c6c8f16c4f25824a20aab11b1933,POS,20-30,2018,9,20,14,39,Thursday,14 days,60137.139
ACC-1516130869,21,42.17,4899.21,1.0,CUS-325142416,2018-09-21,Jessica,F,-12.45,130.84,,e339b7bc-2843-4ccd-a211-26f2965b969c,-12.4,130.86,NT,Eaton,debit,authorized,c93aa9dd78104b1db43806d9b0d5305f,SALES-POS,20-30,2018,9,21,11,35,Friday,14 days,60137.139
ACC-1516130869,21,29.0,4870.21,,CUS-325142416,2018-09-21,Jessica,F,-12.45,130.84,,,,,,,debit,posted,8d5a0cafa21346488a7ce8042a938199,PAYMENT,20-30,2018,9,21,13,0,Friday,14 days,60137.139
ACC-1516130869,21,71.79,4798.42,1.0,CUS-325142416,2018-09-21,Jessica,F,-12.45,130.84,,8f48b018-626c-4dec-add6-a91f3e372086,-12.43,130.88,NT,Winnellie,debit,authorized,7571a9f747db4c55ad4be13ff394d86a,SALES-POS,20-30,2018,9,21,16,14,Friday,14 days,60137.139
ACC-1516130869,21,26.25,4772.17,1.0,CUS-325142416,2018-09-21,Jessica,F,-12.45,130.84,,8f49e7a9-c5ca-4c7a-81dc-911ec5e52ba6,-37.71,145.15,VIC,Ringwood,debit,authorized,7d06efea38694558b72b859b4bf6c935,POS,20-30,2018,9,21,22,49,Friday,14 days,60137.139
ACC-1516130869,21,181.0,4591.17,,CUS-325142416,2018-09-23,Jessica,F,-12.45,130.84,,,,,,,debit,posted,ed7f80e4d1ac444caf185efd9a4ba54e,PAYMENT,20-30,2018,9,23,3,0,Sunday,14 days,60137.139
ACC-1516130869,21,99.59,4491.58,0.0,CUS-325142416,2018-09-25,Jessica,F,-12.45,130.84,,acb77539-e479-4f85-b231-0330e17f620f,-27.47,153.02,QLD,Petrie Terrace,debit,authorized,2c4fa3a537a34ec39260ee4c2d5f2b33,SALES-POS,20-30,2018,9,25,13,50,Tuesday,14 days,60137.139
ACC-1516130869,21,245.16,4246.42,1.0,CUS-325142416,2018-09-26,Jessica,F,-12.45,130.84,,880922a8-b065-4a7b-942f-db523006e273,-12.4,130.85,NT,Coconut Grove,debit,authorized,a9cbd3362ea743ca8e8b651da4203a7d,SALES-POS,20-30,2018,9,26,8,12,Wednesday,14 days,60137.139
ACC-1516130869,21,7.63,4238.79,0.0,CUS-325142416,2018-09-26,Jessica,F,-12.45,130.84,,61334d6d-b25d-4c6c-9145-029b9a988c70,-12.48,130.99,NT,Palmerston City,debit,authorized,3d2b989d09fe4354bf7763624bedcf0a,SALES-POS,20-30,2018,9,26,11,3,Wednesday,14 days,60137.139
ACC-1516130869,21,39.0,4199.79,,CUS-325142416,2018-09-27,Jessica,F,-12.45,130.84,,,,,,,debit,posted,46f97df6054b4ac886e9239b7146ff60,INTER BANK,20-30,2018,9,27,9,0,Thursday,14 days,60137.139
ACC-1516130869,21,7.07,4192.72,1.0,CUS-325142416,2018-09-27,Jessica,F,-12.45,130.84,,ea214ee8-d5c0-4f98-aefb-c568c2e0ba46,-12.44,130.92,NT,Berrimah,debit,authorized,52b84e7d87af4a3dbab31bccd2e48184,SALES-POS,20-30,2018,9,27,15,8,Thursday,14 days,60137.139
ACC-1516130869,21,173.0,4019.72,,CUS-325142416,2018-09-28,Jessica,F,-12.45,130.84,,,,,,,debit,posted,8dab41b9992e4849ae2e858523944962,INTER BANK,20-30,2018,9,28,5,0,Friday,14 days,60137.139
ACC-1516130869,21,52.0,3967.72,1.0,CUS-325142416,2018-09-28,Jessica,F,-12.45,130.84,,5fa60a42-096d-4d97-b830-fb70f449dd4a,-26.75,153.13,QLD,Birtinya,debit,authorized,4ea8f2567cda45b7b76131a4026841a9,POS,20-30,2018,9,28,11,24,Friday,14 days,60137.139
ACC-1516130869,21,29.0,3938.72,,CUS-325142416,2018-09-28,Jessica,F,-12.45,130.84,,,,,,,debit,posted,d053db4242fc4e63b625ca72c833cd70,PAYMENT,20-30,2018,9,28,13,0,Friday,14 days,60137.139
ACC-1516130869,21,9.16,3929.56,1.0,CUS-325142416,2018-09-29,Jessica,F,-12.45,130.84,,5218e5e3-8971-47bc-986a-0428a0fc7a04,-12.48,130.99,NT,Palmerston City,debit,authorized,42e3b6eca58544ec9c930047dedfbb07,SALES-POS,20-30,2018,9,29,0,12,Saturday,14 days,60137.139
ACC-1516130869,21,29.64,3899.92,1.0,CUS-325142416,2018-09-29,Jessica,F,-12.45,130.84,,8420f84b-ac16-498e-be44-f3b2e01c1637,-12.44,130.98,NT,Shoal Bay,debit,authorized,b231ab9ffb324a7e97c94130f2190bcb,SALES-POS,20-30,2018,9,29,10,35,Saturday,14 days,60137.139
ACC-1516130869,21,19.03,3880.89,1.0,CUS-325142416,2018-09-29,Jessica,F,-12.45,130.84,,f5e18f41-c46a-4ffe-ba21-54d71d370455,-12.46,130.93,NT,Wishart,debit,authorized,980fdebd2cd5453fa7de8008864ed546,POS,20-30,2018,9,29,17,35,Saturday,14 days,60137.139
ACC-1516130869,21,6.29,3874.6,1.0,CUS-325142416,2018-09-29,Jessica,F,-12.45,130.84,,7f424437-d396-4374-bdc1-53350e4387ba,-12.5,130.99,NT,Bakewell,debit,authorized,ee28717a09574caca78bcf620d57a904,SALES-POS,20-30,2018,9,29,23,25,Saturday,14 days,60137.139
ACC-1516130869,21,10.88,3863.72,0.0,CUS-325142416,2018-09-30,Jessica,F,-12.45,130.84,,012fee56-7727-4955-921a-f0369663dc65,-12.46,130.84,NT,Darwin City,debit,authorized,83fcdad4abba4bde8353f64413890a11,POS,20-30,2018,9,30,9,21,Sunday,14 days,60137.139
ACC-1516130869,21,11.98,3851.74,1.0,CUS-325142416,2018-09-30,Jessica,F,-12.45,130.84,,87d5733e-37a1-4c74-9520-ba063523472f,-31.94,115.84,WA,Leederville,debit,authorized,2cc40e9ee9524ef889e3f91ac71d1c33,SALES-POS,20-30,2018,9,30,10,9,Sunday,14 days,60137.139
ACC-1516130869,21,19.64,3832.1,1.0,CUS-325142416,2018-09-30,Jessica,F,-12.45,130.84,,4fde251c-0b81-43df-9c05-c3f0704ffe1c,-12.48,130.99,NT,Palmerston City,debit,authorized,26bc1defede0489186c6239bb7aa6743,POS,20-30,2018,9,30,12,31,Sunday,14 days,60137.139
ACC-1516130869,21,8.78,3823.32,1.0,CUS-325142416,2018-09-30,Jessica,F,-12.45,130.84,,45d395f2-14bd-49ef-889c-c0c5973d1421,-12.46,130.84,NT,Darwin City,debit,authorized,c09985ff11f148cfa5965b05886f4b51,SALES-POS,20-30,2018,9,30,15,42,Sunday,14 days,60137.139
ACC-1516130869,21,1134.0,2689.32,,CUS-325142416,2018-10-01,Jessica,F,-12.45,130.84,,,,,,,debit,posted,73478d25802d4b2eb1cedc2fa0de7267,INTER BANK,20-30,2018,10,1,20,0,Monday,14 days,60137.139
ACC-1516130869,21,5.64,4990.31,1.0,CUS-325142416,2018-10-03,Jessica,F,-12.45,130.84,,d7eb4b8f-0961-40b3-b124-13f949b576d7,-12.46,130.84,NT,Darwin City,debit,authorized,e34d9120c3fb4355af914112f6638ca9,SALES-POS,20-30,2018,10,3,16,34,Wednesday,14 days,60137.139
ACC-1516130869,21,17.28,4973.03,1.0,CUS-325142416,2018-10-03,Jessica,F,-12.45,130.84,,266779cc-70b9-4ea0-a015-455e96682423,-12.46,130.84,NT,Darwin City,debit,authorized,40fd55c12ff7421a9126e8b3600b67f9,SALES-POS,20-30,2018,10,3,21,11,Wednesday,14 days,60137.139
ACC-1516130869,21,9.89,4963.14,1.0,CUS-325142416,2018-10-03,Jessica,F,-12.45,130.84,,9564caf3-0416-4bad-9a44-3122374998bf,-12.4,130.92,NT,Karama,debit,authorized,bc2db125ce1c401ea57769901f92d0d8,POS,20-30,2018,10,3,22,9,Wednesday,14 days,60137.139
ACC-1516130869,21,39.0,4924.14,,CUS-325142416,2018-10-04,Jessica,F,-12.45,130.84,,,,,,,debit,posted,42255fcc3b6e4fa2bd6e661d2967913f,INTER BANK,20-30,2018,10,4,9,0,Thursday,14 days,60137.139
ACC-1516130869,21,15.14,4909.0,1.0,CUS-325142416,2018-10-04,Jessica,F,-12.45,130.84,,4f552956-78eb-4cbf-abec-88d28a47c66d,-12.39,130.86,NT,Millner,debit,authorized,10da0a6e64fd4ebaa2e155069a429a6d,POS,20-30,2018,10,4,19,43,Thursday,14 days,60137.139
ACC-1516130869,21,29.0,4880.0,,CUS-325142416,2018-10-05,Jessica,F,-12.45,130.84,,,,,,,debit,posted,00caf17000a04b11ad9124348f0e4700,PAYMENT,20-30,2018,10,5,13,0,Friday,14 days,60137.139
ACC-1516130869,21,11.09,4868.91,0.0,CUS-325142416,2018-10-05,Jessica,F,-12.45,130.84,,a6709743-af53-4d35-a5ae-d529b9ad399d,-33.86,151.21,NSW,Sydney,debit,authorized,7c977fd85a5c4f2182cf77f0b87e766a,SALES-POS,20-30,2018,10,5,21,13,Friday,14 days,60137.139
ACC-1516130869,21,12.11,4856.8,1.0,CUS-325142416,2018-10-11,Jessica,F,-12.45,130.84,,ff7652a0-7d92-41bf-afbc-0f1bb6c5cde2,-12.5,130.99,NT,Bakewell,debit,authorized,18b5d8214b6e4a55b111bd19c343845c,POS,20-30,2018,10,11,4,55,Thursday,14 days,60137.139
ACC-1516130869,21,39.0,4817.8,,CUS-325142416,2018-10-11,Jessica,F,-12.45,130.84,,,,,,,debit,posted,ca9ace4a4f62409db415f1a9c4d6755d,INTER BANK,20-30,2018,10,11,9,0,Thursday,14 days,60137.139
ACC-1516130869,21,6.9,4810.9,1.0,CUS-325142416,2018-10-12,Jessica,F,-12.45,130.84,,be172563-5944-47ae-ad39-c01576a33450,-37.82,144.97,VIC,Melbourne,debit,authorized,61343453dde14d57afc2b2a7dfde0e97,POS,20-30,2018,10,12,9,59,Friday,14 days,60137.139
ACC-1516130869,21,29.0,4781.9,,CUS-325142416,2018-10-12,Jessica,F,-12.45,130.84,,,,,,,debit,posted,8a6934958b2d4fe48c27fa7b1b06a762,PAYMENT,20-30,2018,10,12,13,0,Friday,14 days,60137.139
ACC-1516130869,21,29.64,4752.26,1.0,CUS-325142416,2018-10-12,Jessica,F,-12.45,130.84,,cb021e50-fc33-4d52-9d1c-e17b5c7b277b,-12.46,130.84,NT,Darwin,debit,authorized,143e5c48256b47e4bc2cb9af216eed6c,POS,20-30,2018,10,12,19,21,Friday,14 days,60137.139
ACC-1516130869,21,25.22,4727.04,1.0,CUS-325142416,2018-10-15,Jessica,F,-12.45,130.84,,0be68ac2-b725-4f65-815c-7362b5435768,-12.45,130.84,NT,Stuart Park,debit,authorized,7a3c747d34054b2b9d4432ebd80f1c16,POS,20-30,2018,10,15,18,38,Monday,14 days,60137.139
ACC-1516130869,21,12.53,4714.51,0.0,CUS-325142416,2018-10-15,Jessica,F,-12.45,130.84,,63821ef6-be41-48de-872a-fdd5cc4e29ea,-12.47,130.98,NT,Yarrawonga,debit,authorized,fc1cee3bafaf4b6985a42580526966ca,POS,20-30,2018,10,15,20,35,Monday,14 days,60137.139
ACC-1516130869,21,39.0,6982.14,,CUS-325142416,2018-10-18,Jessica,F,-12.45,130.84,,,,,,,debit,posted,5e29a3c63ae945ad824913cd3cf2cd9a,INTER BANK,20-30,2018,10,18,9,0,Thursday,14 days,60137.139
ACC-1516130869,21,29.0,6953.14,,CUS-325142416,2018-10-19,Jessica,F,-12.45,130.84,,,,,,,debit,posted,cf5acdfcd73444e8bb31d4db79a5260c,PAYMENT,20-30,2018,10,19,13,0,Friday,14 days,60137.139
ACC-1516130869,21,3680.71,3272.43,1.0,CUS-325142416,2018-10-22,Jessica,F,-12.45,130.84,,28d6a5ac-52c7-42f0-96ee-80140a350d8d,-37.82,144.96,VIC,Melbourne,debit,authorized,ea74926b67764c0e889490aa5f04d34c,SALES-POS,20-30,2018,10,22,13,3,Monday,14 days,60137.139
ACC-1516130869,21,181.0,3091.43,,CUS-325142416,2018-10-23,Jessica,F,-12.45,130.84,,,,,,,debit,posted,a7bcce89b4034ca8a31ea79079bcee11,PAYMENT,20-30,2018,10,23,3,0,Tuesday,14 days,60137.139
ACC-1516130869,21,22.63,3068.8,1.0,CUS-325142416,2018-10-24,Jessica,F,-12.45,130.84,,8f3cf4a8-e240-4fa7-9a9d-fda6e0f5ad41,-12.47,130.84,NT,Darwin,debit,authorized,8b1f360933414055973482981497817a,POS,20-30,2018,10,24,10,49,Wednesday,14 days,60137.139
ACC-1516130869,21,14.89,3053.91,1.0,CUS-325142416,2018-10-24,Jessica,F,-12.45,130.84,,2b4c4504-09a4-4055-b52d-d410a85c4a78,-12.47,130.99,NT,Yarrawonga,debit,authorized,b28df6ea38b44d448e0669ca27971a91,POS,20-30,2018,10,24,14,50,Wednesday,14 days,60137.139
ACC-1516130869,21,13.34,3040.57,1.0,CUS-325142416,2018-10-24,Jessica,F,-12.45,130.84,,73c0924f-dc35-4ab1-8136-2b5775cf4280,-12.44,130.84,NT,Stuart Park,debit,authorized,ac94dee99d7748a8907b7b73c5e5caa4,SALES-POS,20-30,2018,10,24,22,54,Wednesday,14 days,60137.139
ACC-1516130869,21,39.0,3001.57,,CUS-325142416,2018-10-25,Jessica,F,-12.45,130.84,,,,,,,debit,posted,dd38764d5c1e41578add0c9cdc055fb6,INTER BANK,20-30,2018,10,25,9,0,Thursday,14 days,60137.139
ACC-1516130869,21,9.68,2991.89,1.0,CUS-325142416,2018-10-25,Jessica,F,-12.45,130.84,,512ead5e-8685-4c6f-825c-2441cd95892d,-12.5,130.99,NT,Bakewell,debit,authorized,646816695c4c456fb0d6bb07534376e5,POS,20-30,2018,10,25,12,40,Thursday,14 days,60137.139
ACC-1516130869,21,13.99,2977.9,1.0,CUS-325142416,2018-10-25,Jessica,F,-12.45,130.84,,dec91e23-6fd7-4a9e-9f46-58c5dad66a3f,-12.39,130.85,NT,Coconut Grove,debit,authorized,9927aa3ae6704814bf5571498d26b9d6,SALES-POS,20-30,2018,10,25,21,54,Thursday,14 days,60137.139
ACC-1516130869,21,13.16,2964.74,1.0,CUS-325142416,2018-10-26,Jessica,F,-12.45,130.84,,f96002fc-55ea-4fa9-a6df-7d7cd8b15596,-12.39,130.88,NT,Jingili,debit,authorized,87a3cb9d3a6547d19b403244cd196f06,SALES-POS,20-30,2018,10,26,8,36,Friday,14 days,60137.139
ACC-1516130869,21,29.0,2935.74,,CUS-325142416,2018-10-26,Jessica,F,-12.45,130.84,,,,,,,debit,posted,46e09a0e4a9b40419e49dce42a47dee8,PAYMENT,20-30,2018,10,26,13,0,Friday,14 days,60137.139
ACC-1516130869,21,8.61,2927.13,0.0,CUS-325142416,2018-10-26,Jessica,F,-12.45,130.84,,44e05260-47f6-4a92-855a-6c3e0d6084d2,-12.46,130.85,NT,Darwin City,debit,authorized,7ffc67cf38c74e658cce6ee4360a528e,POS,20-30,2018,10,26,23,59,Friday,14 days,60137.139
ACC-1516130869,21,21.35,2905.78,1.0,CUS-325142416,2018-10-27,Jessica,F,-12.45,130.84,,ff09356c-3421-4a4a-8557-679a6bf14980,-12.46,130.84,NT,Darwin City,debit,authorized,008a6000c71e466597dd50c52bfcae17,POS,20-30,2018,10,27,15,39,Saturday,14 days,60137.139
ACC-1516130869,21,173.0,2732.78,,CUS-325142416,2018-10-28,Jessica,F,-12.45,130.84,,,,,,,debit,posted,f24accb807344db5a1432f075afcb349,INTER BANK,20-30,2018,10,28,5,0,Sunday,14 days,60137.139
ACC-1516130869,21,7.22,2725.56,1.0,CUS-325142416,2018-10-28,Jessica,F,-12.45,130.84,,358e6a17-3f2d-4023-803d-b63b201c583e,-12.41,130.88,NT,Eaton,debit,authorized,3dd7758d3c56479a88909c2b3641b45d,SALES-POS,20-30,2018,10,28,22,42,Sunday,14 days,60137.139
ACC-1516130869,21,16.8,2708.76,1.0,CUS-325142416,2018-10-29,Jessica,F,-12.45,130.84,,ae341c0f-536e-4250-9304-603a9c0bf52c,-12.48,130.98,NT,Palmerston City,debit,authorized,cad9ca762c894563a75abdf2515a3ef6,POS,20-30,2018,10,29,15,30,Monday,14 days,60137.139
ACC-1516130869,21,25.29,2683.47,1.0,CUS-325142416,2018-10-29,Jessica,F,-12.45,130.84,,27f93a60-ed2e-4b56-826d-8b1c9f1c1b8a,-33.88,151.02,NSW,Regents Park,debit,authorized,d24efa3a81f74904bede0cd0da0bc0e4,SALES-POS,20-30,2018,10,29,21,53,Monday,14 days,60137.139
ACC-1516130869,21,7.95,2675.52,1.0,CUS-325142416,2018-10-30,Jessica,F,-12.45,130.84,,ea38a00c-0d8f-47a9-bf86-d597ae174d69,-12.5,130.98,NT,Gray,debit,authorized,e7ba858ec45e4f4486926d87d86ce887,POS,20-30,2018,10,30,10,54,Tuesday,14 days,60137.139
ACC-1516130869,21,12.05,2663.47,1.0,CUS-325142416,2018-10-31,Jessica,F,-12.45,130.84,,9aadede0-3d4f-4ac2-ac25-8f3e5858435f,-12.44,130.83,NT,The Gardens,debit,authorized,1b5d26e1263c4ee4850e28a0843e61b7,SALES-POS,20-30,2018,10,31,9,47,Wednesday,14 days,60137.139
ACC-1516130869,21,23.48,4946.62,1.0,CUS-325142416,2018-10-31,Jessica,F,-12.45,130.84,,7a3610ce-2f3c-4c7f-becf-987ddeb1c533,-12.46,130.84,NT,Darwin City,debit,authorized,74b737841b9548b494af32ba71627716,POS,20-30,2018,10,31,22,51,Wednesday,14 days,60137.139
ACC-1056639002,22,39.92,39595.08,1.0,CUS-3462882033,2018-08-01,Michael,M,-37.91,145.03,,8caa374e-b525-4314-82e2-b8a4d8828490,-37.78,144.98,VIC,Carlton North,debit,authorized,bc6ef7e90d3a4b479e881b68d68eedf5,SALES-POS,20-30,2018,8,1,15,52,Wednesday,14 days,81700.97
ACC-1056639002,22,86.0,42704.09,,CUS-3462882033,2018-08-02,Michael,M,-37.91,145.03,,,,,,,debit,posted,a2209dcbd0e147abb458dc843f69d66d,PAYMENT,20-30,2018,8,2,21,0,Thursday,14 days,81700.97
ACC-1056639002,22,147.0,42557.09,,CUS-3462882033,2018-08-03,Michael,M,-37.91,145.03,,,,,,,debit,posted,ed7e57d40878401192838f2951d6fd37,INTER BANK,20-30,2018,8,3,6,0,Friday,14 days,81700.97
ACC-1056639002,22,36.0,42521.09,,CUS-3462882033,2018-08-05,Michael,M,-37.91,145.03,,,,,,,debit,posted,d62b65dc372849c7bd86bae0f564dc9f,INTER BANK,20-30,2018,8,5,3,0,Sunday,14 days,81700.97
ACC-1056639002,22,19.96,42501.13,1.0,CUS-3462882033,2018-08-05,Michael,M,-37.91,145.03,,389991f4-f4f4-4d49-bcc0-b4222b5535b6,-37.83,147.61,VIC,Bairnsdale,debit,authorized,801eeb97e2d1467fb67366b9fbd49b39,POS,20-30,2018,8,5,9,15,Sunday,14 days,81700.97
ACC-1056639002,22,101.89,42399.24,1.0,CUS-3462882033,2018-08-05,Michael,M,-37.91,145.03,,fb3fbd7f-e489-4c76-b5eb-ddb641ce9737,-37.9,144.66,VIC,Werribee,debit,authorized,d04982e4ed54404a8366c49ed8e63bf1,POS,20-30,2018,8,5,12,10,Sunday,14 days,81700.97
ACC-1056639002,22,38.7,42360.54,0.0,CUS-3462882033,2018-08-11,Michael,M,-37.91,145.03,,51b2dffe-13c9-4c52-ba4a-a31a41e8a5b5,-37.84,145,VIC,South Yarra,debit,authorized,66c8dd15631843dc995ecf894eec425d,POS,20-30,2018,8,11,15,31,Saturday,14 days,81700.97
ACC-1056639002,22,36.0,42324.54,,CUS-3462882033,2018-08-12,Michael,M,-37.91,145.03,,,,,,,debit,posted,6f307ad77cb34cfc919186111dedceef,INTER BANK,20-30,2018,8,12,3,0,Sunday,14 days,81700.97
ACC-1056639002,22,38.23,42286.31,1.0,CUS-3462882033,2018-08-12,Michael,M,-37.91,145.03,,e8d3e859-db04-4b1b-9e7c-0ae39f23ca67,-37.78,145.16,VIC,Doncaster East,debit,authorized,1cbf1f0b66174b628b68b8c2c82fbe19,SALES-POS,20-30,2018,8,12,9,7,Sunday,14 days,81700.97
ACC-1056639002,22,16.78,42269.53,1.0,CUS-3462882033,2018-08-15,Michael,M,-37.91,145.03,,43a4a2f1-7bf2-478a-aac9-163b2eb0f90b,-38.01,145.19,VIC,Dandenong South,debit,authorized,328ad77cccf742a3aa19b8d43acace73,SALES-POS,20-30,2018,8,15,9,45,Wednesday,14 days,81700.97
ACC-1056639002,22,16.25,42253.28,0.0,CUS-3462882033,2018-08-15,Michael,M,-37.91,145.03,,238774cb-e57c-4054-815a-be7606a52038,-37.83,140.78,SA,Mount Gambier,debit,authorized,978b89143ca543fa9dfa5073bae6dcba,POS,20-30,2018,8,15,11,13,Wednesday,14 days,81700.97
ACC-1056639002,22,103.61,42149.67,1.0,CUS-3462882033,2018-08-15,Michael,M,-37.91,145.03,,0c4bd181-32b2-4b81-8cbc-5f17b0ea5a20,-33.87,151.2,NSW,Sydney,debit,authorized,6962b64d25714a0f9c70cedaa92f7b2d,POS,20-30,2018,8,15,11,41,Wednesday,14 days,81700.97
ACC-1056639002,22,55.55,42094.12,1.0,CUS-3462882033,2018-08-15,Michael,M,-37.91,145.03,,9f8b5e65-e1a3-4406-beef-c96ed9d6de31,-37.68,145.07,VIC,Bundoora,debit,authorized,fe533eeefb124d94919ab212e7027b94,SALES-POS,20-30,2018,8,15,13,1,Wednesday,14 days,81700.97
ACC-1056639002,22,29.04,42065.08,1.0,CUS-3462882033,2018-08-15,Michael,M,-37.91,145.03,,7ce6fb22-ab24-4035-87e9-f1281c6f8ac4,-37.88,145,VIC,Elsternwick,debit,authorized,a211e9b96420460da9dded66a44a64b3,POS,20-30,2018,8,15,14,36,Wednesday,14 days,81700.97
ACC-1056639002,22,25.7,42039.38,1.0,CUS-3462882033,2018-08-15,Michael,M,-37.91,145.03,,d3a6299c-38b6-44d7-9dda-0aea7c6476f9,-37.83,140.78,SA,Mount Gambier,debit,authorized,db90613d727940f485e0d4edf66f8fe4,SALES-POS,20-30,2018,8,15,19,50,Wednesday,14 days,81700.97
ACC-1056639002,22,163.0,43192.39,,CUS-3462882033,2018-08-18,Michael,M,-37.91,145.03,,,,,,,debit,posted,dfeb0f10711f4379b3389b19f7ce37ba,PAYMENT,20-30,2018,8,18,22,0,Saturday,14 days,81700.97
ACC-1056639002,22,36.0,43156.39,,CUS-3462882033,2018-08-19,Michael,M,-37.91,145.03,,,,,,,debit,posted,2324a8fed1594fb39ae8591167cad4e2,INTER BANK,20-30,2018,8,19,3,0,Sunday,14 days,81700.97
ACC-1056639002,22,20.32,43136.07,0.0,CUS-3462882033,2018-08-19,Michael,M,-37.91,145.03,,389991f4-f4f4-4d49-bcc0-b4222b5535b6,-37.83,147.61,VIC,Bairnsdale,debit,authorized,56faf664eaaf45deb154eaad4e223964,POS,20-30,2018,8,19,7,49,Sunday,14 days,81700.97
ACC-1056639002,22,10.79,43125.28,1.0,CUS-3462882033,2018-08-19,Michael,M,-37.91,145.03,,5c271fb0-097e-42ad-bce8-9d79c16923f2,-38.11,147.07,VIC,Sale,debit,authorized,9bd619bcad63494e92c6562759ef8ace,POS,20-30,2018,8,19,9,38,Sunday,14 days,81700.97
ACC-1056639002,22,6.84,43118.44,1.0,CUS-3462882033,2018-08-19,Michael,M,-37.91,145.03,,eb866450-50ca-48ab-a81b-01b464cef36a,-37.81,145.03,VIC,Kew,debit,authorized,f07765b51b5c4989beb749efa033bec5,SALES-POS,20-30,2018,8,19,10,44,Sunday,14 days,81700.97
ACC-1056639002,22,13.41,43105.03,1.0,CUS-3462882033,2018-08-19,Michael,M,-37.91,145.03,,66d798ac-f635-4c07-869d-95376ec05761,-37.91,145.15,VIC,Clayton,debit,authorized,133d79982d0b4349a15340f2d4661206,POS,20-30,2018,8,19,11,29,Sunday,14 days,81700.97
ACC-1056639002,22,30.91,43074.12,1.0,CUS-3462882033,2018-08-19,Michael,M,-37.91,145.03,,13eded63-7e1c-455c-a27b-27c47e39a1c6,-37.95,145.18,VIC,Noble Park,debit,authorized,b21f7b813c6445c2a561df5e3b320286,SALES-POS,20-30,2018,8,19,16,8,Sunday,14 days,81700.97
ACC-1056639002,22,107.47,42966.65,1.0,CUS-3462882033,2018-08-19,Michael,M,-37.91,145.03,,1f32ded5-860d-4944-873e-a3df13d76967,-37.81,144.99,VIC,Collingwood,debit,authorized,bcdabb446f804bff87ab33348dbc73b4,SALES-POS,20-30,2018,8,19,21,39,Sunday,14 days,81700.97
ACC-1056639002,22,9.81,42956.84,0.0,CUS-3462882033,2018-08-20,Michael,M,-37.91,145.03,,309c28ba-4c21-4e0b-8299-48683e56ca54,-37.87,145.03,VIC,Malvern,debit,authorized,8d1fbd6305b54f54aec194be95a0dabb,POS,20-30,2018,8,20,20,31,Monday,14 days,81700.97
ACC-1056639002,22,39.68,42917.16,1.0,CUS-3462882033,2018-08-21,Michael,M,-37.91,145.03,,f1109d9c-a34a-4d95-ade8-3e3a69d5f9aa,-37.86,144.98,VIC,Saint Kilda,debit,authorized,6f68ac53478d4846b5ffd26c30a86d5d,POS,20-30,2018,8,21,13,37,Tuesday,14 days,81700.97
ACC-1056639002,22,7.75,42909.41,0.0,CUS-3462882033,2018-08-22,Michael,M,-37.91,145.03,,707d851c-e281-43ff-ba6c-f2117b56566b,-38.11,145.17,VIC,Carrum Downs,debit,authorized,fd27c8e7916d45d7971421d1d8dc8e32,SALES-POS,20-30,2018,8,22,4,38,Wednesday,14 days,81700.97
ACC-1056639002,22,12.15,42897.26,1.0,CUS-3462882033,2018-08-22,Michael,M,-37.91,145.03,,0190da6a-3d01-40b5-9883-d509cc4002b6,-37.96,145.19,VIC,Noble Park,debit,authorized,6c69314b4aac4b71b761bcffe08c4357,POS,20-30,2018,8,22,6,4,Wednesday,14 days,81700.97
ACC-1056639002,22,11.63,42885.63,0.0,CUS-3462882033,2018-08-23,Michael,M,-37.91,145.03,,bbc415ee-dbcf-4a27-8f61-ea145e0a1a33,-37.74,145,VIC,Preston,debit,authorized,728edb4d227948a09906b77f197a6386,SALES-POS,20-30,2018,8,23,15,34,Thursday,14 days,81700.97
ACC-1056639002,22,9.31,42876.32,1.0,CUS-3462882033,2018-08-23,Michael,M,-37.91,145.03,,36b3e446-2988-449e-9264-8d0c55c09bcb,-37.92,145.12,VIC,Clayton,debit,authorized,60cc625647be4ef5b24f5f95c8a0ac59,SALES-POS,20-30,2018,8,23,20,41,Thursday,14 days,81700.97
ACC-1056639002,22,52.59,42823.73,1.0,CUS-3462882033,2018-08-23,Michael,M,-37.91,145.03,,b44f2d09-7754-4e1c-b412-9b253346742c,-38.09,144.36,VIC,Norlane,debit,authorized,f91303c12e9f422abda25ff92b275ffc,SALES-POS,20-30,2018,8,23,21,55,Thursday,14 days,81700.97
ACC-1056639002,22,5.97,42817.76,1.0,CUS-3462882033,2018-08-24,Michael,M,-37.91,145.03,,37178bdb-2859-474d-b395-f7251b9e2b28,-37.73,144.87,VIC,Keilor East,debit,authorized,a1cdae2ea64346f7a962428774153dc0,SALES-POS,20-30,2018,8,24,11,17,Friday,14 days,81700.97
ACC-1056639002,22,36.0,42781.76,,CUS-3462882033,2018-08-26,Michael,M,-37.91,145.03,,,,,,,debit,posted,75e56d28e08c4b16aec7948198ae9c72,INTER BANK,20-30,2018,8,26,3,0,Sunday,14 days,81700.97
ACC-1056639002,22,12.46,42769.3,1.0,CUS-3462882033,2018-08-28,Michael,M,-37.91,145.03,,fdbf07b8-a347-4dc1-9953-4aadee511d3a,-37.81,144.96,VIC,Melbourne,debit,authorized,b3dc16675e894fbfbb30aeac09a0fbac,POS,20-30,2018,8,28,13,9,Tuesday,14 days,81700.97
ACC-1056639002,22,15.84,42753.46,0.0,CUS-3462882033,2018-08-29,Michael,M,-37.91,145.03,,d11c5550-a396-4b1d-b085-cd76a6274280,-37.74,145.07,VIC,Rosanna,debit,authorized,b793376496fb49389fcd5ce771322031,SALES-POS,20-30,2018,8,29,23,44,Wednesday,14 days,81700.97
ACC-1056639002,22,20.55,45927.92,1.0,CUS-3462882033,2018-09-01,Michael,M,-37.91,145.03,,34982e8c-3d7e-4833-a9e2-905af0d7ae71,-37.81,145.23,VIC,Ringwood,debit,authorized,ada5829b67db44d582411d70e32d9d29,SALES-POS,20-30,2018,9,1,8,39,Saturday,14 days,81700.97
ACC-1056639002,22,49.39,45878.53,1.0,CUS-3462882033,2018-09-01,Michael,M,-37.91,145.03,,fcff708f-9da5-4150-8650-d9aaa3cac19f,-37.83,144.99,VIC,Richmond,debit,authorized,fd5bd940a9be4187bf23b414174361e4,POS,20-30,2018,9,1,11,41,Saturday,14 days,81700.97
ACC-1056639002,22,7.86,45870.67,0.0,CUS-3462882033,2018-09-01,Michael,M,-37.91,145.03,,b627037c-26e1-42dc-9a1b-51d2c73b4629,-37.76,145.07,VIC,Heidelberg,debit,authorized,08a03516c6c546a586078e141cbfa1f6,POS,20-30,2018,9,1,20,0,Saturday,14 days,81700.97
ACC-1056639002,22,36.0,45834.67,,CUS-3462882033,2018-09-02,Michael,M,-37.91,145.03,,,,,,,debit,posted,be8385e9b31c453e82305c3e22347854,INTER BANK,20-30,2018,9,2,3,0,Sunday,14 days,81700.97
ACC-1056639002,22,55.78,45778.89,0.0,CUS-3462882033,2018-09-02,Michael,M,-37.91,145.03,,24751771-4535-46e7-959c-78dee7b00db0,-37.79,144.99,VIC,Clifton Hill,debit,authorized,30d5ad91835b47298b96c0a215ba473f,POS,20-30,2018,9,2,15,18,Sunday,14 days,81700.97
ACC-1056639002,22,15.18,45763.71,0.0,CUS-3462882033,2018-09-02,Michael,M,-37.91,145.03,,65db74fb-6e0a-4d76-9c2d-dd96c66de08b,-37.84,144.75,VIC,Truganina,debit,authorized,6aca27f0567f4fd48998e82bbc027773,POS,20-30,2018,9,2,17,51,Sunday,14 days,81700.97
ACC-1056639002,22,86.0,45677.71,,CUS-3462882033,2018-09-02,Michael,M,-37.91,145.03,,,,,,,debit,posted,7d0fd2ccd71c4dbcae5013b0ba342b6f,PAYMENT,20-30,2018,9,2,21,0,Sunday,14 days,81700.97
ACC-1056639002,22,14.62,45663.09,1.0,CUS-3462882033,2018-09-02,Michael,M,-37.91,145.03,,e3de18b7-b11a-45fd-b1fe-1c4e337242df,-37.85,145.23,VIC,Wantirna,debit,authorized,471da4f1604740ccb40c778dadd135c7,SALES-POS,20-30,2018,9,2,22,12,Sunday,14 days,81700.97
ACC-1056639002,22,147.0,45516.09,,CUS-3462882033,2018-09-03,Michael,M,-37.91,145.03,,,,,,,debit,posted,885790ce9fa942a7a65653e960d1faca,INTER BANK,20-30,2018,9,3,6,0,Monday,14 days,81700.97
ACC-1056639002,22,36.0,45480.09,,CUS-3462882033,2018-09-09,Michael,M,-37.91,145.03,,,,,,,debit,posted,7f660372db85431691a1a645d8d46a28,INTER BANK,20-30,2018,9,9,3,0,Sunday,14 days,81700.97
ACC-1056639002,22,28.06,45452.03,1.0,CUS-3462882033,2018-09-09,Michael,M,-37.91,145.03,,3b531f43-befb-4881-ab75-89dafa836086,-37.8,144.98,VIC,Fitzroy,debit,authorized,90a29f6056154b74843c895e6bc3f309,SALES-POS,20-30,2018,9,9,14,45,Sunday,14 days,81700.97
ACC-1056639002,22,13.44,45438.59,1.0,CUS-3462882033,2018-09-10,Michael,M,-37.91,145.03,,cdcef1bf-8c51-4c37-8986-efdb22d06bd8,-37.82,145,VIC,Richmond,debit,authorized,a9ba3457867d4f0f885fb2e228d948e1,SALES-POS,20-30,2018,9,10,20,5,Monday,14 days,81700.97
ACC-1056639002,22,68.34,45370.25,0.0,CUS-3462882033,2018-09-12,Michael,M,-37.91,145.03,,c019dbd6-3089-4949-b6ca-4c8aee0dc78a,-37.85,145,VIC,Windsor,debit,authorized,077ae5990e2d42a1ac7e1f30d330d055,SALES-POS,20-30,2018,9,12,4,18,Wednesday,14 days,81700.97
ACC-1056639002,22,9.31,45360.94,1.0,CUS-3462882033,2018-09-12,Michael,M,-37.91,145.03,,9db21f6e-950b-47b0-882a-408d3fee71ba,-37.88,144.68,VIC,Hoppers Crossing,debit,authorized,2cc62b944da84472a84b745985d90519,POS,20-30,2018,9,12,9,6,Wednesday,14 days,81700.97
ACC-1056639002,22,24.06,48531.89,1.0,CUS-3462882033,2018-09-15,Michael,M,-37.91,145.03,,e049f21d-3952-463a-878e-d9ab75d851b0,-37.85,145.13,VIC,Burwood East,debit,authorized,659829d40303489b8d8858fb6fe9d896,SALES-POS,20-30,2018,9,15,9,50,Saturday,14 days,81700.97
ACC-1056639002,22,14.55,48517.34,1.0,CUS-3462882033,2018-09-15,Michael,M,-37.91,145.03,,4e088088-0f3c-48bd-bd6f-e8151d535dc3,-37.76,144.92,VIC,Essendon,debit,authorized,08802ddea306419c9cb9f1ccf51114b5,SALES-POS,20-30,2018,9,15,19,59,Saturday,14 days,81700.97
ACC-1056639002,22,26.11,48491.23,1.0,CUS-3462882033,2018-09-15,Michael,M,-37.91,145.03,,62534dab-d47d-46d1-98e0-1419b0643e98,-37.85,144.99,VIC,South Yarra,debit,authorized,6acee96cdaf34e8c847be782633c60ab,SALES-POS,20-30,2018,9,15,20,36,Saturday,14 days,81700.97
ACC-1056639002,22,10.59,48480.64,1.0,CUS-3462882033,2018-09-15,Michael,M,-37.91,145.03,,74655009-eadf-4674-9930-e070251a3fa4,-37.83,144.91,VIC,Port Melbourne,debit,authorized,457b372023cc4e1f97946e188109dbf0,SALES-POS,20-30,2018,9,15,22,17,Saturday,14 days,81700.97
ACC-1056639002,22,405.38,48075.26,1.0,CUS-3462882033,2018-09-15,Michael,M,-37.91,145.03,,87d800d2-528d-425d-b3c7-305a9fc5e49b,-37.87,144.98,VIC,St Kilda,debit,authorized,0d806184821d4c19ae93e1c7956548b2,SALES-POS,20-30,2018,9,15,22,42,Saturday,14 days,81700.97
ACC-1056639002,22,36.0,48039.26,,CUS-3462882033,2018-09-16,Michael,M,-37.91,145.03,,,,,,,debit,posted,7703c8ca89044cb38f64ec0bfa587126,INTER BANK,20-30,2018,9,16,3,0,Sunday,14 days,81700.97
ACC-1056639002,22,13.77,48025.49,1.0,CUS-3462882033,2018-09-18,Michael,M,-37.91,145.03,,b9181f43-80e1-4dea-aab9-702b4d555d73,-37.81,145,VIC,Richmond,debit,authorized,22865d3f51cd4b89bc8b6912e26e2331,POS,20-30,2018,9,18,1,51,Tuesday,14 days,81700.97
ACC-1056639002,22,34.34,47991.15,1.0,CUS-3462882033,2018-09-18,Michael,M,-37.91,145.03,,ce9cbaca-6895-4554-a753-c50c43239c15,-37.88,145.11,VIC,Mount Waverley,debit,authorized,c839c72e15ec40518d2e41abc578100e,SALES-POS,20-30,2018,9,18,9,27,Tuesday,14 days,81700.97
ACC-1056639002,22,15.19,47975.96,1.0,CUS-3462882033,2018-09-18,Michael,M,-37.91,145.03,,2f7f4723-b7eb-43b6-9ad0-57559504dacc,-37.8,145.28,VIC,Croydon,debit,authorized,bbe6587fde6e444cbdddfa8deb0084a0,SALES-POS,20-30,2018,9,18,9,38,Tuesday,14 days,81700.97
ACC-1056639002,22,28.49,47947.47,1.0,CUS-3462882033,2018-09-18,Michael,M,-37.91,145.03,,52caf85e-43d7-4bbe-a9b4-c4296ddfc28a,-37.83,140.77,SA,Mount Gambier,debit,authorized,cddeb9b035364d47816eb10d6c2e545e,SALES-POS,20-30,2018,9,18,10,39,Tuesday,14 days,81700.97
ACC-1056639002,22,9.83,47937.64,1.0,CUS-3462882033,2018-09-18,Michael,M,-37.91,145.03,,a6a414b6-1be5-41ee-b02b-a66e9390858d,-37.74,145.03,VIC,Preston,debit,authorized,268b3eb5669e48f2bf2d911dc235d903,SALES-POS,20-30,2018,9,18,12,34,Tuesday,14 days,81700.97
ACC-1056639002,22,15.71,47921.93,0.0,CUS-3462882033,2018-09-18,Michael,M,-37.91,145.03,,507cfd1d-e392-48c9-8396-4fed929512dd,-37.93,145.27,VIC,Rowville,debit,authorized,f46f7351261848cb86e5e2730df306d4,SALES-POS,20-30,2018,9,18,15,8,Tuesday,14 days,81700.97
ACC-1056639002,22,27.86,47894.07,0.0,CUS-3462882033,2018-09-18,Michael,M,-37.91,145.03,,e9e92c26-7708-4913-b4c7-bd777edac937,-37.85,145.01,VIC,Armadale,debit,authorized,1f15c8397bd9420c88515b3d66154dfa,POS,20-30,2018,9,18,15,52,Tuesday,14 days,81700.97
ACC-1056639002,22,17.07,47877.0,1.0,CUS-3462882033,2018-09-18,Michael,M,-37.91,145.03,,a2723a55-29d2-440b-ac81-70510d75851d,-37.8,144.98,VIC,Fitzroy,debit,authorized,99f3f08ef9c944d78e6e71deea250bd5,SALES-POS,20-30,2018,9,18,16,53,Tuesday,14 days,81700.97
ACC-1056639002,22,163.0,47714.0,,CUS-3462882033,2018-09-18,Michael,M,-37.91,145.03,,,,,,,debit,posted,fac34bcda7dd451f9762bfe88c4fa10b,PAYMENT,20-30,2018,9,18,22,0,Tuesday,14 days,81700.97
ACC-1056639002,22,29.87,47684.13,1.0,CUS-3462882033,2018-09-19,Michael,M,-37.91,145.03,,941a066b-ac42-4ba4-b425-fabdd20547ba,-37.76,145.31,VIC,Chirnside Park,debit,authorized,5826c52147e742dabaaf594e64a574d3,SALES-POS,20-30,2018,9,19,15,54,Wednesday,14 days,81700.97
ACC-1056639002,22,36.0,47648.13,,CUS-3462882033,2018-09-23,Michael,M,-37.91,145.03,,,,,,,debit,posted,ac3656f850a2494291f5e51b9ee99b47,INTER BANK,20-30,2018,9,23,3,0,Sunday,14 days,81700.97
ACC-1056639002,22,10.09,50833.05,1.0,CUS-3462882033,2018-09-28,Michael,M,-37.91,145.03,,557cc3f5-2b22-4999-bdb9-6395dceaf9b9,-37.83,145,VIC,Richmond,debit,authorized,967a479356e443fb8c3b5c5bfd714532,SALES-POS,20-30,2018,9,28,16,17,Friday,14 days,81700.97
ACC-1056639002,22,36.0,50797.05,,CUS-3462882033,2018-09-30,Michael,M,-37.91,145.03,,,,,,,debit,posted,452a37def1204d47a81e82ee79a4f1a2,INTER BANK,20-30,2018,9,30,3,0,Sunday,14 days,81700.97
ACC-1056639002,22,19.4,50777.65,1.0,CUS-3462882033,2018-09-30,Michael,M,-37.91,145.03,,91fbec71-318e-4c1b-a0de-2cc0d7012841,-37.83,144.96,VIC,South Melbourne,debit,authorized,dbf069d56cf94ad4a9884ae68e0f5121,SALES-POS,20-30,2018,9,30,15,2,Sunday,14 days,81700.97
ACC-1056639002,22,40.94,50736.71,1.0,CUS-3462882033,2018-10-01,Michael,M,-37.91,145.03,,89b0ed33-b6f4-4d2e-be81-c966adebb166,-37.86,145.02,VIC,Armadale,debit,authorized,9309a25d339d4de2a67425609fed7e51,POS,20-30,2018,10,1,21,2,Monday,14 days,81700.97
ACC-1056639002,22,86.0,50650.71,,CUS-3462882033,2018-10-02,Michael,M,-37.91,145.03,,,,,,,debit,posted,46e86aee932d4f899fcbbad549a5f73c,PAYMENT,20-30,2018,10,2,21,0,Tuesday,14 days,81700.97
ACC-1056639002,22,147.0,50503.71,,CUS-3462882033,2018-10-03,Michael,M,-37.91,145.03,,,,,,,debit,posted,ea7b6f38109c4fddb9085af5a5be1b5e,INTER BANK,20-30,2018,10,3,6,0,Wednesday,14 days,81700.97
ACC-1056639002,22,17.42,50486.29,1.0,CUS-3462882033,2018-10-06,Michael,M,-37.91,145.03,,f586891e-8bf9-4bbc-bb15-90d8c0738204,-37.82,144.97,VIC,Southbank,debit,authorized,fad4eec612404275b2196a5acf1966c3,POS,20-30,2018,10,6,15,56,Saturday,14 days,81700.97
ACC-1056639002,22,36.0,50450.29,,CUS-3462882033,2018-10-07,Michael,M,-37.91,145.03,,,,,,,debit,posted,9cdd780551b74a56a386e2a2b4de89d5,INTER BANK,20-30,2018,10,7,3,0,Sunday,14 days,81700.97
ACC-1056639002,22,36.0,53609.3,,CUS-3462882033,2018-10-14,Michael,M,-37.91,145.03,,,,,,,debit,posted,158a306059914efe91e0f23409ca20be,INTER BANK,20-30,2018,10,14,3,0,Sunday,14 days,81700.97
ACC-1056639002,22,36.0,53573.3,1.0,CUS-3462882033,2018-10-14,Michael,M,-37.91,145.03,,073a244a-395e-4a0d-aed3-302eceaba586,-37.82,144.96,VIC,Southbank,debit,authorized,5924e4c0b858479b972ace0e78e232ee,SALES-POS,20-30,2018,10,14,22,32,Sunday,14 days,81700.97
ACC-1056639002,22,33.81,53539.49,1.0,CUS-3462882033,2018-10-17,Michael,M,-37.91,145.03,,138d4caf-1025-4013-a659-628b4148eb08,-33.87,151.2,NSW,Sydney,debit,authorized,beca5964e7ac49b79aa171e29f7d266f,SALES-POS,20-30,2018,10,17,9,22,Wednesday,14 days,81700.97
ACC-1056639002,22,9.96,53529.53,1.0,CUS-3462882033,2018-10-17,Michael,M,-37.91,145.03,,c0d4f295-898e-43cf-8b33-ae2ebbbbabef,-38.04,145.11,VIC,Edithvale,debit,authorized,6252e8a756af4b23bded1a6c739948a0,POS,20-30,2018,10,17,14,30,Wednesday,14 days,81700.97
ACC-1056639002,22,163.0,53366.53,,CUS-3462882033,2018-10-18,Michael,M,-37.91,145.03,,,,,,,debit,posted,7cf57aeade3e42cf91a24646ab76d0b7,PAYMENT,20-30,2018,10,18,22,0,Thursday,14 days,81700.97
ACC-1056639002,22,36.0,53330.53,,CUS-3462882033,2018-10-21,Michael,M,-37.91,145.03,,,,,,,debit,posted,917656fda4664f9c8ab6abbeea444e73,INTER BANK,20-30,2018,10,21,3,0,Sunday,14 days,81700.97
ACC-1056639002,22,36.0,56489.54,,CUS-3462882033,2018-10-28,Michael,M,-37.91,145.03,,,,,,,debit,posted,bb90420e483343ebabcd548a7c654e0a,INTER BANK,20-30,2018,10,28,3,0,Sunday,14 days,81700.97
ACC-1279356312,44,8.1,1082.64,1.0,CUS-1892177589,2018-08-01,Tyler,M,-37.73,144.79,,6f26079c-0269-473c-8db5-48c93b871572,-37.76,145.17,VIC,Doncaster East,debit,authorized,6dfe62109c534a1d9cb76b57d703e7fe,POS,40-50,2018,8,1,15,58,Wednesday,14 days,75277.079
ACC-1279356312,44,15.28,1067.36,1.0,CUS-1892177589,2018-08-01,Tyler,M,-37.73,144.79,,9ceb9e51-60f0-4e1a-9656-caad3dd9a75f,-37.72,145.01,VIC,Reservoir,debit,authorized,c06d646beb4b4bb090caf460a6c32f4e,SALES-POS,40-50,2018,8,1,17,10,Wednesday,14 days,75277.079
ACC-1279356312,44,31.81,1035.55,1.0,CUS-1892177589,2018-08-02,Tyler,M,-37.73,144.79,,68ba666f-fcef-45e2-be45-efed62c99653,-38.37,144.82,VIC,Rye,debit,authorized,5092d408f08a491f842632568b80970b,POS,40-50,2018,8,2,9,50,Thursday,14 days,75277.079
ACC-1279356312,44,15.0,1020.55,,CUS-1892177589,2018-08-02,Tyler,M,-37.73,144.79,,,,,,,debit,posted,5810fea62c6542288f4a08f53071f6e3,PAYMENT,40-50,2018,8,2,17,0,Thursday,14 days,75277.079
ACC-1279356312,44,41.0,979.55,,CUS-1892177589,2018-08-02,Tyler,M,-37.73,144.79,,,,,,,debit,posted,64426395f5744097b70d5ec379f94f03,PAYMENT,40-50,2018,8,2,20,0,Thursday,14 days,75277.079
ACC-1279356312,44,27.0,952.55,,CUS-1892177589,2018-08-07,Tyler,M,-37.73,144.79,,,,,,,debit,posted,ff96ae63e0bc4b18b65ca7f0a27804fb,PAYMENT,40-50,2018,8,7,17,0,Tuesday,14 days,75277.079
ACC-1279356312,44,156.0,796.55,,CUS-1892177589,2018-08-08,Tyler,M,-37.73,144.79,,,,,,,debit,posted,28ee36af6f514a0f808f0939e01f5189,PAYMENT,40-50,2018,8,8,6,0,Wednesday,14 days,75277.079
ACC-1279356312,44,15.0,3668.89,,CUS-1892177589,2018-08-09,Tyler,M,-37.73,144.79,,,,,,,debit,posted,d0dadf720f6240d6a8bbb9ae6d817008,PAYMENT,40-50,2018,8,9,17,0,Thursday,14 days,75277.079
ACC-1279356312,44,41.0,3627.89,,CUS-1892177589,2018-08-09,Tyler,M,-37.73,144.79,,,,,,,debit,posted,259520c2024d4de2ad66470d8feaaacf,PAYMENT,40-50,2018,8,9,20,0,Thursday,14 days,75277.079
ACC-1279356312,44,159.0,3468.89,,CUS-1892177589,2018-08-09,Tyler,M,-37.73,144.79,,,,,,,debit,posted,4e9341530c684d7b86cf734196c36512,PAYMENT,40-50,2018,8,9,22,0,Thursday,14 days,75277.079
ACC-1279356312,44,27.0,3441.89,,CUS-1892177589,2018-08-14,Tyler,M,-37.73,144.79,,,,,,,debit,posted,311f78567b2e43e4b34176bd5f722fb7,PAYMENT,40-50,2018,8,14,17,0,Tuesday,14 days,75277.079
ACC-1279356312,44,164.0,3277.89,,CUS-1892177589,2018-08-15,Tyler,M,-37.73,144.79,,,,,,,debit,posted,deafe767838044ec8eadd452b824ed0a,INTER BANK,40-50,2018,8,15,18,0,Wednesday,14 days,75277.079
ACC-1279356312,44,27.0,3194.89,,CUS-1892177589,2018-08-21,Tyler,M,-37.73,144.79,,,,,,,debit,posted,bc9bf50726d14a1185af195099403e23,PAYMENT,40-50,2018,8,21,17,0,Tuesday,14 days,75277.079
ACC-1279356312,44,15.0,6067.23,,CUS-1892177589,2018-08-23,Tyler,M,-37.73,144.79,,,,,,,debit,posted,e5efee336030410ea6cf26e7b6ee0216,PAYMENT,40-50,2018,8,23,17,0,Thursday,14 days,75277.079
ACC-1279356312,44,41.0,6026.23,,CUS-1892177589,2018-08-23,Tyler,M,-37.73,144.79,,,,,,,debit,posted,cec6e19c899d4ab4bf1a8fad4690cf97,PAYMENT,40-50,2018,8,23,20,0,Thursday,14 days,75277.079
ACC-1279356312,44,6.4,6019.83,1.0,CUS-1892177589,2018-08-25,Tyler,M,-37.73,144.79,,632ad1d4-16ae-4d8c-aac8-dec4c3aed886,-37.65,145.02,VIC,Epping,debit,authorized,b97dca92a62e4505b556f91ac95f0b64,SALES-POS,40-50,2018,8,25,22,56,Saturday,14 days,75277.079
ACC-1279356312,44,22.07,5997.76,1.0,CUS-1892177589,2018-08-25,Tyler,M,-37.73,144.79,,a61580ea-86e1-469c-84f6-b1e3bf8f81c5,-37.78,145.27,VIC,Croydon,debit,authorized,f72e46dfb0354070934f96eb1a6de2c5,POS,40-50,2018,8,25,23,50,Saturday,14 days,75277.079
ACC-1279356312,44,15.46,5982.3,1.0,CUS-1892177589,2018-08-26,Tyler,M,-37.73,144.79,,62a97634-26c0-4828-a968-56c2a401f6ee,-37.78,145.46,VIC,Seville,debit,authorized,2ce60332c9964be18d87aadde84f3233,SALES-POS,40-50,2018,8,26,20,19,Sunday,14 days,75277.079
ACC-1279356312,44,31.62,5950.68,0.0,CUS-1892177589,2018-08-28,Tyler,M,-37.73,144.79,,f14b8e90-2e94-4249-841f-a8a16cb1f88e,-37.72,145.15,VIC,Eltham,debit,authorized,9d3720eda10d4451af21d3e411c7ab27,POS,40-50,2018,8,28,14,10,Tuesday,14 days,75277.079
ACC-1279356312,44,27.0,5923.68,,CUS-1892177589,2018-08-28,Tyler,M,-37.73,144.79,,,,,,,debit,posted,09107032d07242cd87f6f1e6cecd062b,PAYMENT,40-50,2018,8,28,17,0,Tuesday,14 days,75277.079
ACC-1279356312,44,17.4,5906.28,1.0,CUS-1892177589,2018-08-29,Tyler,M,-37.73,144.79,,8bee9f57-4517-4f80-b7ee-c161f33421e2,-37.74,145,VIC,Preston,debit,authorized,d87dc36be2a2414784dd1c84ced28c71,POS,40-50,2018,8,29,9,43,Wednesday,14 days,75277.079
ACC-1279356312,44,26.13,5880.15,1.0,CUS-1892177589,2018-08-29,Tyler,M,-37.73,144.79,,eeb9bc98-a2b3-432d-9c90-9745f21912bc,-37.74,142.02,VIC,Hamilton,debit,authorized,01bc8ae1ea2c447ca3f69b4108f3041f,POS,40-50,2018,8,29,11,41,Wednesday,14 days,75277.079
ACC-1279356312,44,21.29,5858.86,1.0,CUS-1892177589,2018-08-29,Tyler,M,-37.73,144.79,,3204a3c7-f065-4621-93c4-c332d9563c80,-37.93,145.23,VIC,Rowville,debit,authorized,34594e195c0c40feac1d46a0492ea32e,POS,40-50,2018,8,29,13,10,Wednesday,14 days,75277.079
ACC-1279356312,44,229.56,5629.3,1.0,CUS-1892177589,2018-08-29,Tyler,M,-37.73,144.79,,efce5f93-8e38-4b86-a643-0177ef9dc192,-37.78,145.03,VIC,Alphington,debit,authorized,0151859b57834d788ded8981cc711b3b,SALES-POS,40-50,2018,8,29,18,51,Wednesday,14 days,75277.079
ACC-1279356312,44,16.49,5612.81,1.0,CUS-1892177589,2018-08-30,Tyler,M,-37.73,144.79,,f4ae589f-2e4c-4329-acec-19a947c4c73b,-37.68,144.44,VIC,Bacchus Marsh,debit,authorized,127082352c0546ce8b6744d5eafaa495,POS,40-50,2018,8,30,13,16,Thursday,14 days,75277.079
ACC-1279356312,44,10.12,5602.69,0.0,CUS-1892177589,2018-08-30,Tyler,M,-37.73,144.79,,08fa85a5-f949-47b2-9fd6-8fe2a7119e36,-34.5,144.84,NSW,Hay,debit,authorized,306037f360094962881739e93b850150,SALES-POS,40-50,2018,8,30,14,7,Thursday,14 days,75277.079
ACC-1279356312,44,18.15,5584.54,0.0,CUS-1892177589,2018-08-30,Tyler,M,-37.73,144.79,,414aa9fd-4062-4963-accd-2079ef2a93af,-37.71,144.89,VIC,Airport West,debit,authorized,27148b054c514ae7a89acbadbeeae04b,SALES-POS,40-50,2018,8,30,16,38,Thursday,14 days,75277.079
ACC-1279356312,44,15.0,5550.44,,CUS-1892177589,2018-08-30,Tyler,M,-37.73,144.79,,,,,,,debit,posted,113243cfcbf24286b7945c8e4c046343,PAYMENT,40-50,2018,8,30,17,0,Thursday,14 days,75277.079
ACC-1279356312,44,19.1,5565.44,0.0,CUS-1892177589,2018-08-30,Tyler,M,-37.73,144.79,,6f47afe3-a2b1-4022-bc74-0d6caf24db02,-37.86,145.24,VIC,Wantirna South,debit,authorized,af5530d99d39482dbe91c8df2cdab277,POS,40-50,2018,8,30,17,54,Thursday,14 days,75277.079
ACC-1279356312,44,23.99,5526.45,1.0,CUS-1892177589,2018-08-30,Tyler,M,-37.73,144.79,,8b0785bf-16f2-42ec-a11b-e5c7538045da,-37.9,144.66,VIC,Werribee,debit,authorized,90fe33d7c80144728e29aaa271d50668,POS,40-50,2018,8,30,18,12,Thursday,14 days,75277.079
ACC-1279356312,44,41.0,5485.45,,CUS-1892177589,2018-08-30,Tyler,M,-37.73,144.79,,,,,,,debit,posted,15ce0c3ebe524a0a9835d56b8001ef2b,PAYMENT,40-50,2018,8,30,20,0,Thursday,14 days,75277.079
ACC-1279356312,44,6.61,5478.84,1.0,CUS-1892177589,2018-08-31,Tyler,M,-37.73,144.79,,7a356389-e911-4f7f-815a-9fed89acaf2e,-37.82,144.96,VIC,Melbourne,debit,authorized,a68ce4927e924b7f98856c309a592905,POS,40-50,2018,8,31,2,22,Friday,14 days,75277.079
ACC-1279356312,44,28.66,5450.18,1.0,CUS-1892177589,2018-08-31,Tyler,M,-37.73,144.79,,7a5cb7fa-bc0f-45ce-80d8-d01f316ec58e,-38.34,144.74,VIC,Sorrento,debit,authorized,ac8fb63c0783409bacbefb28c2ee5a4a,SALES-POS,40-50,2018,8,31,2,47,Friday,14 days,75277.079
ACC-1279356312,44,364.69,5085.49,1.0,CUS-1892177589,2018-09-01,Tyler,M,-37.73,144.79,,51c5261f-1bb0-4913-8a7f-f59224213151,-37.69,145.11,VIC,Greensborough,debit,authorized,cb2a40b3523f4a2ea7d359ddb7b0542a,SALES-POS,40-50,2018,9,1,11,13,Saturday,14 days,75277.079
ACC-1279356312,44,11.28,5074.21,1.0,CUS-1892177589,2018-09-01,Tyler,M,-37.73,144.79,,76760ebf-de38-4ca6-a239-81751a689133,-37.94,145.49,VIC,Cockatoo,debit,authorized,13639c80014f459282d324d32654759a,POS,40-50,2018,9,1,11,20,Saturday,14 days,75277.079
ACC-1279356312,44,33.93,5040.28,1.0,CUS-1892177589,2018-09-02,Tyler,M,-37.73,144.79,,065491b2-7c30-488c-be7f-c7a20fe4e041,-37.78,145.06,VIC,Ivanhoe,debit,authorized,7db8de9b673042adaf51f4478da81c73,SALES-POS,40-50,2018,9,2,19,29,Sunday,14 days,75277.079
ACC-1279356312,44,21.92,5018.36,0.0,CUS-1892177589,2018-09-02,Tyler,M,-37.73,144.79,,5bd759ba-27b5-4aa0-971f-a4e7fb5c8cd3,-37.97,145.06,VIC,Cheltenham,debit,authorized,d5b832ffc1844b788922aeaca1a6858d,POS,40-50,2018,9,2,20,58,Sunday,14 days,75277.079
ACC-1279356312,44,27.0,4991.36,,CUS-1892177589,2018-09-04,Tyler,M,-37.73,144.79,,,,,,,debit,posted,feb193ab03374b6e81137604139a322d,PAYMENT,40-50,2018,9,4,17,0,Tuesday,14 days,75277.079
ACC-1279356312,44,15.0,7863.7,,CUS-1892177589,2018-09-06,Tyler,M,-37.73,144.79,,,,,,,debit,posted,c4c2647dbcf14bbc9a628a54113644d6,PAYMENT,40-50,2018,9,6,17,0,Thursday,14 days,75277.079
ACC-1279356312,44,41.0,7822.7,,CUS-1892177589,2018-09-06,Tyler,M,-37.73,144.79,,,,,,,debit,posted,bc9e89ac067b49acbadba1043d5a230d,PAYMENT,40-50,2018,9,6,20,0,Thursday,14 days,75277.079
ACC-1279356312,44,156.0,7666.7,,CUS-1892177589,2018-09-08,Tyler,M,-37.73,144.79,,,,,,,debit,posted,74e6729468d2477599fbaebde9c7ea39,PAYMENT,40-50,2018,9,8,6,0,Saturday,14 days,75277.079
ACC-1279356312,44,1312.0,6354.7,,CUS-1892177589,2018-09-09,Tyler,M,-37.73,144.79,,,,,,,debit,posted,496224eb7927466789dbf58cef7ba384,PAYMENT,40-50,2018,9,9,5,0,Sunday,14 days,75277.079
ACC-1279356312,44,159.0,6195.7,,CUS-1892177589,2018-09-09,Tyler,M,-37.73,144.79,,,,,,,debit,posted,32027c17d51f4e7dba980caac781ab13,PAYMENT,40-50,2018,9,9,22,0,Sunday,14 days,75277.079
ACC-1279356312,44,27.0,6168.7,,CUS-1892177589,2018-09-11,Tyler,M,-37.73,144.79,,,,,,,debit,posted,217fb4b5b21c4381a68926b059292749,PAYMENT,40-50,2018,9,11,17,0,Tuesday,14 days,75277.079
ACC-1279356312,44,15.0,6153.7,,CUS-1892177589,2018-09-13,Tyler,M,-37.73,144.79,,,,,,,debit,posted,f01fcbfb128c47fa956d839599a59e5c,PAYMENT,40-50,2018,9,13,17,0,Thursday,14 days,75277.079
ACC-1279356312,44,41.0,6112.7,,CUS-1892177589,2018-09-13,Tyler,M,-37.73,144.79,,,,,,,debit,posted,42ba1e07b8ab40b69a0f6e440f15db4c,PAYMENT,40-50,2018,9,13,20,0,Thursday,14 days,75277.079
ACC-1279356312,44,164.0,5948.7,,CUS-1892177589,2018-09-15,Tyler,M,-37.73,144.79,,,,,,,debit,posted,97810c39a74a4840a2458acef8bd7174,INTER BANK,40-50,2018,9,15,18,0,Saturday,14 days,75277.079
ACC-1279356312,44,27.0,5921.7,,CUS-1892177589,2018-09-18,Tyler,M,-37.73,144.79,,,,,,,debit,posted,1898d03e7c3a41a998ecca07548834e3,PAYMENT,40-50,2018,9,18,17,0,Tuesday,14 days,75277.079
ACC-1279356312,44,20.54,8788.5,1.0,CUS-1892177589,2018-09-20,Tyler,M,-37.73,144.79,,068b77f0-0af3-4fca-9bb2-7cf408363092,-37.93,145.15,VIC,Mulgrave,debit,authorized,5f9caf5aa3c44f0f98acaeb4b691e340,SALES-POS,40-50,2018,9,20,16,10,Thursday,14 days,75277.079
ACC-1279356312,44,15.0,8766.62,,CUS-1892177589,2018-09-20,Tyler,M,-37.73,144.79,,,,,,,debit,posted,75335fb595434655abb700922a74d335,PAYMENT,40-50,2018,9,20,17,0,Thursday,14 days,75277.079
ACC-1279356312,44,6.88,8781.62,1.0,CUS-1892177589,2018-09-20,Tyler,M,-37.73,144.79,,3002605a-1a77-4c85-a768-cbc31e2e1ca4,-37.71,145.15,VIC,Eltham,debit,authorized,34f6f944df1145e697560f1de029f4bc,POS,40-50,2018,9,20,17,11,Thursday,14 days,75277.079
ACC-1279356312,44,41.0,8725.62,,CUS-1892177589,2018-09-20,Tyler,M,-37.73,144.79,,,,,,,debit,posted,6da6db238bc440248a05a6b0b53c4bba,PAYMENT,40-50,2018,9,20,20,0,Thursday,14 days,75277.079
ACC-1279356312,44,14.36,8711.26,0.0,CUS-1892177589,2018-09-20,Tyler,M,-37.73,144.79,,2c38c1f8-9044-46eb-8a94-e86e36923198,-37.76,144.76,VIC,Burnside,debit,authorized,11cbf529953c4ce392f637db931aba56,SALES-POS,40-50,2018,9,20,21,18,Thursday,14 days,75277.079
ACC-1279356312,44,13.66,8697.6,1.0,CUS-1892177589,2018-09-21,Tyler,M,-37.73,144.79,,74988af2-9cec-49e5-9f8f-21bdacc80cd9,-37.74,142.03,VIC,Hamilton,debit,authorized,5cd43ab745124990a49e12e30f953748,POS,40-50,2018,9,21,4,32,Friday,14 days,75277.079
ACC-1279356312,44,10.34,8687.26,0.0,CUS-1892177589,2018-09-21,Tyler,M,-37.73,144.79,,139e3953-2293-4ab6-9a2e-52991715d8d1,-37.85,145.09,VIC,Camberwell,debit,authorized,4ac3c3b1a5d94142b25fdca8a6ef6c8d,SALES-POS,40-50,2018,9,21,8,34,Friday,14 days,75277.079
ACC-1279356312,44,19.23,8668.03,0.0,CUS-1892177589,2018-09-21,Tyler,M,-37.73,144.79,,dd40bbd2-2af1-40d7-bc51-ae34535db828,-37.76,145.17,VIC,Doncaster East,debit,authorized,0edd89ab3cbe435d9b9c66abe5d5703f,SALES-POS,40-50,2018,9,21,9,27,Friday,14 days,75277.079
ACC-1279356312,44,12.86,8655.17,0.0,CUS-1892177589,2018-09-21,Tyler,M,-37.73,144.79,,16ea7b98-1467-47be-b798-9ac281a50ca7,-37.83,144.96,VIC,South Melbourne,debit,authorized,dae4368b3ce0483896bfc14b22e32708,SALES-POS,40-50,2018,9,21,15,39,Friday,14 days,75277.079
ACC-1279356312,44,11.26,8643.91,1.0,CUS-1892177589,2018-09-24,Tyler,M,-37.73,144.79,,67a63748-45ab-4325-b888-35fffb2d6bb8,-37.65,145.02,VIC,Epping,debit,authorized,b43ecf01c07e483baa6d8b9c35c2c39f,SALES-POS,40-50,2018,9,24,9,22,Monday,14 days,75277.079
ACC-1279356312,44,13.14,8630.77,0.0,CUS-1892177589,2018-09-25,Tyler,M,-37.73,144.79,,ecd852d6-74e1-41d8-9804-0b459043cf7e,-37.75,144.92,VIC,Essendon,debit,authorized,dfba2c1591114c7eb3bf7db9e9b4a61d,SALES-POS,40-50,2018,9,25,9,32,Tuesday,14 days,75277.079
ACC-1279356312,44,27.0,8603.77,,CUS-1892177589,2018-09-25,Tyler,M,-37.73,144.79,,,,,,,debit,posted,55776a6ac7384a33a925619fe25649b7,PAYMENT,40-50,2018,9,25,17,0,Tuesday,14 days,75277.079
ACC-1279356312,44,22.08,8581.69,0.0,CUS-1892177589,2018-09-25,Tyler,M,-37.73,144.79,,85f205ca-dc6b-43f4-b081-859a27457643,-31.86,115.81,WA,Balcatta,debit,authorized,2857267174e94327a3723ea0a7b8a977,POS,40-50,2018,9,25,18,1,Tuesday,14 days,75277.079
ACC-1279356312,44,17.53,8564.16,1.0,CUS-1892177589,2018-09-26,Tyler,M,-37.73,144.79,,acff7cc5-72ce-4b25-a434-8db80f28c7d4,-37.8,145.28,VIC,Croydon,debit,authorized,cb4ccc824b9c4aeab7969b141ad3924c,SALES-POS,40-50,2018,9,26,8,24,Wednesday,14 days,75277.079
ACC-1279356312,44,38.23,8525.93,0.0,CUS-1892177589,2018-09-26,Tyler,M,-37.73,144.79,,04195484-409c-49f1-b03f-6dd9cbf574af,-37.65,145.02,VIC,Epping,debit,authorized,06bafe8542bc4b59a692d3c1d5a829de,POS,40-50,2018,9,26,8,58,Wednesday,14 days,75277.079
ACC-1279356312,44,6.89,8519.04,1.0,CUS-1892177589,2018-09-26,Tyler,M,-37.73,144.79,,2ee17ea7-70e8-40a3-8a95-056ceb1dde29,-37.78,145.31,VIC,Mooroolbark,debit,authorized,50c2934e522b4a3f8a5b68ad8c8a52f8,POS,40-50,2018,9,26,9,50,Wednesday,14 days,75277.079
ACC-1279356312,44,44.55,8474.49,1.0,CUS-1892177589,2018-09-26,Tyler,M,-37.73,144.79,,78c379a0-eb99-4362-84c1-c1f19f2e0304,-37.82,144.96,VIC,Melbourne,debit,authorized,768e4886f2584d71ba5449ada6313be9,POS,40-50,2018,9,26,14,22,Wednesday,14 days,75277.079
ACC-1279356312,44,19.58,8454.91,1.0,CUS-1892177589,2018-09-27,Tyler,M,-37.73,144.79,,72a1e656-d1fb-472c-9ea0-fadc0994b6b1,-36.14,144.75,VIC,Echuca,debit,authorized,c83d45e20755426bbeaa80e74645a2d7,SALES-POS,40-50,2018,9,27,16,56,Thursday,14 days,75277.079
ACC-1279356312,44,15.0,8439.91,,CUS-1892177589,2018-09-27,Tyler,M,-37.73,144.79,,,,,,,debit,posted,8d3c3650f8ae47958aca83f376e896bf,PAYMENT,40-50,2018,9,27,17,0,Thursday,14 days,75277.079
ACC-1279356312,44,74.16,8365.75,1.0,CUS-1892177589,2018-09-27,Tyler,M,-37.73,144.79,,09ab267b-6dcc-4420-a708-91cae4d02875,-37.76,145.31,VIC,Chirnside Park,debit,authorized,fe6b6eb9132b47dbaad86a08ac8d6eb5,SALES-POS,40-50,2018,9,27,19,17,Thursday,14 days,75277.079
ACC-1279356312,44,18.92,8346.83,1.0,CUS-1892177589,2018-09-27,Tyler,M,-37.73,144.79,,1ee623ab-0446-4764-950f-1db9a02c3f27,-37.73,144.91,VIC,Essendon Fields,debit,authorized,01fca48646cb42c79c5c6cf79b743a3b,POS,40-50,2018,9,27,19,46,Thursday,14 days,75277.079
ACC-1279356312,44,41.0,8108.42,,CUS-1892177589,2018-09-27,Tyler,M,-37.73,144.79,,,,,,,debit,posted,d9808a801f24486f9922137b28a521eb,PAYMENT,40-50,2018,9,27,20,0,Thursday,14 days,75277.079
ACC-1279356312,44,197.41,8149.42,1.0,CUS-1892177589,2018-09-27,Tyler,M,-37.73,144.79,,909424d1-936e-4438-b877-b1ffad297e22,-37.77,145.04,VIC,Ivanhoe,debit,authorized,ff7dbb06dbbd4d9ebe419317c77349f3,POS,40-50,2018,9,27,20,40,Thursday,14 days,75277.079
ACC-1279356312,44,19.36,8089.06,1.0,CUS-1892177589,2018-09-27,Tyler,M,-37.73,144.79,,bc7a1a4c-f2a2-4d78-8965-745bb569addb,-37.83,145.05,VIC,Hawthorn East,debit,authorized,74565c985b0c4d8d97afc4044cc0983d,POS,40-50,2018,9,27,21,47,Thursday,14 days,75277.079
ACC-1279356312,44,18.95,8070.11,1.0,CUS-1892177589,2018-09-28,Tyler,M,-37.73,144.79,,c1c614b6-2790-4343-9dcf-f9bd736b2255,-37.74,142.02,VIC,Hamilton,debit,authorized,d9a36167696a4cc5bf140fd3c99272fb,POS,40-50,2018,9,28,0,16,Friday,14 days,75277.079
ACC-1279356312,44,38.4,8031.71,0.0,CUS-1892177589,2018-09-28,Tyler,M,-37.73,144.79,,3548afe8-7f2b-4fe3-9ece-bdf6b1398099,-33.95,150.96,NSW,Hammondville,debit,authorized,68e1dcb86b834ea592e7da484d588406,POS,40-50,2018,9,28,1,39,Friday,14 days,75277.079
ACC-1279356312,44,13.63,8018.08,1.0,CUS-1892177589,2018-09-30,Tyler,M,-37.73,144.79,,8107e596-afb0-47b0-af4d-9840d93a4f07,-37.75,145.23,VIC,Warrandyte South,debit,authorized,5b174538667a46e99f07551a3fe053a2,POS,40-50,2018,9,30,21,41,Sunday,14 days,75277.079
ACC-1279356312,44,15.96,8002.12,0.0,CUS-1892177589,2018-09-30,Tyler,M,-37.73,144.79,,df1f0fb8-be90-4080-b10b-c176c0bdd4a0,-37.93,145,VIC,Brighton,debit,authorized,8aeedc3068d94968844cf6836912cc53,SALES-POS,40-50,2018,9,30,21,48,Sunday,14 days,75277.079
ACC-1279356312,44,27.0,7975.12,,CUS-1892177589,2018-10-02,Tyler,M,-37.73,144.79,,,,,,,debit,posted,b4a79fed12524b1ebd000d97d96e9607,PAYMENT,40-50,2018,10,2,17,0,Tuesday,14 days,75277.079
ACC-1279356312,44,7.66,7967.46,0.0,CUS-1892177589,2018-10-04,Tyler,M,-37.73,144.79,,b7775d17-b9b8-4d0e-9d66-20760f186f8f,-37.82,144.95,VIC,Melbourne,debit,authorized,8c3f4da1bae54332b4c52da4833ea04f,POS,40-50,2018,10,4,10,59,Thursday,14 days,75277.079
ACC-1279356312,44,15.0,10839.8,,CUS-1892177589,2018-10-04,Tyler,M,-37.73,144.79,,,,,,,debit,posted,7e1c917a61a54ecea1dbc5debfb80eef,PAYMENT,40-50,2018,10,4,17,0,Thursday,14 days,75277.079
ACC-1279356312,44,41.0,10781.17,,CUS-1892177589,2018-10-04,Tyler,M,-37.73,144.79,,,,,,,debit,posted,9d87f3e6479c4d929aea0ce39a08c4fa,PAYMENT,40-50,2018,10,4,20,0,Thursday,14 days,75277.079
ACC-1279356312,44,17.63,10822.17,1.0,CUS-1892177589,2018-10-04,Tyler,M,-37.73,144.79,,d61d7ca9-e029-4516-90a9-f3c5a37348f0,-37.76,145.36,VIC,Lilydale,debit,authorized,b24a9443347646fe8672c0d4438a7906,SALES-POS,40-50,2018,10,4,20,22,Thursday,14 days,75277.079
ACC-1279356312,44,12.79,10768.38,1.0,CUS-1892177589,2018-10-05,Tyler,M,-37.73,144.79,,00a628aa-244d-4ab3-add4-95202d76fd98,-37.72,145.14,VIC,Eltham,debit,authorized,b9b4ef040e7c4095ace209d380ca10e2,SALES-POS,40-50,2018,10,5,10,27,Friday,14 days,75277.079
ACC-1279356312,44,11.84,10756.54,1.0,CUS-1892177589,2018-10-06,Tyler,M,-37.73,144.79,,0c040de5-2fa1-4e87-bfc9-dd43b7ed29df,-37.74,142.02,VIC,Hamilton,debit,authorized,e3fd465e53204dd8ad826143efb869d6,POS,40-50,2018,10,6,6,23,Saturday,14 days,75277.079
ACC-1279356312,44,156.0,10600.54,,CUS-1892177589,2018-10-08,Tyler,M,-37.73,144.79,,,,,,,debit,posted,d66350a85cb34821b3db1577d0717177,PAYMENT,40-50,2018,10,8,6,0,Monday,14 days,75277.079
ACC-1279356312,44,27.0,10573.54,,CUS-1892177589,2018-10-09,Tyler,M,-37.73,144.79,,,,,,,debit,posted,6a81dfd0d1814931b266a7b0a4482ce8,PAYMENT,40-50,2018,10,9,17,0,Tuesday,14 days,75277.079
ACC-1279356312,44,159.0,10414.54,,CUS-1892177589,2018-10-09,Tyler,M,-37.73,144.79,,,,,,,debit,posted,193f4650be7f47c18d23c881340ea078,PAYMENT,40-50,2018,10,9,22,0,Tuesday,14 days,75277.079
ACC-1279356312,44,24.27,10390.27,1.0,CUS-1892177589,2018-10-10,Tyler,M,-37.73,144.79,,42e419ec-36e1-4d12-9030-6b17ea707739,-37.85,145.03,VIC,Malvern,debit,authorized,86ffdd54bc854b49a8ff7552e40cb96d,SALES-POS,40-50,2018,10,10,10,40,Wednesday,14 days,75277.079
ACC-1279356312,44,20.99,10369.28,1.0,CUS-1892177589,2018-10-10,Tyler,M,-37.73,144.79,,42b308f7-2613-46b6-a56b-67d15b4c0394,-37.68,145.14,VIC,Saint Helena,debit,authorized,26a04f81040c4b0e93b9eec3968b955c,POS,40-50,2018,10,10,22,48,Wednesday,14 days,75277.079
ACC-1279356312,44,53.45,10315.83,0.0,CUS-1892177589,2018-10-10,Tyler,M,-37.73,144.79,,eb76067a-41f4-4b70-bd2f-e5cc22e09c45,-37.82,145.23,VIC,Ringwood,debit,authorized,a912534cf7274d89ad77ada765e70a77,SALES-POS,40-50,2018,10,10,23,35,Wednesday,14 days,75277.079
ACC-1279356312,44,8.2,10307.63,1.0,CUS-1892177589,2018-10-11,Tyler,M,-37.73,144.79,,32aa73dc-b7c2-4161-b14d-6271b96ce792,-37.81,145.23,VIC,Ringwood,debit,authorized,a7ea3d5154904c4592e1a2ba0d1b4995,SALES-POS,40-50,2018,10,11,15,32,Thursday,14 days,75277.079
ACC-1279356312,44,15.0,10277.97,,CUS-1892177589,2018-10-11,Tyler,M,-37.73,144.79,,,,,,,debit,posted,e916c24a0a354415b164f7743cbb0b39,PAYMENT,40-50,2018,10,11,17,0,Thursday,14 days,75277.079
ACC-1279356312,44,14.66,10292.97,1.0,CUS-1892177589,2018-10-11,Tyler,M,-37.73,144.79,,6e2724e1-7d5c-40d4-b13c-f9bfb34532e7,-37.68,145.07,VIC,Bundoora,debit,authorized,95ef11475f7d470da0386028ce8be8ad,POS,40-50,2018,10,11,17,37,Thursday,14 days,75277.079
ACC-1279356312,44,41.0,10236.97,,CUS-1892177589,2018-10-11,Tyler,M,-37.73,144.79,,,,,,,debit,posted,62da7d00890b434b9b8a0e3447e30a17,PAYMENT,40-50,2018,10,11,20,0,Thursday,14 days,75277.079
ACC-1279356312,44,16.71,10220.26,0.0,CUS-1892177589,2018-10-11,Tyler,M,-37.73,144.79,,bdcf9ea0-9997-4409-b44f-a05b96fb41d8,-37.85,144.98,VIC,Melbourne,debit,authorized,bcf11c1eb3954bdca1c5e1bd9caf26c1,POS,40-50,2018,10,11,21,51,Thursday,14 days,75277.079
ACC-1279356312,44,30.54,10189.72,1.0,CUS-1892177589,2018-10-13,Tyler,M,-37.73,144.79,,e580dea9-e35f-41f4-8e67-ceea503ba044,-37.86,145.03,VIC,Armadale,debit,authorized,3cbda1b6aeb84489aa3bf87979af4d6a,POS,40-50,2018,10,13,16,15,Saturday,14 days,75277.079
ACC-1279356312,44,164.0,10025.72,,CUS-1892177589,2018-10-15,Tyler,M,-37.73,144.79,,,,,,,debit,posted,5495bcc059a64fc2b5ec9ae7d3ee1706,INTER BANK,40-50,2018,10,15,18,0,Monday,14 days,75277.079
ACC-1279356312,44,33.42,9992.3,0.0,CUS-1892177589,2018-10-16,Tyler,M,-37.73,144.79,,6f72f36a-e75c-4b21-8080-4ce4306c2cfb,-37.83,145.15,VIC,Blackburn,debit,authorized,e9e31331ceb0487a9bdee503093652e2,SALES-POS,40-50,2018,10,16,16,43,Tuesday,14 days,75277.079
ACC-1279356312,44,27.0,9965.3,,CUS-1892177589,2018-10-16,Tyler,M,-37.73,144.79,,,,,,,debit,posted,e6011e9fc5f549efa962e47c67e081c1,PAYMENT,40-50,2018,10,16,17,0,Tuesday,14 days,75277.079
ACC-1279356312,44,113.21,9852.09,1.0,CUS-1892177589,2018-10-17,Tyler,M,-37.73,144.79,,d4a0c2f1-5731-417e-a8a1-753e790c79a8,-37.74,144.97,VIC,Coburg,debit,authorized,032dec970b814db78c01148797e42eb3,POS,40-50,2018,10,17,12,5,Wednesday,14 days,75277.079
ACC-1279356312,44,23.57,9828.52,1.0,CUS-1892177589,2018-10-17,Tyler,M,-37.73,144.79,,b9cd291e-bc55-4ec5-aa9d-0e126b067f1d,-37.85,145.17,VIC,Forest Hill,debit,authorized,24cd97b5c4614a83a44339d18c279cba,POS,40-50,2018,10,17,14,44,Wednesday,14 days,75277.079
ACC-1279356312,44,33.88,9794.64,1.0,CUS-1892177589,2018-10-17,Tyler,M,-37.73,144.79,,9941b103-6ac8-42c7-9ba6-6c55f8182b99,-37.74,145.03,VIC,Preston,debit,authorized,7ff48ee076b942bca8aa5589c41f1b17,POS,40-50,2018,10,17,20,36,Wednesday,14 days,75277.079
ACC-1279356312,44,19.62,9775.02,1.0,CUS-1892177589,2018-10-18,Tyler,M,-37.73,144.79,,73c391e4-0706-4f30-989b-f56f03e87f26,-37.69,144.56,VIC,Melton,debit,authorized,1196abf36e724465a68ab988abd729b2,SALES-POS,40-50,2018,10,18,8,39,Thursday,14 days,75277.079
ACC-1279356312,44,17.24,9757.78,1.0,CUS-1892177589,2018-10-18,Tyler,M,-37.73,144.79,,962e2a2f-88f2-46b2-b23c-5e096b276343,-37.76,145.13,VIC,Templestowe,debit,authorized,51ed5fa8802c4bc7b1e590b7ab78463c,SALES-POS,40-50,2018,10,18,8,53,Thursday,14 days,75277.079
ACC-1279356312,44,19.21,9738.57,1.0,CUS-1892177589,2018-10-18,Tyler,M,-37.73,144.79,,a2adedd6-1fc8-4aaa-bf00-cdb1a7f5bc4e,-37.88,144.68,VIC,Werribee,debit,authorized,05be5ae4c1eb4a38876893d2eef12503,SALES-POS,40-50,2018,10,18,9,5,Thursday,14 days,75277.079
ACC-1279356312,44,15.0,12610.91,,CUS-1892177589,2018-10-18,Tyler,M,-37.73,144.79,,,,,,,debit,posted,10679d2ff4b3445b9d26a563d8e9ab10,PAYMENT,40-50,2018,10,18,17,0,Thursday,14 days,75277.079
ACC-1279356312,44,41.0,12569.91,,CUS-1892177589,2018-10-18,Tyler,M,-37.73,144.79,,,,,,,debit,posted,c37eca56b5084b9f9960cf929428339c,PAYMENT,40-50,2018,10,18,20,0,Thursday,14 days,75277.079
ACC-1279356312,44,27.0,12542.91,,CUS-1892177589,2018-10-23,Tyler,M,-37.73,144.79,,,,,,,debit,posted,d66d04d6457c491faea18ea75085d75c,PAYMENT,40-50,2018,10,23,17,0,Tuesday,14 days,75277.079
ACC-1279356312,44,15.0,12527.91,,CUS-1892177589,2018-10-25,Tyler,M,-37.73,144.79,,,,,,,debit,posted,0b3f97ae98f74d39b38c23b8d6b9376e,PAYMENT,40-50,2018,10,25,17,0,Thursday,14 days,75277.079
ACC-1279356312,44,41.0,12486.91,,CUS-1892177589,2018-10-25,Tyler,M,-37.73,144.79,,,,,,,debit,posted,98c6698009be415a84d6e7778454777f,PAYMENT,40-50,2018,10,25,20,0,Thursday,14 days,75277.079
ACC-1279356312,44,27.0,12459.91,,CUS-1892177589,2018-10-30,Tyler,M,-37.73,144.79,,,,,,,debit,posted,cabbe67f8c4f440c8a7b7235d4032ca4,PAYMENT,40-50,2018,10,30,17,0,Tuesday,14 days,75277.079
ACC-4065652575,21,55.0,2335.35,,CUS-1117979751,2018-08-01,Lucas,M,-31.82,115.81,,,,,,,debit,posted,726f54003e2e460ca39707aede401ab6,PAYMENT,20-30,2018,8,1,16,0,Wednesday,14 days,93300.518
ACC-4065652575,21,41.49,2293.86,1.0,CUS-1117979751,2018-08-02,Lucas,M,-31.82,115.81,,ae5f353c-afd0-4ed5-a4e3-d8b5bf48b5ec,-34.92,138.6,SA,Adelaide,debit,authorized,fa843fd8be634856978df16f243f1b8b,SALES-POS,20-30,2018,8,2,8,33,Thursday,14 days,93300.518
ACC-4065652575,21,8.84,2285.02,1.0,CUS-1117979751,2018-08-02,Lucas,M,-31.82,115.81,,a6dffbca-a78e-482a-bfe4-ee7ef065c1c3,-32.05,115.79,WA,Melville,debit,authorized,2287bf597e6a47b59a85af1c7f4196ce,SALES-POS,20-30,2018,8,2,9,58,Thursday,14 days,93300.518
ACC-4065652575,21,8.26,2276.76,1.0,CUS-1117979751,2018-08-04,Lucas,M,-31.82,115.81,,d623a279-3e39-4058-ba06-097a0aafa130,-31.9,115.8,WA,Innaloo,debit,authorized,c36512dc8ab24e37affff16e6ab2cf59,SALES-POS,20-30,2018,8,4,1,41,Saturday,14 days,93300.518
ACC-4065652575,21,20.3,2256.46,1.0,CUS-1117979751,2018-08-04,Lucas,M,-31.82,115.81,,8bfd095a-2403-4c09-8ce5-31b670b46931,-33.98,115.76,WA,Nannup,debit,authorized,50276e07d12a4064ac912b6633bc449c,POS,20-30,2018,8,4,16,53,Saturday,14 days,93300.518
ACC-4065652575,21,40.0,5795.11,,CUS-1117979751,2018-08-06,Lucas,M,-31.82,115.81,,,,,,,debit,posted,b2763f95135c4160b96a8f6c6cf0abb2,PAYMENT,20-30,2018,8,6,14,0,Monday,14 days,93300.518
ACC-4065652575,21,55.0,5740.11,,CUS-1117979751,2018-08-08,Lucas,M,-31.82,115.81,,,,,,,debit,posted,96197b0a96954592aeb99e0e66e53436,PAYMENT,20-30,2018,8,8,16,0,Wednesday,14 days,93300.518
ACC-4065652575,21,12.93,5727.18,1.0,CUS-1117979751,2018-08-09,Lucas,M,-31.82,115.81,,7af25499-cfc0-43cd-a3ec-815220ff97fb,-32.01,115.85,WA,Applecross,debit,authorized,8ad73837703f40cfaa745eaa97d89158,SALES-POS,20-30,2018,8,9,17,19,Thursday,14 days,93300.518
ACC-4065652575,21,43.34,5683.84,1.0,CUS-1117979751,2018-08-11,Lucas,M,-31.82,115.81,,9902c5c1-09c0-47e2-9cb5-6cb1df5607f4,-31.95,115.86,WA,Northbridge,debit,authorized,f36cf2d1e70545b496cd8729e3db1ade,SALES-POS,20-30,2018,8,11,13,38,Saturday,14 days,93300.518
ACC-4065652575,21,40.0,5643.84,,CUS-1117979751,2018-08-13,Lucas,M,-31.82,115.81,,,,,,,debit,posted,550d0e9c780e4fb7bea94c219be9b494,PAYMENT,20-30,2018,8,13,14,0,Monday,14 days,93300.518
ACC-4065652575,21,55.0,5588.84,,CUS-1117979751,2018-08-15,Lucas,M,-31.82,115.81,,,,,,,debit,posted,cd721f6bf95449b4869c44ca166845aa,PAYMENT,20-30,2018,8,15,16,0,Wednesday,14 days,93300.518
ACC-4065652575,21,42.67,5426.5,1.0,CUS-1117979751,2018-08-17,Lucas,M,-31.82,115.81,,faf8ddf3-25d6-4ee2-9254-158c65a13232,-31.87,115.86,WA,Mirrabooka,debit,authorized,947bd8f2d7284df6ac687809c0b6f10d,POS,20-30,2018,8,17,20,7,Friday,14 days,93300.518
ACC-4065652575,21,13.02,5413.48,1.0,CUS-1117979751,2018-08-19,Lucas,M,-31.82,115.81,,865d3eb2-b81f-42d3-a70a-60851de8938f,-31.94,115.87,WA,Highgate,debit,authorized,6c396959f7b14920879e69752eda0d5e,POS,20-30,2018,8,19,1,43,Sunday,14 days,93300.518
ACC-4065652575,21,33.36,5380.12,1.0,CUS-1117979751,2018-08-19,Lucas,M,-31.82,115.81,,1b215926-0bee-41a6-ab50-458ca96096cd,-31.93,115.85,WA,North Perth,debit,authorized,7e960fca4766439b803e7fa7dbad6875,POS,20-30,2018,8,19,1,58,Sunday,14 days,93300.518
ACC-4065652575,21,18.44,5361.68,1.0,CUS-1117979751,2018-08-19,Lucas,M,-31.82,115.81,,4ffef83d-9410-4dab-b976-212bda0b9c4d,-31.65,117.24,WA,Cunderdin,debit,authorized,7178a2223d38498285bff0671b52139c,POS,20-30,2018,8,19,2,41,Sunday,14 days,93300.518
ACC-4065652575,21,46.76,5314.92,1.0,CUS-1117979751,2018-08-19,Lucas,M,-31.82,115.81,,e234cbd2-be0c-4e7d-8e4b-2b84b5bac0d6,-33.87,151.21,NSW,Sydney,debit,authorized,1cd4f4e226564ec68fa4390f4c294f20,POS,20-30,2018,8,19,15,52,Sunday,14 days,93300.518
ACC-4065652575,21,14.85,5300.07,1.0,CUS-1117979751,2018-08-19,Lucas,M,-31.82,115.81,,52e7bca7-17c8-456a-b2dc-a58f648dae6e,-31.65,152.8,NSW,Laurieton,debit,authorized,1c38a77d72424dacbad6ff4cae2d2213,POS,20-30,2018,8,19,18,3,Sunday,14 days,93300.518
ACC-4065652575,21,20.31,5279.76,1.0,CUS-1117979751,2018-08-20,Lucas,M,-31.82,115.81,,5a2500c3-41bc-448e-9666-0e197622b647,-31.95,141.46,NSW,Broken Hill,debit,authorized,23356178036743a48ad591169060fdf8,POS,20-30,2018,8,20,10,4,Monday,14 days,93300.518
ACC-4065652575,21,40.0,8818.41,,CUS-1117979751,2018-08-20,Lucas,M,-31.82,115.81,,,,,,,debit,posted,be849d70939d42f3a110f95a51a8f58c,PAYMENT,20-30,2018,8,20,14,0,Monday,14 days,93300.518
ACC-4065652575,21,15.95,8802.46,1.0,CUS-1117979751,2018-08-20,Lucas,M,-31.82,115.81,,138db8c3-eca4-4582-ad4c-460169759673,-32.06,115.9,WA,Willetton,debit,authorized,bc5afaa35c83479db30434bbd6640c41,POS,20-30,2018,8,20,18,37,Monday,14 days,93300.518
ACC-4065652575,21,29.7,8772.76,1.0,CUS-1117979751,2018-08-21,Lucas,M,-31.82,115.81,,d6f22281-0a36-4b48-9e75-f8e308fd2165,-32.03,115.83,WA,Booragoon,debit,authorized,c53aba9781ec4395a7296bb995e0b4b2,POS,20-30,2018,8,21,0,11,Tuesday,14 days,93300.518
ACC-4065652575,21,15.6,8757.16,1.0,CUS-1117979751,2018-08-21,Lucas,M,-31.82,115.81,,f2585ba4-8cb2-48af-a6fa-e0eba690d891,-31.95,115.89,WA,Burswood,debit,authorized,01f14adb427e43e68af3f1cbdbf74831,SALES-POS,20-30,2018,8,21,11,39,Tuesday,14 days,93300.518
ACC-4065652575,21,13.0,8744.16,1.0,CUS-1117979751,2018-08-22,Lucas,M,-31.82,115.81,,4a873909-4fa6-4814-8ee4-965aef03f8b2,-31.91,115.85,WA,Yokine,debit,authorized,d546f569ae884437b4acac1b9ab5dd62,POS,20-30,2018,8,22,1,36,Wednesday,14 days,93300.518
ACC-4065652575,21,18.73,8725.43,0.0,CUS-1117979751,2018-08-22,Lucas,M,-31.82,115.81,,65c70256-9c0c-46f7-aba1-5065fbcc350a,-31.98,115.78,WA,Claremont,debit,authorized,b73240ef11c84ba39ec9a8758ffbfc37,SALES-POS,20-30,2018,8,22,11,34,Wednesday,14 days,93300.518
ACC-4065652575,21,55.0,8670.43,,CUS-1117979751,2018-08-22,Lucas,M,-31.82,115.81,,,,,,,debit,posted,7a649c5271824a908e58614428190b4d,PAYMENT,20-30,2018,8,22,16,0,Wednesday,14 days,93300.518
ACC-4065652575,21,94.0,8576.43,,CUS-1117979751,2018-08-24,Lucas,M,-31.82,115.81,,,,,,,debit,posted,68437823eac547bdb68ebfb8de73e448,PAYMENT,20-30,2018,8,24,14,0,Friday,14 days,93300.518
ACC-4065652575,21,130.0,8446.43,,CUS-1117979751,2018-08-25,Lucas,M,-31.82,115.81,,,,,,,debit,posted,3f2d6bb3a31d44fc9e3886c10c9aff7f,PAYMENT,20-30,2018,8,25,2,0,Saturday,14 days,93300.518
ACC-4065652575,21,17.7,8428.73,1.0,CUS-1117979751,2018-08-25,Lucas,M,-31.82,115.81,,30b1938c-d627-46c3-b0f6-f1a3f1a8ff57,-31.96,141.47,NSW,Broken Hill,debit,authorized,720ba126c5234c239f1e0170f6527876,SALES-POS,20-30,2018,8,25,13,41,Saturday,14 days,93300.518
ACC-4065652575,21,18.99,8409.74,1.0,CUS-1117979751,2018-08-25,Lucas,M,-31.82,115.81,,326be4c0-2e6d-4b4a-bc3d-c26abe723c9f,-32.06,115.78,WA,Hilton,debit,authorized,de4d288729dd4a35a8aa5a82b80a9594,SALES-POS,20-30,2018,8,25,16,48,Saturday,14 days,93300.518
ACC-4065652575,21,20.18,8389.56,0.0,CUS-1117979751,2018-08-25,Lucas,M,-31.82,115.81,,5a2500c3-41bc-448e-9666-0e197622b647,-31.95,141.46,NSW,Broken Hill,debit,authorized,4d50bf427ab444f19f503d3c14eb703d,SALES-POS,20-30,2018,8,25,20,59,Saturday,14 days,93300.518
ACC-4065652575,21,83.0,8306.56,,CUS-1117979751,2018-08-26,Lucas,M,-31.82,115.81,,,,,,,debit,posted,c640edd76829416f8248372dbef7e170,PAYMENT,20-30,2018,8,26,3,0,Sunday,14 days,93300.518
ACC-4065652575,21,14.63,8291.93,1.0,CUS-1117979751,2018-08-26,Lucas,M,-31.82,115.81,,a83f2b24-784d-4b24-bcd7-bc5f03b1f0e2,-31.72,115.74,WA,Kinross,debit,authorized,070f8c312271434fb70cf3b067c7cc4a,SALES-POS,20-30,2018,8,26,8,17,Sunday,14 days,93300.518
ACC-4065652575,21,21.97,8269.96,1.0,CUS-1117979751,2018-08-26,Lucas,M,-31.82,115.81,,f0d50182-9f97-4071-9cd6-2dee18a94e4e,-32.04,115.76,WA,East Fremantle,debit,authorized,ebad5f2da3d84ea99244d631f07ced63,POS,20-30,2018,8,26,9,13,Sunday,14 days,93300.518
ACC-4065652575,21,5.64,8264.32,0.0,CUS-1117979751,2018-08-26,Lucas,M,-31.82,115.81,,be37f62b-6874-494d-9905-54d7e27b1eec,-31.95,115.86,WA,Perth,debit,authorized,9b68e324ab384d8d8b05812b4029af64,SALES-POS,20-30,2018,8,26,22,30,Sunday,14 days,93300.518
ACC-4065652575,21,190.0,8074.32,,CUS-1117979751,2018-08-27,Lucas,M,-31.82,115.81,,,,,,,debit,posted,afc62fcb794b49b3a34e791f12d58652,PAYMENT,20-30,2018,8,27,3,0,Monday,14 days,93300.518
ACC-4065652575,21,40.0,8034.32,,CUS-1117979751,2018-08-27,Lucas,M,-31.82,115.81,,,,,,,debit,posted,4e0ccd98508a41069493e32265d04f73,PAYMENT,20-30,2018,8,27,14,0,Monday,14 days,93300.518
ACC-4065652575,21,10.43,8023.89,0.0,CUS-1117979751,2018-08-28,Lucas,M,-31.82,115.81,,c174574a-035e-45ac-a012-734bb797bd07,-31.95,115.86,WA,Northbridge,debit,authorized,e2ade8a1ca8340b289a06d354b5c5ff2,SALES-POS,20-30,2018,8,28,21,36,Tuesday,14 days,93300.518
ACC-4065652575,21,40.2,7983.69,1.0,CUS-1117979751,2018-08-29,Lucas,M,-31.82,115.81,,999bebd6-9b43-4a85-b17b-85c68b7042e5,-31.95,115.86,WA,Northbridge,debit,authorized,d2eeb6ccf8684186805673599ad82d4b,POS,20-30,2018,8,29,7,15,Wednesday,14 days,93300.518
ACC-4065652575,21,55.0,7928.69,,CUS-1117979751,2018-08-29,Lucas,M,-31.82,115.81,,,,,,,debit,posted,74a4b79a01f74bcd9469a53455e106d9,PAYMENT,20-30,2018,8,29,16,0,Wednesday,14 days,93300.518
ACC-4065652575,21,37.41,7891.28,0.0,CUS-1117979751,2018-08-30,Lucas,M,-31.82,115.81,,5ffb8a54-eab8-4a36-8703-badd60d3e783,-31.82,115.74,WA,Hillarys,debit,authorized,59fab504286446ed9d0256f85308184d,POS,20-30,2018,8,30,19,48,Thursday,14 days,93300.518
ACC-4065652575,21,9.3,7881.98,0.0,CUS-1117979751,2018-08-31,Lucas,M,-31.82,115.81,,ad61874f-6b54-4a56-ab41-4a1ba9b95a24,-31.99,115.81,WA,Nedlands,debit,authorized,bd4f8c76da304afca181de8d1e56984e,SALES-POS,20-30,2018,8,31,11,11,Friday,14 days,93300.518
ACC-4065652575,21,10.79,7871.19,1.0,CUS-1117979751,2018-09-01,Lucas,M,-31.82,115.81,,0b9582bf-aee0-494b-86f9-08ed5a989322,-32.17,115.86,WA,Aubin Grove,debit,authorized,e3d5a663efc941e2910a994d26c9ccad,POS,20-30,2018,9,1,12,22,Saturday,14 days,93300.518
ACC-4065652575,21,40.0,11409.84,,CUS-1117979751,2018-09-03,Lucas,M,-31.82,115.81,,,,,,,debit,posted,f377feb628164b61a69907920659b958,PAYMENT,20-30,2018,9,3,14,0,Monday,14 days,93300.518
ACC-4065652575,21,55.0,11354.84,,CUS-1117979751,2018-09-05,Lucas,M,-31.82,115.81,,,,,,,debit,posted,eeb4726d3e974c43a414b8d166f97892,PAYMENT,20-30,2018,9,5,16,0,Wednesday,14 days,93300.518
ACC-4065652575,21,2885.85,8468.99,1.0,CUS-1117979751,2018-09-06,Lucas,M,-31.82,115.81,,e5b2b589-812a-44a1-a1bb-403d9ee9a1b4,-33.94,151.17,NSW,Mascot,debit,authorized,a836b593cbe64a13aa5779c675d4294b,SALES-POS,20-30,2018,9,6,19,45,Thursday,14 days,93300.518
ACC-4065652575,21,8.08,8460.91,1.0,CUS-1117979751,2018-09-07,Lucas,M,-31.82,115.81,,a9fd7bc5-19c8-4d9e-af00-29e5d84c6ab1,-31.98,115.78,WA,Claremont,debit,authorized,a7ab10074369410a83dc18ef74f166b7,SALES-POS,20-30,2018,9,7,21,32,Friday,14 days,93300.518
ACC-4065652575,21,64.0,8396.91,1.0,CUS-1117979751,2018-09-08,Lucas,M,-31.82,115.81,,79ef2a69-e119-4d7b-a33c-7099f65c8c5d,-31.79,115.82,WA,Wangara,debit,authorized,de75f6f7df5048a881de896780957505,POS,20-30,2018,9,8,20,7,Saturday,14 days,93300.518
ACC-4065652575,21,18.4,8378.51,1.0,CUS-1117979751,2018-09-08,Lucas,M,-31.82,115.81,,629a092b-8b4a-4182-bace-d7c632aa921a,-32.41,115.76,WA,Secret Harbour,debit,authorized,b6265aad9f8346f09920721aea45c0bb,SALES-POS,20-30,2018,9,8,22,59,Saturday,14 days,93300.518
ACC-4065652575,21,40.0,8338.51,,CUS-1117979751,2018-09-10,Lucas,M,-31.82,115.81,,,,,,,debit,posted,82706568d5fa488e8d0502a04e8e74aa,PAYMENT,20-30,2018,9,10,14,0,Monday,14 days,93300.518
ACC-4065652575,21,55.0,8283.51,,CUS-1117979751,2018-09-12,Lucas,M,-31.82,115.81,,,,,,,debit,posted,284e12f75fd34714ba0f8f4f81f90c62,PAYMENT,20-30,2018,9,12,16,0,Wednesday,14 days,93300.518
ACC-4065652575,21,1001.0,7282.51,,CUS-1117979751,2018-09-15,Lucas,M,-31.82,115.81,,,,,,,debit,posted,fddfc7d7163c40728473749f21d6108f,INTER BANK,20-30,2018,9,15,10,0,Saturday,14 days,93300.518
ACC-4065652575,21,40.0,10821.16,,CUS-1117979751,2018-09-17,Lucas,M,-31.82,115.81,,,,,,,debit,posted,6370f9b1a2ad446db8bca2e78816039e,PAYMENT,20-30,2018,9,17,14,0,Monday,14 days,93300.518
ACC-4065652575,21,55.0,10766.16,,CUS-1117979751,2018-09-19,Lucas,M,-31.82,115.81,,,,,,,debit,posted,3573e17264464e34bddf25026e7a29d2,PAYMENT,20-30,2018,9,19,16,0,Wednesday,14 days,93300.518
ACC-4065652575,21,1176.0,9590.16,,CUS-1117979751,2018-09-20,Lucas,M,-31.82,115.81,,,,,,,debit,posted,79b1ce4f35e94a25bd9776b6309742f2,PAYMENT,20-30,2018,9,20,19,0,Thursday,14 days,93300.518
ACC-4065652575,21,40.0,9550.16,,CUS-1117979751,2018-09-24,Lucas,M,-31.82,115.81,,,,,,,debit,posted,28b193408da1425ea66f260f5b6d5ffb,PAYMENT,20-30,2018,9,24,14,0,Monday,14 days,93300.518
ACC-4065652575,21,94.0,9456.16,,CUS-1117979751,2018-09-24,Lucas,M,-31.82,115.81,,,,,,,debit,posted,e08b68c43f30461d90b5761b0d01ff00,PAYMENT,20-30,2018,9,24,14,0,Monday,14 days,93300.518
ACC-4065652575,21,130.0,9326.16,,CUS-1117979751,2018-09-25,Lucas,M,-31.82,115.81,,,,,,,debit,posted,7d54b5a4a22447ada3319e45e4b9c3d6,PAYMENT,20-30,2018,9,25,2,0,Tuesday,14 days,93300.518
ACC-4065652575,21,83.0,9243.16,,CUS-1117979751,2018-09-26,Lucas,M,-31.82,115.81,,,,,,,debit,posted,9751e67163ce4939a147cfbd7861ddd4,PAYMENT,20-30,2018,9,26,3,0,Wednesday,14 days,93300.518
ACC-4065652575,21,55.0,9188.16,,CUS-1117979751,2018-09-26,Lucas,M,-31.82,115.81,,,,,,,debit,posted,db97f4f5d6014d06a612a9dc97bbf2dc,PAYMENT,20-30,2018,9,26,16,0,Wednesday,14 days,93300.518
ACC-4065652575,21,190.0,8998.16,,CUS-1117979751,2018-09-27,Lucas,M,-31.82,115.81,,,,,,,debit,posted,bff044b0197e4e45a929a65f76122357,PAYMENT,20-30,2018,9,27,3,0,Thursday,14 days,93300.518
ACC-4065652575,21,7.14,8991.02,1.0,CUS-1117979751,2018-09-27,Lucas,M,-31.82,115.81,,7d7894ed-9057-438e-bd74-8eeb66adeb80,-32.06,115.74,WA,Fremantle,debit,authorized,d168952cd16c45058a3c191eb106b26b,SALES-POS,20-30,2018,9,27,9,22,Thursday,14 days,93300.518
ACC-4065652575,21,11.54,8979.48,0.0,CUS-1117979751,2018-09-29,Lucas,M,-31.82,115.81,,9b675803-29cb-4ff4-bf23-8d47143ce271,-31.96,115.86,WA,Perth,debit,authorized,9313e979c5764654b63425cb27c49eac,POS,20-30,2018,9,29,4,43,Saturday,14 days,93300.518
ACC-4065652575,21,22.89,8956.59,1.0,CUS-1117979751,2018-09-29,Lucas,M,-31.82,115.81,,0edc7b19-b856-40df-aa3d-1d9e8ccad89f,-31.95,141.48,NSW,Broken Hill,debit,authorized,9607591c6fe549d0883140beb34728bf,POS,20-30,2018,9,29,8,37,Saturday,14 days,93300.518
ACC-4065652575,21,17.62,8938.97,1.0,CUS-1117979751,2018-09-30,Lucas,M,-31.82,115.81,,50f0c409-1887-4c6a-9739-463c06b290bf,-32.13,115.8,WA,Beeliar,debit,authorized,26c57f3da3564b93b2821669f782ff4c,SALES-POS,20-30,2018,9,30,1,14,Sunday,14 days,93300.518
ACC-4065652575,21,16.98,8921.99,1.0,CUS-1117979751,2018-10-01,Lucas,M,-31.82,115.81,,c8c5a63c-993b-4f10-9905-efc03c2be02c,-37.79,145.07,VIC,Balwyn North,debit,authorized,1b1ae2152aad4a6092b51a5aeb413d98,SALES-POS,20-30,2018,10,1,10,54,Monday,14 days,93300.518
ACC-4065652575,21,40.0,12460.64,,CUS-1117979751,2018-10-01,Lucas,M,-31.82,115.81,,,,,,,debit,posted,089747d5a4624dffaae3aeaa852b6df8,PAYMENT,20-30,2018,10,1,14,0,Monday,14 days,93300.518
ACC-4065652575,21,55.0,12405.64,,CUS-1117979751,2018-10-03,Lucas,M,-31.82,115.81,,,,,,,debit,posted,97fa1cb07bec4b18adadcec5211e888c,PAYMENT,20-30,2018,10,3,16,0,Wednesday,14 days,93300.518
ACC-4065652575,21,47.57,12358.07,1.0,CUS-1117979751,2018-10-05,Lucas,M,-31.82,115.81,,2be09a29-2f79-4cb3-9ed2-36594d0138d4,-31.67,150.15,NSW,Yarraman,debit,authorized,4e976ceac5704fe7920c1f9deb095a5d,SALES-POS,20-30,2018,10,5,1,48,Friday,14 days,93300.518
ACC-4065652575,21,24.9,12333.17,1.0,CUS-1117979751,2018-10-05,Lucas,M,-31.82,115.81,,ca12b1d8-8b87-43ab-a009-8dcc2f3407e7,-31.78,115.75,WA,Beldon,debit,authorized,0f42598a72e64d9b9fc04f89a9bdf377,POS,20-30,2018,10,5,9,43,Friday,14 days,93300.518
ACC-4065652575,21,59.84,12273.33,1.0,CUS-1117979751,2018-10-06,Lucas,M,-31.82,115.81,,21b00470-af61-44be-b19b-395cd00536df,-32.06,115.91,WA,Canning Vale,debit,authorized,4659c4e4a0aa4c4a98ffe3c1af9b90dc,SALES-POS,20-30,2018,10,6,19,1,Saturday,14 days,93300.518
ACC-4065652575,21,9.59,12263.74,1.0,CUS-1117979751,2018-10-07,Lucas,M,-31.82,115.81,,5593fb21-bd5a-439a-af57-128149494da1,-31.94,115.84,WA,Leederville,debit,authorized,b8eec0caefa845ddbb94b843a89ef699,POS,20-30,2018,10,7,15,37,Sunday,14 days,93300.518
ACC-4065652575,21,17.78,12245.96,1.0,CUS-1117979751,2018-10-07,Lucas,M,-31.82,115.81,,8b1e8c4a-2d48-41a3-bb53-31bc3f255f99,-31.74,115.77,WA,Joondalup,debit,authorized,01dc61efb2424fd9b385f1b936611784,SALES-POS,20-30,2018,10,7,19,52,Sunday,14 days,93300.518
ACC-4065652575,21,20.36,12225.6,1.0,CUS-1117979751,2018-10-07,Lucas,M,-31.82,115.81,,ba2377f8-064d-4ef8-914b-8dd05d28047d,-32.06,115.8,WA,O'connor,debit,authorized,93c527a1611e48eb89a676cfdc04b125,POS,20-30,2018,10,7,21,58,Sunday,14 days,93300.518
ACC-4065652575,21,40.0,12185.6,,CUS-1117979751,2018-10-08,Lucas,M,-31.82,115.81,,,,,,,debit,posted,ec624afad13f414691960bcbf67fd321,PAYMENT,20-30,2018,10,8,14,0,Monday,14 days,93300.518
ACC-4065652575,21,55.0,12130.6,,CUS-1117979751,2018-10-10,Lucas,M,-31.82,115.81,,,,,,,debit,posted,24a0c8a26e9d47928bd31458fc4be284,PAYMENT,20-30,2018,10,10,16,0,Wednesday,14 days,93300.518
ACC-4065652575,21,22.29,12108.31,1.0,CUS-1117979751,2018-10-11,Lucas,M,-31.82,115.81,,6c84c219-96ea-4c6f-9de5-0a28bcaec62f,-32.01,152.47,NSW,Rainbow Flat,debit,authorized,7bd8ede5e5f64abcb830f75046ea6cef,SALES-POS,20-30,2018,10,11,15,39,Thursday,14 days,93300.518
ACC-4065652575,21,8.1,12100.21,0.0,CUS-1117979751,2018-10-12,Lucas,M,-31.82,115.81,,b0f26c5a-1cb9-49d7-b2e7-566f0438e8cf,-37.92,144.99,VIC,Brighton,debit,authorized,8d662cbfcf1e4b37a5f5a691eab10ec1,POS,20-30,2018,10,12,8,59,Friday,14 days,93300.518
ACC-4065652575,21,40.0,15638.86,,CUS-1117979751,2018-10-15,Lucas,M,-31.82,115.81,,,,,,,debit,posted,0d52458efade40ffa113bc7e12575bab,PAYMENT,20-30,2018,10,15,14,0,Monday,14 days,93300.518
ACC-4065652575,21,55.0,15583.86,,CUS-1117979751,2018-10-17,Lucas,M,-31.82,115.81,,,,,,,debit,posted,47661df5079a4944917d4b0ec40a8748,PAYMENT,20-30,2018,10,17,16,0,Wednesday,14 days,93300.518
ACC-4065652575,21,40.0,15543.86,,CUS-1117979751,2018-10-22,Lucas,M,-31.82,115.81,,,,,,,debit,posted,b2cbdbcda6ca4d748450f3281f73fd02,PAYMENT,20-30,2018,10,22,14,0,Monday,14 days,93300.518
ACC-4065652575,21,94.0,15449.86,,CUS-1117979751,2018-10-24,Lucas,M,-31.82,115.81,,,,,,,debit,posted,8e8aa67f92c44031998ae9b85773dda1,PAYMENT,20-30,2018,10,24,14,0,Wednesday,14 days,93300.518
ACC-4065652575,21,55.0,15394.86,,CUS-1117979751,2018-10-24,Lucas,M,-31.82,115.81,,,,,,,debit,posted,98b54111833b43cf8969351b29b2ef33,PAYMENT,20-30,2018,10,24,16,0,Wednesday,14 days,93300.518
ACC-4065652575,21,130.0,15264.86,,CUS-1117979751,2018-10-25,Lucas,M,-31.82,115.81,,,,,,,debit,posted,57b84324a85840d0805741bfb94e2083,PAYMENT,20-30,2018,10,25,2,0,Thursday,14 days,93300.518
ACC-4065652575,21,83.0,15181.86,,CUS-1117979751,2018-10-26,Lucas,M,-31.82,115.81,,,,,,,debit,posted,bb23d017076b4c728c8a873c6c306f93,PAYMENT,20-30,2018,10,26,3,0,Friday,14 days,93300.518
ACC-4065652575,21,190.0,14991.86,,CUS-1117979751,2018-10-27,Lucas,M,-31.82,115.81,,,,,,,debit,posted,03a87f27104a4be1aaa9bdae0d5f5cdd,PAYMENT,20-30,2018,10,27,3,0,Saturday,14 days,93300.518
ACC-4065652575,21,24.53,14967.33,1.0,CUS-1117979751,2018-10-28,Lucas,M,-31.82,115.81,,b8066f7a-ffe8-49d2-9e04-5123755ecf5a,-32.31,115.83,WA,Baldivis,debit,authorized,6e68de29770646d1b7264d278f95f474,POS,20-30,2018,10,28,10,32,Sunday,14 days,93300.518
ACC-4065652575,21,7.74,14959.59,1.0,CUS-1117979751,2018-10-28,Lucas,M,-31.82,115.81,,4533f924-6d16-48cc-b96b-d784a2473fb9,-34.86,138.65,SA,Windsor Gardens,debit,authorized,f541c75adf7e40e59199f061eed783ff,POS,20-30,2018,10,28,12,9,Sunday,14 days,93300.518
ACC-4065652575,21,5.89,14953.7,1.0,CUS-1117979751,2018-10-28,Lucas,M,-31.82,115.81,,4d1bf7a7-d609-408f-9105-9bb09df408a5,-31.95,115.86,WA,Perth,debit,authorized,0b7fc9be705a45ae9d7d02f85e85e93f,SALES-POS,20-30,2018,10,28,13,2,Sunday,14 days,93300.518
ACC-4065652575,21,15.95,14937.75,0.0,CUS-1117979751,2018-10-28,Lucas,M,-31.82,115.81,,8220cbcb-1cfd-4dda-ac1d-9e96351aa765,-31.97,115.85,WA,South Perth,debit,authorized,c3ed54f028ec48829c121ece93005bce,SALES-POS,20-30,2018,10,28,20,21,Sunday,14 days,93300.518
ACC-4065652575,21,40.0,18476.4,,CUS-1117979751,2018-10-29,Lucas,M,-31.82,115.81,,,,,,,debit,posted,c29b25006ef14cffa88cdaf54c825ed8,PAYMENT,20-30,2018,10,29,14,0,Monday,14 days,93300.518
ACC-4065652575,21,18.01,18458.39,1.0,CUS-1117979751,2018-10-29,Lucas,M,-31.82,115.81,,65c70256-9c0c-46f7-aba1-5065fbcc350a,-31.98,115.78,WA,Claremont,debit,authorized,d1453af53eb14426ba68599effd34d57,POS,20-30,2018,10,29,21,35,Monday,14 days,93300.518
ACC-4065652575,21,15.98,18442.41,1.0,CUS-1117979751,2018-10-30,Lucas,M,-31.82,115.81,,3814a278-6030-4aa6-8ec7-b1ccfb8ccced,-32.1,115.78,WA,Spearwood,debit,authorized,ff0f205b82cc4172a027c8cb3fff6bcc,POS,20-30,2018,10,30,9,10,Tuesday,14 days,93300.518
ACC-4065652575,21,55.0,18387.41,,CUS-1117979751,2018-10-31,Lucas,M,-31.82,115.81,,,,,,,debit,posted,06db7ed792e54d559ccd797604c797d7,PAYMENT,20-30,2018,10,31,16,0,Wednesday,14 days,93300.518
ACC-854938045,28,22.59,6941.78,0.0,CUS-4023861240,2018-08-01,James,M,-22.84,147.63,,a676e908-5124-4f59-b35c-4617dac98872,-34.86,147.59,NSW,Junee,debit,authorized,77e20a08f52446c3b903a215949968d3,POS,20-30,2018,8,1,17,1,Wednesday,14 days,66187.014
ACC-854938045,28,17.13,6924.65,0.0,CUS-4023861240,2018-08-01,James,M,-22.84,147.63,,6ef562a8-928c-4f56-86f1-592357fd5daa,-42.86,147.5,TAS,Seven Mile Beach,debit,authorized,414f37db1e6143fbbf24501ce457c161,SALES-POS,20-30,2018,8,1,20,35,Wednesday,14 days,66187.014
ACC-854938045,28,58.0,6866.65,,CUS-4023861240,2018-08-02,James,M,-22.84,147.63,,,,,,,debit,posted,32fb30d6f06645f1b200c2f73bf8203c,PHONE BANK,20-30,2018,8,2,21,0,Thursday,14 days,66187.014
ACC-854938045,28,98.17,6768.48,1.0,CUS-4023861240,2018-08-03,James,M,-22.84,147.63,,9ce00882-f927-41b8-a030-c286f9c478e7,-37.81,145.04,VIC,Kew,debit,authorized,23b45c8c57324ce3bac56fe85f24fb28,SALES-POS,20-30,2018,8,3,22,20,Friday,14 days,66187.014
ACC-854938045,28,49.0,6719.48,,CUS-4023861240,2018-08-04,James,M,-22.84,147.63,,,,,,,debit,posted,c972a145d1b4495384e597423c636cc4,PAYMENT,20-30,2018,8,4,17,0,Saturday,14 days,66187.014
ACC-854938045,28,41.61,6677.87,1.0,CUS-4023861240,2018-08-05,James,M,-22.84,147.63,,6757edfb-48a8-4f1a-8550-068f94604061,-22.82,147.64,QLD,Clermont,debit,authorized,c60eb16606954df9a1089ae8b6b45bd6,POS,20-30,2018,8,5,9,32,Sunday,14 days,66187.014
ACC-854938045,28,34.0,6643.87,,CUS-4023861240,2018-08-05,James,M,-22.84,147.63,,,,,,,debit,posted,4d0b6ba1ee7b4116b3629b776c993281,PAYMENT,20-30,2018,8,5,11,0,Sunday,14 days,66187.014
ACC-854938045,28,15.24,6628.63,1.0,CUS-4023861240,2018-08-05,James,M,-22.84,147.63,,6ef562a8-928c-4f56-86f1-592357fd5daa,-42.86,147.5,TAS,Seven Mile Beach,debit,authorized,02b8aca593c84a0aa59aec9e5c986b3b,SALES-POS,20-30,2018,8,5,19,28,Sunday,14 days,66187.014
ACC-854938045,28,92.63,6536.0,1.0,CUS-4023861240,2018-08-05,James,M,-22.84,147.63,,040172a4-15b7-406c-80e6-cd502f0852c4,-31.96,115.88,WA,East Perth,debit,authorized,f2ca79a043084187949ec31bce564684,SALES-POS,20-30,2018,8,5,21,48,Sunday,14 days,66187.014
ACC-854938045,28,12.11,6523.89,0.0,CUS-4023861240,2018-08-06,James,M,-22.84,147.63,,4bf11f3a-c3e4-4f41-b5a5-72f3337034fc,-22.92,118.97,WA,Newman,debit,authorized,fdc1c3ee8c094292ac52c0fd651ba6c0,SALES-POS,20-30,2018,8,6,15,33,Monday,14 days,66187.014
ACC-854938045,28,6.35,9056.22,1.0,CUS-4023861240,2018-08-07,James,M,-22.84,147.63,,b34457a8-f092-422d-b39d-44828e15d69c,-22.98,119.79,WA,Newman,debit,authorized,c0284613be284b389ec72e61d581eb55,SALES-POS,20-30,2018,8,7,9,0,Tuesday,14 days,66187.014
ACC-854938045,28,28.56,9027.66,0.0,CUS-4023861240,2018-08-08,James,M,-22.84,147.63,,d22c0bb7-5406-403f-a9bc-3e4d01f51df8,-33.85,151.03,NSW,Auburn,debit,authorized,232b1fad733249e495e68887e90c3d70,SALES-POS,20-30,2018,8,8,1,39,Wednesday,14 days,66187.014
ACC-854938045,28,37.2,8990.46,0.0,CUS-4023861240,2018-08-08,James,M,-22.84,147.63,,d57b8149-8eca-48e6-811d-e7317249725f,-22.76,113.83,WA,Ningaloo,debit,authorized,7c7f98fff39f4827acb15a6e98b06d34,POS,20-30,2018,8,8,9,43,Wednesday,14 days,66187.014
ACC-854938045,28,58.0,8932.46,,CUS-4023861240,2018-08-09,James,M,-22.84,147.63,,,,,,,debit,posted,dcf3a1da511941efa502f372a297d9ae,PHONE BANK,20-30,2018,8,9,21,0,Thursday,14 days,66187.014
ACC-854938045,28,106.0,8826.46,,CUS-4023861240,2018-08-10,James,M,-22.84,147.63,,,,,,,debit,posted,0babdba2688143fead10c5bc6d2d1f5c,PAYMENT,20-30,2018,8,10,20,0,Friday,14 days,66187.014
ACC-854938045,28,49.0,8777.46,,CUS-4023861240,2018-08-11,James,M,-22.84,147.63,,,,,,,debit,posted,9f03eccd1f1a4250ace43709afb66c10,PAYMENT,20-30,2018,8,11,17,0,Saturday,14 days,66187.014
ACC-854938045,28,16.84,8760.62,1.0,CUS-4023861240,2018-08-11,James,M,-22.84,147.63,,64e6e6b9-088b-4855-acad-1210d5eb2f85,-42.74,147.44,TAS,Richmond,debit,authorized,9183a012f022486dbeead8a5cf1a77e7,SALES-POS,20-30,2018,8,11,18,9,Saturday,14 days,66187.014
ACC-854938045,28,35.91,8724.71,0.0,CUS-4023861240,2018-08-11,James,M,-22.84,147.63,,d57b8149-8eca-48e6-811d-e7317249725f,-22.76,113.83,WA,Ningaloo,debit,authorized,a987252a6e3b4f549ab028bf8345f390,POS,20-30,2018,8,11,20,21,Saturday,14 days,66187.014
ACC-854938045,28,181.0,8543.71,,CUS-4023861240,2018-08-11,James,M,-22.84,147.63,,,,,,,debit,posted,e2c75d1e061d4c8b9a945b48ffbb73b4,PAYMENT,20-30,2018,8,11,21,0,Saturday,14 days,66187.014
ACC-854938045,28,34.0,8509.71,,CUS-4023861240,2018-08-12,James,M,-22.84,147.63,,,,,,,debit,posted,ca1c7d8c7881455490baca95284e7076,PAYMENT,20-30,2018,8,12,11,0,Sunday,14 days,66187.014
ACC-854938045,28,84.0,8425.71,,CUS-4023861240,2018-08-13,James,M,-22.84,147.63,,,,,,,debit,posted,c2608d83a53f43a68bb50b5bfe767457,PAYMENT,20-30,2018,8,13,22,0,Monday,14 days,66187.014
ACC-854938045,28,29.78,8395.93,1.0,CUS-4023861240,2018-08-14,James,M,-22.84,147.63,,a334a579-ab5a-4f27-99fd-434463233507,-37.8,144.96,VIC,Carlton,debit,authorized,f666efa236994571b48c127f83abe0b9,SALES-POS,20-30,2018,8,14,1,1,Tuesday,14 days,66187.014
ACC-854938045,28,12.73,8383.2,1.0,CUS-4023861240,2018-08-14,James,M,-22.84,147.63,,38c1492f-bb0b-4735-9cf5-55c96f75311e,-22.91,119.99,WA,Newman,debit,authorized,ac03e84ac0b145faa89ae0ed768d2492,POS,20-30,2018,8,14,11,54,Tuesday,14 days,66187.014
ACC-854938045,28,30.44,8352.76,1.0,CUS-4023861240,2018-08-14,James,M,-22.84,147.63,,feff3b43-5ed6-4920-bedb-04ef1401ff84,-37.84,147.6,VIC,Bairnsdale,debit,authorized,03996f2d9f57485a834cc50e8f4610ed,POS,20-30,2018,8,14,21,22,Tuesday,14 days,66187.014
ACC-854938045,28,62.84,8289.92,1.0,CUS-4023861240,2018-08-15,James,M,-22.84,147.63,,23c674b9-cfb9-4597-9014-674cde7a4e0f,-42.8,147.42,TAS,Cambridge,debit,authorized,bd7d6350cb9745f8ae216afcfb84c2c5,SALES-POS,20-30,2018,8,15,10,45,Wednesday,14 days,66187.014
ACC-854938045,28,45.54,8244.38,0.0,CUS-4023861240,2018-08-15,James,M,-22.84,147.63,,812dd3a5-ff7d-4ddb-b08d-578e7ea2449d,-37.64,144.93,VIC,Roxburgh Park,debit,authorized,1c1cb0c194634a488ca927fdcfaacbf3,POS,20-30,2018,8,15,20,28,Wednesday,14 days,66187.014
ACC-854938045,28,49.0,8098.35,,CUS-4023861240,2018-08-18,James,M,-22.84,147.63,,,,,,,debit,posted,14acbc40e8924defb8c9300f69d21a1a,PAYMENT,20-30,2018,8,18,17,0,Saturday,14 days,66187.014
ACC-854938045,28,7.67,8090.68,1.0,CUS-4023861240,2018-08-18,James,M,-22.84,147.63,,d02cbd35-220d-43b0-ad63-47c97d1cf95a,-41.15,147.51,TAS,Scottsdale,debit,authorized,0cf0d31a079049bd8266ab6cac16d267,SALES-POS,20-30,2018,8,18,19,58,Saturday,14 days,66187.014
ACC-854938045,28,18.06,8072.62,1.0,CUS-4023861240,2018-08-18,James,M,-22.84,147.63,,bd0007b0-30ee-4a81-ac20-485016874527,-37.68,144.58,VIC,Melton,debit,authorized,8e805de1f5c04cd896fe7f46ef85b4cc,SALES-POS,20-30,2018,8,18,20,59,Saturday,14 days,66187.014
ACC-854938045,28,34.0,8013.27,,CUS-4023861240,2018-08-19,James,M,-22.84,147.63,,,,,,,debit,posted,fd165bd15f024e94834886f4da59bdcd,PAYMENT,20-30,2018,8,19,11,0,Sunday,14 days,66187.014
ACC-854938045,28,25.35,8047.27,1.0,CUS-4023861240,2018-08-19,James,M,-22.84,147.63,,65d67292-aec5-4e2b-96a8-67ddf70a9960,-41.17,147.74,TAS,Branxholm,debit,authorized,5f24f16990424e758a0076ce0b4038b2,SALES-POS,20-30,2018,8,19,11,57,Sunday,14 days,66187.014
ACC-854938045,28,55.24,10496.71,1.0,CUS-4023861240,2018-08-21,James,M,-22.84,147.63,,f6cb6b79-8707-4c6d-a6bc-2b2012de5aed,-33.87,151.19,NSW,Pyrmont,debit,authorized,4737fa427044428da9845f1b11b087a8,SALES-POS,20-30,2018,8,21,10,1,Tuesday,14 days,66187.014
ACC-854938045,28,8.16,10488.55,1.0,CUS-4023861240,2018-08-23,James,M,-22.84,147.63,,7645bd89-9675-4b0b-a598-7a72e59483d7,-35.15,147.46,NSW,Forest Hill,debit,authorized,5a301b19a3ec4fe580b7569c1bc8637d,POS,20-30,2018,8,23,9,44,Thursday,14 days,66187.014
ACC-854938045,28,45.34,10443.21,1.0,CUS-4023861240,2018-08-23,James,M,-22.84,147.63,,4141523d-7390-42e4-92ac-40d0022481e7,-22.82,148.7,QLD,Middlemount,debit,authorized,8d248f2be56f4d788d8c28cc695bba16,SALES-POS,20-30,2018,8,23,13,46,Thursday,14 days,66187.014
ACC-854938045,28,58.0,10385.21,,CUS-4023861240,2018-08-23,James,M,-22.84,147.63,,,,,,,debit,posted,e5adad16b6124406b4af13964aedfc17,PHONE BANK,20-30,2018,8,23,21,0,Thursday,14 days,66187.014
ACC-854938045,28,17.08,10368.13,1.0,CUS-4023861240,2018-08-24,James,M,-22.84,147.63,,71a62c87-49db-403c-9a83-546bbd4b4f5d,-38,147.69,VIC,Ocean Grange,debit,authorized,3cf81fcdc6bb44c1a8f59d8419a320e2,POS,20-30,2018,8,24,11,49,Friday,14 days,66187.014
ACC-854938045,28,16.81,10351.32,1.0,CUS-4023861240,2018-08-25,James,M,-22.84,147.63,,3dbe3404-41c1-4e37-aed4-7e27cc6a0a16,-42.78,147.56,TAS,Sorell,debit,authorized,795b04f867a248ecab2ff95014c04f0b,SALES-POS,20-30,2018,8,25,9,35,Saturday,14 days,66187.014
ACC-854938045,28,25.25,10326.07,1.0,CUS-4023861240,2018-08-25,James,M,-22.84,147.63,,75b9d12a-839e-48ed-8115-d51837cb308d,-38.02,145.3,VIC,Narre Warren,debit,authorized,ea99c95597af4e14b86aa51f8a3dcc7a,POS,20-30,2018,8,25,14,12,Saturday,14 days,66187.014
ACC-854938045,28,49.0,10277.07,,CUS-4023861240,2018-08-25,James,M,-22.84,147.63,,,,,,,debit,posted,ae702e50f81f47439c9466779547c50b,PAYMENT,20-30,2018,8,25,17,0,Saturday,14 days,66187.014
ACC-854938045,28,9.19,10267.88,1.0,CUS-4023861240,2018-08-25,James,M,-22.84,147.63,,989c53c1-692b-4602-ad5f-3f62b704a621,-42.91,147.48,TAS,Lauderdale,debit,authorized,d9bba9422d2949e7b1b26b16afd7faee,POS,20-30,2018,8,25,19,12,Saturday,14 days,66187.014
ACC-854938045,28,34.0,10233.88,,CUS-4023861240,2018-08-26,James,M,-22.84,147.63,,,,,,,debit,posted,d25a0737a237419b9278a033dba3fa17,PAYMENT,20-30,2018,8,26,11,0,Sunday,14 days,66187.014
ACC-854938045,28,10.5,10223.38,1.0,CUS-4023861240,2018-08-27,James,M,-22.84,147.63,,bb7006de-3d66-489a-bd1f-952cdadc6840,-42.84,147.51,TAS,Cambridge,debit,authorized,6821c09c46e94598a161dbff6a91a9c5,SALES-POS,20-30,2018,8,27,19,10,Monday,14 days,66187.014
ACC-854938045,28,64.72,10158.66,1.0,CUS-4023861240,2018-08-28,James,M,-22.84,147.63,,6b519c78-9dc0-4911-9135-4594ff253217,-22.81,148.7,QLD,Middlemount,debit,authorized,cd13a88e32be4da7910af8a2a3be3aae,SALES-POS,20-30,2018,8,28,9,12,Tuesday,14 days,66187.014
ACC-854938045,28,41.52,10117.14,0.0,CUS-4023861240,2018-08-28,James,M,-22.84,147.63,,a25d7bfa-76a9-475d-9251-c73b1f14b4bc,-33.88,151.2,NSW,Ultimo,debit,authorized,bf3284f752ab4ee68aeab5d8e6008b92,SALES-POS,20-30,2018,8,28,11,18,Tuesday,14 days,66187.014
ACC-854938045,28,82.08,10035.06,1.0,CUS-4023861240,2018-08-30,James,M,-22.84,147.63,,39057114-0e63-476e-9877-dea209de407d,-32.92,147.71,NSW,Trundle,debit,authorized,057d5ecf5dba47058b0c8482b13e5055,SALES-POS,20-30,2018,8,30,19,9,Thursday,14 days,66187.014
ACC-854938045,28,58.0,9940.93,,CUS-4023861240,2018-08-30,James,M,-22.84,147.63,,,,,,,debit,posted,fd6dd33e3e8f43418ce8dcc576dcf7b7,PHONE BANK,20-30,2018,8,30,21,0,Thursday,14 days,66187.014
ACC-854938045,28,36.13,9998.93,1.0,CUS-4023861240,2018-08-30,James,M,-22.84,147.63,,3367da74-aa94-4f49-83a1-263705e30e83,-23.04,148.35,QLD,Tieri,debit,authorized,980f648b48e44d17b0ad296c18953059,POS,20-30,2018,8,30,21,29,Thursday,14 days,66187.014
ACC-854938045,28,85.81,9855.12,1.0,CUS-4023861240,2018-08-30,James,M,-22.84,147.63,,31f0219e-ba45-44bc-b9b6-9f6e9d60e67d,-37.78,144.82,VIC,Albion,debit,authorized,c7d93dbbd806480a92ceb5b23f1d8129,SALES-POS,20-30,2018,8,30,23,7,Thursday,14 days,66187.014
ACC-854938045,28,207.03,9648.09,1.0,CUS-4023861240,2018-08-31,James,M,-22.84,147.63,,640a9df2-a42d-4d8b-8393-c1199cd413f2,-37.91,145,VIC,Brighton,debit,authorized,169492f536d44cb89db74ef615e1bda6,POS,20-30,2018,8,31,12,48,Friday,14 days,66187.014
ACC-854938045,28,13.52,9634.57,1.0,CUS-4023861240,2018-09-01,James,M,-22.84,147.63,,a24bb055-ef5a-4930-8023-d3cd9a7b8ae7,-41.93,147.49,TAS,Campbell Town,debit,authorized,81f29922e21d4f6d9cbac78e53006a41,POS,20-30,2018,9,1,11,48,Saturday,14 days,66187.014
ACC-854938045,28,49.0,9585.57,,CUS-4023861240,2018-09-01,James,M,-22.84,147.63,,,,,,,debit,posted,1792f3653c4846c78a8b4970b694ddee,PAYMENT,20-30,2018,9,1,17,0,Saturday,14 days,66187.014
ACC-854938045,28,44.36,9541.21,1.0,CUS-4023861240,2018-09-02,James,M,-22.84,147.63,,b2bfeb0c-0b50-493e-a1e4-bd6c571b22a6,-37.81,144.97,VIC,Melbourne,debit,authorized,b3709b324c964a43813e313a21a4a084,POS,20-30,2018,9,2,1,13,Sunday,14 days,66187.014
ACC-854938045,28,28.69,9512.52,1.0,CUS-4023861240,2018-09-02,James,M,-22.84,147.63,,eb0272c4-ab58-4e30-a0bf-278a58032a40,-22.69,117.8,WA,Tom Price,debit,authorized,d84484e0ea264fccbe97db0badb129aa,SALES-POS,20-30,2018,9,2,9,49,Sunday,14 days,66187.014
ACC-854938045,28,34.0,9478.52,,CUS-4023861240,2018-09-02,James,M,-22.84,147.63,,,,,,,debit,posted,29e24448de9743f2ac6fc245b0a72d97,PAYMENT,20-30,2018,9,2,11,0,Sunday,14 days,66187.014
ACC-854938045,28,15.2,12002.0,0.0,CUS-4023861240,2018-09-04,James,M,-22.84,147.63,,eeba33db-ad53-414d-bc4d-f7d321cf661c,-41.16,147.52,TAS,Scottsdale,debit,authorized,a0cae3d763e44395bc036b653d6d952f,SALES-POS,20-30,2018,9,4,5,46,Tuesday,14 days,66187.014
ACC-854938045,28,361.37,11640.63,0.0,CUS-4023861240,2018-09-04,James,M,-22.84,147.63,,91287e52-e392-47c6-8f7c-b94c41f7626c,-33.86,151.2,NSW,Sydney,debit,authorized,9c17199b70b64dd1895618098e0b701f,POS,20-30,2018,9,4,12,30,Tuesday,14 days,66187.014
ACC-854938045,28,38.82,11601.81,1.0,CUS-4023861240,2018-09-05,James,M,-22.84,147.63,,91827347-8f24-4968-b614-92aca2eb5f35,-22.83,147.64,QLD,Clermont,debit,authorized,c7e944d5cf41421daa5cc511940ece19,POS,20-30,2018,9,5,1,18,Wednesday,14 days,66187.014
ACC-854938045,28,34.0,11567.81,1.0,CUS-4023861240,2018-09-05,James,M,-22.84,147.63,,5ca0af7b-4e68-4c5e-85f4-ccf90bc9f359,-37.71,147.83,VIC,Bruthen,debit,authorized,a4db548d86ef4e17a1103ec71cd23f72,POS,20-30,2018,9,5,13,26,Wednesday,14 days,66187.014
ACC-854938045,28,58.0,11509.81,,CUS-4023861240,2018-09-06,James,M,-22.84,147.63,,,,,,,debit,posted,09c439f18c204ab5b6d2aa0f21996e7e,PHONE BANK,20-30,2018,9,6,21,0,Thursday,14 days,66187.014
ACC-854938045,28,23.35,11486.46,1.0,CUS-4023861240,2018-09-07,James,M,-22.84,147.63,,8e83c95f-f8d1-44c1-8cc1-a06fc34b5482,-27.5,153.03,QLD,Annerley,debit,authorized,445fcab63949463b80b37e8a7e574b5f,SALES-POS,20-30,2018,9,7,9,50,Friday,14 days,66187.014
ACC-854938045,28,35.66,11450.8,1.0,CUS-4023861240,2018-09-07,James,M,-22.84,147.63,,d57b8149-8eca-48e6-811d-e7317249725f,-22.76,113.83,WA,Ningaloo,debit,authorized,56eba74155304d0799af15ca05db842d,POS,20-30,2018,9,7,11,20,Friday,14 days,66187.014
ACC-854938045,28,47.36,11403.44,1.0,CUS-4023861240,2018-09-07,James,M,-22.84,147.63,,8f49e7a9-c5ca-4c7a-81dc-911ec5e52ba6,-37.71,145.15,VIC,Ringwood,debit,authorized,2dc9a41dc833457da7bf518663adb7a0,POS,20-30,2018,9,7,16,40,Friday,14 days,66187.014
ACC-854938045,28,475.52,10927.92,1.0,CUS-4023861240,2018-09-07,James,M,-22.84,147.63,,62ec8580-7b7f-4024-b09a-30c94d0f43f4,-27.97,153.41,QLD,Southport,debit,authorized,b4e62b0f02e74fa9bcd892675deda7f4,SALES-POS,20-30,2018,9,7,21,45,Friday,14 days,66187.014
ACC-854938045,28,49.0,10878.92,,CUS-4023861240,2018-09-08,James,M,-22.84,147.63,,,,,,,debit,posted,3d6e595d2cc3414392864bac717f5063,PAYMENT,20-30,2018,9,8,17,0,Saturday,14 days,66187.014
ACC-854938045,28,34.0,10844.92,,CUS-4023861240,2018-09-09,James,M,-22.84,147.63,,,,,,,debit,posted,7f8f4eb0e14e4a00a8f7268df93b90f0,PAYMENT,20-30,2018,9,9,11,0,Sunday,14 days,66187.014
ACC-854938045,28,28.54,10816.38,1.0,CUS-4023861240,2018-09-09,James,M,-22.84,147.63,,65d67292-aec5-4e2b-96a8-67ddf70a9960,-41.17,147.74,TAS,Branxholm,debit,authorized,f5140debcac9433fba327ca1f52ecc1a,POS,20-30,2018,9,9,21,10,Sunday,14 days,66187.014
ACC-854938045,28,106.0,10710.38,,CUS-4023861240,2018-09-10,James,M,-22.84,147.63,,,,,,,debit,posted,45769ac990204aa8bf8b3a351c899dda,PAYMENT,20-30,2018,9,10,20,0,Monday,14 days,66187.014
ACC-854938045,28,181.0,10529.38,,CUS-4023861240,2018-09-11,James,M,-22.84,147.63,,,,,,,debit,posted,828387b77211478e9883f8487252131c,PAYMENT,20-30,2018,9,11,21,0,Tuesday,14 days,66187.014
ACC-854938045,28,11.26,10518.12,1.0,CUS-4023861240,2018-09-12,James,M,-22.84,147.63,,4bf11f3a-c3e4-4f41-b5a5-72f3337034fc,-22.92,118.97,WA,Newman,debit,authorized,b19bbea9250347579e2453a87d8ad217,SALES-POS,20-30,2018,9,12,8,2,Wednesday,14 days,66187.014
ACC-854938045,28,58.0,10460.12,,CUS-4023861240,2018-09-13,James,M,-22.84,147.63,,,,,,,debit,posted,1419afa25ae043ae979fc83177e345f7,PHONE BANK,20-30,2018,9,13,21,0,Thursday,14 days,66187.014
ACC-854938045,28,84.0,10376.12,,CUS-4023861240,2018-09-13,James,M,-22.84,147.63,,,,,,,debit,posted,d52b80c8d7eb40b78d655b2db62c7b43,PAYMENT,20-30,2018,9,13,22,0,Thursday,14 days,66187.014
ACC-854938045,28,55.04,10321.08,1.0,CUS-4023861240,2018-09-13,James,M,-22.84,147.63,,165ae310-aa9e-43b6-b875-f996db6586bd,-27.47,153.03,QLD,Brisbane City,debit,authorized,dd5c9c9a134b4a15a29d9936f30a745c,POS,20-30,2018,9,13,23,47,Thursday,14 days,66187.014
ACC-854938045,28,130.03,10191.05,1.0,CUS-4023861240,2018-09-14,James,M,-22.84,147.63,,26c92de4-4848-4c65-aba4-f33884e7545a,-27.99,153.39,QLD,Ashmore,debit,authorized,14743a88f24247f2adb0a925eb4b8e87,SALES-POS,20-30,2018,9,14,2,48,Friday,14 days,66187.014
ACC-854938045,28,43.89,10147.16,0.0,CUS-4023861240,2018-09-14,James,M,-22.84,147.63,,9b1f5867-31b9-4119-a0d7-3eca9826f940,-33.76,151.26,NSW,Brookvale,debit,authorized,379e3170e0ce4a0583c74823717bb4f6,SALES-POS,20-30,2018,9,14,16,4,Friday,14 days,66187.014
ACC-854938045,28,48.03,10099.13,1.0,CUS-4023861240,2018-09-14,James,M,-22.84,147.63,,eeca52d2-c1d3-429c-9cd1-fca8346924a5,-38.02,145.3,VIC,Fountain Gate,debit,authorized,19f7596b7e9c4e4e890d588b423867d8,POS,20-30,2018,9,14,19,11,Friday,14 days,66187.014
ACC-854938045,28,11.19,10087.94,1.0,CUS-4023861240,2018-09-15,James,M,-22.84,147.63,,38c1492f-bb0b-4735-9cf5-55c96f75311e,-22.91,119.99,WA,Newman,debit,authorized,352060ec2718470d84ba5a0233ec2046,SALES-POS,20-30,2018,9,15,5,57,Saturday,14 days,66187.014
ACC-854938045,28,26.09,10061.85,1.0,CUS-4023861240,2018-09-15,James,M,-22.84,147.63,,be2fdae5-77c0-479f-87e6-3708f631d2e6,-38.02,145.3,VIC,Narre Warren,debit,authorized,f45ffa017ee544c795ad08caa1554464,SALES-POS,20-30,2018,9,15,10,29,Saturday,14 days,66187.014
ACC-854938045,28,148.09,9913.76,1.0,CUS-4023861240,2018-09-15,James,M,-22.84,147.63,,b034674f-6a5d-47f4-a148-8521a992dd15,-37.93,145.15,VIC,Mulgrave,debit,authorized,7bad29dfbc7d48b3929707ea18cc5d0a,SALES-POS,20-30,2018,9,15,13,22,Saturday,14 days,66187.014
ACC-854938045,28,49.0,9864.76,,CUS-4023861240,2018-09-15,James,M,-22.84,147.63,,,,,,,debit,posted,cea96dcd4a8f45dca9e14afc5b472d16,PAYMENT,20-30,2018,9,15,17,0,Saturday,14 days,66187.014
ACC-854938045,28,34.0,9830.76,,CUS-4023861240,2018-09-16,James,M,-22.84,147.63,,,,,,,debit,posted,360d24b7d2164d8db292025cfa6aec90,PAYMENT,20-30,2018,9,16,11,0,Sunday,14 days,66187.014
ACC-854938045,28,44.3,9786.46,1.0,CUS-4023861240,2018-09-16,James,M,-22.84,147.63,,e409298f-baab-4942-a431-beba6ea59c72,-37.82,145.2,VIC,Mitcham,debit,authorized,d1debbbcdb5b4ba4b70522d18cccacd0,POS,20-30,2018,9,16,17,59,Sunday,14 days,66187.014
ACC-854938045,28,17.85,12307.29,1.0,CUS-4023861240,2018-09-18,James,M,-22.84,147.63,,71a62c87-49db-403c-9a83-546bbd4b4f5d,-38,147.69,VIC,Ocean Grange,debit,authorized,ed6916b0254d416c8e9a7ea2028915e5,SALES-POS,20-30,2018,9,18,14,11,Tuesday,14 days,66187.014
ACC-854938045,28,23.56,12283.73,1.0,CUS-4023861240,2018-09-19,James,M,-22.84,147.63,,fd0fd393-5324-45a7-b68a-fa035f53cef1,-37.86,145.05,VIC,Glen Iris,debit,authorized,0e0ec8c199b3480488e225af64c4c582,POS,20-30,2018,9,19,9,49,Wednesday,14 days,66187.014
ACC-854938045,28,38.58,12245.15,1.0,CUS-4023861240,2018-09-19,James,M,-22.84,147.63,,47392c25-91e7-4803-9a4c-f26571922b85,-37.83,145.08,VIC,Camberwell,debit,authorized,a4704aa80c1f41998773290ae1f04157,POS,20-30,2018,9,19,14,33,Wednesday,14 days,66187.014
ACC-854938045,28,41.18,12203.97,1.0,CUS-4023861240,2018-09-19,James,M,-22.84,147.63,,31312403-0025-44ea-9d7f-4c7ad378eacc,-37.68,145.03,VIC,Thomastown,debit,authorized,1db896f24cfb4ff297fd37332e294b61,SALES-POS,20-30,2018,9,19,19,32,Wednesday,14 days,66187.014
ACC-854938045,28,82.67,12121.3,1.0,CUS-4023861240,2018-09-20,James,M,-22.84,147.63,,39057114-0e63-476e-9877-dea209de407d,-32.92,147.71,NSW,Trundle,debit,authorized,e66cafe170aa47b89ff87119dfd46a42,POS,20-30,2018,9,20,14,48,Thursday,14 days,66187.014
ACC-854938045,28,58.0,12063.3,,CUS-4023861240,2018-09-20,James,M,-22.84,147.63,,,,,,,debit,posted,bd68397b58fa48039faf17fefb901788,PHONE BANK,20-30,2018,9,20,21,0,Thursday,14 days,66187.014
ACC-854938045,28,5.62,12057.68,1.0,CUS-4023861240,2018-09-21,James,M,-22.84,147.63,,09f289b2-6d59-4325-b710-689496f66c77,-37.85,144.86,VIC,Williamstown North,debit,authorized,d06dcb7d9c0e4febac06d54db3d7325c,POS,20-30,2018,9,21,13,20,Friday,14 days,66187.014
ACC-854938045,28,33.91,12023.77,0.0,CUS-4023861240,2018-09-21,James,M,-22.84,147.63,,5ca0af7b-4e68-4c5e-85f4-ccf90bc9f359,-37.71,147.83,VIC,Bruthen,debit,authorized,524c7682595a4c18b7c30b9867afbebe,POS,20-30,2018,9,21,14,37,Friday,14 days,66187.014
ACC-854938045,28,23.73,12000.04,0.0,CUS-4023861240,2018-09-21,James,M,-22.84,147.63,,af951f2e-1850-4126-8b40-ad0d80ceeb06,-37.78,144.83,VIC,Sunshine,debit,authorized,c77edb9a47de49f693aecf0dea3c03f6,SALES-POS,20-30,2018,9,21,14,45,Friday,14 days,66187.014
ACC-854938045,28,191.12,11808.92,1.0,CUS-4023861240,2018-09-21,James,M,-22.84,147.63,,294d0299-6194-4e98-9236-c9579956d082,-33.86,151.21,NSW,Sydney,debit,authorized,b046821f3ac04330b18fc92a4e8d8a18,SALES-POS,20-30,2018,9,21,21,47,Friday,14 days,66187.014
ACC-854938045,28,49.0,11759.92,,CUS-4023861240,2018-09-22,James,M,-22.84,147.63,,,,,,,debit,posted,504b10b97d4d4d2eb58699d9647909af,PAYMENT,20-30,2018,9,22,17,0,Saturday,14 days,66187.014
ACC-854938045,28,34.88,11725.04,1.0,CUS-4023861240,2018-09-22,James,M,-22.84,147.63,,132a93ef-30fa-4329-8ad3-a967cfd93dbd,-37.67,144.85,VIC,Tullamarine,debit,authorized,f09339fc412a4a2d964e5b0f9ae05a28,SALES-POS,20-30,2018,9,22,21,18,Saturday,14 days,66187.014
ACC-854938045,28,28.19,11696.85,1.0,CUS-4023861240,2018-09-22,James,M,-22.84,147.63,,eb0272c4-ab58-4e30-a0bf-278a58032a40,-22.69,117.8,WA,Tom Price,debit,authorized,e5cf9f2f5868475fb19808fd6344a617,POS,20-30,2018,9,22,23,24,Saturday,14 days,66187.014
ACC-854938045,28,34.0,11662.85,,CUS-4023861240,2018-09-23,James,M,-22.84,147.63,,,,,,,debit,posted,fda2fbd26e6a46999be41a17adf80e0e,PAYMENT,20-30,2018,9,23,11,0,Sunday,14 days,66187.014
ACC-854938045,28,16.94,11645.91,1.0,CUS-4023861240,2018-09-25,James,M,-22.84,147.63,,71a62c87-49db-403c-9a83-546bbd4b4f5d,-38,147.69,VIC,Ocean Grange,debit,authorized,125bb09de2e24711b5d2ddc79863c41a,POS,20-30,2018,9,25,8,36,Tuesday,14 days,66187.014
ACC-854938045,28,38.31,11607.6,1.0,CUS-4023861240,2018-09-25,James,M,-22.84,147.63,,388848fa-5b48-40ef-9fa0-f1d271a93bf2,-37.79,144.85,VIC,Sunshine,debit,authorized,912c58e2840f4cbf8c4a3d5a4a9f53e5,POS,20-30,2018,9,25,9,40,Tuesday,14 days,66187.014
ACC-854938045,28,43.55,11564.05,1.0,CUS-4023861240,2018-09-26,James,M,-22.84,147.63,,c087506c-c4c6-42de-aae2-2d244e49f4be,-37.9,145.14,VIC,Mount Waverley,debit,authorized,4004f688ddcb4509a4aba164f9da3036,POS,20-30,2018,9,26,16,30,Wednesday,14 days,66187.014
ACC-854938045,28,34.76,11529.29,1.0,CUS-4023861240,2018-09-27,James,M,-22.84,147.63,,684e9848-c2e4-455b-8cf5-f209c4bb7db2,-42.74,147.44,TAS,Richmond,debit,authorized,aca0e7d0b260492c8be0eb43e2dd9f65,SALES-POS,20-30,2018,9,27,19,56,Thursday,14 days,66187.014
ACC-854938045,28,58.0,11471.29,,CUS-4023861240,2018-09-27,James,M,-22.84,147.63,,,,,,,debit,posted,6dd8c2c5e8dc45189bb04e3ceba8a7c9,PHONE BANK,20-30,2018,9,27,21,0,Thursday,14 days,66187.014
ACC-854938045,28,11.8,11459.49,1.0,CUS-4023861240,2018-09-27,James,M,-22.84,147.63,,a24bb055-ef5a-4930-8023-d3cd9a7b8ae7,-41.93,147.49,TAS,Campbell Town,debit,authorized,db5865293d3d4d928844ca731207a2c6,SALES-POS,20-30,2018,9,27,23,17,Thursday,14 days,66187.014
ACC-854938045,28,10.12,11449.37,1.0,CUS-4023861240,2018-09-28,James,M,-22.84,147.63,,a214fc56-46ce-4b3e-9e0b-88a1e0b30166,-37.91,145.13,VIC,Clayton,debit,authorized,9fcf8997e3cd473793d023f29b14feb6,POS,20-30,2018,9,28,1,59,Friday,14 days,66187.014
ACC-854938045,28,109.23,11340.14,1.0,CUS-4023861240,2018-09-28,James,M,-22.84,147.63,,42ade571-5972-4160-9ecb-e0162a305fee,-33.7,151.21,NSW,Belrose,debit,authorized,b254a32af922473c959da636635ab28c,POS,20-30,2018,9,28,8,14,Friday,14 days,66187.014
ACC-854938045,28,64.03,11276.11,1.0,CUS-4023861240,2018-09-28,James,M,-22.84,147.63,,6b519c78-9dc0-4911-9135-4594ff253217,-22.81,148.7,QLD,Middlemount,debit,authorized,96c04c8408464a228e929c87e6145dd2,POS,20-30,2018,9,28,19,9,Friday,14 days,66187.014
ACC-854938045,28,54.73,11221.38,1.0,CUS-4023861240,2018-09-28,James,M,-22.84,147.63,,61890fd6-7092-414f-9473-edc181e46843,-43.04,147.27,TAS,Margate,debit,authorized,0aca2400bf754350b6bf2a00c5e14ecb,SALES-POS,20-30,2018,9,28,22,46,Friday,14 days,66187.014
ACC-854938045,28,49.0,11172.38,,CUS-4023861240,2018-09-29,James,M,-22.84,147.63,,,,,,,debit,posted,9bd9aca202c84a8da59075ec6044b90d,PAYMENT,20-30,2018,9,29,17,0,Saturday,14 days,66187.014
ACC-854938045,28,17.93,11154.45,1.0,CUS-4023861240,2018-09-30,James,M,-22.84,147.63,,64e6e6b9-088b-4855-acad-1210d5eb2f85,-42.74,147.44,TAS,Richmond,debit,authorized,2bdc27752dc248ef9f91a0b44ef64400,POS,20-30,2018,9,30,2,57,Sunday,14 days,66187.014
ACC-854938045,28,34.0,11105.33,,CUS-4023861240,2018-09-30,James,M,-22.84,147.63,,,,,,,debit,posted,800eaa6c835b4399afea67e40d009067,PAYMENT,20-30,2018,9,30,11,0,Sunday,14 days,66187.014
ACC-854938045,28,15.12,11139.33,1.0,CUS-4023861240,2018-09-30,James,M,-22.84,147.63,,b7f42867-024d-499c-b2ae-af0754b3bb84,-42.88,147.41,TAS,Howrah,debit,authorized,7f37822c08d4443792b726a884ff8213,SALES-POS,20-30,2018,9,30,11,45,Sunday,14 days,66187.014
ACC-854938045,28,341.78,13302.23,1.0,CUS-4023861240,2018-10-02,James,M,-22.84,147.63,,16b9f329-7a9d-415d-8a7e-98429a138219,-37.81,144.97,VIC,Melbourne,debit,authorized,7fbc9c9d3ab74c4d82f092b679d2e7be,SALES-POS,20-30,2018,10,2,17,59,Tuesday,14 days,66187.014
ACC-854938045,28,26.71,13275.52,1.0,CUS-4023861240,2018-10-03,James,M,-22.84,147.63,,65d67292-aec5-4e2b-96a8-67ddf70a9960,-41.17,147.74,TAS,Branxholm,debit,authorized,f129be42da8a4906963d705f77c546ab,SALES-POS,20-30,2018,10,3,9,46,Wednesday,14 days,66187.014
ACC-854938045,28,10.71,13264.81,1.0,CUS-4023861240,2018-10-03,James,M,-22.84,147.63,,989c53c1-692b-4602-ad5f-3f62b704a621,-42.91,147.48,TAS,Lauderdale,debit,authorized,719b8d857e63475fa231521f4947b85c,POS,20-30,2018,10,3,10,13,Wednesday,14 days,66187.014
ACC-854938045,28,58.0,13206.81,,CUS-4023861240,2018-10-04,James,M,-22.84,147.63,,,,,,,debit,posted,e4212afb4d5343268d250d8f95b4e48c,PHONE BANK,20-30,2018,10,4,21,0,Thursday,14 days,66187.014
ACC-854938045,28,31.23,13175.58,1.0,CUS-4023861240,2018-10-05,James,M,-22.84,147.63,,4019f5b1-a868-40f1-81d8-941cb97eacba,-37.83,145,VIC,Richmond,debit,authorized,3691dac5a3a0423294e2392fc28b7142,POS,20-30,2018,10,5,22,35,Friday,14 days,66187.014
ACC-854938045,28,45.28,13130.3,0.0,CUS-4023861240,2018-10-06,James,M,-22.84,147.63,,ed5f83fa-595e-4198-a9d6-939e591b7271,-37.93,145.15,VIC,Mulgrave,debit,authorized,91c9977b1be643f5b385df8ab74c0880,SALES-POS,20-30,2018,10,6,2,8,Saturday,14 days,66187.014
ACC-854938045,28,49.0,13081.3,,CUS-4023861240,2018-10-06,James,M,-22.84,147.63,,,,,,,debit,posted,b1e23a17c18c4354bbea5b72a492ef18,PAYMENT,20-30,2018,10,6,17,0,Saturday,14 days,66187.014
ACC-854938045,28,21.14,13060.16,0.0,CUS-4023861240,2018-10-06,James,M,-22.84,147.63,,331ab704-9468-460b-b677-4c170a3cc5b9,-23.04,148.34,QLD,Tieri,debit,authorized,fce396d4ce7841aba61270bf9e2e55a1,POS,20-30,2018,10,6,21,18,Saturday,14 days,66187.014
ACC-854938045,28,17.6,13042.56,1.0,CUS-4023861240,2018-10-07,James,M,-22.84,147.63,,71a62c87-49db-403c-9a83-546bbd4b4f5d,-38,147.69,VIC,Ocean Grange,debit,authorized,e0aec0a50bc84d0b82b9e9ea31292721,POS,20-30,2018,10,7,10,53,Sunday,14 days,66187.014
ACC-854938045,28,34.0,13008.56,,CUS-4023861240,2018-10-07,James,M,-22.84,147.63,,,,,,,debit,posted,0721b3d2c3af455ca34f5b37efa64c74,PAYMENT,20-30,2018,10,7,11,0,Sunday,14 days,66187.014
ACC-854938045,28,39.14,12969.42,1.0,CUS-4023861240,2018-10-07,James,M,-22.84,147.63,,3b9f2a58-76ae-4e0d-a8e3-f68d6152c856,-37.71,144.89,VIC,Airport West,debit,authorized,707d6a182133493494b46ef5a2a0083b,SALES-POS,20-30,2018,10,7,13,49,Sunday,14 days,66187.014
ACC-854938045,28,34.36,12935.06,1.0,CUS-4023861240,2018-10-08,James,M,-22.84,147.63,,8f2350e9-a4f9-4dc5-8e87-0560594ea2a4,-42.89,147.8,TAS,Dunalley,debit,authorized,0c8b91d306fb45ef9df095df74cc3d4a,SALES-POS,20-30,2018,10,8,10,17,Monday,14 days,66187.014
ACC-854938045,28,11.76,12923.3,1.0,CUS-4023861240,2018-10-09,James,M,-22.84,147.63,,38c1492f-bb0b-4735-9cf5-55c96f75311e,-22.91,119.99,WA,Newman,debit,authorized,4cc7cf946b154fad8218ede14c3fe5d7,SALES-POS,20-30,2018,10,9,8,10,Tuesday,14 days,66187.014
ACC-854938045,28,11.88,12911.42,1.0,CUS-4023861240,2018-10-10,James,M,-22.84,147.63,,5db857fb-118c-4757-ab48-337ea3710e01,-35.12,147.42,NSW,Wagga Wagga,debit,authorized,a0624de7f1bf44d5812239eeb91c4846,POS,20-30,2018,10,10,11,7,Wednesday,14 days,66187.014
ACC-854938045,28,106.0,12805.42,,CUS-4023861240,2018-10-10,James,M,-22.84,147.63,,,,,,,debit,posted,01f743471dba426ebd96cfccf1581cc2,PAYMENT,20-30,2018,10,10,20,0,Wednesday,14 days,66187.014
ACC-854938045,28,56.58,12748.84,1.0,CUS-4023861240,2018-10-11,James,M,-22.84,147.63,,617a670e-a706-400a-bbfa-09858d56a871,-26.72,153.06,QLD,Sippy Downs,debit,authorized,410d0e9e29aa4ea4a86d38d6ce97de74,SALES-POS,20-30,2018,10,11,14,33,Thursday,14 days,66187.014
ACC-854938045,28,16.22,12732.62,0.0,CUS-4023861240,2018-10-11,James,M,-22.84,147.63,,84a5be12-07d2-4de0-a371-978a8544e6b0,-37.91,145.08,VIC,Oakleigh,debit,authorized,fb3c293bf6e24f0a8a0ff6da41c9af40,SALES-POS,20-30,2018,10,11,16,39,Thursday,14 days,66187.014
ACC-854938045,28,58.0,12674.62,,CUS-4023861240,2018-10-11,James,M,-22.84,147.63,,,,,,,debit,posted,9c6b91528d214472865da8cfe840c5f8,PHONE BANK,20-30,2018,10,11,21,0,Thursday,14 days,66187.014
ACC-854938045,28,181.0,12493.62,,CUS-4023861240,2018-10-11,James,M,-22.84,147.63,,,,,,,debit,posted,cc5b1a5682a04c8da520eef261c3be4d,PAYMENT,20-30,2018,10,11,21,0,Thursday,14 days,66187.014
ACC-854938045,28,103.37,12390.25,1.0,CUS-4023861240,2018-10-12,James,M,-22.84,147.63,,46a57a24-c922-4ed2-96c6-e012b4e2c8d3,-33.88,151.21,NSW,SYDNEY,debit,authorized,4a722abf05194bcfbd366c4e5a702fb4,POS,20-30,2018,10,12,9,39,Friday,14 days,66187.014
ACC-854938045,28,52.93,12337.32,1.0,CUS-4023861240,2018-10-13,James,M,-22.84,147.63,,54b18f6b-0ab1-4f24-bd8c-95dae51ad526,-22.8,147.65,QLD,Clermont,debit,authorized,8fe15cfb91fd4f029d9fc7ac75ebb559,SALES-POS,20-30,2018,10,13,12,23,Saturday,14 days,66187.014
ACC-854938045,28,49.0,12288.32,,CUS-4023861240,2018-10-13,James,M,-22.84,147.63,,,,,,,debit,posted,7c26bfdd383e4df39ecab13666a9f347,PAYMENT,20-30,2018,10,13,17,0,Saturday,14 days,66187.014
ACC-854938045,28,147.66,12140.66,1.0,CUS-4023861240,2018-10-13,James,M,-22.84,147.63,,3647e656-341b-4fc7-b46e-d4b5fd2c93d4,-33.9,151.2,NSW,Alexandria,debit,authorized,da1fa5af0ed54c20906cd47ddc220d05,SALES-POS,20-30,2018,10,13,20,0,Saturday,14 days,66187.014
ACC-854938045,28,84.0,12056.66,,CUS-4023861240,2018-10-13,James,M,-22.84,147.63,,,,,,,debit,posted,200c776206e54337b0c93746eb57e0dc,PAYMENT,20-30,2018,10,13,22,0,Saturday,14 days,66187.014
ACC-854938045,28,34.0,12022.66,,CUS-4023861240,2018-10-14,James,M,-22.84,147.63,,,,,,,debit,posted,c567d4b6def6498182599e342cea291f,PAYMENT,20-30,2018,10,14,11,0,Sunday,14 days,66187.014
ACC-854938045,28,24.47,14536.87,1.0,CUS-4023861240,2018-10-15,James,M,-22.84,147.63,,0aeb7ee5-8e75-470c-bb75-fa4cb23efe12,-33.87,151.21,NSW,Sydney,debit,authorized,5100935345cf44129dbf5c07f2c9779b,SALES-POS,20-30,2018,10,15,21,25,Monday,14 days,66187.014
ACC-854938045,28,18.59,14518.28,1.0,CUS-4023861240,2018-10-16,James,M,-22.84,147.63,,331ab704-9468-460b-b677-4c170a3cc5b9,-23.04,148.34,QLD,Tieri,debit,authorized,a0f441ac97274061b46f25aa6585f1c9,POS,20-30,2018,10,16,9,45,Tuesday,14 days,66187.014
ACC-854938045,28,7.29,14510.99,1.0,CUS-4023861240,2018-10-17,James,M,-22.84,147.63,,b34457a8-f092-422d-b39d-44828e15d69c,-22.98,119.79,WA,Newman,debit,authorized,a2e22c187a724302a9df1dd75b8564f3,SALES-POS,20-30,2018,10,17,9,8,Wednesday,14 days,66187.014
ACC-854938045,28,170.8,14340.19,1.0,CUS-4023861240,2018-10-17,James,M,-22.84,147.63,,1755f299-52e5-4489-a5ce-d86c236a351c,-33.82,151.19,NSW,St Leonards,debit,authorized,2ef69679b9264d9883d1cce0035dfc41,SALES-POS,20-30,2018,10,17,9,50,Wednesday,14 days,66187.014
ACC-854938045,28,30.69,14309.5,1.0,CUS-4023861240,2018-10-17,James,M,-22.84,147.63,,f9de03bb-805f-42aa-b888-1a771e5dc6da,-37.78,145.46,VIC,Seville,debit,authorized,977e51ebdc6141ad9bf2610e1e783bb5,POS,20-30,2018,10,17,11,56,Wednesday,14 days,66187.014
ACC-854938045,28,65.41,14244.09,1.0,CUS-4023861240,2018-10-17,James,M,-22.84,147.63,,6b519c78-9dc0-4911-9135-4594ff253217,-22.81,148.7,QLD,Middlemount,debit,authorized,0f79068111e3457dab4d0da804b31d1b,SALES-POS,20-30,2018,10,17,17,14,Wednesday,14 days,66187.014
ACC-854938045,28,41.28,14202.81,1.0,CUS-4023861240,2018-10-17,James,M,-22.84,147.63,,333df983-cd39-4229-a6da-a096f2419981,-33.84,151.21,NSW,North Sydney,debit,authorized,b27a25ceda53499fab5decad144cbfb2,SALES-POS,20-30,2018,10,17,19,1,Wednesday,14 days,66187.014
ACC-854938045,28,42.94,14159.87,1.0,CUS-4023861240,2018-10-18,James,M,-22.84,147.63,,c087506c-c4c6-42de-aae2-2d244e49f4be,-37.9,145.14,VIC,Mount Waverley,debit,authorized,53a24df09807444e9c9bdef1aa948c83,POS,20-30,2018,10,18,8,32,Thursday,14 days,66187.014
ACC-854938045,28,43.46,14116.41,0.0,CUS-4023861240,2018-10-18,James,M,-22.84,147.63,,bc42a2eb-caa9-4257-a82c-d52aa11ae3b6,-38.01,145.31,VIC,Narre Warren,debit,authorized,72b445c2df80486db59d4896a0c3a0c0,POS,20-30,2018,10,18,15,10,Thursday,14 days,66187.014
ACC-854938045,28,58.0,14058.41,,CUS-4023861240,2018-10-18,James,M,-22.84,147.63,,,,,,,debit,posted,52ce8f5a82e94e5badbb67382ac76d2a,PHONE BANK,20-30,2018,10,18,21,0,Thursday,14 days,66187.014
ACC-854938045,28,31.93,14026.48,0.0,CUS-4023861240,2018-10-19,James,M,-22.84,147.63,,d62043e3-70e5-4118-aeb5-1817c846538a,-37.82,144.96,VIC,Melbourne,debit,authorized,3335c73a453d43a4a7f520f32516958c,SALES-POS,20-30,2018,10,19,8,26,Friday,14 days,66187.014
ACC-854938045,28,15.83,14010.65,1.0,CUS-4023861240,2018-10-19,James,M,-22.84,147.63,,d1c66cfe-1569-4918-bbb2-ca9f76a14e08,-33.87,151.2,NSW,Sydney,debit,authorized,e4c69e04b5d64965aad72ab259e4b24a,SALES-POS,20-30,2018,10,19,14,49,Friday,14 days,66187.014
ACC-854938045,28,72.6,13938.05,1.0,CUS-4023861240,2018-10-19,James,M,-22.84,147.63,,4cd67a3e-2cac-4d3f-91c9-fc45b6c4483f,-37.82,147.63,VIC,Bairnsdale,debit,authorized,66bfd78c0b5b4e56b66b88da94d15203,POS,20-30,2018,10,19,16,10,Friday,14 days,66187.014
ACC-854938045,28,40.68,13897.37,0.0,CUS-4023861240,2018-10-19,James,M,-22.84,147.63,,91827347-8f24-4968-b614-92aca2eb5f35,-22.83,147.64,QLD,Clermont,debit,authorized,ceb3130a5c144f948d3b4b78d970298b,SALES-POS,20-30,2018,10,19,19,49,Friday,14 days,66187.014
ACC-854938045,28,49.0,13848.37,,CUS-4023861240,2018-10-20,James,M,-22.84,147.63,,,,,,,debit,posted,b51aafd99ae242429f05d263ea8e2426,PAYMENT,20-30,2018,10,20,17,0,Saturday,14 days,66187.014
ACC-854938045,28,7.46,13840.91,0.0,CUS-4023861240,2018-10-20,James,M,-22.84,147.63,,7645bd89-9675-4b0b-a598-7a72e59483d7,-35.15,147.46,NSW,Forest Hill,debit,authorized,113e4284b3d744bba1a85c11138a3385,SALES-POS,20-30,2018,10,20,18,1,Saturday,14 days,66187.014
ACC-854938045,28,18.46,13822.45,1.0,CUS-4023861240,2018-10-20,James,M,-22.84,147.63,,4acb01fe-dc71-4c9b-ab97-e4ba75504be1,-37.64,144.93,VIC,Roxburgh Park,debit,authorized,5dd5caa741474aa7805837c5bc09779d,SALES-POS,20-30,2018,10,20,21,32,Saturday,14 days,66187.014
ACC-854938045,28,34.0,13788.45,,CUS-4023861240,2018-10-21,James,M,-22.84,147.63,,,,,,,debit,posted,3acfbf3878a8419f947fd5e58c58736d,PAYMENT,20-30,2018,10,21,11,0,Sunday,14 days,66187.014
ACC-854938045,28,85.77,13702.68,0.0,CUS-4023861240,2018-10-24,James,M,-22.84,147.63,,c52203b5-920c-4eb9-ae43-34c065f1e8b2,-33.92,151.16,NSW,Tempe,debit,authorized,1128d77869b54ba4b85fd91b26103f11,SALES-POS,20-30,2018,10,24,17,30,Wednesday,14 days,66187.014
ACC-854938045,28,58.0,13644.68,,CUS-4023861240,2018-10-25,James,M,-22.84,147.63,,,,,,,debit,posted,3d6a8775cc974b5d9a12c9b5d316e2ff,PHONE BANK,20-30,2018,10,25,21,0,Thursday,14 days,66187.014
ACC-854938045,28,59.98,13584.7,1.0,CUS-4023861240,2018-10-27,James,M,-22.84,147.63,,1a3c8a43-184a-4bd0-bcc8-18c64a769ee7,-37.86,145.02,VIC,Armadale,debit,authorized,b060f2873abb47e2b51d53bb5da69e99,SALES-POS,20-30,2018,10,27,14,13,Saturday,14 days,66187.014
ACC-854938045,28,49.0,13535.7,,CUS-4023861240,2018-10-27,James,M,-22.84,147.63,,,,,,,debit,posted,d7b0d6e0724244229e3be8bc7b33b3cb,PAYMENT,20-30,2018,10,27,17,0,Saturday,14 days,66187.014
ACC-854938045,28,33.27,13502.43,0.0,CUS-4023861240,2018-10-27,James,M,-22.84,147.63,,5ca0af7b-4e68-4c5e-85f4-ccf90bc9f359,-37.71,147.83,VIC,Bruthen,debit,authorized,6c89d26e8e6f466095f0e3aa0b321a90,SALES-POS,20-30,2018,10,27,21,47,Saturday,14 days,66187.014
ACC-854938045,28,34.0,13468.43,,CUS-4023861240,2018-10-28,James,M,-22.84,147.63,,,,,,,debit,posted,379980751bd44097a34a73dee617b0b2,PAYMENT,20-30,2018,10,28,11,0,Sunday,14 days,66187.014
ACC-854938045,28,32.46,15974.65,1.0,CUS-4023861240,2018-10-29,James,M,-22.84,147.63,,5ca0af7b-4e68-4c5e-85f4-ccf90bc9f359,-37.71,147.83,VIC,Bruthen,debit,authorized,4d6853fae7ad4295b9de2331e691cdcb,POS,20-30,2018,10,29,21,17,Monday,14 days,66187.014
ACC-854938045,28,56.81,15917.84,1.0,CUS-4023861240,2018-10-30,James,M,-22.84,147.63,,61890fd6-7092-414f-9473-edc181e46843,-43.04,147.27,TAS,Margate,debit,authorized,cfbac68757534c7ab5187292dfcb8f48,SALES-POS,20-30,2018,10,30,10,41,Tuesday,14 days,66187.014
ACC-854938045,28,11.35,15906.49,1.0,CUS-4023861240,2018-10-31,James,M,-22.84,147.63,,baca0a58-2459-406e-b747-cdecf3b72c28,-37.77,144.93,VIC,Ascot Vale,debit,authorized,d8a05b4e2ef04131bc77b6cfcb885c84,POS,20-30,2018,10,31,9,12,Wednesday,14 days,66187.014
ACC-854938045,28,19.18,15887.31,1.0,CUS-4023861240,2018-10-31,James,M,-22.84,147.63,,64e6e6b9-088b-4855-acad-1210d5eb2f85,-42.74,147.44,TAS,Richmond,debit,authorized,0a0d8b849b18477ab6031708d7b6cf76,SALES-POS,20-30,2018,10,31,12,56,Wednesday,14 days,66187.014
ACC-574997646,18,5.62,189.55,1.0,CUS-586638664,2018-08-01,Mackenzie,F,-33.64,150.79,,68c05695-d552-4a40-b4a8-cc9f8d88b18f,-33.97,139,SA,Robertson,debit,authorized,91e5965b88db48109b49395233411ddc,SALES-POS,<20,2018,8,1,17,20,Wednesday,14 days,50898.989
ACC-574997646,18,151.0,38.55,,CUS-586638664,2018-08-02,Mackenzie,F,-33.64,150.79,,,,,,,debit,posted,33084ce6fa3743998092d4f2c427071f,PAYMENT,<20,2018,8,2,8,0,Thursday,14 days,50898.989
ACC-574997646,18,36.17,2.38,1.0,CUS-586638664,2018-08-02,Mackenzie,F,-33.64,150.79,,e118ada1-248d-407c-8e8c-553cbc134cfd,-33.92,151.06,NSW,Punchbowl,debit,authorized,cb538f413d8e42e48b75188da75f8706,POS,<20,2018,8,2,16,23,Thursday,14 days,50898.989
ACC-574997646,18,45.0,1909.67,,CUS-586638664,2018-08-11,Mackenzie,F,-33.64,150.79,,,,,,,debit,posted,025d07906b7a43c1852ce4ab21703cd3,PAYMENT,<20,2018,8,11,10,0,Saturday,14 days,50898.989
ACC-574997646,18,9.26,1827.14,1.0,CUS-586638664,2018-08-17,Mackenzie,F,-33.64,150.79,,1af41466-63c6-49e8-aa67-daf5a959bf88,-34.49,150.81,NSW,Brownsville,debit,authorized,e6f9a8cc86ca49b08f231fcdbe664a86,SALES-POS,<20,2018,8,17,19,57,Friday,14 days,50898.989
ACC-574997646,18,9.65,1817.49,1.0,CUS-586638664,2018-08-17,Mackenzie,F,-33.64,150.79,,9358b9cb-5ec2-41a2-847d-86037c599981,-34.04,151.1,NSW,Miranda,debit,authorized,fcb474afdef14ec7b5b23de064cfa902,SALES-POS,<20,2018,8,17,23,5,Friday,14 days,50898.989
ACC-574997646,18,45.0,1772.49,,CUS-586638664,2018-08-18,Mackenzie,F,-33.64,150.79,,,,,,,debit,posted,4aa190157e3d463181496320ae79198d,PAYMENT,<20,2018,8,18,10,0,Saturday,14 days,50898.989
ACC-574997646,18,14.67,1757.82,1.0,CUS-586638664,2018-08-18,Mackenzie,F,-33.64,150.79,,b9510d80-80d9-4fe5-b712-523881bfff75,-33.65,115.34,WA,Busselton,debit,authorized,5f8e800766cd483eb4e2439294036197,POS,<20,2018,8,18,13,17,Saturday,14 days,50898.989
ACC-574997646,18,6.39,1751.43,1.0,CUS-586638664,2018-08-18,Mackenzie,F,-33.64,150.79,,80f166c3-439a-4309-8c95-038524bb1426,-33.69,150.93,NSW,Rouse Hill,debit,authorized,2dd29c318c3b4294bd05e9054a4f9fa7,POS,<20,2018,8,18,14,53,Saturday,14 days,50898.989
ACC-574997646,18,29.52,1721.91,1.0,CUS-586638664,2018-08-18,Mackenzie,F,-33.64,150.79,,a14e90d5-cf90-4b99-8767-0044b543c88a,-33.92,150.92,NSW,Liverpool,debit,authorized,841c5ef23827430fabe77cfb4f541a59,SALES-POS,<20,2018,8,18,19,36,Saturday,14 days,50898.989
ACC-574997646,18,20.0,1701.91,1.0,CUS-586638664,2018-08-20,Mackenzie,F,-33.64,150.79,,f96fca02-1662-4ad1-88a8-a6b37b34b098,-33.65,115.34,WA,Busselton,debit,authorized,5dbfb3f50f0249dbb596e4c5ff164cbd,SALES-POS,<20,2018,8,20,11,33,Monday,14 days,50898.989
ACC-574997646,18,189.0,1512.91,,CUS-586638664,2018-08-21,Mackenzie,F,-33.64,150.79,,,,,,,debit,posted,8924bbb0bb76487bb5c66be28c20a578,PAYMENT,<20,2018,8,21,8,0,Tuesday,14 days,50898.989
ACC-574997646,18,25.58,1487.33,0.0,CUS-586638664,2018-08-21,Mackenzie,F,-33.64,150.79,,8a300708-e7f1-44d8-a9e8-7d8b94127a91,-34.07,150.8,NSW,Campbelltown,debit,authorized,5d85da8dbb314d79bb931b03422849b2,SALES-POS,<20,2018,8,21,15,11,Tuesday,14 days,50898.989
ACC-574997646,18,15.23,1472.1,1.0,CUS-586638664,2018-08-22,Mackenzie,F,-33.64,150.79,,17c5ea0e-2786-4e91-9cbb-a5ce9f0e64d4,-33.94,151.24,NSW,Maroubra,debit,authorized,76afff68a3cc41689e1c5a7ac1fbf394,POS,<20,2018,8,22,18,36,Wednesday,14 days,50898.989
ACC-574997646,18,91.0,1381.1,,CUS-586638664,2018-08-24,Mackenzie,F,-33.64,150.79,,,,,,,debit,posted,a27f132268f74867927e15fc5a4195c4,PAYMENT,<20,2018,8,24,7,0,Friday,14 days,50898.989
ACC-574997646,18,45.0,3288.39,,CUS-586638664,2018-08-25,Mackenzie,F,-33.64,150.79,,,,,,,debit,posted,99b68061922c47baa4a9a58d74e70384,PAYMENT,<20,2018,8,25,10,0,Saturday,14 days,50898.989
ACC-574997646,18,38.83,3249.56,0.0,CUS-586638664,2018-08-25,Mackenzie,F,-33.64,150.79,,11909ca3-e107-4a69-9826-c47ff6bd9e70,-33.92,151.2,NSW,Rosebery,debit,authorized,4c08fbd6b7794ff9babd626f57c6a74c,POS,<20,2018,8,25,15,4,Saturday,14 days,50898.989
ACC-574997646,18,4.99,3244.57,1.0,CUS-586638664,2018-08-27,Mackenzie,F,-33.64,150.79,,e339d722-2349-4e18-a86a-7f17dd209523,-34.56,150.84,NSW,Shellharbour City Centre,debit,authorized,c0e34a20ceb44940a5bd03bc17b0ba8f,POS,<20,2018,8,27,10,49,Monday,14 days,50898.989
ACC-574997646,18,25.18,3219.39,1.0,CUS-586638664,2018-08-28,Mackenzie,F,-33.64,150.79,,57de149c-95cb-4fc4-89b1-c64249e6aee1,-37.83,144.96,VIC,South Melbourne,debit,authorized,8af6efc375a446a797d3a28cff3d86dc,POS,<20,2018,8,28,23,6,Tuesday,14 days,50898.989
ACC-574997646,18,28.15,3191.24,1.0,CUS-586638664,2018-08-29,Mackenzie,F,-33.64,150.79,,f5fa6091-a464-4f01-b563-4a3cba0ae50c,-33.69,117.56,WA,Katanning,debit,authorized,f3a59fb36ff9487997609b5e23b8c429,POS,<20,2018,8,29,14,54,Wednesday,14 days,50898.989
ACC-574997646,18,45.0,3146.24,,CUS-586638664,2018-09-01,Mackenzie,F,-33.64,150.79,,,,,,,debit,posted,6a205d2eac134d95a4e4ae4a99db180e,PAYMENT,<20,2018,9,1,10,0,Saturday,14 days,50898.989
ACC-574997646,18,151.0,2995.24,,CUS-586638664,2018-09-02,Mackenzie,F,-33.64,150.79,,,,,,,debit,posted,96f8a9e68c9442619d486d16437b99d2,PAYMENT,<20,2018,9,2,8,0,Sunday,14 days,50898.989
ACC-574997646,18,47.7,2947.54,1.0,CUS-586638664,2018-09-05,Mackenzie,F,-33.64,150.79,,2cc53184-c4f2-43b9-84bd-7a6127f6a781,-33.64,150.29,NSW,Blackheath,debit,authorized,55344957b62243ffb2ae33822fae6a19,POS,<20,2018,9,5,8,36,Wednesday,14 days,50898.989
ACC-574997646,18,15.84,2931.7,1.0,CUS-586638664,2018-09-05,Mackenzie,F,-33.64,150.79,,5aab531a-f596-4184-b229-f5b8ab29b51a,-33.98,151.08,NSW,Oatley,debit,authorized,5e42b70648df4250babc984a61dff598,POS,<20,2018,9,5,15,14,Wednesday,14 days,50898.989
ACC-574997646,18,85.52,2846.18,1.0,CUS-586638664,2018-09-05,Mackenzie,F,-33.64,150.79,,cd31a750-0ea4-477c-9d91-85b15212f9b0,-33.69,151.02,NSW,Dural,debit,authorized,4da5db479cba4e549352dcac1d5b8e6b,SALES-POS,<20,2018,9,5,23,13,Wednesday,14 days,50898.989
ACC-574997646,18,9.32,2836.86,1.0,CUS-586638664,2018-09-06,Mackenzie,F,-33.64,150.79,,462dc650-bacb-422c-b797-e6b0d5b0fd66,-33.87,151.2,NSW,Pyrmont,debit,authorized,5b24a490d8cb43ffbd2789d7da635ef1,SALES-POS,<20,2018,9,6,14,41,Thursday,14 days,50898.989
ACC-574997646,18,11.45,2825.41,1.0,CUS-586638664,2018-09-06,Mackenzie,F,-33.64,150.79,,40eb2ba1-4b6f-46cf-9146-5cb8b2030660,-33.69,150.93,NSW,Rouse Hill,debit,authorized,113dd0d0945f46a98162223d74402cc5,SALES-POS,<20,2018,9,6,22,42,Thursday,14 days,50898.989
ACC-574997646,18,20.02,2805.39,1.0,CUS-586638664,2018-09-07,Mackenzie,F,-33.64,150.79,,f96fca02-1662-4ad1-88a8-a6b37b34b098,-33.65,115.34,WA,Busselton,debit,authorized,1ba847f14eb242a788e3d6ca2dfe4232,POS,<20,2018,9,7,8,53,Friday,14 days,50898.989
ACC-574997646,18,19.77,4737.91,1.0,CUS-586638664,2018-09-07,Mackenzie,F,-33.64,150.79,,f96fca02-1662-4ad1-88a8-a6b37b34b098,-33.65,115.34,WA,Busselton,debit,authorized,19e6647f7ab34ca7b901eca251f65d24,SALES-POS,<20,2018,9,7,21,51,Friday,14 days,50898.989
ACC-574997646,18,45.0,4692.91,,CUS-586638664,2018-09-08,Mackenzie,F,-33.64,150.79,,,,,,,debit,posted,f96b914494024d36a5adb5c41f1252ea,PAYMENT,<20,2018,9,8,10,0,Saturday,14 days,50898.989
ACC-574997646,18,133.38,4559.53,0.0,CUS-586638664,2018-09-08,Mackenzie,F,-33.64,150.79,,a8c127a3-f399-4861-91ea-159125f1837c,-33.66,115.34,WA,Busselton,debit,authorized,9543c378e8de41ccacb6036cab95a9fa,SALES-POS,<20,2018,9,8,12,50,Saturday,14 days,50898.989
ACC-574997646,18,21.49,4538.04,0.0,CUS-586638664,2018-09-08,Mackenzie,F,-33.64,150.79,,10e9a367-5948-4fa6-83a3-62e0ab1d8934,-33.69,150.55,NSW,Faulconbridge,debit,authorized,5d8cc136993a4f379a8dc4088ad14329,POS,<20,2018,9,8,18,11,Saturday,14 days,50898.989
ACC-574997646,18,43.99,4494.05,1.0,CUS-586638664,2018-09-09,Mackenzie,F,-33.64,150.79,,55fcdb20-741d-4cc1-8e8a-7ceb7bd356dc,-34.44,150.47,NSW,Mittagong,debit,authorized,1ebb7172b9d64cfda465c6c8772c42d4,POS,<20,2018,9,9,9,40,Sunday,14 days,50898.989
ACC-574997646,18,11.38,4482.67,1.0,CUS-586638664,2018-09-10,Mackenzie,F,-33.64,150.79,,b09b9843-a21b-4fce-a9d3-149276af4065,-34.05,151.15,NSW,Cronulla,debit,authorized,d0efb7a2b122439e91a12c077f09ab5b,POS,<20,2018,9,10,9,6,Monday,14 days,50898.989
ACC-574997646,18,510.0,3972.67,,CUS-586638664,2018-09-10,Mackenzie,F,-33.64,150.79,,,,,,,debit,posted,e52211dc11f54e9bb42735de7d87c6ee,PAYMENT,<20,2018,9,10,13,0,Monday,14 days,50898.989
ACC-574997646,18,31.15,3941.52,1.0,CUS-586638664,2018-09-11,Mackenzie,F,-33.64,150.79,,8bdc1e1c-40eb-49f9-aa1c-33b6e8f8e13f,-34.05,150.76,NSW,Narellan,debit,authorized,f5c2babb63ed4db7b365d2872a387903,POS,<20,2018,9,11,22,15,Tuesday,14 days,50898.989
ACC-574997646,18,45.0,3896.52,,CUS-586638664,2018-09-15,Mackenzie,F,-33.64,150.79,,,,,,,debit,posted,24e9e90db08743fbb1567ab7a9628c9a,PAYMENT,<20,2018,9,15,10,0,Saturday,14 days,50898.989
ACC-574997646,18,8.95,3887.57,0.0,CUS-586638664,2018-09-15,Mackenzie,F,-33.64,150.79,,33ff13ea-0ed5-4c31-8f43-d30c9dbabb0d,-33.64,151.33,NSW,Avalon Beach,debit,authorized,e1cf89a98aab4396b94b19e648367f5b,POS,<20,2018,9,15,17,33,Saturday,14 days,50898.989
ACC-574997646,18,12.86,3874.71,1.0,CUS-586638664,2018-09-16,Mackenzie,F,-33.64,150.79,,836794ef-9a32-49cd-8dfe-1e058c2027b6,-33.92,150.92,NSW,Liverpool,debit,authorized,f2259399425442609177bebabe77a288,POS,<20,2018,9,16,8,29,Sunday,14 days,50898.989
ACC-574997646,18,13.63,3861.08,1.0,CUS-586638664,2018-09-16,Mackenzie,F,-33.64,150.79,,696a09cc-c7b4-41cd-8fbe-f08a9da4a79a,-34.48,138.98,SA,Nuriootpa,debit,authorized,7b39cbcf84a644bfa854fd335c84279b,SALES-POS,<20,2018,9,16,21,48,Sunday,14 days,50898.989
ACC-574997646,18,28.96,3832.12,1.0,CUS-586638664,2018-09-17,Mackenzie,F,-33.64,150.79,,3716e385-33dd-4645-bd4d-6a6e42dcf6eb,-33.65,115.35,WA,Busselton,debit,authorized,bc560436d5294721b3ee589eec05952a,POS,<20,2018,9,17,9,9,Monday,14 days,50898.989
ACC-574997646,18,37.84,3794.28,1.0,CUS-586638664,2018-09-18,Mackenzie,F,-33.64,150.79,,35f17316-3cba-4383-b2ba-07745f007afb,-33.91,151.06,NSW,Greenacre,debit,authorized,71f197980200488cabe5d8a670bf5c47,SALES-POS,<20,2018,9,18,15,19,Tuesday,14 days,50898.989
ACC-574997646,18,1307.11,2487.17,1.0,CUS-586638664,2018-09-18,Mackenzie,F,-33.64,150.79,,82b10172-94af-4f92-9c4c-82b7c2e76d68,-33.91,151.2,NSW,Beaconsfield,debit,authorized,d358ed64d7ab4eeaade009184292e703,SALES-POS,<20,2018,9,18,21,49,Tuesday,14 days,50898.989
ACC-574997646,18,20.11,2467.06,1.0,CUS-586638664,2018-09-19,Mackenzie,F,-33.64,150.79,,7ee161ae-2fe3-4195-b339-448457dcf085,-33.6,150.75,NSW,Richmond,debit,authorized,aebec4e64aa84a5eafb368e63414eeea,POS,<20,2018,9,19,8,45,Wednesday,14 days,50898.989
ACC-574997646,18,36.64,2430.42,0.0,CUS-586638664,2018-09-19,Mackenzie,F,-33.64,150.79,,dc4dd283-2d33-4ef8-966d-96b61ce95a4b,-33.62,115.11,WA,Dunsborough,debit,authorized,342ecfd3dc924c70b8d4e11cc270f9bd,SALES-POS,<20,2018,9,19,15,13,Wednesday,14 days,50898.989
ACC-574997646,18,189.0,2241.42,,CUS-586638664,2018-09-21,Mackenzie,F,-33.64,150.79,,,,,,,debit,posted,b7cb9f0b2d464bbe95ccd0c0d44aaa67,PAYMENT,<20,2018,9,21,8,0,Friday,14 days,50898.989
ACC-574997646,18,58.54,2182.88,1.0,CUS-586638664,2018-09-21,Mackenzie,F,-33.64,150.79,,64289ba2-0923-4fec-b762-c3bab5d337d3,-33.69,150.93,NSW,Rouse Hill,debit,authorized,50ac9cef77a34ff5bfd03136f25133cb,POS,<20,2018,9,21,13,56,Friday,14 days,50898.989
ACC-574997646,18,7.14,4128.03,1.0,CUS-586638664,2018-09-21,Mackenzie,F,-33.64,150.79,,49870fad-8e92-408f-9909-e411824b59f0,-33.6,150.75,NSW,Richmond,debit,authorized,70ac006e8aeb4806926866d8449a4d30,POS,<20,2018,9,21,17,28,Friday,14 days,50898.989
ACC-574997646,18,15.34,4112.69,0.0,CUS-586638664,2018-09-21,Mackenzie,F,-33.64,150.79,,035fde6b-0983-444b-895f-fc7e6f58edfe,-33.65,115.35,WA,Busselton,debit,authorized,6e11a81e60f740b3aa895fd6b9709239,SALES-POS,<20,2018,9,21,21,13,Friday,14 days,50898.989
ACC-574997646,18,14.3,4098.39,0.0,CUS-586638664,2018-09-21,Mackenzie,F,-33.64,150.79,,9d1dd1b7-4360-4d25-b7b8-8faa9ea6e2f8,-33.97,151.15,NSW,Brighton-Le-Sands,debit,authorized,c337064ca563488eb202fd648a7eb2ae,SALES-POS,<20,2018,9,21,23,49,Friday,14 days,50898.989
ACC-574997646,18,45.0,4053.39,,CUS-586638664,2018-09-22,Mackenzie,F,-33.64,150.79,,,,,,,debit,posted,3042e98265924ee7acff85f5884e7d43,PAYMENT,<20,2018,9,22,10,0,Saturday,14 days,50898.989
ACC-574997646,18,44.34,4009.05,0.0,CUS-586638664,2018-09-22,Mackenzie,F,-33.64,150.79,,a445b2d2-1e3d-4612-bae7-733896a54ee4,-34.02,151.01,NSW,Menai,debit,authorized,7b6e1b09c6a44d8a9410cb25560f3a8e,POS,<20,2018,9,22,21,46,Saturday,14 days,50898.989
ACC-574997646,18,108.86,3900.19,1.0,CUS-586638664,2018-09-22,Mackenzie,F,-33.64,150.79,,3075b265-3b29-4d54-a38e-c379113f73bf,-33.79,115.97,WA,Balingup,debit,authorized,678af5d640d44d2aaf8d1a2a8ea22885,POS,<20,2018,9,22,22,36,Saturday,14 days,50898.989
ACC-574997646,18,33.35,3866.84,0.0,CUS-586638664,2018-09-23,Mackenzie,F,-33.64,150.79,,a114c660-5f8c-4bb2-9b66-7dfc331f6475,-33.65,115.34,WA,Busselton,debit,authorized,93caab6e2a7441fda9107fee59444f1e,POS,<20,2018,9,23,17,0,Sunday,14 days,50898.989
ACC-574997646,18,91.0,3775.84,,CUS-586638664,2018-09-24,Mackenzie,F,-33.64,150.79,,,,,,,debit,posted,02f5e03b242541488366ea02f83c5061,PAYMENT,<20,2018,9,24,7,0,Monday,14 days,50898.989
ACC-574997646,18,14.53,3761.31,0.0,CUS-586638664,2018-09-27,Mackenzie,F,-33.64,150.79,,1a0279b6-947e-43a0-886a-0a054184e85a,-33.69,150.92,NSW,Rouse Hill,debit,authorized,f17d691a08a84e739c0b7047fa354026,POS,<20,2018,9,27,19,26,Thursday,14 days,50898.989
ACC-574997646,18,26.73,3734.58,1.0,CUS-586638664,2018-09-28,Mackenzie,F,-33.64,150.79,,80e34b41-0ab3-44d4-9c88-229bc25f1db0,-33.95,151.01,NSW,Revesby,debit,authorized,02a9432287984e64ac0e6f5b08652f30,POS,<20,2018,9,28,14,45,Friday,14 days,50898.989
ACC-574997646,18,4.95,3729.63,0.0,CUS-586638664,2018-09-29,Mackenzie,F,-33.64,150.79,,7b3288fc-11c0-40b5-9c65-7007fb4aeec1,-33.66,115.31,WA,West Busselton,debit,authorized,093b2121af284176b298617559ae170d,POS,<20,2018,9,29,2,21,Saturday,14 days,50898.989
ACC-574997646,18,45.0,3684.63,,CUS-586638664,2018-09-29,Mackenzie,F,-33.64,150.79,,,,,,,debit,posted,ae4583f9a0744e7fa836fb98068723eb,PAYMENT,<20,2018,9,29,10,0,Saturday,14 days,50898.989
ACC-574997646,18,21.85,3662.78,0.0,CUS-586638664,2018-09-29,Mackenzie,F,-33.64,150.79,,efc08534-0d8d-4bf0-b4fc-4362fb67b93d,-33.68,115.25,WA,Vasse,debit,authorized,c1eadbf3e64042cf9cfe5795a18c36cc,POS,<20,2018,9,29,16,23,Saturday,14 days,50898.989
ACC-574997646,18,47.67,3615.11,1.0,CUS-586638664,2018-10-01,Mackenzie,F,-33.64,150.79,,a12fc7c1-9b11-4282-be9f-68d6797b9d38,-34.5,139.03,SA,Angaston,debit,authorized,639f0349b91e48e0be4c2329a269b3b1,SALES-POS,<20,2018,10,1,12,37,Monday,14 days,50898.989
ACC-574997646,18,151.0,3464.11,,CUS-586638664,2018-10-02,Mackenzie,F,-33.64,150.79,,,,,,,debit,posted,28efdb623ee144b9bafebaa935e1785c,PAYMENT,<20,2018,10,2,8,0,Tuesday,14 days,50898.989
ACC-574997646,18,15.39,3448.72,1.0,CUS-586638664,2018-10-04,Mackenzie,F,-33.64,150.79,,0aca15c9-1ae2-4c0a-8792-c4c5f8982494,-33.9,151.14,NSW,Summer Hill,debit,authorized,712f500e4edd4fe486f9ba6329c8595e,POS,<20,2018,10,4,10,5,Thursday,14 days,50898.989
ACC-574997646,18,34.01,3414.71,1.0,CUS-586638664,2018-10-05,Mackenzie,F,-33.64,150.79,,98b89c23-91c6-4ea2-a8ac-1279f3f378a7,-33.94,151.14,NSW,Arncliffe,debit,authorized,44fbedbea22c4d1f970c8c984276d7b2,SALES-POS,<20,2018,10,5,11,39,Friday,14 days,50898.989
ACC-574997646,18,45.0,5322.0,,CUS-586638664,2018-10-06,Mackenzie,F,-33.64,150.79,,,,,,,debit,posted,dcf2ab1783424442841760fbb8be737e,PAYMENT,<20,2018,10,6,10,0,Saturday,14 days,50898.989
ACC-574997646,18,17.61,5304.39,1.0,CUS-586638664,2018-10-09,Mackenzie,F,-33.64,150.79,,80e35799-67a3-4502-93c1-7c06fe7bf2aa,-33.72,151.05,NSW,Cherrybrook,debit,authorized,0cbf677c69b74e4f89cd46723406e104,POS,<20,2018,10,9,11,39,Tuesday,14 days,50898.989
ACC-574997646,18,13.52,5290.87,1.0,CUS-586638664,2018-10-10,Mackenzie,F,-33.64,150.79,,c41218ee-e1e9-4da6-9e8c-c4e6c27f3bdd,-33.65,115.34,WA,Busselton,debit,authorized,42cc0314941442fd86870b827123ced2,SALES-POS,<20,2018,10,10,8,35,Wednesday,14 days,50898.989
ACC-574997646,18,22.4,5268.47,1.0,CUS-586638664,2018-10-11,Mackenzie,F,-33.64,150.79,,5a3c3a04-69ec-4c07-beb1-64e96cd3bceb,-33.66,115.36,WA,Busselton,debit,authorized,ca319f20f35a4001b8080a5a387638fc,POS,<20,2018,10,11,11,54,Thursday,14 days,50898.989
ACC-574997646,18,17.42,5251.05,1.0,CUS-586638664,2018-10-13,Mackenzie,F,-33.64,150.79,,ca436ce2-8e1e-4daa-a158-8440fb237a92,-33.6,150.75,NSW,Richmond,debit,authorized,2a7da956a8c74fa6924c09d8d40052c0,POS,<20,2018,10,13,9,30,Saturday,14 days,50898.989
ACC-574997646,18,45.0,5206.05,,CUS-586638664,2018-10-13,Mackenzie,F,-33.64,150.79,,,,,,,debit,posted,0634e04a70d14f57a36a6f6345f234f1,PAYMENT,<20,2018,10,13,10,0,Saturday,14 days,50898.989
ACC-574997646,18,29.44,5176.61,1.0,CUS-586638664,2018-10-13,Mackenzie,F,-33.64,150.79,,f5fa6091-a464-4f01-b563-4a3cba0ae50c,-33.69,117.56,WA,Katanning,debit,authorized,56f3bc7cfb3944a3a52aba5a8eb20016,POS,<20,2018,10,13,11,54,Saturday,14 days,50898.989
ACC-574997646,18,8.56,5168.05,1.0,CUS-586638664,2018-10-14,Mackenzie,F,-33.64,150.79,,216044bb-76d9-48b1-a10b-8a59145b1bb6,-33.68,151.11,NSW,Mount Colah,debit,authorized,4f9b62b2a96d4f11a68486fc9333aef0,SALES-POS,<20,2018,10,14,9,14,Sunday,14 days,50898.989
ACC-574997646,18,23.48,5144.57,1.0,CUS-586638664,2018-10-14,Mackenzie,F,-33.64,150.79,,10e9a367-5948-4fa6-83a3-62e0ab1d8934,-33.69,150.55,NSW,Faulconbridge,debit,authorized,9ceefe3817864d47979b9588815f3ffd,POS,<20,2018,10,14,18,12,Sunday,14 days,50898.989
ACC-574997646,18,23.7,5120.87,1.0,CUS-586638664,2018-10-15,Mackenzie,F,-33.64,150.79,,b62a7332-5d09-402f-9b27-ba528c050331,-34.48,150.42,NSW,Bowral,debit,authorized,a8a41d6165c444f6b75f5e970356f334,SALES-POS,<20,2018,10,15,9,51,Monday,14 days,50898.989
ACC-574997646,18,29.83,5091.04,1.0,CUS-586638664,2018-10-15,Mackenzie,F,-33.64,150.79,,3716e385-33dd-4645-bd4d-6a6e42dcf6eb,-33.65,115.35,WA,Busselton,debit,authorized,dc45fd39e0e247e695b6cd6ffcb9d59f,POS,<20,2018,10,15,20,47,Monday,14 days,50898.989
ACC-574997646,18,14.55,5076.49,1.0,CUS-586638664,2018-10-16,Mackenzie,F,-33.64,150.79,,991be0c2-f5b5-4174-9265-97d1607603ff,-34.1,150.8,NSW,Rosemeadow,debit,authorized,1c290fa7cf0f4ef99e223ef2727538a4,POS,<20,2018,10,16,9,34,Tuesday,14 days,50898.989
ACC-574997646,18,14.22,5062.27,1.0,CUS-586638664,2018-10-18,Mackenzie,F,-33.64,150.79,,c41218ee-e1e9-4da6-9e8c-c4e6c27f3bdd,-33.65,115.34,WA,Busselton,debit,authorized,50180b78d0a240b9946d04967a852cc2,SALES-POS,<20,2018,10,18,11,14,Thursday,14 days,50898.989
ACC-574997646,18,8.61,5053.66,1.0,CUS-586638664,2018-10-18,Mackenzie,F,-33.64,150.79,,c0e6eb7b-1111-4318-adef-f0f18d4e99f6,-34.56,150.84,NSW,Shellharbour City Centre,debit,authorized,5cc099f4131d4439b7314582e53c9705,SALES-POS,<20,2018,10,18,12,59,Thursday,14 days,50898.989
ACC-574997646,18,17.19,5036.47,1.0,CUS-586638664,2018-10-18,Mackenzie,F,-33.64,150.79,,463bf9d5-5d79-41a3-a65e-5b7df8a6f2a8,-33.63,151.33,NSW,Avalon Beach,debit,authorized,95bbc59503264464a025703f1700c1d9,SALES-POS,<20,2018,10,18,16,37,Thursday,14 days,50898.989
ACC-574997646,18,52.99,6935.77,1.0,CUS-586638664,2018-10-19,Mackenzie,F,-33.64,150.79,,f2111cef-4de4-45c7-8bb5-17639c3d5662,-37.82,144.96,VIC,Melbourne,debit,authorized,e4edc48533c34fcd91f1a6a2492df628,SALES-POS,<20,2018,10,19,20,50,Friday,14 days,50898.989
ACC-574997646,18,45.0,6890.77,,CUS-586638664,2018-10-20,Mackenzie,F,-33.64,150.79,,,,,,,debit,posted,2d65a25345fb442eb8a1bd57fa2a6dc9,PAYMENT,<20,2018,10,20,10,0,Saturday,14 days,50898.989
ACC-574997646,18,14.34,6876.43,1.0,CUS-586638664,2018-10-20,Mackenzie,F,-33.64,150.79,,b3ee89aa-e70a-403d-a1e3-e35baef1b515,-33.91,151.15,NSW,Marrickville,debit,authorized,8cd8b577c91d4b0ca19d76a33de3af4c,SALES-POS,<20,2018,10,20,23,38,Saturday,14 days,50898.989
ACC-574997646,18,189.0,6687.43,,CUS-586638664,2018-10-21,Mackenzie,F,-33.64,150.79,,,,,,,debit,posted,3146692e26b74f39a1acb08f0eadd02a,PAYMENT,<20,2018,10,21,8,0,Sunday,14 days,50898.989
ACC-574997646,18,9.05,6678.38,0.0,CUS-586638664,2018-10-21,Mackenzie,F,-33.64,150.79,,8bf2f3e1-c41e-4264-9c2e-67202ac3b5b3,-33.79,151.13,NSW,Macquarie Park,debit,authorized,fa7a444fab684be4a1ab1f16f64d5f32,SALES-POS,<20,2018,10,21,12,11,Sunday,14 days,50898.989
ACC-574997646,18,12.49,6665.89,0.0,CUS-586638664,2018-10-21,Mackenzie,F,-33.64,150.79,,c091541c-c2cc-4657-a44d-8ce2611f2951,-33.94,151.2,NSW,Botany,debit,authorized,b6e40214a9674766b4303c726a58f987,SALES-POS,<20,2018,10,21,16,3,Sunday,14 days,50898.989
ACC-574997646,18,20.54,6645.35,1.0,CUS-586638664,2018-10-21,Mackenzie,F,-33.64,150.79,,79d5a9b0-3e0e-4d2d-ab76-f4e969977c9c,-34.55,150.79,NSW,Albion Park Rail,debit,authorized,c1adb54d25464ae68ad8f35f27bfb669,POS,<20,2018,10,21,21,14,Sunday,14 days,50898.989
ACC-574997646,18,11.45,6633.9,1.0,CUS-586638664,2018-10-23,Mackenzie,F,-33.64,150.79,,dd91411c-36d1-46d7-af1b-6267a7c0799f,-33.97,151.14,NSW,Kogarah,debit,authorized,91085812e8d049e392406bbdfe9e7d82,SALES-POS,<20,2018,10,23,22,51,Tuesday,14 days,50898.989
ACC-574997646,18,91.0,6542.9,,CUS-586638664,2018-10-24,Mackenzie,F,-33.64,150.79,,,,,,,debit,posted,d24be31f3ba34aceac2401f831cf5a48,PAYMENT,<20,2018,10,24,7,0,Wednesday,14 days,50898.989
ACC-574997646,18,23.18,6519.72,1.0,CUS-586638664,2018-10-24,Mackenzie,F,-33.64,150.79,,a9e473d9-ab9d-4ab8-921e-85177fc04b39,-33.68,151.3,NSW,Mona Vale,debit,authorized,3ec93b4cc3074ff6ab8c36e7e580c7e8,SALES-POS,<20,2018,10,24,9,53,Wednesday,14 days,50898.989
ACC-574997646,18,12.98,6506.74,1.0,CUS-586638664,2018-10-26,Mackenzie,F,-33.64,150.79,,fec31452-e20c-436e-8138-f6429bc3d99a,-33.94,151.22,NSW,Eastgardens,debit,authorized,8127e7210cf140abba8768db5fe1d10b,POS,<20,2018,10,26,9,31,Friday,14 days,50898.989
ACC-574997646,18,39.19,6467.55,1.0,CUS-586638664,2018-10-27,Mackenzie,F,-33.64,150.79,,30c69d30-dbad-40dd-8933-689c2ab45f4b,-33.67,115.25,WA,Vasse,debit,authorized,e715a03ddae54d0ebae615ad64ee17a3,SALES-POS,<20,2018,10,27,8,1,Saturday,14 days,50898.989
ACC-574997646,18,45.0,6422.55,,CUS-586638664,2018-10-27,Mackenzie,F,-33.64,150.79,,,,,,,debit,posted,011ec4540a7f475982952bf97bb8f72f,PAYMENT,<20,2018,10,27,10,0,Saturday,14 days,50898.989
ACC-574997646,18,18.46,6404.09,1.0,CUS-586638664,2018-10-27,Mackenzie,F,-33.64,150.79,,b3506429-602e-4caf-983c-299e0adc56d3,-33.65,134.89,SA,Elliston,debit,authorized,9c84cb6d9d2c41ea922909940c70f2bc,POS,<20,2018,10,27,22,3,Saturday,14 days,50898.989
ACC-574997646,18,34.49,6369.6,1.0,CUS-586638664,2018-10-28,Mackenzie,F,-33.64,150.79,,35834d38-a6cc-4b1a-a05a-91fbf44588cb,-33.74,151.21,NSW,Belrose,debit,authorized,407e6e6724314c05bb8d9bb8e3f503dc,POS,<20,2018,10,28,10,40,Sunday,14 days,50898.989
ACC-574997646,18,20.37,6349.23,1.0,CUS-586638664,2018-10-28,Mackenzie,F,-33.64,150.79,,b3506429-602e-4caf-983c-299e0adc56d3,-33.65,134.89,SA,Elliston,debit,authorized,8283271eee19456295e2dd1d64016b86,POS,<20,2018,10,28,18,39,Sunday,14 days,50898.989
ACC-574997646,18,22.35,6326.88,1.0,CUS-586638664,2018-10-29,Mackenzie,F,-33.64,150.79,,efc08534-0d8d-4bf0-b4fc-4362fb67b93d,-33.68,115.25,WA,Vasse,debit,authorized,8e51966e0afb45fa892f7632affa7471,POS,<20,2018,10,29,10,21,Monday,14 days,50898.989
ACC-1650504218,23,14.86,2025.72,1.0,CUS-2500783281,2018-08-01,Marissa,F,-37.93,145.01,,f15a375b-5aeb-48ff-a5c5-3334605186a0,-37.79,145.28,VIC,Croydon,debit,authorized,b16ca12e31304618bd133f80cf64c331,SALES-POS,20-30,2018,8,1,17,48,Wednesday,7 days,84809.314
ACC-1650504218,23,33.0,1992.72,,CUS-2500783281,2018-08-01,Marissa,F,-37.93,145.01,,,,,,,debit,posted,5b8a8ad7f1f24ccd9fd04696bc43aaf8,PAYMENT,20-30,2018,8,1,20,0,Wednesday,7 days,84809.314
ACC-1650504218,23,17.95,1974.77,1.0,CUS-2500783281,2018-08-03,Marissa,F,-37.93,145.01,,55a6c7b2-3f0e-4f25-bc84-0471bbb9e56c,-37.69,145.06,VIC,Bundoora,debit,authorized,3726205cd374427097d7d129d2b86b2b,POS,20-30,2018,8,3,12,32,Friday,7 days,84809.314
ACC-1650504218,23,4.38,1970.39,1.0,CUS-2500783281,2018-08-03,Marissa,F,-37.93,145.01,,0bf7d15e-20d0-4246-8e99-59c3dd1a2dcb,-37.86,144.99,VIC,Windsor,debit,authorized,31eb650226544364a8ce37d70c7b0ea5,SALES-POS,20-30,2018,8,3,13,42,Friday,7 days,84809.314
ACC-1650504218,23,13.31,1957.08,1.0,CUS-2500783281,2018-08-03,Marissa,F,-37.93,145.01,,c4eb066b-dad1-4116-8023-8f123a60642f,-37.88,145.22,VIC,Wantirna South,debit,authorized,33631af76bcc4f2499e6baa0b954c008,POS,20-30,2018,8,3,14,48,Friday,7 days,84809.314
ACC-1650504218,23,43.0,1914.08,,CUS-2500783281,2018-08-04,Marissa,F,-37.93,145.01,,,,,,,debit,posted,f22ff82e68ee4e17a451907fbf79c1e1,PAYMENT,20-30,2018,8,4,5,0,Saturday,7 days,84809.314
ACC-1650504218,23,18.0,1896.08,,CUS-2500783281,2018-08-05,Marissa,F,-37.93,145.01,,,,,,,debit,posted,0cc2709352384e9eae5bff523cf3ffbf,PAYMENT,20-30,2018,8,5,19,0,Sunday,7 days,84809.314
ACC-1650504218,23,22.0,1874.08,,CUS-2500783281,2018-08-06,Marissa,F,-37.93,145.01,,,,,,,debit,posted,d214a84211064f9ea22bcb174084d2e9,PAYMENT,20-30,2018,8,6,15,0,Monday,7 days,84809.314
ACC-1650504218,23,213.0,1661.08,,CUS-2500783281,2018-08-07,Marissa,F,-37.93,145.01,,,,,,,debit,posted,4e07fc29d8f448ec8e1467f3bf127b2b,INTER BANK,20-30,2018,8,7,14,0,Tuesday,7 days,84809.314
ACC-1650504218,23,33.0,3254.56,,CUS-2500783281,2018-08-08,Marissa,F,-37.93,145.01,,,,,,,debit,posted,d8378f92adff4ab29bbb8460f715abb8,PAYMENT,20-30,2018,8,8,20,0,Wednesday,7 days,84809.314
ACC-1650504218,23,43.0,3211.56,,CUS-2500783281,2018-08-11,Marissa,F,-37.93,145.01,,,,,,,debit,posted,7bfe277949ef4214bb81d70ab8e9b906,PAYMENT,20-30,2018,8,11,5,0,Saturday,7 days,84809.314
ACC-1650504218,23,18.0,3193.56,,CUS-2500783281,2018-08-12,Marissa,F,-37.93,145.01,,,,,,,debit,posted,aaff342cd25e4d0ba6839aecba155d7f,PAYMENT,20-30,2018,8,12,19,0,Sunday,7 days,84809.314
ACC-1650504218,23,154.0,3039.56,,CUS-2500783281,2018-08-13,Marissa,F,-37.93,145.01,,,,,,,debit,posted,188a30b5ebf648a59b758c62bedc3f32,PAYMENT,20-30,2018,8,13,9,0,Monday,7 days,84809.314
ACC-1650504218,23,22.0,3017.56,,CUS-2500783281,2018-08-13,Marissa,F,-37.93,145.01,,,,,,,debit,posted,cc3a4b6936274400b62f833b72efbb30,PAYMENT,20-30,2018,8,13,15,0,Monday,7 days,84809.314
ACC-1650504218,23,33.0,4611.04,,CUS-2500783281,2018-08-15,Marissa,F,-37.93,145.01,,,,,,,debit,posted,597b5a0cbf6b45eaab1785f8c11060c2,PAYMENT,20-30,2018,8,15,20,0,Wednesday,7 days,84809.314
ACC-1650504218,23,43.0,4568.04,,CUS-2500783281,2018-08-18,Marissa,F,-37.93,145.01,,,,,,,debit,posted,2887d70ebd5c4810824d0e475da73bac,PAYMENT,20-30,2018,8,18,5,0,Saturday,7 days,84809.314
ACC-1650504218,23,150.0,4418.04,,CUS-2500783281,2018-08-18,Marissa,F,-37.93,145.01,,,,,,,debit,posted,72f2647025f34f4bac295b22260bb581,PAYMENT,20-30,2018,8,18,15,0,Saturday,7 days,84809.314
ACC-1650504218,23,128.0,4290.04,,CUS-2500783281,2018-08-19,Marissa,F,-37.93,145.01,,,,,,,debit,posted,75fdf83263424d0bbc1d60bb98d66591,PAYMENT,20-30,2018,8,19,13,0,Sunday,7 days,84809.314
ACC-1650504218,23,18.0,4272.04,,CUS-2500783281,2018-08-19,Marissa,F,-37.93,145.01,,,,,,,debit,posted,1aae220817824fb3852d941c57b918f0,PAYMENT,20-30,2018,8,19,19,0,Sunday,7 days,84809.314
ACC-1650504218,23,22.0,4250.04,,CUS-2500783281,2018-08-20,Marissa,F,-37.93,145.01,,,,,,,debit,posted,418dd9fcdc0d4407b7badbd9b161a001,PAYMENT,20-30,2018,8,20,15,0,Monday,7 days,84809.314
ACC-1650504218,23,179.0,4071.04,,CUS-2500783281,2018-08-21,Marissa,F,-37.93,145.01,,,,,,,debit,posted,8368b454c36c4615a341939adb28dbe2,PAYMENT,20-30,2018,8,21,12,0,Tuesday,7 days,84809.314
ACC-1650504218,23,33.0,5664.52,,CUS-2500783281,2018-08-22,Marissa,F,-37.93,145.01,,,,,,,debit,posted,a2a45cc6883b42738c58f8153ce59dfd,PAYMENT,20-30,2018,8,22,20,0,Wednesday,7 days,84809.314
ACC-1650504218,23,43.0,5621.52,,CUS-2500783281,2018-08-25,Marissa,F,-37.93,145.01,,,,,,,debit,posted,84878232e8964f1091843ad7f7398eb6,PAYMENT,20-30,2018,8,25,5,0,Saturday,7 days,84809.314
ACC-1650504218,23,18.0,5603.52,,CUS-2500783281,2018-08-26,Marissa,F,-37.93,145.01,,,,,,,debit,posted,9cc6f98d11ac4998baaf0de3884408ae,PAYMENT,20-30,2018,8,26,19,0,Sunday,7 days,84809.314
ACC-1650504218,23,22.0,5581.52,,CUS-2500783281,2018-08-27,Marissa,F,-37.93,145.01,,,,,,,debit,posted,fe840ce9a1b443f1bb40a7be376ce2ef,PAYMENT,20-30,2018,8,27,15,0,Monday,7 days,84809.314
ACC-1650504218,23,33.0,7175.0,,CUS-2500783281,2018-08-29,Marissa,F,-37.93,145.01,,,,,,,debit,posted,0be583d23f504c6ba5180294534d6292,PAYMENT,20-30,2018,8,29,20,0,Wednesday,7 days,84809.314
ACC-1650504218,23,43.0,7132.0,,CUS-2500783281,2018-09-01,Marissa,F,-37.93,145.01,,,,,,,debit,posted,09e297238df346cf8d08b5e1cbf5ce88,PAYMENT,20-30,2018,9,1,5,0,Saturday,7 days,84809.314
ACC-1650504218,23,18.0,7114.0,,CUS-2500783281,2018-09-02,Marissa,F,-37.93,145.01,,,,,,,debit,posted,9d54a5bbfde0489aab11a2c30ca316a4,PAYMENT,20-30,2018,9,2,19,0,Sunday,7 days,84809.314
ACC-1650504218,23,22.0,7092.0,,CUS-2500783281,2018-09-03,Marissa,F,-37.93,145.01,,,,,,,debit,posted,7e1699046d424af8a3e75dc2eeda3c4e,PAYMENT,20-30,2018,9,3,15,0,Monday,7 days,84809.314
ACC-1650504218,23,33.0,8685.48,,CUS-2500783281,2018-09-05,Marissa,F,-37.93,145.01,,,,,,,debit,posted,f7ddd3a52ba94d85a2cff129f6aa9fe4,PAYMENT,20-30,2018,9,5,20,0,Wednesday,7 days,84809.314
ACC-1650504218,23,43.0,8642.48,,CUS-2500783281,2018-09-08,Marissa,F,-37.93,145.01,,,,,,,debit,posted,72c08b5d180149e68b8fae7acdb8f179,PAYMENT,20-30,2018,9,8,5,0,Saturday,7 days,84809.314
ACC-1650504218,23,18.0,8624.48,,CUS-2500783281,2018-09-09,Marissa,F,-37.93,145.01,,,,,,,debit,posted,89870c34a9e345eab3b2cb2e48f65db0,PAYMENT,20-30,2018,9,9,19,0,Sunday,7 days,84809.314
ACC-1650504218,23,22.0,8602.48,,CUS-2500783281,2018-09-10,Marissa,F,-37.93,145.01,,,,,,,debit,posted,d2c8d54b400f44e0939de69693abed61,PAYMENT,20-30,2018,9,10,15,0,Monday,7 days,84809.314
ACC-1650504218,23,33.0,10195.96,,CUS-2500783281,2018-09-12,Marissa,F,-37.93,145.01,,,,,,,debit,posted,cc259a17eb7f440f96548efab065c136,PAYMENT,20-30,2018,9,12,20,0,Wednesday,7 days,84809.314
ACC-1650504218,23,154.0,10041.96,,CUS-2500783281,2018-09-13,Marissa,F,-37.93,145.01,,,,,,,debit,posted,dbbdbe0773614aa499d221cca5ae18dc,PAYMENT,20-30,2018,9,13,9,0,Thursday,7 days,84809.314
ACC-1650504218,23,43.0,9998.96,,CUS-2500783281,2018-09-15,Marissa,F,-37.93,145.01,,,,,,,debit,posted,3d92a8bfd0e541c19e322076499dfd1e,PAYMENT,20-30,2018,9,15,5,0,Saturday,7 days,84809.314
ACC-1650504218,23,18.0,9980.96,,CUS-2500783281,2018-09-16,Marissa,F,-37.93,145.01,,,,,,,debit,posted,fdf349541ada404d91f8266a0bcdcb92,PAYMENT,20-30,2018,9,16,19,0,Sunday,7 days,84809.314
ACC-1650504218,23,22.0,9958.96,,CUS-2500783281,2018-09-17,Marissa,F,-37.93,145.01,,,,,,,debit,posted,3efd1192a80b479c9a4213fbe72f1c84,PAYMENT,20-30,2018,9,17,15,0,Monday,7 days,84809.314
ACC-1650504218,23,150.0,9808.96,,CUS-2500783281,2018-09-18,Marissa,F,-37.93,145.01,,,,,,,debit,posted,893d9e6f3ed6490b85c8f045d0dc0c91,PAYMENT,20-30,2018,9,18,15,0,Tuesday,7 days,84809.314
ACC-1650504218,23,128.0,11307.44,,CUS-2500783281,2018-09-19,Marissa,F,-37.93,145.01,,,,,,,debit,posted,ae0aa4d0636b4f6b8d0fa8bd8d4879d6,PAYMENT,20-30,2018,9,19,13,0,Wednesday,7 days,84809.314
ACC-1650504218,23,33.0,11274.44,,CUS-2500783281,2018-09-19,Marissa,F,-37.93,145.01,,,,,,,debit,posted,f814a1e3d4a342ea9bccea2ecacbd698,PAYMENT,20-30,2018,9,19,20,0,Wednesday,7 days,84809.314
ACC-1650504218,23,179.0,11095.44,,CUS-2500783281,2018-09-21,Marissa,F,-37.93,145.01,,,,,,,debit,posted,30e249f731044136a1d265c3da0f683c,PAYMENT,20-30,2018,9,21,12,0,Friday,7 days,84809.314
ACC-1650504218,23,43.0,11052.44,,CUS-2500783281,2018-09-22,Marissa,F,-37.93,145.01,,,,,,,debit,posted,886d9c39d1fa4f1689428f0ec9d6dbc8,PAYMENT,20-30,2018,9,22,5,0,Saturday,7 days,84809.314
ACC-1650504218,23,18.0,11034.44,,CUS-2500783281,2018-09-23,Marissa,F,-37.93,145.01,,,,,,,debit,posted,548697c717234c4194eb465fc4aa9221,PAYMENT,20-30,2018,9,23,19,0,Sunday,7 days,84809.314
ACC-1650504218,23,22.0,11012.44,,CUS-2500783281,2018-09-24,Marissa,F,-37.93,145.01,,,,,,,debit,posted,5e3e2bedb675426eb2e1de6ead9a7fc9,PAYMENT,20-30,2018,9,24,15,0,Monday,7 days,84809.314
ACC-1650504218,23,33.0,12605.92,,CUS-2500783281,2018-09-26,Marissa,F,-37.93,145.01,,,,,,,debit,posted,5221151f71d845a5aa8ffc26dcda7265,PAYMENT,20-30,2018,9,26,20,0,Wednesday,7 days,84809.314
ACC-1650504218,23,43.0,12562.92,,CUS-2500783281,2018-09-29,Marissa,F,-37.93,145.01,,,,,,,debit,posted,c83002cef8e849a1ba924dc0f3d1da23,PAYMENT,20-30,2018,9,29,5,0,Saturday,7 days,84809.314
ACC-1650504218,23,18.0,12544.92,,CUS-2500783281,2018-09-30,Marissa,F,-37.93,145.01,,,,,,,debit,posted,33badb55946445f6b5f546b175a56cc0,PAYMENT,20-30,2018,9,30,19,0,Sunday,7 days,84809.314
ACC-1650504218,23,22.0,12522.92,,CUS-2500783281,2018-10-01,Marissa,F,-37.93,145.01,,,,,,,debit,posted,dc563fffa6a04c37b871bc4148a19e81,PAYMENT,20-30,2018,10,1,15,0,Monday,7 days,84809.314
ACC-1650504218,23,33.0,14116.4,,CUS-2500783281,2018-10-03,Marissa,F,-37.93,145.01,,,,,,,debit,posted,0de740e629554d57b02dfad3adb4dcf1,PAYMENT,20-30,2018,10,3,20,0,Wednesday,7 days,84809.314
ACC-1650504218,23,43.0,14073.4,,CUS-2500783281,2018-10-06,Marissa,F,-37.93,145.01,,,,,,,debit,posted,d666aac5b9364138913523a5c5a6fc48,PAYMENT,20-30,2018,10,6,5,0,Saturday,7 days,84809.314
ACC-1650504218,23,18.0,14055.4,,CUS-2500783281,2018-10-07,Marissa,F,-37.93,145.01,,,,,,,debit,posted,da5d0c8b33e744ee9bdc16aceb9137b9,PAYMENT,20-30,2018,10,7,19,0,Sunday,7 days,84809.314
ACC-1650504218,23,22.0,14033.4,,CUS-2500783281,2018-10-08,Marissa,F,-37.93,145.01,,,,,,,debit,posted,e0d243c456864ee38b4bcb428db61ca5,PAYMENT,20-30,2018,10,8,15,0,Monday,7 days,84809.314
ACC-1650504218,23,33.0,15626.88,,CUS-2500783281,2018-10-10,Marissa,F,-37.93,145.01,,,,,,,debit,posted,5dde5d833f314aedb12b4e4672d546f2,PAYMENT,20-30,2018,10,10,20,0,Wednesday,7 days,84809.314
ACC-1650504218,23,43.0,15583.88,,CUS-2500783281,2018-10-13,Marissa,F,-37.93,145.01,,,,,,,debit,posted,ec65a16adac346a6ab205b9e0bdb0864,PAYMENT,20-30,2018,10,13,5,0,Saturday,7 days,84809.314
ACC-1650504218,23,154.0,15429.88,,CUS-2500783281,2018-10-13,Marissa,F,-37.93,145.01,,,,,,,debit,posted,d9d044a5f5124b0b89643c5878a47387,PAYMENT,20-30,2018,10,13,9,0,Saturday,7 days,84809.314
ACC-1650504218,23,18.0,15411.88,,CUS-2500783281,2018-10-14,Marissa,F,-37.93,145.01,,,,,,,debit,posted,ada5df44ff3a4446a6077d3b80445a20,PAYMENT,20-30,2018,10,14,19,0,Sunday,7 days,84809.314
ACC-1650504218,23,22.0,15389.88,,CUS-2500783281,2018-10-15,Marissa,F,-37.93,145.01,,,,,,,debit,posted,e78146a8b04c42dca7676a36bf6fc809,PAYMENT,20-30,2018,10,15,15,0,Monday,7 days,84809.314
ACC-1650504218,23,33.0,16983.36,,CUS-2500783281,2018-10-17,Marissa,F,-37.93,145.01,,,,,,,debit,posted,e937f3ef809c4b2793dd621dd08ed406,PAYMENT,20-30,2018,10,17,20,0,Wednesday,7 days,84809.314
ACC-1650504218,23,150.0,16833.36,,CUS-2500783281,2018-10-18,Marissa,F,-37.93,145.01,,,,,,,debit,posted,7b0822bac0994ed7a60648623ed526ce,PAYMENT,20-30,2018,10,18,15,0,Thursday,7 days,84809.314
ACC-1650504218,23,128.0,16705.36,,CUS-2500783281,2018-10-19,Marissa,F,-37.93,145.01,,,,,,,debit,posted,8eb2acd8feb64dc9a7cba0363ffafc0d,PAYMENT,20-30,2018,10,19,13,0,Friday,7 days,84809.314
ACC-1650504218,23,43.0,16662.36,,CUS-2500783281,2018-10-20,Marissa,F,-37.93,145.01,,,,,,,debit,posted,c43febe818674a61af2dc4c8ce129705,PAYMENT,20-30,2018,10,20,5,0,Saturday,7 days,84809.314
ACC-1650504218,23,179.0,16483.36,,CUS-2500783281,2018-10-21,Marissa,F,-37.93,145.01,,,,,,,debit,posted,793f22d4774e4a02a32d2f17bbaecfb8,PAYMENT,20-30,2018,10,21,12,0,Sunday,7 days,84809.314
ACC-1650504218,23,18.0,16465.36,,CUS-2500783281,2018-10-21,Marissa,F,-37.93,145.01,,,,,,,debit,posted,72cb4af74ac8461caa1c2c50f57e5d5e,PAYMENT,20-30,2018,10,21,19,0,Sunday,7 days,84809.314
ACC-1650504218,23,22.0,16443.36,,CUS-2500783281,2018-10-22,Marissa,F,-37.93,145.01,,,,,,,debit,posted,ce384a10f20f4620bbcc0ff90d546aa8,PAYMENT,20-30,2018,10,22,15,0,Monday,7 days,84809.314
ACC-1650504218,23,33.0,18036.84,,CUS-2500783281,2018-10-24,Marissa,F,-37.93,145.01,,,,,,,debit,posted,7eaf2a9dd4fe41e893ad27081bf08f32,PAYMENT,20-30,2018,10,24,20,0,Wednesday,7 days,84809.314
ACC-1650504218,23,43.0,17993.84,,CUS-2500783281,2018-10-27,Marissa,F,-37.93,145.01,,,,,,,debit,posted,f12459f7ce774933b1612390e0241324,PAYMENT,20-30,2018,10,27,5,0,Saturday,7 days,84809.314
ACC-1650504218,23,18.0,17975.84,,CUS-2500783281,2018-10-28,Marissa,F,-37.93,145.01,,,,,,,debit,posted,f468325727724fb6a2ba55d93f07ef69,PAYMENT,20-30,2018,10,28,19,0,Sunday,7 days,84809.314
ACC-1650504218,23,22.0,17953.84,,CUS-2500783281,2018-10-29,Marissa,F,-37.93,145.01,,,,,,,debit,posted,99a16d3f7bc545878eb28f468ffd2baa,PAYMENT,20-30,2018,10,29,15,0,Monday,7 days,84809.314
ACC-1650504218,23,33.0,19547.32,,CUS-2500783281,2018-10-31,Marissa,F,-37.93,145.01,,,,,,,debit,posted,96e0fa11725543af9b0af61f3244081b,PAYMENT,20-30,2018,10,31,20,0,Wednesday,7 days,84809.314
ACC-2153562714,24,46.0,860.46,,CUS-423725039,2018-08-01,Linda,F,-31.88,116.00,,,,,,,debit,posted,daebc880287f457d9389595d92d8951a,PAYMENT,20-30,2018,8,1,18,0,Wednesday,30 days,45169.48
ACC-2153562714,24,12.97,847.49,1.0,CUS-423725039,2018-08-02,Linda,F,-31.88,116.00,,e2591002-0bb4-4adc-a30a-49e3505355b5,-31.85,115.81,WA,Warwick,debit,authorized,f0db55df71b9413b8c408c0387020925,POS,20-30,2018,8,2,8,50,Thursday,30 days,45169.48
ACC-2153562714,24,4.71,842.78,1.0,CUS-423725039,2018-08-02,Linda,F,-31.88,116.00,,027c3f27-080e-4927-9371-feae5ff0d17d,-31.95,115.82,WA,Subiaco,debit,authorized,52b86db6e4424d31be20ceb9e5394753,SALES-POS,20-30,2018,8,2,15,49,Thursday,30 days,45169.48
ACC-2153562714,24,8.31,834.47,1.0,CUS-423725039,2018-08-03,Linda,F,-31.88,116.00,,616c96a2-afaa-49ac-bdfe-fc45256d1f0c,-32.07,115.95,WA,Thornlie,debit,authorized,ca5fef4903454249b08117540ca88e38,POS,20-30,2018,8,3,12,49,Friday,30 days,45169.48
ACC-2153562714,24,27.0,807.47,,CUS-423725039,2018-08-03,Linda,F,-31.88,116.00,,,,,,,debit,posted,80f8b657075c4f0282fb4c594889cbc9,PAYMENT,20-30,2018,8,3,16,0,Friday,30 days,45169.48
ACC-2153562714,24,24.06,783.41,1.0,CUS-423725039,2018-08-03,Linda,F,-31.88,116.00,,2df8bd3d-ef44-4d84-8ef2-bace9ccfd7fb,-31.88,115.78,WA,Karrinyup,debit,authorized,b18156eff59e415582dfc8e323194fe9,POS,20-30,2018,8,3,19,17,Friday,30 days,45169.48
ACC-2153562714,24,10.94,772.47,1.0,CUS-423725039,2018-08-04,Linda,F,-31.88,116.00,,294193ff-d76e-445f-b240-dea59df2caf8,-31.94,141.47,NSW,Broken Hill,debit,authorized,4ed969752b794ab09034b65b65437338,POS,20-30,2018,8,4,8,39,Saturday,30 days,45169.48
ACC-2153562714,24,50.5,721.97,1.0,CUS-423725039,2018-08-04,Linda,F,-31.88,116.00,,57865c1f-5a8e-41d3-8086-f1b7650cd26c,-31.86,115.82,WA,Balcatta,debit,authorized,8c7348d9fd004068b98187fb89826a3a,POS,20-30,2018,8,4,14,57,Saturday,30 days,45169.48
ACC-2153562714,24,46.0,675.97,,CUS-423725039,2018-08-08,Linda,F,-31.88,116.00,,,,,,,debit,posted,ae6b2cff9c5c41b8aedf1f7faeb94115,PAYMENT,20-30,2018,8,8,18,0,Wednesday,30 days,45169.48
ACC-2153562714,24,27.0,648.97,,CUS-423725039,2018-08-10,Linda,F,-31.88,116.00,,,,,,,debit,posted,bbf326c566d84c44a0e9b93e92eec2af,PAYMENT,20-30,2018,8,10,16,0,Friday,30 days,45169.48
ACC-2153562714,24,46.0,602.97,,CUS-423725039,2018-08-15,Linda,F,-31.88,116.00,,,,,,,debit,posted,61f13a4b16be49038aaa14b9ddbe4068,PAYMENT,20-30,2018,8,15,18,0,Wednesday,30 days,45169.48
ACC-2153562714,24,8.94,594.03,0.0,CUS-423725039,2018-08-17,Linda,F,-31.88,116.00,,6cf56f91-9c53-4cfa-b945-000628ec0508,-32.07,115.83,WA,Murdoch,debit,authorized,35d5b0296a624f3084798ad049f2512f,SALES-POS,20-30,2018,8,17,11,31,Friday,30 days,45169.48
ACC-2153562714,24,41.9,552.13,1.0,CUS-423725039,2018-08-17,Linda,F,-31.88,116.00,,faf8ddf3-25d6-4ee2-9254-158c65a13232,-31.87,115.86,WA,Mirrabooka,debit,authorized,66af750f7c2f479ca1a5db48ce9db398,POS,20-30,2018,8,17,15,8,Friday,30 days,45169.48
ACC-2153562714,24,27.0,525.13,,CUS-423725039,2018-08-17,Linda,F,-31.88,116.00,,,,,,,debit,posted,ef84290a05a947d5b53c602a7bfa3403,PAYMENT,20-30,2018,8,17,16,0,Friday,30 days,45169.48
ACC-2153562714,24,15.67,509.46,1.0,CUS-423725039,2018-08-18,Linda,F,-31.88,116.00,,428f9cbe-9d7a-41b8-af5b-a9fa0cf63866,-31.79,132.23,SA,Coorabie,debit,authorized,54ed31c413d44b8a956b722cdad3c43a,POS,20-30,2018,8,18,0,39,Saturday,30 days,45169.48
ACC-2153562714,24,53.03,456.43,1.0,CUS-423725039,2018-08-19,Linda,F,-31.88,116.00,,31f0219e-ba45-44bc-b9b6-9f6e9d60e67d,-37.78,144.82,VIC,Albion,debit,authorized,2804525f0429410fab67bf0b8c258e20,POS,20-30,2018,8,19,15,12,Sunday,30 days,45169.48
ACC-2153562714,24,16.46,439.97,1.0,CUS-423725039,2018-08-20,Linda,F,-31.88,116.00,,a2d81d53-020d-4921-bc82-e1f0161d839c,-32.05,115.75,WA,Fremantle,debit,authorized,a63842b5085342799aaa09c1ca12cf4a,SALES-POS,20-30,2018,8,20,19,15,Monday,30 days,45169.48
ACC-2153562714,24,29.05,410.92,1.0,CUS-423725039,2018-08-20,Linda,F,-31.88,116.00,,94bc98cc-e31d-4a04-b33c-64656dfd5d5c,-32.03,115.84,WA,Booragoon,debit,authorized,413d17ae370342ea82c7e17b2238965b,POS,20-30,2018,8,20,21,33,Monday,30 days,45169.48
ACC-2153562714,24,26.27,384.65,1.0,CUS-423725039,2018-08-21,Linda,F,-31.88,116.00,,b54967e0-175f-45e5-b657-264f9fe52f8e,-31.97,116.06,WA,Kalamunda,debit,authorized,b5011eb1a65d427fba882bd001812ba3,POS,20-30,2018,8,21,0,39,Tuesday,30 days,45169.48
ACC-2153562714,24,29.66,354.99,1.0,CUS-423725039,2018-08-21,Linda,F,-31.88,116.00,,e890bc9b-c064-4e60-a672-50a46876310a,-31.92,115.84,WA,Mount Hawthorn,debit,authorized,6ad72bc6f470455c871b814b509189ad,SALES-POS,20-30,2018,8,21,1,5,Tuesday,30 days,45169.48
ACC-2153562714,24,28.77,326.22,1.0,CUS-423725039,2018-08-21,Linda,F,-31.88,116.00,,ae024401-3e47-48c7-973a-89f50714893d,-31.9,115.8,WA,Innaloo,debit,authorized,731359b09f8e4fc9abdbaae6d8f6d64c,SALES-POS,20-30,2018,8,21,9,27,Tuesday,30 days,45169.48
ACC-2153562714,24,46.0,280.22,,CUS-423725039,2018-08-22,Linda,F,-31.88,116.00,,,,,,,debit,posted,4e2f183153cd41f390efc1c576ea6e85,PAYMENT,20-30,2018,8,22,18,0,Wednesday,30 days,45169.48
ACC-2153562714,24,27.0,3965.78,,CUS-423725039,2018-08-24,Linda,F,-31.88,116.00,,,,,,,debit,posted,cd380788044a4f118183fd4c1d7dd36b,PAYMENT,20-30,2018,8,24,16,0,Friday,30 days,45169.48
ACC-2153562714,24,16.95,3948.83,1.0,CUS-423725039,2018-08-26,Linda,F,-31.88,116.00,,6d1bb943-6105-4d9e-9df5-2cfea7144fa4,-31.98,115.78,WA,Claremont,debit,authorized,499f952d8cd545d1985dc01c1a768320,POS,20-30,2018,8,26,16,13,Sunday,30 days,45169.48
ACC-2153562714,24,13.02,3935.81,0.0,CUS-423725039,2018-08-26,Linda,F,-31.88,116.00,,310bc95b-1a79-4b26-b404-cbafca1285c3,-31.84,115.76,WA,Duncraig,debit,authorized,71ac34dd92a54b0b99156abf00c7a738,SALES-POS,20-30,2018,8,26,16,54,Sunday,30 days,45169.48
ACC-2153562714,24,185.0,3750.81,,CUS-423725039,2018-08-26,Linda,F,-31.88,116.00,,,,,,,debit,posted,d5d2bbabad75447796ce435c60e08ea5,INTER BANK,20-30,2018,8,26,21,0,Sunday,30 days,45169.48
ACC-2153562714,24,12.71,3738.1,1.0,CUS-423725039,2018-08-27,Linda,F,-31.88,116.00,,552b4220-1a02-4608-9e48-4b81003fb6e8,-31.89,116.77,WA,York,debit,authorized,00a3f07d1369476abf7b0b8514cb9bdd,POS,20-30,2018,8,27,9,36,Monday,30 days,45169.48
ACC-2153562714,24,17.8,3720.3,1.0,CUS-423725039,2018-08-27,Linda,F,-31.88,116.00,,0097a400-1f29-4dc5-80fd-72efda13ce03,-31.99,116.01,WA,Forrestfield,debit,authorized,6e90e9a366a141bf955c882dd4647a52,SALES-POS,20-30,2018,8,27,13,39,Monday,30 days,45169.48
ACC-2153562714,24,53.74,3666.56,1.0,CUS-423725039,2018-08-28,Linda,F,-31.88,116.00,,57865c1f-5a8e-41d3-8086-f1b7650cd26c,-31.86,115.82,WA,Balcatta,debit,authorized,61de4233ad754ad2b6bb6550f2c68587,SALES-POS,20-30,2018,8,28,2,17,Tuesday,30 days,45169.48
ACC-2153562714,24,10.91,3655.65,1.0,CUS-423725039,2018-08-28,Linda,F,-31.88,116.00,,82ffa8d8-c0ab-444f-90fc-c9003f92e7a6,-31.95,115.86,WA,Northbridge,debit,authorized,1fca3e4251ac499fa24174009b680fd9,POS,20-30,2018,8,28,9,4,Tuesday,30 days,45169.48
ACC-2153562714,24,46.0,3609.65,,CUS-423725039,2018-08-29,Linda,F,-31.88,116.00,,,,,,,debit,posted,e3befe99febc430d84df23e3ebfdf520,PAYMENT,20-30,2018,8,29,18,0,Wednesday,30 days,45169.48
ACC-2153562714,24,27.0,3582.65,,CUS-423725039,2018-08-31,Linda,F,-31.88,116.00,,,,,,,debit,posted,4f40d7824cbc415b8a4a2c5c4694b8b7,PAYMENT,20-30,2018,8,31,16,0,Friday,30 days,45169.48
ACC-2153562714,24,46.0,3536.65,,CUS-423725039,2018-09-05,Linda,F,-31.88,116.00,,,,,,,debit,posted,290cf19abce5465a83982b038d8a4ae8,PAYMENT,20-30,2018,9,5,18,0,Wednesday,30 days,45169.48
ACC-2153562714,24,27.0,3509.65,,CUS-423725039,2018-09-07,Linda,F,-31.88,116.00,,,,,,,debit,posted,e403e7ed7297464fb950f941fae03d9d,PAYMENT,20-30,2018,9,7,16,0,Friday,30 days,45169.48
ACC-2153562714,24,46.0,3463.65,,CUS-423725039,2018-09-12,Linda,F,-31.88,116.00,,,,,,,debit,posted,fe8af72252474e54a37d95613db5ac72,PAYMENT,20-30,2018,9,12,18,0,Wednesday,30 days,45169.48
ACC-2153562714,24,27.0,3436.65,,CUS-423725039,2018-09-14,Linda,F,-31.88,116.00,,,,,,,debit,posted,a4b9932919654af19c13e89fa2efee46,PAYMENT,20-30,2018,9,14,16,0,Friday,30 days,45169.48
ACC-2153562714,24,46.0,3390.65,,CUS-423725039,2018-09-19,Linda,F,-31.88,116.00,,,,,,,debit,posted,67da26a98e6b438f89e4109c526bb8ce,PAYMENT,20-30,2018,9,19,18,0,Wednesday,30 days,45169.48
ACC-2153562714,24,27.0,3363.65,,CUS-423725039,2018-09-21,Linda,F,-31.88,116.00,,,,,,,debit,posted,bcacdc043f2b41aba4ad53370b856956,PAYMENT,20-30,2018,9,21,16,0,Friday,30 days,45169.48
ACC-2153562714,24,21.47,7054.74,1.0,CUS-423725039,2018-09-26,Linda,F,-31.88,116.00,,f7689758-41ec-43fd-bc61-f86689a9ffcb,-31.95,115.85,WA,West Perth,debit,authorized,38c87fa560fc4c7f8fcdf849925b097c,SALES-POS,20-30,2018,9,26,15,0,Wednesday,30 days,45169.48
ACC-2153562714,24,46.0,7008.74,,CUS-423725039,2018-09-26,Linda,F,-31.88,116.00,,,,,,,debit,posted,152ce23ffd4f43fb89e3cda1f29e6452,PAYMENT,20-30,2018,9,26,18,0,Wednesday,30 days,45169.48
ACC-2153562714,24,185.0,6823.74,,CUS-423725039,2018-09-26,Linda,F,-31.88,116.00,,,,,,,debit,posted,daddc023321549d0bfee8eab572ca517,INTER BANK,20-30,2018,9,26,21,0,Wednesday,30 days,45169.48
ACC-2153562714,24,11.82,6811.92,1.0,CUS-423725039,2018-09-27,Linda,F,-31.88,116.00,,9003ed2b-710e-46a7-abc2-5faecc41a2d5,-31.99,115.79,WA,Claremont,debit,authorized,662b40dfb19c4617bc4d19891cde56af,POS,20-30,2018,9,27,11,23,Thursday,30 days,45169.48
ACC-2153562714,24,27.0,6784.92,,CUS-423725039,2018-09-28,Linda,F,-31.88,116.00,,,,,,,debit,posted,79e1e46a6f084bf9bd652e399611deb6,PAYMENT,20-30,2018,9,28,16,0,Friday,30 days,45169.48
ACC-2153562714,24,46.0,6738.92,,CUS-423725039,2018-10-03,Linda,F,-31.88,116.00,,,,,,,debit,posted,7446d2575005491895c52d52038ac8ac,PAYMENT,20-30,2018,10,3,18,0,Wednesday,30 days,45169.48
ACC-2153562714,24,27.0,6711.92,,CUS-423725039,2018-10-05,Linda,F,-31.88,116.00,,,,,,,debit,posted,085c2d31573b4c6d9a3da032133e8f34,PAYMENT,20-30,2018,10,5,16,0,Friday,30 days,45169.48
ACC-2153562714,24,27.37,6684.55,0.0,CUS-423725039,2018-10-09,Linda,F,-31.88,116.00,,4bf96cad-fb6e-481b-b093-5b37aeb3a6d2,-31.92,115.84,WA,Mount Hawthorn,debit,authorized,0496ad208f304bef9b61c65d4ae30bd3,POS,20-30,2018,10,9,18,56,Tuesday,30 days,45169.48
ACC-2153562714,24,46.0,6638.55,,CUS-423725039,2018-10-10,Linda,F,-31.88,116.00,,,,,,,debit,posted,ef22276a11fe45e5ab463577f1aa4b9d,PAYMENT,20-30,2018,10,10,18,0,Wednesday,30 days,45169.48
ACC-2153562714,24,7.68,6630.87,1.0,CUS-423725039,2018-10-11,Linda,F,-31.88,116.00,,cc545834-17b0-4013-aa87-1c6ff2e12f5f,-32.01,115.89,WA,Waterford,debit,authorized,515e9b1edf7b465bba2de6a54c7e6954,SALES-POS,20-30,2018,10,11,11,24,Thursday,30 days,45169.48
ACC-2153562714,24,5.56,6625.31,1.0,CUS-423725039,2018-10-12,Linda,F,-31.88,116.00,,f44c33b7-12f0-4ed9-80ca-e2ae890faf94,-31.99,115.78,WA,Claremont,debit,authorized,0d1deafaffef43a981fabb294c927f23,POS,20-30,2018,10,12,9,4,Friday,30 days,45169.48
ACC-2153562714,24,9.95,6615.36,1.0,CUS-423725039,2018-10-12,Linda,F,-31.88,116.00,,8add4403-9c52-4509-b28c-4ed727c3e417,-32.08,115.78,WA,Hamilton Hill,debit,authorized,2d3a41aca88f40bd8e638caeb6a88e91,POS,20-30,2018,10,12,11,19,Friday,30 days,45169.48
ACC-2153562714,24,27.0,6588.36,,CUS-423725039,2018-10-12,Linda,F,-31.88,116.00,,,,,,,debit,posted,452f59664e444ef59a3eee5a7f70cd2a,PAYMENT,20-30,2018,10,12,16,0,Friday,30 days,45169.48
ACC-2153562714,24,16.72,6571.64,1.0,CUS-423725039,2018-10-17,Linda,F,-31.88,116.00,,1e8353f3-0cea-40d2-b7ee-fb2a374191bb,-31.9,115.76,WA,Scarborough,debit,authorized,76c30290d1a6467f9cc0b0b8c2f4d6b6,POS,20-30,2018,10,17,16,45,Wednesday,30 days,45169.48
ACC-2153562714,24,46.0,6496.02,,CUS-423725039,2018-10-17,Linda,F,-31.88,116.00,,,,,,,debit,posted,73e0557b1d9d4286b88d0da2d3af29e0,PAYMENT,20-30,2018,10,17,18,0,Wednesday,30 days,45169.48
ACC-2153562714,24,29.62,6542.02,0.0,CUS-423725039,2018-10-17,Linda,F,-31.88,116.00,,5e6b6a71-977d-4905-8775-28ece644996f,-32.04,115.78,WA,Palmyra,debit,authorized,204a3fe5a1d64776a87ff4c4e46498d1,SALES-POS,20-30,2018,10,17,18,35,Wednesday,30 days,45169.48
ACC-2153562714,24,8.34,6487.68,0.0,CUS-423725039,2018-10-17,Linda,F,-31.88,116.00,,77b930b1-1493-40f3-b90d-4c6ea273d856,-31.85,115.78,WA,Carine,debit,authorized,cf7a4df7a0b6434782d5586110716f86,POS,20-30,2018,10,17,21,32,Wednesday,30 days,45169.48
ACC-2153562714,24,17.02,6470.66,1.0,CUS-423725039,2018-10-18,Linda,F,-31.88,116.00,,8ae15cfd-7ffc-4987-8e62-c75c1b555bbd,-31.87,115.81,WA,Balcatta,debit,authorized,272953d22a7c4e47b9fed6107f99b85e,POS,20-30,2018,10,18,8,17,Thursday,30 days,45169.48
ACC-2153562714,24,4.23,6466.43,0.0,CUS-423725039,2018-10-18,Linda,F,-31.88,116.00,,5a1d09a1-46a8-4ea2-a1fa-77e44588085c,-32.04,115.83,WA,Booragoon,debit,authorized,4685421b6a50401788934aef3ad29c9c,SALES-POS,20-30,2018,10,18,20,35,Thursday,30 days,45169.48
ACC-2153562714,24,27.0,6439.43,,CUS-423725039,2018-10-19,Linda,F,-31.88,116.00,,,,,,,debit,posted,42da185bb31d47e6b905c024388afe0e,PAYMENT,20-30,2018,10,19,16,0,Friday,30 days,45169.48
ACC-2153562714,24,207.19,6232.24,1.0,CUS-423725039,2018-10-20,Linda,F,-31.88,116.00,,b4c93406-b25f-4e7e-961b-af807d71e186,-32.04,115.76,WA,East Fremantle,debit,authorized,4903f3b1973c42ffa78e44e5c4fa910f,POS,20-30,2018,10,20,20,36,Saturday,30 days,45169.48
ACC-2153562714,24,10.69,6221.55,1.0,CUS-423725039,2018-10-20,Linda,F,-31.88,116.00,,00bddef1-a891-4701-90bc-44fe1d911839,-32.01,115.89,WA,Karawara,debit,authorized,dbaf79b3a4a042d48499882e209d4b1a,POS,20-30,2018,10,20,21,1,Saturday,30 days,45169.48
ACC-2153562714,24,16.5,6205.05,1.0,CUS-423725039,2018-10-21,Linda,F,-31.88,116.00,,b8fa60ab-e122-4f63-b92f-83526fb63090,-31.89,115.76,WA,Scarborough,debit,authorized,79d98ff8a1844c00bfb54a05471a03da,SALES-POS,20-30,2018,10,21,14,24,Sunday,30 days,45169.48
ACC-2153562714,24,28.62,6176.43,0.0,CUS-423725039,2018-10-21,Linda,F,-31.88,116.00,,7a696b6f-7586-4d4d-a2c6-e32904de84dd,-32.13,133.67,SA,Ceduna,debit,authorized,bf888cd9c3b7425894d0d64c202e5ada,SALES-POS,20-30,2018,10,21,14,58,Sunday,30 days,45169.48
ACC-2153562714,24,17.5,6158.93,1.0,CUS-423725039,2018-10-23,Linda,F,-31.88,116.00,,dcb265cb-9288-453e-95f4-a0e1ed4224aa,-31.89,115.9,WA,Morley,debit,authorized,d9625dca48414ed48f5c39678cf1eba2,SALES-POS,20-30,2018,10,23,12,6,Tuesday,30 days,45169.48
ACC-2153562714,24,13.34,6145.59,1.0,CUS-423725039,2018-10-24,Linda,F,-31.88,116.00,,4c90fdf3-5b7d-4fdc-b734-8bd894ed6a89,-32.12,133.67,SA,Ceduna,debit,authorized,3f662a1d46764ffb8ebe76a68c9a2fcf,POS,20-30,2018,10,24,11,39,Wednesday,30 days,45169.48
ACC-2153562714,24,150.38,5995.21,1.0,CUS-423725039,2018-10-24,Linda,F,-31.88,116.00,,ae795fdc-a1a3-4dce-8869-2a39ea3231cf,-37.83,145.06,VIC,Hawthorn East,debit,authorized,4a47a5fd38c444b390dd4365f10ffe89,SALES-POS,20-30,2018,10,24,11,45,Wednesday,30 days,45169.48
ACC-2153562714,24,46.0,9661.77,,CUS-423725039,2018-10-24,Linda,F,-31.88,116.00,,,,,,,debit,posted,2161555cefe44ccdb882a75a617f3233,PAYMENT,20-30,2018,10,24,18,0,Wednesday,30 days,45169.48
ACC-2153562714,24,10.41,9651.36,0.0,CUS-423725039,2018-10-25,Linda,F,-31.88,116.00,,8d1075d3-05c6-4a8b-8e97-6171a08a5921,-31.89,116.77,WA,York,debit,authorized,8c3822b3d6c340bea0900eeeea3912c2,POS,20-30,2018,10,25,8,28,Thursday,30 days,45169.48
ACC-2153562714,24,13.94,9637.42,1.0,CUS-423725039,2018-10-25,Linda,F,-31.88,116.00,,7d6c834c-8d38-4dea-bd0e-5c3e858525ef,-31.89,115.76,WA,Scarborough,debit,authorized,ee9489b6ce9441f6b96457dba0995018,POS,20-30,2018,10,25,8,35,Thursday,30 days,45169.48
ACC-2153562714,24,9.12,9628.3,1.0,CUS-423725039,2018-10-25,Linda,F,-31.88,116.00,,d0a5e33c-4a72-49db-b9bd-67e9f45453c2,-32.01,151.96,NSW,Gloucester,debit,authorized,edd39eb0dc2147bf8da183c4791ed0dd,POS,20-30,2018,10,25,9,13,Thursday,30 days,45169.48
ACC-2153562714,24,19.96,9608.34,1.0,CUS-423725039,2018-10-25,Linda,F,-31.88,116.00,,2fe5541a-1d32-4a82-b8f9-b011dafb5ce4,-32.12,115.78,WA,Munster,debit,authorized,05c934191a254f89a9262a1ff09fb1aa,SALES-POS,20-30,2018,10,25,9,17,Thursday,30 days,45169.48
ACC-2153562714,24,13.6,9594.74,1.0,CUS-423725039,2018-10-26,Linda,F,-31.88,116.00,,0cc03d95-bf40-41a7-9248-2d7c42e95c04,-32.13,133.67,SA,Ceduna,debit,authorized,1ee51bb4958442bfa926f6affb52aaaf,POS,20-30,2018,10,26,10,27,Friday,30 days,45169.48
ACC-2153562714,24,27.0,9567.74,,CUS-423725039,2018-10-26,Linda,F,-31.88,116.00,,,,,,,debit,posted,bc3b91de335d4eb19f13d33d24127b31,PAYMENT,20-30,2018,10,26,16,0,Friday,30 days,45169.48
ACC-2153562714,24,185.0,9382.74,,CUS-423725039,2018-10-26,Linda,F,-31.88,116.00,,,,,,,debit,posted,b6ae89a5642a45d798b304f8d2b6d91e,INTER BANK,20-30,2018,10,26,21,0,Friday,30 days,45169.48
ACC-2153562714,24,19.04,9363.7,1.0,CUS-423725039,2018-10-29,Linda,F,-31.88,116.00,,442296c7-c041-4547-8979-25626e1a766d,-31.96,141.46,NSW,Broken Hill,debit,authorized,bcae42b5ef584bb09d7121e44ad7b7e7,POS,20-30,2018,10,29,10,59,Monday,30 days,45169.48
ACC-2153562714,24,46.0,9317.7,,CUS-423725039,2018-10-31,Linda,F,-31.88,116.00,,,,,,,debit,posted,6cd220c5e30b4f8cb41f7daf147d1a88,PAYMENT,20-30,2018,10,31,18,0,Wednesday,30 days,45169.48
ACC-90814749,35,19.58,6022.68,0.0,CUS-1896554896,2018-08-01,Christopher,M,-32.98,151.68,,5e4447f8-8083-40eb-b75f-f7e9a0583d3c,-32.97,138.84,SA,Peterborough,debit,authorized,3b8ac93bc7cd4d24a288882782a805e6,SALES-POS,30-40,2018,8,1,18,45,Wednesday,14 days,60190.325
ACC-90814749,35,36.0,5986.68,,CUS-1896554896,2018-08-02,Christopher,M,-32.98,151.68,,,,,,,debit,posted,9f9f0420363b450cbdea788bf738e27b,PAYMENT,30-40,2018,8,2,22,0,Thursday,14 days,60190.325
ACC-90814749,35,110.0,5876.68,,CUS-1896554896,2018-08-03,Christopher,M,-32.98,151.68,,,,,,,debit,posted,e48af287f57041c6807e1ba25dc93b85,INTER BANK,30-40,2018,8,3,7,0,Friday,14 days,60190.325
ACC-90814749,35,21.38,5855.3,0.0,CUS-1896554896,2018-08-04,Christopher,M,-32.98,151.68,,5e4447f8-8083-40eb-b75f-f7e9a0583d3c,-32.97,138.84,SA,Peterborough,debit,authorized,2692d71617a94c97b2a94677bd71c947,POS,30-40,2018,8,4,0,29,Saturday,14 days,60190.325
ACC-90814749,35,37.54,5817.76,1.0,CUS-1896554896,2018-08-04,Christopher,M,-32.98,151.68,,0437b95e-f8be-4752-b932-305315407ead,-32.77,151.7,NSW,Millers Forest,debit,authorized,eb7c93101f3a4f859326c9952c54679a,POS,30-40,2018,8,4,6,54,Saturday,14 days,60190.325
ACC-90814749,35,44.0,5773.76,,CUS-1896554896,2018-08-04,Christopher,M,-32.98,151.68,,,,,,,debit,posted,9b593371b78b4f18800e83d3b7edd980,INTER BANK,30-40,2018,8,4,13,0,Saturday,14 days,60190.325
ACC-90814749,35,14.06,5759.7,0.0,CUS-1896554896,2018-08-05,Christopher,M,-32.98,151.68,,7293cc8f-efea-4b62-ad9d-dc069ab37255,-32.79,151.73,NSW,Heatherbrae,debit,authorized,c5679e7599e84320bc29c8e30df4f87f,SALES-POS,30-40,2018,8,5,14,16,Sunday,14 days,60190.325
ACC-90814749,35,21.52,5738.18,0.0,CUS-1896554896,2018-08-05,Christopher,M,-32.98,151.68,,5e4447f8-8083-40eb-b75f-f7e9a0583d3c,-32.97,138.84,SA,Peterborough,debit,authorized,832befc6b48b4a539befd8afc2705d70,POS,30-40,2018,8,5,21,15,Sunday,14 days,60190.325
ACC-90814749,35,9.51,5728.67,1.0,CUS-1896554896,2018-08-06,Christopher,M,-32.98,151.68,,15388986-8d72-4006-aacb-2eacc4150ab3,-32.92,151.69,NSW,New Lambton Heights,debit,authorized,e312bcaa118e47669a14c8d7ca4efb19,SALES-POS,30-40,2018,8,6,15,14,Monday,14 days,60190.325
ACC-90814749,35,31.59,5697.08,1.0,CUS-1896554896,2018-08-07,Christopher,M,-32.98,151.68,,ab79479c-da5d-4a41-ae59-2c6355c917d2,-33.01,151.59,NSW,Toronto,debit,authorized,e373fe83888b48eeaa210e5ca39d1db4,SALES-POS,30-40,2018,8,7,9,16,Tuesday,14 days,60190.325
ACC-90814749,35,6.9,5690.18,1.0,CUS-1896554896,2018-08-07,Christopher,M,-32.98,151.68,,ba23d4fd-81e8-4850-8e24-412e2e985541,-35.32,149.18,ACT,Fyshwick,debit,authorized,90b843e61e9544ffb2f93f67d9fd2827,SALES-POS,30-40,2018,8,7,11,15,Tuesday,14 days,60190.325
ACC-90814749,35,22.4,5667.78,1.0,CUS-1896554896,2018-08-07,Christopher,M,-32.98,151.68,,5e4447f8-8083-40eb-b75f-f7e9a0583d3c,-32.97,138.84,SA,Peterborough,debit,authorized,595a58f9b33f4814a00a2e4263eeab18,POS,30-40,2018,8,7,11,33,Tuesday,14 days,60190.325
ACC-90814749,35,84.21,5583.57,1.0,CUS-1896554896,2018-08-08,Christopher,M,-32.98,151.68,,39057114-0e63-476e-9877-dea209de407d,-32.92,147.71,NSW,Trundle,debit,authorized,13dee8f825a148cb9ecc78794eaaa6e1,SALES-POS,30-40,2018,8,8,12,35,Wednesday,14 days,60190.325
ACC-90814749,35,12.03,5571.54,1.0,CUS-1896554896,2018-08-09,Christopher,M,-32.98,151.68,,910d238b-70e0-4ea3-914b-b83c39b44c9f,-30.51,151.68,NSW,Armidale,debit,authorized,838191a6ac924dc9b9582967a2a945e6,SALES-POS,30-40,2018,8,9,13,43,Thursday,14 days,60190.325
ACC-90814749,35,36.0,5535.54,,CUS-1896554896,2018-08-09,Christopher,M,-32.98,151.68,,,,,,,debit,posted,3171d5b12f2d484ba115b0a8a35b111d,PAYMENT,30-40,2018,8,9,22,0,Thursday,14 days,60190.325
ACC-90814749,35,33.95,5501.59,1.0,CUS-1896554896,2018-08-10,Christopher,M,-32.98,151.68,,d8843cbf-95eb-4bf7-b5e1-bcbfe3b02c22,-33.03,137.54,SA,Whyalla Norrie,debit,authorized,4d93fbd37a9a49fd815aa0d1682c7f8e,POS,30-40,2018,8,10,15,46,Friday,14 days,60190.325
ACC-90814749,35,44.0,7766.26,,CUS-1896554896,2018-08-11,Christopher,M,-32.98,151.68,,,,,,,debit,posted,32c13441a5f149a5a507aed7f9e973bf,INTER BANK,30-40,2018,8,11,13,0,Saturday,14 days,60190.325
ACC-90814749,35,18.81,7747.45,1.0,CUS-1896554896,2018-08-13,Christopher,M,-32.98,151.68,,41d52afd-3bd3-4d29-bc43-93df414b0f1f,-32.85,151.69,NSW,Hexham,debit,authorized,cd131733b0ea452293c430aada02ec5d,SALES-POS,30-40,2018,8,13,9,10,Monday,14 days,60190.325
ACC-90814749,35,19.67,7727.78,0.0,CUS-1896554896,2018-08-14,Christopher,M,-32.98,151.68,,5e4447f8-8083-40eb-b75f-f7e9a0583d3c,-32.97,138.84,SA,Peterborough,debit,authorized,e28b73e0866d45b8891af87773e88bd8,POS,30-40,2018,8,14,20,10,Tuesday,14 days,60190.325
ACC-90814749,35,44.0,7633.13,,CUS-1896554896,2018-08-18,Christopher,M,-32.98,151.68,,,,,,,debit,posted,09639e6a953749f48898ffef1619bd91,INTER BANK,30-40,2018,8,18,13,0,Saturday,14 days,60190.325
ACC-90814749,35,36.0,7597.13,,CUS-1896554896,2018-08-23,Christopher,M,-32.98,151.68,,,,,,,debit,posted,e31a9f3f1e734ab6bd37cb661701c0a2,PAYMENT,30-40,2018,8,23,22,0,Thursday,14 days,60190.325
ACC-90814749,35,35.05,9870.75,1.0,CUS-1896554896,2018-08-24,Christopher,M,-32.98,151.68,,a40690d5-f670-49ad-87e0-4ebd4d901364,-32.93,117.18,WA,Narrogin,debit,authorized,45e6572150da44188a3d972587515f5f,POS,30-40,2018,8,24,19,40,Friday,14 days,60190.325
ACC-90814749,35,20.18,9850.57,1.0,CUS-1896554896,2018-08-24,Christopher,M,-32.98,151.68,,7e90d0c6-eacb-405e-97bc-c0bcbe562c3f,-33.01,115.74,WA,Myalup,debit,authorized,88c654ae1d49408189d91da2cd356cf1,SALES-POS,30-40,2018,8,24,19,50,Friday,14 days,60190.325
ACC-90814749,35,23.22,9827.35,1.0,CUS-1896554896,2018-08-24,Christopher,M,-32.98,151.68,,615600a8-fe3c-42f9-9332-5dbc336daa50,-30.51,151.67,NSW,Armidale,debit,authorized,dbf823135cff4d408d5392c89a216f92,SALES-POS,30-40,2018,8,24,21,40,Friday,14 days,60190.325
ACC-90814749,35,48.26,9779.09,0.0,CUS-1896554896,2018-08-24,Christopher,M,-32.98,151.68,,2a8e613d-ee65-403b-963b-0bb42b75e1c9,-32.92,151.76,NSW,Wickham,debit,authorized,f180326c3f824ed6af1ad91252716c94,SALES-POS,30-40,2018,8,24,22,8,Friday,14 days,60190.325
ACC-90814749,35,18.21,9760.88,1.0,CUS-1896554896,2018-08-25,Christopher,M,-32.98,151.68,,3f7a269b-4fce-41d9-8472-1ce1cab9e9b9,-32.94,151.71,NSW,Kotara,debit,authorized,8e65acd5ca43475a985c2c36cbd4d58d,POS,30-40,2018,8,25,9,52,Saturday,14 days,60190.325
ACC-90814749,35,44.0,9716.88,,CUS-1896554896,2018-08-25,Christopher,M,-32.98,151.68,,,,,,,debit,posted,7080e4dea9584ffebaeea6c1a46c81fd,INTER BANK,30-40,2018,8,25,13,0,Saturday,14 days,60190.325
ACC-90814749,35,33.35,9683.53,0.0,CUS-1896554896,2018-08-25,Christopher,M,-32.98,151.68,,b0904b8b-80cf-40f0-a208-d190f5e565a1,-33.02,137.54,SA,Whyalla Norrie,debit,authorized,378d572fa73b46b39a88fc6774c53e14,SALES-POS,30-40,2018,8,25,14,29,Saturday,14 days,60190.325
ACC-90814749,35,56.91,9626.62,1.0,CUS-1896554896,2018-08-25,Christopher,M,-32.98,151.68,,cc64c86b-30e3-4bed-ac9b-a1faa39946b2,-32.94,117.18,WA,Narrogin,debit,authorized,fbfdf41420964733af38c3f07de5d710,SALES-POS,30-40,2018,8,25,14,54,Saturday,14 days,60190.325
ACC-90814749,35,55.76,9570.86,0.0,CUS-1896554896,2018-08-25,Christopher,M,-32.98,151.68,,8127981a-4d2f-402a-8999-1177d0d720f2,-32.89,151.71,NSW,Warabrook,debit,authorized,6f2dec94479544099f52b97e4e7b18a7,SALES-POS,30-40,2018,8,25,16,15,Saturday,14 days,60190.325
ACC-90814749,35,13.19,9557.67,1.0,CUS-1896554896,2018-08-25,Christopher,M,-32.98,151.68,,42b9bd12-297b-4cae-a557-821c5c0c22b2,-31.98,115.82,WA,Crawley,debit,authorized,786b541c48b04054a31ebfd3e1dfc80a,POS,30-40,2018,8,25,23,17,Saturday,14 days,60190.325
ACC-90814749,35,11.26,9546.41,1.0,CUS-1896554896,2018-08-27,Christopher,M,-32.98,151.68,,15388986-8d72-4006-aacb-2eacc4150ab3,-32.92,151.69,NSW,New Lambton Heights,debit,authorized,d6b173bfca6040c381479c803cfef027,POS,30-40,2018,8,27,10,41,Monday,14 days,60190.325
ACC-90814749,35,23.38,9523.03,1.0,CUS-1896554896,2018-08-28,Christopher,M,-32.98,151.68,,615600a8-fe3c-42f9-9332-5dbc336daa50,-30.51,151.67,NSW,Armidale,debit,authorized,9fda2de18ff54cdd9be362596064ac8b,SALES-POS,30-40,2018,8,28,8,19,Tuesday,14 days,60190.325
ACC-90814749,35,101.43,9421.6,0.0,CUS-1896554896,2018-08-28,Christopher,M,-32.98,151.68,,1b946c71-30b4-4644-92da-bd0d92bf2909,-32.94,117.18,WA,Narrogin,debit,authorized,ad0ea75812034f2a94a63d9569720636,POS,30-40,2018,8,28,19,22,Tuesday,14 days,60190.325
ACC-90814749,35,133.0,9288.6,,CUS-1896554896,2018-08-28,Christopher,M,-32.98,151.68,,,,,,,debit,posted,5968e5aa93c64829b0a7f9a9a455f58f,PAYMENT,30-40,2018,8,28,20,0,Tuesday,14 days,60190.325
ACC-90814749,35,19.87,9268.73,1.0,CUS-1896554896,2018-08-29,Christopher,M,-32.98,151.68,,a254b32f-cf0d-476f-bce8-c579a623add7,-32.94,151.66,NSW,Cardiff,debit,authorized,51ef2038d61d4fb2a765f9914447b2f3,SALES-POS,30-40,2018,8,29,0,30,Wednesday,14 days,60190.325
ACC-90814749,35,19.72,9249.01,1.0,CUS-1896554896,2018-08-29,Christopher,M,-32.98,151.68,,b059aa9e-10ab-46ce-9c18-5769a9020d0b,-32.94,117.18,WA,Narrogin,debit,authorized,46d2212b502149af84596481a9c2511b,POS,30-40,2018,8,29,13,29,Wednesday,14 days,60190.325
ACC-90814749,35,18.89,9230.12,0.0,CUS-1896554896,2018-08-29,Christopher,M,-32.98,151.68,,7e90d0c6-eacb-405e-97bc-c0bcbe562c3f,-33.01,115.74,WA,Myalup,debit,authorized,352670cf66ca42509d06ed08d010dbf4,POS,30-40,2018,8,29,20,46,Wednesday,14 days,60190.325
ACC-90814749,35,75.31,9154.81,1.0,CUS-1896554896,2018-08-30,Christopher,M,-32.98,151.68,,0fab4c47-59e6-4978-a65d-921fc447728f,-32.72,151.65,NSW,Hinton,debit,authorized,b2c7bd69bdb64dd0ba53ecb917c6fdbb,POS,30-40,2018,8,30,11,18,Thursday,14 days,60190.325
ACC-90814749,35,36.0,9118.81,,CUS-1896554896,2018-08-30,Christopher,M,-32.98,151.68,,,,,,,debit,posted,26687223ba8d40a4aa27a7826114e96b,PAYMENT,30-40,2018,8,30,22,0,Thursday,14 days,60190.325
ACC-90814749,35,14.13,9104.68,1.0,CUS-1896554896,2018-09-01,Christopher,M,-32.98,151.68,,fc76d86e-a1ac-4864-a500-9ca999e84d61,-32.94,151.71,NSW,Kotara,debit,authorized,c33d9296dca14cfd935f1db3d3b19b74,SALES-POS,30-40,2018,9,1,4,42,Saturday,14 days,60190.325
ACC-90814749,35,74.79,9029.89,1.0,CUS-1896554896,2018-09-01,Christopher,M,-32.98,151.68,,0fab4c47-59e6-4978-a65d-921fc447728f,-32.72,151.65,NSW,Hinton,debit,authorized,6acd1e388e5d43c088ee7b2a9bbada95,POS,30-40,2018,9,1,7,28,Saturday,14 days,60190.325
ACC-90814749,35,9.94,9019.95,1.0,CUS-1896554896,2018-09-01,Christopher,M,-32.98,151.68,,9fbd34f1-3a80-45ce-9784-e76c763fa428,-32.94,151.76,NSW,The Junction,debit,authorized,8e36192eb7df49e38d130e4bd9909043,SALES-POS,30-40,2018,9,1,11,6,Saturday,14 days,60190.325
ACC-90814749,35,44.0,8975.95,,CUS-1896554896,2018-09-01,Christopher,M,-32.98,151.68,,,,,,,debit,posted,1d8b2962c87e45ddbc240557e37a80eb,INTER BANK,30-40,2018,9,1,13,0,Saturday,14 days,60190.325
ACC-90814749,35,26.03,8949.92,1.0,CUS-1896554896,2018-09-01,Christopher,M,-32.98,151.68,,a67930fa-c3e4-4d0a-99ca-fce0c8391dbf,-27.44,151.72,QLD,Oakey,debit,authorized,56f264846c1e41af84eb12bb7ee8458f,SALES-POS,30-40,2018,9,1,15,49,Saturday,14 days,60190.325
ACC-90814749,35,38.97,8910.95,1.0,CUS-1896554896,2018-09-01,Christopher,M,-32.98,151.68,,3d429f5a-6a5b-482b-9c30-5357af5b569f,-33.03,137.57,SA,Whyalla,debit,authorized,f48bd40b6ec040c885de3b0c07240aa8,SALES-POS,30-40,2018,9,1,20,54,Saturday,14 days,60190.325
ACC-90814749,35,35.03,8875.92,1.0,CUS-1896554896,2018-09-02,Christopher,M,-32.98,151.68,,a40690d5-f670-49ad-87e0-4ebd4d901364,-32.93,117.18,WA,Narrogin,debit,authorized,125ac8bc64bf4ec69bddaa0b810ae1fe,POS,30-40,2018,9,2,19,14,Sunday,14 days,60190.325
ACC-90814749,35,36.99,8838.93,0.0,CUS-1896554896,2018-09-02,Christopher,M,-32.98,151.68,,3d429f5a-6a5b-482b-9c30-5357af5b569f,-33.03,137.57,SA,Whyalla,debit,authorized,19250c7c35bf42229e3028c2f2f614c5,SALES-POS,30-40,2018,9,2,21,29,Sunday,14 days,60190.325
ACC-90814749,35,110.0,8728.93,,CUS-1896554896,2018-09-03,Christopher,M,-32.98,151.68,,,,,,,debit,posted,73e611a7af1345c581ea14921ac677fd,INTER BANK,30-40,2018,9,3,7,0,Monday,14 days,60190.325
ACC-90814749,35,14.8,8714.13,1.0,CUS-1896554896,2018-09-04,Christopher,M,-32.98,151.68,,b40a8a1f-4bb7-4c05-8029-e7c68eb04fcb,-33.03,137.57,SA,Whyalla Playford,debit,authorized,fdfe7cefdc914866b047eb9014a5ef2b,POS,30-40,2018,9,4,20,36,Tuesday,14 days,60190.325
ACC-90814749,35,38.75,8675.38,1.0,CUS-1896554896,2018-09-05,Christopher,M,-32.98,151.68,,14f8c748-af9a-4332-8c45-6f39f4912968,-27.45,151.72,QLD,Oakey,debit,authorized,ddf8d7348c5e42898039fdf7ac6bf80a,SALES-POS,30-40,2018,9,5,2,26,Wednesday,14 days,60190.325
ACC-90814749,35,7.0,8668.38,1.0,CUS-1896554896,2018-09-05,Christopher,M,-32.98,151.68,,2c95dafb-898a-4fef-8cb9-97ba6a15116b,-33.01,151.6,NSW,Toronto,debit,authorized,bf05ea6763a34981b76d912ba5da3249,SALES-POS,30-40,2018,9,5,9,12,Wednesday,14 days,60190.325
ACC-90814749,35,33.93,8634.45,1.0,CUS-1896554896,2018-09-05,Christopher,M,-32.98,151.68,,ed0e3543-a273-4f45-a305-4f33f25e457d,-32.97,151.64,NSW,Warners Bay,debit,authorized,9bc5d34630e741ca839b67c84c8273e2,SALES-POS,30-40,2018,9,5,21,6,Wednesday,14 days,60190.325
ACC-90814749,35,34.67,8599.78,0.0,CUS-1896554896,2018-09-05,Christopher,M,-32.98,151.68,,d8843cbf-95eb-4bf7-b5e1-bcbfe3b02c22,-33.03,137.54,SA,Whyalla Norrie,debit,authorized,06265963baa24b09a77c98cf21256dcb,SALES-POS,30-40,2018,9,5,21,28,Wednesday,14 days,60190.325
ACC-90814749,35,17.69,8582.09,1.0,CUS-1896554896,2018-09-06,Christopher,M,-32.98,151.68,,b059aa9e-10ab-46ce-9c18-5769a9020d0b,-32.94,117.18,WA,Narrogin,debit,authorized,08de83e35cff4465b61c0cc1fc41754a,SALES-POS,30-40,2018,9,6,9,14,Thursday,14 days,60190.325
ACC-90814749,35,15.71,8566.38,1.0,CUS-1896554896,2018-09-06,Christopher,M,-32.98,151.68,,b40a8a1f-4bb7-4c05-8029-e7c68eb04fcb,-33.03,137.57,SA,Whyalla Playford,debit,authorized,64b4b0d3ce9846c7ab359baafb532b8b,SALES-POS,30-40,2018,9,6,11,6,Thursday,14 days,60190.325
ACC-90814749,35,26.71,8539.67,1.0,CUS-1896554896,2018-09-06,Christopher,M,-32.98,151.68,,0d0bb99b-1c7d-468c-b0af-56a86e7bf47a,-32.93,117.18,WA,Narrogin,debit,authorized,1808a77b393f4074ac19b6d0d6478e14,POS,30-40,2018,9,6,17,49,Thursday,14 days,60190.325
ACC-90814749,35,36.0,8503.67,,CUS-1896554896,2018-09-06,Christopher,M,-32.98,151.68,,,,,,,debit,posted,ca5c650160674403ac49237ebcc65129,PAYMENT,30-40,2018,9,6,22,0,Thursday,14 days,60190.325
ACC-90814749,35,15.73,8487.94,1.0,CUS-1896554896,2018-09-07,Christopher,M,-32.98,151.68,,578abd32-896d-4677-9738-69306f8d3caa,-37.82,145.08,VIC,Canterbury,debit,authorized,6bc4920e78554a7ca711475271a1116a,SALES-POS,30-40,2018,9,7,12,41,Friday,14 days,60190.325
ACC-90814749,35,11.21,10785.4,0.0,CUS-1896554896,2018-09-08,Christopher,M,-32.98,151.68,,910d238b-70e0-4ea3-914b-b83c39b44c9f,-30.51,151.68,NSW,Armidale,debit,authorized,e3811736c523461785d2197547f3d3dc,POS,30-40,2018,9,8,7,34,Saturday,14 days,60190.325
ACC-90814749,35,173.24,10612.16,1.0,CUS-1896554896,2018-09-08,Christopher,M,-32.98,151.68,,1c35dc92-8eb1-4f35-8ea4-5a013fa77f88,-33.86,151.2,NSW,Barangaroo,debit,authorized,65dea3f65507423d905e88058d627b55,POS,30-40,2018,9,8,9,51,Saturday,14 days,60190.325
ACC-90814749,35,44.0,10568.16,,CUS-1896554896,2018-09-08,Christopher,M,-32.98,151.68,,,,,,,debit,posted,8aa9015817e047fe8db0e1ad029d555c,INTER BANK,30-40,2018,9,8,13,0,Saturday,14 days,60190.325
ACC-90814749,35,102.27,10465.89,1.0,CUS-1896554896,2018-09-08,Christopher,M,-32.98,151.68,,1b946c71-30b4-4644-92da-bd0d92bf2909,-32.94,117.18,WA,Narrogin,debit,authorized,f89153773f0a42a3a02d06a8cab8fa8d,POS,30-40,2018,9,8,20,47,Saturday,14 days,60190.325
ACC-90814749,35,27.9,10437.99,1.0,CUS-1896554896,2018-09-09,Christopher,M,-32.98,151.68,,d088a060-511c-4bb9-8a16-9f5e37689919,-33.04,137.57,SA,Whyalla,debit,authorized,2d0c96f695554b26996e64450529db59,SALES-POS,30-40,2018,9,9,4,50,Sunday,14 days,60190.325
ACC-90814749,35,43.8,10394.19,1.0,CUS-1896554896,2018-09-09,Christopher,M,-32.98,151.68,,f3cb8108-19a2-4ac9-9960-63cfe244ddf4,-32.81,151.66,NSW,Tarro,debit,authorized,96d96dedb79d48f98fae418e0aa772a5,SALES-POS,30-40,2018,9,9,9,35,Sunday,14 days,60190.325
ACC-90814749,35,45.28,10348.91,0.0,CUS-1896554896,2018-09-10,Christopher,M,-32.98,151.68,,fcdb2a11-0335-4aab-92d6-cd9f62edafd1,-30.51,151.67,NSW,Armidale,debit,authorized,fce435efe12745608ce6134d4caba271,SALES-POS,30-40,2018,9,10,8,10,Monday,14 days,60190.325
ACC-90814749,35,37.93,10310.98,1.0,CUS-1896554896,2018-09-10,Christopher,M,-32.98,151.68,,3d429f5a-6a5b-482b-9c30-5357af5b569f,-33.03,137.57,SA,Whyalla,debit,authorized,85b4e1640cb349dead8212d9ca3366fb,POS,30-40,2018,9,10,9,57,Monday,14 days,60190.325
ACC-90814749,35,32.82,10278.16,1.0,CUS-1896554896,2018-09-11,Christopher,M,-32.98,151.68,,1e16b2d4-5c0a-4c97-b8f4-c43b8d95fe08,-30.51,151.66,NSW,Armidale,debit,authorized,f34e223633ce44ea935994bb74ed813a,SALES-POS,30-40,2018,9,11,8,15,Tuesday,14 days,60190.325
ACC-90814749,35,57.63,10220.53,1.0,CUS-1896554896,2018-09-11,Christopher,M,-32.98,151.68,,cc64c86b-30e3-4bed-ac9b-a1faa39946b2,-32.94,117.18,WA,Narrogin,debit,authorized,26b163f3e83d40dc8ff33969186b3afb,POS,30-40,2018,9,11,10,41,Tuesday,14 days,60190.325
ACC-90814749,35,66.52,10154.01,1.0,CUS-1896554896,2018-09-11,Christopher,M,-32.98,151.68,,eb93860b-42d6-4afd-8c0b-74fb08a1336f,-32.92,151.75,NSW,Hamilton,debit,authorized,4f3f1151e1e844a3ac5610f504c78e81,POS,30-40,2018,9,11,15,11,Tuesday,14 days,60190.325
ACC-90814749,35,36.0,10118.01,,CUS-1896554896,2018-09-13,Christopher,M,-32.98,151.68,,,,,,,debit,posted,abdae1cecb484fbaa76f7f419ca99eec,PAYMENT,30-40,2018,9,13,22,0,Thursday,14 days,60190.325
ACC-90814749,35,44.0,10074.01,,CUS-1896554896,2018-09-15,Christopher,M,-32.98,151.68,,,,,,,debit,posted,5df3f590311e41619f07d1c025ecb5b6,INTER BANK,30-40,2018,9,15,13,0,Saturday,14 days,60190.325
ACC-90814749,35,57.06,10016.95,0.0,CUS-1896554896,2018-09-15,Christopher,M,-32.98,151.68,,d5dd999e-95ce-436f-a70b-a259910ef210,-32.92,151.75,NSW,Hamilton,debit,authorized,ab277b77e5604237bbf10895ed3e879c,SALES-POS,30-40,2018,9,15,22,59,Saturday,14 days,60190.325
ACC-90814749,35,26.19,9990.76,1.0,CUS-1896554896,2018-09-15,Christopher,M,-32.98,151.68,,f44f53d8-9425-41e5-a6d3-4d0127f47d9c,-32.94,151.71,NSW,Kotara,debit,authorized,35530ce3721142f480c8c37b61da904a,POS,30-40,2018,9,15,23,53,Saturday,14 days,60190.325
ACC-90814749,35,102.56,9888.2,1.0,CUS-1896554896,2018-09-16,Christopher,M,-32.98,151.68,,1b946c71-30b4-4644-92da-bd0d92bf2909,-32.94,117.18,WA,Narrogin,debit,authorized,c1d5d769b96f46e59bb9a8dda2dd9a6b,POS,30-40,2018,9,16,9,41,Sunday,14 days,60190.325
ACC-90814749,35,13.72,9874.48,1.0,CUS-1896554896,2018-09-19,Christopher,M,-32.98,151.68,,018eef24-15d1-480b-82c7-616d1588ccdd,-32.94,117.18,WA,Narrogin,debit,authorized,caa377618b034dec8a6eda31c73a7d2d,SALES-POS,30-40,2018,9,19,8,37,Wednesday,14 days,60190.325
ACC-90814749,35,9.3,9865.18,1.0,CUS-1896554896,2018-09-19,Christopher,M,-32.98,151.68,,e1a66027-c32d-4496-8893-09133188b1ec,-32.94,151.71,NSW,Kotara,debit,authorized,2ff30eae601f4691be31a86d867e2d25,SALES-POS,30-40,2018,9,19,9,17,Wednesday,14 days,60190.325
ACC-90814749,35,58.5,9806.68,1.0,CUS-1896554896,2018-09-19,Christopher,M,-32.98,151.68,,cc64c86b-30e3-4bed-ac9b-a1faa39946b2,-32.94,117.18,WA,Narrogin,debit,authorized,cb98c31823044d76897ce089d69254f2,SALES-POS,30-40,2018,9,19,11,27,Wednesday,14 days,60190.325
ACC-90814749,35,25.28,9781.4,1.0,CUS-1896554896,2018-09-20,Christopher,M,-32.98,151.68,,457d85df-5803-40b8-92fb-8e3645141de7,-32.92,151.75,NSW,Hamilton,debit,authorized,fa25ac6e8a4244beb75461b8a82e82ea,POS,30-40,2018,9,20,8,17,Thursday,14 days,60190.325
ACC-90814749,35,84.05,9697.35,1.0,CUS-1896554896,2018-09-20,Christopher,M,-32.98,151.68,,39057114-0e63-476e-9877-dea209de407d,-32.92,147.71,NSW,Trundle,debit,authorized,cdb13d05e286440bbd01247b94ae4182,SALES-POS,30-40,2018,9,20,9,13,Thursday,14 days,60190.325
ACC-90814749,35,34.15,9663.2,1.0,CUS-1896554896,2018-09-20,Christopher,M,-32.98,151.68,,d8843cbf-95eb-4bf7-b5e1-bcbfe3b02c22,-33.03,137.54,SA,Whyalla Norrie,debit,authorized,351ae6a20534488d88e50bda00156e29,SALES-POS,30-40,2018,9,20,13,59,Thursday,14 days,60190.325
ACC-90814749,35,84.67,9578.53,0.0,CUS-1896554896,2018-09-20,Christopher,M,-32.98,151.68,,39057114-0e63-476e-9877-dea209de407d,-32.92,147.71,NSW,Trundle,debit,authorized,16ed759f23ae4fff91b24708e17bccbe,SALES-POS,30-40,2018,9,20,15,35,Thursday,14 days,60190.325
ACC-90814749,35,21.92,9556.61,1.0,CUS-1896554896,2018-09-20,Christopher,M,-32.98,151.68,,4ecb3f5e-07f3-4865-8db4-ec2fa99e8454,-29.74,151.74,NSW,Glen Innes,debit,authorized,82bbf0a527a54595a913a985d6e6ca45,POS,30-40,2018,9,20,15,42,Thursday,14 days,60190.325
ACC-90814749,35,36.0,9520.61,,CUS-1896554896,2018-09-20,Christopher,M,-32.98,151.68,,,,,,,debit,posted,25d3d76111204098ac548bce9f5c322a,PAYMENT,30-40,2018,9,20,22,0,Thursday,14 days,60190.325
ACC-90814749,35,44.0,11785.28,,CUS-1896554896,2018-09-22,Christopher,M,-32.98,151.68,,,,,,,debit,posted,ccb9e9586fdf4b469bfa8aac1d3c6190,INTER BANK,30-40,2018,9,22,13,0,Saturday,14 days,60190.325
ACC-90814749,35,1916.0,9869.28,,CUS-1896554896,2018-09-22,Christopher,M,-32.98,151.68,,,,,,,debit,posted,bdfaa9e29ccd4a2ea3209e1056a5e1dd,PHONE BANK,30-40,2018,9,22,23,0,Saturday,14 days,60190.325
ACC-90814749,35,17.78,9851.5,0.0,CUS-1896554896,2018-09-27,Christopher,M,-32.98,151.68,,41d52afd-3bd3-4d29-bc43-93df414b0f1f,-32.85,151.69,NSW,Hexham,debit,authorized,179d1bac63584dbb8d61c258d5698b52,POS,30-40,2018,9,27,11,32,Thursday,14 days,60190.325
ACC-90814749,35,60.47,9791.03,0.0,CUS-1896554896,2018-09-27,Christopher,M,-32.98,151.68,,cc64c86b-30e3-4bed-ac9b-a1faa39946b2,-32.94,117.18,WA,Narrogin,debit,authorized,721c2780d08449b59d6ebca26e66d318,SALES-POS,30-40,2018,9,27,16,3,Thursday,14 days,60190.325
ACC-90814749,35,36.0,9755.03,,CUS-1896554896,2018-09-27,Christopher,M,-32.98,151.68,,,,,,,debit,posted,a544be73964b4f48b608a6ae2db451ba,PAYMENT,30-40,2018,9,27,22,0,Thursday,14 days,60190.325
ACC-90814749,35,133.0,9622.03,,CUS-1896554896,2018-09-28,Christopher,M,-32.98,151.68,,,,,,,debit,posted,d6c6a65ec5f948a2b392721bca8a1a05,PAYMENT,30-40,2018,9,28,20,0,Friday,14 days,60190.325
ACC-90814749,35,44.0,9578.03,,CUS-1896554896,2018-09-29,Christopher,M,-32.98,151.68,,,,,,,debit,posted,7fccef75b855493bbb1bcda8e0f4fe3a,INTER BANK,30-40,2018,9,29,13,0,Saturday,14 days,60190.325
ACC-90814749,35,110.0,9468.03,,CUS-1896554896,2018-10-03,Christopher,M,-32.98,151.68,,,,,,,debit,posted,c9085a0413a8465f9cd014f14723f631,INTER BANK,30-40,2018,10,3,7,0,Wednesday,14 days,60190.325
ACC-90814749,35,36.0,9432.03,,CUS-1896554896,2018-10-04,Christopher,M,-32.98,151.68,,,,,,,debit,posted,3ec238c177a447629719334715284bec,PAYMENT,30-40,2018,10,4,22,0,Thursday,14 days,60190.325
ACC-90814749,35,44.0,11696.7,,CUS-1896554896,2018-10-06,Christopher,M,-32.98,151.68,,,,,,,debit,posted,a67ad8f1e7a745929b2a3200896bfe04,INTER BANK,30-40,2018,10,6,13,0,Saturday,14 days,60190.325
ACC-90814749,35,36.05,11660.65,1.0,CUS-1896554896,2018-10-11,Christopher,M,-32.98,151.68,,3b4cef6e-7b92-41cb-92cb-2602d25486b6,-37.82,145.03,VIC,Hawthorn,debit,authorized,7ece4d68c61141909b2b144da6aa8b7a,POS,30-40,2018,10,11,10,47,Thursday,14 days,60190.325
ACC-90814749,35,38.67,11621.98,1.0,CUS-1896554896,2018-10-11,Christopher,M,-32.98,151.68,,9aa64420-35ca-4e9f-b4c1-da5ab79e4894,-30.51,151.67,NSW,Armidale,debit,authorized,b0315d69acba497a8338f36c00e0a562,SALES-POS,30-40,2018,10,11,13,6,Thursday,14 days,60190.325
ACC-90814749,35,36.0,11585.98,,CUS-1896554896,2018-10-11,Christopher,M,-32.98,151.68,,,,,,,debit,posted,46af2a5b1063475492ec07719ac4e790,PAYMENT,30-40,2018,10,11,22,0,Thursday,14 days,60190.325
ACC-90814749,35,44.0,11541.98,,CUS-1896554896,2018-10-13,Christopher,M,-32.98,151.68,,,,,,,debit,posted,0b3424f80f5045da938f5639f34c38fb,INTER BANK,30-40,2018,10,13,13,0,Saturday,14 days,60190.325
ACC-90814749,35,58.08,11483.9,1.0,CUS-1896554896,2018-10-14,Christopher,M,-32.98,151.68,,d5dd999e-95ce-436f-a70b-a259910ef210,-32.92,151.75,NSW,Hamilton,debit,authorized,1131a9886eb44e85bbbaf3dec4cbeb8a,POS,30-40,2018,10,14,9,6,Sunday,14 days,60190.325
ACC-90814749,35,65.69,11418.21,1.0,CUS-1896554896,2018-10-14,Christopher,M,-32.98,151.68,,eb93860b-42d6-4afd-8c0b-74fb08a1336f,-32.92,151.75,NSW,Hamilton,debit,authorized,2ff219ba2f884f75b002168c870e3c33,POS,30-40,2018,10,14,23,40,Sunday,14 days,60190.325
ACC-90814749,35,18.41,11399.8,1.0,CUS-1896554896,2018-10-15,Christopher,M,-32.98,151.68,,7e90d0c6-eacb-405e-97bc-c0bcbe562c3f,-33.01,115.74,WA,Myalup,debit,authorized,d509cd1bd7654fa4a27c948c2c720bf0,POS,30-40,2018,10,15,10,4,Monday,14 days,60190.325
ACC-90814749,35,35.88,11363.92,1.0,CUS-1896554896,2018-10-15,Christopher,M,-32.98,151.68,,d8843cbf-95eb-4bf7-b5e1-bcbfe3b02c22,-33.03,137.54,SA,Whyalla Norrie,debit,authorized,37001cc3de9f45f79f79e68f4f1fea0a,SALES-POS,30-40,2018,10,15,14,10,Monday,14 days,60190.325
ACC-90814749,35,95.6,11268.32,1.0,CUS-1896554896,2018-10-15,Christopher,M,-32.98,151.68,,c05793a8-011a-4cee-bb28-54127559c420,-33.87,151.21,NSW,Sydney,debit,authorized,09c23741b47d42d78e2e4a60b04eb4a3,POS,30-40,2018,10,15,17,4,Monday,14 days,60190.325
ACC-90814749,35,33.79,11234.53,1.0,CUS-1896554896,2018-10-17,Christopher,M,-32.98,151.68,,c1c50ba6-c044-45ec-ba4e-55d9d566a6b6,-32.93,151.78,NSW,Newcastle,debit,authorized,b7b05c4bd1b448a7bd2a36444c56ab96,SALES-POS,30-40,2018,10,17,11,36,Wednesday,14 days,60190.325
ACC-90814749,35,36.0,11198.53,,CUS-1896554896,2018-10-18,Christopher,M,-32.98,151.68,,,,,,,debit,posted,74f0a778b0514a1398f35c66e3dc145e,PAYMENT,30-40,2018,10,18,22,0,Thursday,14 days,60190.325
ACC-90814749,35,149.17,11049.36,1.0,CUS-1896554896,2018-10-19,Christopher,M,-32.98,151.68,,df6d8273-44fb-479a-a2d0-091d6a7d300c,-32.93,151.78,NSW,Newcastle,debit,authorized,49bd5832bc2647f796d163e33aa9ac58,POS,30-40,2018,10,19,9,42,Friday,14 days,60190.325
ACC-90814749,35,30.14,11019.22,1.0,CUS-1896554896,2018-10-19,Christopher,M,-32.98,151.68,,48f2e156-4769-4b86-8372-f1e7900aba0f,-33.03,137.53,SA,Whyalla Norrie,debit,authorized,1a5f59bf3b34403a8c9f8d32e4b2b972,SALES-POS,30-40,2018,10,19,10,57,Friday,14 days,60190.325
ACC-90814749,35,16.15,11003.07,1.0,CUS-1896554896,2018-10-19,Christopher,M,-32.98,151.68,,e90a5311-1a4f-48ca-a08e-e61e144faf3e,-32.97,151.66,NSW,Warners Bay,debit,authorized,b9351919b6524db3a6cb825f7d3bc0a6,POS,30-40,2018,10,19,11,24,Friday,14 days,60190.325
ACC-90814749,35,58.8,10944.27,0.0,CUS-1896554896,2018-10-19,Christopher,M,-32.98,151.68,,cc64c86b-30e3-4bed-ac9b-a1faa39946b2,-32.94,117.18,WA,Narrogin,debit,authorized,0eb6cac2c3454c4fb6a9d503de01de07,POS,30-40,2018,10,19,14,3,Friday,14 days,60190.325
ACC-90814749,35,34.26,10910.01,1.0,CUS-1896554896,2018-10-19,Christopher,M,-32.98,151.68,,b0904b8b-80cf-40f0-a208-d190f5e565a1,-33.02,137.54,SA,Whyalla Norrie,debit,authorized,05efb45a736044ffa7f2c0ad49d35def,POS,30-40,2018,10,19,15,8,Friday,14 days,60190.325
ACC-90814749,35,19.03,13199.65,1.0,CUS-1896554896,2018-10-20,Christopher,M,-32.98,151.68,,ed717c5e-9a81-4005-a370-36a30f2b59d8,-33.01,151.59,NSW,Toronto,debit,authorized,2965a807b20c4e4fb253251c7f4658c6,POS,30-40,2018,10,20,1,42,Saturday,14 days,60190.325
ACC-90814749,35,44.0,13155.65,,CUS-1896554896,2018-10-20,Christopher,M,-32.98,151.68,,,,,,,debit,posted,629a18b68d7947d2ac02e0bfd7d47ce6,INTER BANK,30-40,2018,10,20,13,0,Saturday,14 days,60190.325
ACC-90814749,35,35.06,13120.59,1.0,CUS-1896554896,2018-10-21,Christopher,M,-32.98,151.68,,a038df8c-bade-40e9-b864-9371758a8745,-33.87,151.2,NSW,Pyrmont,debit,authorized,7821f46e93ae47d4bb735f34d3e6fcaf,POS,30-40,2018,10,21,11,48,Sunday,14 days,60190.325
ACC-90814749,35,15.26,13105.33,1.0,CUS-1896554896,2018-10-21,Christopher,M,-32.98,151.68,,018eef24-15d1-480b-82c7-616d1588ccdd,-32.94,117.18,WA,Narrogin,debit,authorized,009c3c7fd967422eab9fbbccec63faea,SALES-POS,30-40,2018,10,21,17,25,Sunday,14 days,60190.325
ACC-90814749,35,15.48,13089.85,1.0,CUS-1896554896,2018-10-24,Christopher,M,-32.98,151.68,,45bc960b-329f-4f2f-bb8b-ed8cc90699e1,-32.93,151.77,NSW,Newcastle,debit,authorized,c6118dc823e64adcb7248caf16411041,POS,30-40,2018,10,24,8,42,Wednesday,14 days,60190.325
ACC-90814749,35,36.0,13053.85,,CUS-1896554896,2018-10-25,Christopher,M,-32.98,151.68,,,,,,,debit,posted,b5b02b46774144358aa6240c4e660309,PAYMENT,30-40,2018,10,25,22,0,Thursday,14 days,60190.325
ACC-90814749,35,44.0,13009.85,,CUS-1896554896,2018-10-27,Christopher,M,-32.98,151.68,,,,,,,debit,posted,02edff8a695c4612821b11f2dc371370,INTER BANK,30-40,2018,10,27,13,0,Saturday,14 days,60190.325
ACC-90814749,35,133.0,12876.85,,CUS-1896554896,2018-10-28,Christopher,M,-32.98,151.68,,,,,,,debit,posted,2fcc2d376bb848c2a9140e575bb2eab2,PAYMENT,30-40,2018,10,28,20,0,Sunday,14 days,60190.325
ACC-1349834573,39,48.0,7046.77,,CUS-1790886359,2018-08-01,Matthew,M,-37.84,145.17,,,,,,,debit,posted,29e8473f761e49a4a9c0a03b6542afec,PAYMENT,30-40,2018,8,1,19,0,Wednesday,14 days,80069.007
ACC-1349834573,39,32.0,7014.77,,CUS-1790886359,2018-08-01,Matthew,M,-37.84,145.17,,,,,,,debit,posted,5fdab046bfbb404386499d6aa7e02228,PAYMENT,30-40,2018,8,1,23,0,Wednesday,14 days,80069.007
ACC-1349834573,39,60.0,6954.77,,CUS-1790886359,2018-08-02,Matthew,M,-37.84,145.17,,,,,,,debit,posted,2251fa91e42948c196564d4974c407a1,PAYMENT,30-40,2018,8,2,14,0,Thursday,14 days,80069.007
ACC-1349834573,39,74.96,6879.81,1.0,CUS-1790886359,2018-08-02,Matthew,M,-37.84,145.17,,c59880e5-1079-43e2-8243-1fcd746ff6fc,-37.87,144.72,VIC,Hoppers Crossing,debit,authorized,b8edec9cb20d4e4db1c9c98bf7f9a71b,SALES-POS,30-40,2018,8,2,22,17,Thursday,14 days,80069.007
ACC-1349834573,39,51.89,6827.92,1.0,CUS-1790886359,2018-08-03,Matthew,M,-37.84,145.17,,a947dd7e-b2f9-41be-a4cc-4bdf693ec1c2,-37.93,145.12,VIC,Clayton,debit,authorized,ccbc1e0dbe6a4cfda1f6461134981dda,SALES-POS,30-40,2018,8,3,12,15,Friday,14 days,80069.007
ACC-1349834573,39,45.13,6782.79,0.0,CUS-1790886359,2018-08-04,Matthew,M,-37.84,145.17,,e288a819-9b84-424f-b17c-e4e4869472b4,-37.83,140.78,SA,Mount Gambier,debit,authorized,659020e8a1774685aa3aaadfea6db06f,SALES-POS,30-40,2018,8,4,23,14,Saturday,14 days,80069.007
ACC-1349834573,39,167.0,6615.79,,CUS-1790886359,2018-08-05,Matthew,M,-37.84,145.17,,,,,,,debit,posted,0b8fad3a84254a449f92bb61cdb5e7ee,PAYMENT,30-40,2018,8,5,2,0,Sunday,14 days,80069.007
ACC-1349834573,39,33.0,6582.79,,CUS-1790886359,2018-08-06,Matthew,M,-37.84,145.17,,,,,,,debit,posted,b00cf121610549c883f4d7cc77434920,INTER BANK,30-40,2018,8,6,3,0,Monday,14 days,80069.007
ACC-1349834573,39,34.0,6548.79,,CUS-1790886359,2018-08-07,Matthew,M,-37.84,145.17,,,,,,,debit,posted,924b58c05cb94f8386a164dea6212b85,PAYMENT,30-40,2018,8,7,20,0,Tuesday,14 days,80069.007
ACC-1349834573,39,48.0,6500.79,,CUS-1790886359,2018-08-08,Matthew,M,-37.84,145.17,,,,,,,debit,posted,6c967ddd3b1046c6a4bc39d838c031f8,PAYMENT,30-40,2018,8,8,19,0,Wednesday,14 days,80069.007
ACC-1349834573,39,21.52,6479.27,1.0,CUS-1790886359,2018-08-08,Matthew,M,-37.84,145.17,,2fc63504-5462-4673-8cf1-2614feb94cc4,-37.78,145.13,VIC,Doncaster,debit,authorized,b5cd0d2e5f34405abdaa3253d5312ae2,SALES-POS,30-40,2018,8,8,20,27,Wednesday,14 days,80069.007
ACC-1349834573,39,32.0,6447.27,,CUS-1790886359,2018-08-08,Matthew,M,-37.84,145.17,,,,,,,debit,posted,f752aa6c5bf34a79ae7d1fb453f48fa3,PAYMENT,30-40,2018,8,8,23,0,Wednesday,14 days,80069.007
ACC-1349834573,39,15.26,6432.01,1.0,CUS-1790886359,2018-08-09,Matthew,M,-37.84,145.17,,4be6a60b-6f12-4d9d-9bc1-3fa5b0bfc5d3,-37.76,145,VIC,Thornbury,debit,authorized,19530e0c6d7a42bfabd6bd5339621505,POS,30-40,2018,8,9,8,51,Thursday,14 days,80069.007
ACC-1349834573,39,60.0,6372.01,,CUS-1790886359,2018-08-09,Matthew,M,-37.84,145.17,,,,,,,debit,posted,261fdfba81b94b4bb5d9be39e0b2a450,PAYMENT,30-40,2018,8,9,14,0,Thursday,14 days,80069.007
ACC-1349834573,39,14.31,6357.7,1.0,CUS-1790886359,2018-08-09,Matthew,M,-37.84,145.17,,63721c0d-ef24-4c23-98d0-722561c938ac,-37.78,144.89,VIC,Maribyrnong,debit,authorized,35c5ae9b03514e658bc30540cee7545a,SALES-POS,30-40,2018,8,9,17,41,Thursday,14 days,80069.007
ACC-1349834573,39,19.3,6338.4,1.0,CUS-1790886359,2018-08-10,Matthew,M,-37.84,145.17,,b53bc667-bb5c-4901-9955-3c4401cc6c7c,-37.84,147.6,VIC,Bairnsdale,debit,authorized,b3c0c7e7a0f54071a88a7b96f9bfce62,SALES-POS,30-40,2018,8,10,0,43,Friday,14 days,80069.007
ACC-1349834573,39,16.44,6321.96,1.0,CUS-1790886359,2018-08-10,Matthew,M,-37.84,145.17,,8de53634-b8a5-4b4a-bbd8-0a79eab20e87,-37.83,144.95,VIC,South Wharf,debit,authorized,27a02982a20049d6a166ff545f3895b5,POS,30-40,2018,8,10,9,22,Friday,14 days,80069.007
ACC-1349834573,39,150.0,6171.96,,CUS-1790886359,2018-08-11,Matthew,M,-37.84,145.17,,,,,,,debit,posted,f7f62400164844cc8374e2070f2ab6ce,PAYMENT,30-40,2018,8,11,13,0,Saturday,14 days,80069.007
ACC-1349834573,39,33.0,6138.96,,CUS-1790886359,2018-08-13,Matthew,M,-37.84,145.17,,,,,,,debit,posted,0a7565dab7984d708fefbe2a58125127,INTER BANK,30-40,2018,8,13,3,0,Monday,14 days,80069.007
ACC-1349834573,39,31.15,6107.81,0.0,CUS-1790886359,2018-08-14,Matthew,M,-37.84,145.17,,583b5c19-f8a4-4559-bfbd-81bc6264759c,-37.85,144.87,VIC,Newport,debit,authorized,17bcc2610ec94967b65aeff5ab4ebcbf,POS,30-40,2018,8,14,9,35,Tuesday,14 days,80069.007
ACC-1349834573,39,34.0,6073.81,,CUS-1790886359,2018-08-14,Matthew,M,-37.84,145.17,,,,,,,debit,posted,0f442ce72f59462eb0f290002accc232,PAYMENT,30-40,2018,8,14,20,0,Tuesday,14 days,80069.007
ACC-1349834573,39,179.66,5894.15,1.0,CUS-1790886359,2018-08-14,Matthew,M,-37.84,145.17,,0b8fab23-d4fd-45e7-acac-555c96e0b1c7,-33.87,151.2,NSW,Sydney,debit,authorized,ddc576820e3c4bb5af0f4c4fd16e8bc3,SALES-POS,30-40,2018,8,14,22,47,Tuesday,14 days,80069.007
ACC-1349834573,39,48.0,8917.29,,CUS-1790886359,2018-08-15,Matthew,M,-37.84,145.17,,,,,,,debit,posted,294dab45a60e438597fdd28fa11e793c,PAYMENT,30-40,2018,8,15,19,0,Wednesday,14 days,80069.007
ACC-1349834573,39,32.0,8885.29,,CUS-1790886359,2018-08-15,Matthew,M,-37.84,145.17,,,,,,,debit,posted,20a1f3901f7f4e8cbe1a024e5ecc40b6,PAYMENT,30-40,2018,8,15,23,0,Wednesday,14 days,80069.007
ACC-1349834573,39,33.0,8449.74,,CUS-1790886359,2018-08-20,Matthew,M,-37.84,145.17,,,,,,,debit,posted,e29b670f58e64a79b05a6567ff900bd2,INTER BANK,30-40,2018,8,20,3,0,Monday,14 days,80069.007
ACC-1349834573,39,53.39,8396.35,1.0,CUS-1790886359,2018-08-20,Matthew,M,-37.84,145.17,,e98b306d-8324-4b40-a038-457546bb99bc,-37.83,147.63,VIC,Bairnsdale,debit,authorized,ed8079ba1d634dfaa57404ca5e05e682,POS,30-40,2018,8,20,9,49,Monday,14 days,80069.007
ACC-1349834573,39,34.0,8362.35,,CUS-1790886359,2018-08-21,Matthew,M,-37.84,145.17,,,,,,,debit,posted,0b8906b57cf64a5496b064c1891d0396,PAYMENT,30-40,2018,8,21,20,0,Tuesday,14 days,80069.007
ACC-1349834573,39,48.0,8314.35,,CUS-1790886359,2018-08-22,Matthew,M,-37.84,145.17,,,,,,,debit,posted,17cac465d56c46adb8a6315238cef739,PAYMENT,30-40,2018,8,22,19,0,Wednesday,14 days,80069.007
ACC-1349834573,39,32.0,8282.35,,CUS-1790886359,2018-08-22,Matthew,M,-37.84,145.17,,,,,,,debit,posted,2f54f5fcddc147ecafb543e3140b26ee,PAYMENT,30-40,2018,8,22,23,0,Wednesday,14 days,80069.007
ACC-1349834573,39,34.94,8247.41,0.0,CUS-1790886359,2018-08-23,Matthew,M,-37.84,145.17,,e54ca4cf-2c21-4b2c-86f1-1ad5dcd943e1,-37.9,145.09,VIC,Oakleigh,debit,authorized,52d47fb956d346b488548b5e9f479937,POS,30-40,2018,8,23,1,45,Thursday,14 days,80069.007
ACC-1349834573,39,60.0,8121.28,,CUS-1790886359,2018-08-23,Matthew,M,-37.84,145.17,,,,,,,debit,posted,6337be8db5cf4209bbb3c57db6d553f5,PAYMENT,30-40,2018,8,23,14,0,Thursday,14 days,80069.007
ACC-1349834573,39,66.13,8181.28,1.0,CUS-1790886359,2018-08-23,Matthew,M,-37.84,145.17,,dc72ced4-7989-42cc-b650-46c249793433,-37.83,145.06,VIC,Camberwell,debit,authorized,76dcbe84a7984dd29ec721bf6abb90ad,POS,30-40,2018,8,23,14,52,Thursday,14 days,80069.007
ACC-1349834573,39,253.06,7868.22,1.0,CUS-1790886359,2018-08-23,Matthew,M,-37.84,145.17,,3794505f-1ad4-4b8e-9dd1-866311c34481,-37.84,140.78,SA,Mount Gambier,debit,authorized,4ec16ddcd3bc4fe0b00c34ebdaf1b7a3,SALES-POS,30-40,2018,8,23,15,21,Thursday,14 days,80069.007
ACC-1349834573,39,33.0,7835.22,,CUS-1790886359,2018-08-27,Matthew,M,-37.84,145.17,,,,,,,debit,posted,c3d35b1345ab45a69b8ff749fbc1ab37,INTER BANK,30-40,2018,8,27,3,0,Monday,14 days,80069.007
ACC-1349834573,39,81.0,7754.22,,CUS-1790886359,2018-08-27,Matthew,M,-37.84,145.17,,,,,,,debit,posted,43831634d9b14b6d95288944ec47f365,PAYMENT,30-40,2018,8,27,12,0,Monday,14 days,80069.007
ACC-1349834573,39,82.0,7672.22,,CUS-1790886359,2018-08-28,Matthew,M,-37.84,145.17,,,,,,,debit,posted,f6864bda7c9f4befa6991b6102f0c5ac,PAYMENT,30-40,2018,8,28,2,0,Tuesday,14 days,80069.007
ACC-1349834573,39,34.0,7638.22,,CUS-1790886359,2018-08-28,Matthew,M,-37.84,145.17,,,,,,,debit,posted,cd500acbc6e94fb29ef15fda352cb3ac,PAYMENT,30-40,2018,8,28,20,0,Tuesday,14 days,80069.007
ACC-1349834573,39,48.0,10661.36,,CUS-1790886359,2018-08-29,Matthew,M,-37.84,145.17,,,,,,,debit,posted,a81148accf734909bc083e19c92b4d6b,PAYMENT,30-40,2018,8,29,19,0,Wednesday,14 days,80069.007
ACC-1349834573,39,32.0,10629.36,,CUS-1790886359,2018-08-29,Matthew,M,-37.84,145.17,,,,,,,debit,posted,d047335eb2c3416e909a35f6829b6047,PAYMENT,30-40,2018,8,29,23,0,Wednesday,14 days,80069.007
ACC-1349834573,39,60.0,10569.36,,CUS-1790886359,2018-08-30,Matthew,M,-37.84,145.17,,,,,,,debit,posted,ca66f5cc4d614f408264595bf8b0b29f,PAYMENT,30-40,2018,8,30,14,0,Thursday,14 days,80069.007
ACC-1349834573,39,33.0,10536.36,,CUS-1790886359,2018-09-03,Matthew,M,-37.84,145.17,,,,,,,debit,posted,f79dd71b584f43db8ec7c2b8acf4a459,INTER BANK,30-40,2018,9,3,3,0,Monday,14 days,80069.007
ACC-1349834573,39,46.67,10489.69,1.0,CUS-1790886359,2018-09-04,Matthew,M,-37.84,145.17,,f2582055-65ad-4c61-af59-293820178700,-37.7,144.41,VIC,Maddingley,debit,authorized,362f29e0c47748fd83e826cf98baf477,POS,30-40,2018,9,4,15,34,Tuesday,14 days,80069.007
ACC-1349834573,39,34.0,10455.69,,CUS-1790886359,2018-09-04,Matthew,M,-37.84,145.17,,,,,,,debit,posted,0dcc3821d9ef40ffba65564c6e32e99e,PAYMENT,30-40,2018,9,4,20,0,Tuesday,14 days,80069.007
ACC-1349834573,39,167.0,10288.69,,CUS-1790886359,2018-09-05,Matthew,M,-37.84,145.17,,,,,,,debit,posted,71f1c1c65b2646f4aed47b6d894c1176,PAYMENT,30-40,2018,9,5,2,0,Wednesday,14 days,80069.007
ACC-1349834573,39,11.04,10277.65,1.0,CUS-1790886359,2018-09-05,Matthew,M,-37.84,145.17,,4b227720-d6ff-4a29-ba14-ce7eb6bbcdac,-37.87,144.69,VIC,Hoppers Crossing,debit,authorized,a262ba486eae4d38bd2aab60ec2debd2,POS,30-40,2018,9,5,9,4,Wednesday,14 days,80069.007
ACC-1349834573,39,48.0,10229.65,,CUS-1790886359,2018-09-05,Matthew,M,-37.84,145.17,,,,,,,debit,posted,56345e1dd0a64b03a69ac37f4f07c0ae,PAYMENT,30-40,2018,9,5,19,0,Wednesday,14 days,80069.007
ACC-1349834573,39,32.0,10197.65,,CUS-1790886359,2018-09-05,Matthew,M,-37.84,145.17,,,,,,,debit,posted,12ec07b9369c4dde876de8390023eb38,PAYMENT,30-40,2018,9,5,23,0,Wednesday,14 days,80069.007
ACC-1349834573,39,60.0,10137.65,,CUS-1790886359,2018-09-06,Matthew,M,-37.84,145.17,,,,,,,debit,posted,118f2b65691944baa1658fea16e1ee53,PAYMENT,30-40,2018,9,6,14,0,Thursday,14 days,80069.007
ACC-1349834573,39,18.16,10119.49,0.0,CUS-1790886359,2018-09-07,Matthew,M,-37.84,145.17,,bec58f68-5893-4cc9-a9fa-729feaccc665,-37.81,144.98,VIC,Collingwood,debit,authorized,0488780565b6427abe392b6e5d8a647b,POS,30-40,2018,9,7,21,13,Friday,14 days,80069.007
ACC-1349834573,39,18.2,10101.29,1.0,CUS-1790886359,2018-09-07,Matthew,M,-37.84,145.17,,759d8ced-e171-4238-9465-00cbe78e0d06,-37.87,144.83,VIC,Altona,debit,authorized,32dc45e5694e4fa39695a57a97bac9bd,SALES-POS,30-40,2018,9,7,21,38,Friday,14 days,80069.007
ACC-1349834573,39,43.4,10057.89,0.0,CUS-1790886359,2018-09-08,Matthew,M,-37.84,145.17,,649e2ff1-e1ca-4a2f-a34e-abc5ae73e64f,-37.82,144.96,VIC,Melbourne,debit,authorized,873f7a0a15dd490c8fb03d83960fa221,POS,30-40,2018,9,8,10,38,Saturday,14 days,80069.007
ACC-1349834573,39,14.52,10043.37,1.0,CUS-1790886359,2018-09-08,Matthew,M,-37.84,145.17,,e8fdd758-7551-4d62-8e7b-faf65c503c5f,-37.82,144.96,VIC,Melbourne,debit,authorized,9505f31bb0554903ae1bb6ad6f1cf585,SALES-POS,30-40,2018,9,8,17,8,Saturday,14 days,80069.007
ACC-1349834573,39,21.94,10021.43,1.0,CUS-1790886359,2018-09-09,Matthew,M,-37.84,145.17,,e7b87064-dac2-4549-a43f-bc9c50cb9384,-38.02,145.3,VIC,Narre Warren,debit,authorized,516212bef3d646909e15642fcbacd293,SALES-POS,30-40,2018,9,9,7,7,Sunday,14 days,80069.007
ACC-1349834573,39,23.15,9998.28,1.0,CUS-1790886359,2018-09-09,Matthew,M,-37.84,145.17,,27e8bea5-a0b7-4a0a-a4fe-82e4e1693c74,-37.88,145.04,VIC,Caulfield East,debit,authorized,fc479678239f4c99ac8b24fba8892e7e,POS,30-40,2018,9,9,16,25,Sunday,14 days,80069.007
ACC-1349834573,39,241.65,9756.63,1.0,CUS-1790886359,2018-09-09,Matthew,M,-37.84,145.17,,ae795fdc-a1a3-4dce-8869-2a39ea3231cf,-37.83,145.06,VIC,Hawthorn East,debit,authorized,bb26231f91cd4029bac9acfc21416fc1,SALES-POS,30-40,2018,9,9,21,43,Sunday,14 days,80069.007
ACC-1349834573,39,33.0,9723.63,,CUS-1790886359,2018-09-10,Matthew,M,-37.84,145.17,,,,,,,debit,posted,dd43d6d809b34e92ab2337f0142c36a5,INTER BANK,30-40,2018,9,10,3,0,Monday,14 days,80069.007
ACC-1349834573,39,86.5,9637.13,1.0,CUS-1790886359,2018-09-11,Matthew,M,-37.84,145.17,,ca81094e-ca7c-4d45-b6a6-bcd8fc0d5ac8,-33.75,151.24,NSW,Frenchs Forest,debit,authorized,1fc92ff73cf0430982683ed6978a70e3,POS,30-40,2018,9,11,9,53,Tuesday,14 days,80069.007
ACC-1349834573,39,150.0,9487.13,,CUS-1790886359,2018-09-11,Matthew,M,-37.84,145.17,,,,,,,debit,posted,cf0f8d2108314057b51f7e8510b95dbc,PAYMENT,30-40,2018,9,11,13,0,Tuesday,14 days,80069.007
ACC-1349834573,39,34.0,9453.13,,CUS-1790886359,2018-09-11,Matthew,M,-37.84,145.17,,,,,,,debit,posted,5136dc590d9d425ca102a62a0382b99d,PAYMENT,30-40,2018,9,11,20,0,Tuesday,14 days,80069.007
ACC-1349834573,39,11.54,9441.59,1.0,CUS-1790886359,2018-09-12,Matthew,M,-37.84,145.17,,42bbf3d8-113a-41ac-bc23-50a8b6dad91a,-37.81,144.97,VIC,Melbourne,debit,authorized,ccd8a4f515254190b8ab4adabb3497c7,SALES-POS,30-40,2018,9,12,9,58,Wednesday,14 days,80069.007
ACC-1349834573,39,48.0,12464.73,,CUS-1790886359,2018-09-12,Matthew,M,-37.84,145.17,,,,,,,debit,posted,a638c7e6768f457e9000dd9e2982d2e8,PAYMENT,30-40,2018,9,12,19,0,Wednesday,14 days,80069.007
ACC-1349834573,39,32.0,12432.73,,CUS-1790886359,2018-09-12,Matthew,M,-37.84,145.17,,,,,,,debit,posted,089806b148394ee3be84ecca8d8f6359,PAYMENT,30-40,2018,9,12,23,0,Wednesday,14 days,80069.007
ACC-1349834573,39,60.0,12372.73,,CUS-1790886359,2018-09-13,Matthew,M,-37.84,145.17,,,,,,,debit,posted,524e8655624e4e1bb6bc98e6600add28,PAYMENT,30-40,2018,9,13,14,0,Thursday,14 days,80069.007
ACC-1349834573,39,60.24,12312.49,1.0,CUS-1790886359,2018-09-14,Matthew,M,-37.84,145.17,,1bb2f452-fcc3-4b3d-aeba-2037e0cf03c0,-37.8,144.98,VIC,Fitzroy,debit,authorized,e505fe7939694b30b308b734fa63c1cc,POS,30-40,2018,9,14,6,35,Friday,14 days,80069.007
ACC-1349834573,39,51.5,12260.99,1.0,CUS-1790886359,2018-09-14,Matthew,M,-37.84,145.17,,27f93a60-ed2e-4b56-826d-8b1c9f1c1b8a,-33.88,151.02,NSW,Regents Park,debit,authorized,d34e99a34a284f289d2ff218b20a92eb,POS,30-40,2018,9,14,17,27,Friday,14 days,80069.007
ACC-1349834573,39,41.25,12219.74,1.0,CUS-1790886359,2018-09-14,Matthew,M,-37.84,145.17,,d582810b-04c5-4fec-9016-ab0ee3c27e01,-37.84,144.69,VIC,Tarneit,debit,authorized,1175e4595d3749f497c9c80bf5baf3fb,SALES-POS,30-40,2018,9,14,19,20,Friday,14 days,80069.007
ACC-1349834573,39,33.0,12186.74,,CUS-1790886359,2018-09-17,Matthew,M,-37.84,145.17,,,,,,,debit,posted,dcd1fc56f9564485b03e9591027edd6a,INTER BANK,30-40,2018,9,17,3,0,Monday,14 days,80069.007
ACC-1349834573,39,45.81,12140.93,1.0,CUS-1790886359,2018-09-17,Matthew,M,-37.84,145.17,,0d7a479e-b812-4dee-96cd-773b40c4e22b,-37.79,144.83,VIC,Sunshine,debit,authorized,1e131865ef0247c09161bb4917b7a312,POS,30-40,2018,9,17,11,11,Monday,14 days,80069.007
ACC-1349834573,39,34.0,12106.93,,CUS-1790886359,2018-09-18,Matthew,M,-37.84,145.17,,,,,,,debit,posted,ac2a4c208d3449c6b9ff9044636bf724,PAYMENT,30-40,2018,9,18,20,0,Tuesday,14 days,80069.007
ACC-1349834573,39,144.05,11962.88,0.0,CUS-1790886359,2018-09-19,Matthew,M,-37.84,145.17,,daa7c3ae-c00a-45ae-89b1-db88d8ab4fe6,-37.82,144.95,VIC,Docklands,debit,authorized,b80d7cf9e7a64ddb92d9fc8d8bcfa392,POS,30-40,2018,9,19,16,55,Wednesday,14 days,80069.007
ACC-1349834573,39,48.0,11914.88,,CUS-1790886359,2018-09-19,Matthew,M,-37.84,145.17,,,,,,,debit,posted,a41218c405244c3c8f89580a12003384,PAYMENT,30-40,2018,9,19,19,0,Wednesday,14 days,80069.007
ACC-1349834573,39,32.0,11882.88,,CUS-1790886359,2018-09-19,Matthew,M,-37.84,145.17,,,,,,,debit,posted,d19891cab11a4b47ba32dd08a6ccc885,PAYMENT,30-40,2018,9,19,23,0,Wednesday,14 days,80069.007
ACC-1349834573,39,60.0,11822.88,,CUS-1790886359,2018-09-20,Matthew,M,-37.84,145.17,,,,,,,debit,posted,3068953afe2c49ecbc90ff4d2b2f1b50,PAYMENT,30-40,2018,9,20,14,0,Thursday,14 days,80069.007
ACC-1349834573,39,13.49,11809.39,1.0,CUS-1790886359,2018-09-21,Matthew,M,-37.84,145.17,,934890a0-37c4-4745-be2f-271aa98c235a,-37.88,144.73,VIC,Point Cook,debit,authorized,2dbdbfc2ea7e454a9d1ddcf2b61c4177,POS,30-40,2018,9,21,9,44,Friday,14 days,80069.007
ACC-1349834573,39,33.29,11776.1,1.0,CUS-1790886359,2018-09-21,Matthew,M,-37.84,145.17,,8d12783c-af96-4601-ad0e-73fd7c000934,-37.81,144.96,VIC,Melbourne,debit,authorized,d8eb963e56d84c129ae9a47a3a16e7de,SALES-POS,30-40,2018,9,21,9,55,Friday,14 days,80069.007
ACC-1349834573,39,14.16,11761.94,1.0,CUS-1790886359,2018-09-21,Matthew,M,-37.84,145.17,,885d0e80-22ed-410a-8d35-8e2fe961aa9d,-37.82,144.95,VIC,Docklands,debit,authorized,2f128cab26aa479f9e1a10a5eea5a0fc,SALES-POS,30-40,2018,9,21,19,33,Friday,14 days,80069.007
ACC-1349834573,39,158.27,11603.67,0.0,CUS-1790886359,2018-09-22,Matthew,M,-37.84,145.17,,d1f233cc-3f37-4c24-a188-7d842a11bb3d,-37.81,144.96,VIC,Melbourne,debit,authorized,23916cef9eea42288b2ce4283e739331,SALES-POS,30-40,2018,9,22,20,7,Saturday,14 days,80069.007
ACC-1349834573,39,19.15,11584.52,1.0,CUS-1790886359,2018-09-23,Matthew,M,-37.84,145.17,,3c2c933e-4dae-47f8-a566-75186f0e4f55,-37.82,144.95,VIC,Melbourne,debit,authorized,89ae96b8ffad4d26834c65888f8d9489,SALES-POS,30-40,2018,9,23,18,19,Sunday,14 days,80069.007
ACC-1349834573,39,33.0,11551.52,,CUS-1790886359,2018-09-24,Matthew,M,-37.84,145.17,,,,,,,debit,posted,4b5802e378524bb792d6373194a7d275,INTER BANK,30-40,2018,9,24,3,0,Monday,14 days,80069.007
ACC-1349834573,39,34.0,11517.52,,CUS-1790886359,2018-09-25,Matthew,M,-37.84,145.17,,,,,,,debit,posted,35bf0c2f42164775acd9b22348b32425,PAYMENT,30-40,2018,9,25,20,0,Tuesday,14 days,80069.007
ACC-1349834573,39,48.0,14540.66,,CUS-1790886359,2018-09-26,Matthew,M,-37.84,145.17,,,,,,,debit,posted,ce4757bb442148ea92cf58a6b3b2bbc1,PAYMENT,30-40,2018,9,26,19,0,Wednesday,14 days,80069.007
ACC-1349834573,39,32.0,14508.66,,CUS-1790886359,2018-09-26,Matthew,M,-37.84,145.17,,,,,,,debit,posted,ff50a757647b4996ad2df29b8b89de20,PAYMENT,30-40,2018,9,26,23,0,Wednesday,14 days,80069.007
ACC-1349834573,39,81.0,14427.66,,CUS-1790886359,2018-09-27,Matthew,M,-37.84,145.17,,,,,,,debit,posted,b5a65a444ff6481fb7ba1f018c3ba4b5,PAYMENT,30-40,2018,9,27,12,0,Thursday,14 days,80069.007
ACC-1349834573,39,60.0,14367.66,,CUS-1790886359,2018-09-27,Matthew,M,-37.84,145.17,,,,,,,debit,posted,c93bcc2012214c6aa469dbc721e8438a,PAYMENT,30-40,2018,9,27,14,0,Thursday,14 days,80069.007
ACC-1349834573,39,82.0,14285.66,,CUS-1790886359,2018-09-28,Matthew,M,-37.84,145.17,,,,,,,debit,posted,c5d2754fd0f5420db2e8eaab9cd4ffcc,PAYMENT,30-40,2018,9,28,2,0,Friday,14 days,80069.007
ACC-1349834573,39,33.0,14252.66,,CUS-1790886359,2018-10-01,Matthew,M,-37.84,145.17,,,,,,,debit,posted,eee15b6732fa4f2eafc74f92b77de5e8,INTER BANK,30-40,2018,10,1,3,0,Monday,14 days,80069.007
ACC-1349834573,39,34.0,14218.66,,CUS-1790886359,2018-10-02,Matthew,M,-37.84,145.17,,,,,,,debit,posted,9d2f8b4476f8403894720d1795e9b323,PAYMENT,30-40,2018,10,2,20,0,Tuesday,14 days,80069.007
ACC-1349834573,39,48.0,14170.66,,CUS-1790886359,2018-10-03,Matthew,M,-37.84,145.17,,,,,,,debit,posted,d6edcd17da2b4d3497901e249e547b85,PAYMENT,30-40,2018,10,3,19,0,Wednesday,14 days,80069.007
ACC-1349834573,39,32.0,14138.66,,CUS-1790886359,2018-10-03,Matthew,M,-37.84,145.17,,,,,,,debit,posted,e800316d934e4a63b56a8f26088da9d0,PAYMENT,30-40,2018,10,3,23,0,Wednesday,14 days,80069.007
ACC-1349834573,39,60.0,14078.66,,CUS-1790886359,2018-10-04,Matthew,M,-37.84,145.17,,,,,,,debit,posted,56401b7c1c144737bbd18ec5ce5e0681,PAYMENT,30-40,2018,10,4,14,0,Thursday,14 days,80069.007
ACC-1349834573,39,167.0,13911.66,,CUS-1790886359,2018-10-05,Matthew,M,-37.84,145.17,,,,,,,debit,posted,1a42aeac1d5c441a9e9b7ea055f965da,PAYMENT,30-40,2018,10,5,2,0,Friday,14 days,80069.007
ACC-1349834573,39,50.13,13861.53,1.0,CUS-1790886359,2018-10-06,Matthew,M,-37.84,145.17,,e073b046-7632-4b69-a46b-681be6baa67c,-33.77,151.26,NSW,Brookvale,debit,authorized,eca8ade7fd1948209f5c0d9bb8463d12,SALES-POS,30-40,2018,10,6,7,20,Saturday,14 days,80069.007
ACC-1349834573,39,8.52,13853.01,1.0,CUS-1790886359,2018-10-06,Matthew,M,-37.84,145.17,,d7234bbe-5603-4f17-80f3-8c9b88035a3c,-37.82,144.95,VIC,Docklands,debit,authorized,e638f6689ab14c85a215c9d8f76dc18d,SALES-POS,30-40,2018,10,6,10,9,Saturday,14 days,80069.007
ACC-1349834573,39,29.96,13823.05,1.0,CUS-1790886359,2018-10-06,Matthew,M,-37.84,145.17,,d45df1bd-91b3-4a90-be55-8068f8b92bca,-37.84,144.86,VIC,Altona North,debit,authorized,1d5e76d3f208443088e5d7a2e3783648,POS,30-40,2018,10,6,21,3,Saturday,14 days,80069.007
ACC-1349834573,39,33.0,13790.05,,CUS-1790886359,2018-10-08,Matthew,M,-37.84,145.17,,,,,,,debit,posted,32adefd820b1434d8bf89d1c15b2b1dc,INTER BANK,30-40,2018,10,8,3,0,Monday,14 days,80069.007
ACC-1349834573,39,27.53,13762.52,0.0,CUS-1790886359,2018-10-09,Matthew,M,-37.84,145.17,,79e87fa1-250c-4eef-bef1-d13650738394,-37.71,144.63,VIC,Rockbank,debit,authorized,7586fae3e8444f00b1d7fed0d3a82ce1,POS,30-40,2018,10,9,13,42,Tuesday,14 days,80069.007
ACC-1349834573,39,34.0,13728.52,,CUS-1790886359,2018-10-09,Matthew,M,-37.84,145.17,,,,,,,debit,posted,5942ca4016634bd7b307565dbd21b191,PAYMENT,30-40,2018,10,9,20,0,Tuesday,14 days,80069.007
ACC-1349834573,39,57.17,13671.35,1.0,CUS-1790886359,2018-10-10,Matthew,M,-37.84,145.17,,842e1017-9030-4f9f-b812-27af4298b2fe,-38.05,145.12,VIC,Chelsea,debit,authorized,4042182882b342a0ad56e695c96b7306,SALES-POS,30-40,2018,10,10,13,10,Wednesday,14 days,80069.007
ACC-1349834573,39,29.4,13641.95,1.0,CUS-1790886359,2018-10-10,Matthew,M,-37.84,145.17,,bf381ec0-df2c-4703-98d5-4436b2133ff6,-37.88,145,VIC,Elsternwick,debit,authorized,8e7072b777c14701b20348ec47cd6725,SALES-POS,30-40,2018,10,10,14,4,Wednesday,14 days,80069.007
ACC-1349834573,39,48.0,16665.09,,CUS-1790886359,2018-10-10,Matthew,M,-37.84,145.17,,,,,,,debit,posted,c5153274a8314afe9a74284ad49f7b1d,PAYMENT,30-40,2018,10,10,19,0,Wednesday,14 days,80069.007
ACC-1349834573,39,32.0,16633.09,,CUS-1790886359,2018-10-10,Matthew,M,-37.84,145.17,,,,,,,debit,posted,7ccb19091f9f40f692166bdd7a1d30d3,PAYMENT,30-40,2018,10,10,23,0,Wednesday,14 days,80069.007
ACC-1349834573,39,150.0,16483.09,,CUS-1790886359,2018-10-11,Matthew,M,-37.84,145.17,,,,,,,debit,posted,2fca039b70574ff8a1b9a3ddaa1dcff7,PAYMENT,30-40,2018,10,11,13,0,Thursday,14 days,80069.007
ACC-1349834573,39,60.0,16423.09,,CUS-1790886359,2018-10-11,Matthew,M,-37.84,145.17,,,,,,,debit,posted,9a895362a0fd4e60b2921e79e60f44be,PAYMENT,30-40,2018,10,11,14,0,Thursday,14 days,80069.007
ACC-1349834573,39,33.0,16390.09,,CUS-1790886359,2018-10-15,Matthew,M,-37.84,145.17,,,,,,,debit,posted,638cc8b24a5d4e2ba32f90edf7869081,INTER BANK,30-40,2018,10,15,3,0,Monday,14 days,80069.007
ACC-1349834573,39,34.0,16356.09,,CUS-1790886359,2018-10-16,Matthew,M,-37.84,145.17,,,,,,,debit,posted,dfcac919176d45758f0bc1fa88537a51,PAYMENT,30-40,2018,10,16,20,0,Tuesday,14 days,80069.007
ACC-1349834573,39,48.0,16308.09,,CUS-1790886359,2018-10-17,Matthew,M,-37.84,145.17,,,,,,,debit,posted,46047f10b7f841fb94f91f794c1c2fa5,PAYMENT,30-40,2018,10,17,19,0,Wednesday,14 days,80069.007
ACC-1349834573,39,32.0,16276.09,,CUS-1790886359,2018-10-17,Matthew,M,-37.84,145.17,,,,,,,debit,posted,cf04c7d8e6ef488396299f408025f8e1,PAYMENT,30-40,2018,10,17,23,0,Wednesday,14 days,80069.007
ACC-1349834573,39,60.0,16216.09,,CUS-1790886359,2018-10-18,Matthew,M,-37.84,145.17,,,,,,,debit,posted,86ba36452d6e4146be66776c7b17f781,PAYMENT,30-40,2018,10,18,14,0,Thursday,14 days,80069.007
ACC-1349834573,39,15.86,16200.23,0.0,CUS-1790886359,2018-10-18,Matthew,M,-37.84,145.17,,a28e2c48-1216-4985-b068-8cca60bad857,-37.81,144.96,VIC,Melbourne,debit,authorized,c426391b2e334086b0e1b5610a2aa647,POS,30-40,2018,10,18,15,39,Thursday,14 days,80069.007
ACC-1349834573,39,47.11,16153.12,0.0,CUS-1790886359,2018-10-18,Matthew,M,-37.84,145.17,,980e2f29-ab10-40e4-af15-96797765f28e,-37.83,144.99,VIC,Richmond,debit,authorized,27af42bae5994b62b8cbd3ed79b96049,SALES-POS,30-40,2018,10,18,17,23,Thursday,14 days,80069.007
ACC-1349834573,39,61.06,16092.06,1.0,CUS-1790886359,2018-10-18,Matthew,M,-37.84,145.17,,fcff708f-9da5-4150-8650-d9aaa3cac19f,-37.83,144.99,VIC,Richmond,debit,authorized,414281c09f594ea59900ee7c0e142adf,POS,30-40,2018,10,18,19,53,Thursday,14 days,80069.007
ACC-1349834573,39,15.07,16076.99,1.0,CUS-1790886359,2018-10-19,Matthew,M,-37.84,145.17,,c67d525b-f7f7-42b1-804a-feacef9f5736,-37.8,144.99,VIC,Abbotsford,debit,authorized,710482ea402a411d9cfb5791a549ecd2,POS,30-40,2018,10,19,17,11,Friday,14 days,80069.007
ACC-1349834573,39,49.19,16027.8,1.0,CUS-1790886359,2018-10-19,Matthew,M,-37.84,145.17,,c9356757-73dd-4631-9a42-5f47faabeeed,-37.75,144.8,VIC,Saint Albans,debit,authorized,f6c9b77ebaeb41a2940e84548a65d912,POS,30-40,2018,10,19,17,22,Friday,14 days,80069.007
ACC-1349834573,39,7.33,16020.47,1.0,CUS-1790886359,2018-10-20,Matthew,M,-37.84,145.17,,8471620b-c6c7-4a7f-8b60-781d0fd108d3,-37.82,144.96,VIC,Melbourne,debit,authorized,37fb69897215400e8313ae69e024b71c,SALES-POS,30-40,2018,10,20,0,3,Saturday,14 days,80069.007
ACC-1349834573,39,53.99,15966.48,1.0,CUS-1790886359,2018-10-20,Matthew,M,-37.84,145.17,,6c97fa19-15f7-4be4-a1ce-2ef7ddb79eb6,-37.8,148.53,VIC,Marlo,debit,authorized,a2c7704c49d14d9b95fb4b5d200ef443,SALES-POS,30-40,2018,10,20,20,11,Saturday,14 days,80069.007
ACC-1349834573,39,22.03,15944.45,0.0,CUS-1790886359,2018-10-20,Matthew,M,-37.84,145.17,,56281b7c-c276-41fc-96bc-3ccd2d38659f,-37.82,145.04,VIC,Hawthorn,debit,authorized,c6e76ccdc88c44afb9b8f60b91dd2217,SALES-POS,30-40,2018,10,20,21,40,Saturday,14 days,80069.007
ACC-1349834573,39,33.0,15911.45,,CUS-1790886359,2018-10-22,Matthew,M,-37.84,145.17,,,,,,,debit,posted,74e765ec93f04eb1be69cc89850bc163,INTER BANK,30-40,2018,10,22,3,0,Monday,14 days,80069.007
ACC-1349834573,39,17.11,15894.34,1.0,CUS-1790886359,2018-10-22,Matthew,M,-37.84,145.17,,c8d2f552-2a94-4ed2-93d6-3c665c46963e,-37.85,144.98,VIC,Melbourne,debit,authorized,9130058541f9441f9aaf8fc3ba064944,POS,30-40,2018,10,22,18,9,Monday,14 days,80069.007
ACC-1349834573,39,82.38,15811.96,1.0,CUS-1790886359,2018-10-22,Matthew,M,-37.84,145.17,,d8bfe16f-cf4e-4d66-a307-b6bc8a817a12,-37.81,144.97,VIC,Melbourne,debit,authorized,ff543cd3beb04a9bbaef248be92a1583,POS,30-40,2018,10,22,20,42,Monday,14 days,80069.007
ACC-1349834573,39,32.15,15779.81,0.0,CUS-1790886359,2018-10-23,Matthew,M,-37.84,145.17,,d3a6299c-38b6-44d7-9dda-0aea7c6476f9,-37.83,140.78,SA,Mount Gambier,debit,authorized,d69f495c4423417f856a74621afaea55,SALES-POS,30-40,2018,10,23,9,13,Tuesday,14 days,80069.007
ACC-1349834573,39,73.87,15705.94,1.0,CUS-1790886359,2018-10-23,Matthew,M,-37.84,145.17,,42b108e1-a8e2-4a0b-90d8-c28f59129ac0,-37.8,144.98,VIC,Fitzroy,debit,authorized,b3ae836698064d27a2a816bff6497471,POS,30-40,2018,10,23,10,9,Tuesday,14 days,80069.007
ACC-1349834573,39,38.88,15667.06,1.0,CUS-1790886359,2018-10-23,Matthew,M,-37.84,145.17,,c3f58ae3-51e2-48c4-a5e7-445bb24d1f6b,-37.86,144.67,VIC,Tarneit,debit,authorized,166e43be28b247d3810f9e4d1e3cab54,SALES-POS,30-40,2018,10,23,19,18,Tuesday,14 days,80069.007
ACC-1349834573,39,34.0,15633.06,,CUS-1790886359,2018-10-23,Matthew,M,-37.84,145.17,,,,,,,debit,posted,116c44485607425d82e946e93b166e5a,PAYMENT,30-40,2018,10,23,20,0,Tuesday,14 days,80069.007
ACC-1349834573,39,17.44,15615.62,0.0,CUS-1790886359,2018-10-24,Matthew,M,-37.84,145.17,,3c3c3250-e466-408c-94dd-54763b8f579c,-37.81,144.81,VIC,Sunshine,debit,authorized,66d48849ecae4ad4bdc304526806516b,SALES-POS,30-40,2018,10,24,17,43,Wednesday,14 days,80069.007
ACC-1349834573,39,48.0,18638.76,,CUS-1790886359,2018-10-24,Matthew,M,-37.84,145.17,,,,,,,debit,posted,52ca920a000145ffbffeeb4a4f35bd8f,PAYMENT,30-40,2018,10,24,19,0,Wednesday,14 days,80069.007
ACC-1349834573,39,32.0,18606.76,,CUS-1790886359,2018-10-24,Matthew,M,-37.84,145.17,,,,,,,debit,posted,b8342dee502b471dbf9ba484f4cfc4b7,PAYMENT,30-40,2018,10,24,23,0,Wednesday,14 days,80069.007
ACC-1349834573,39,38.28,18568.48,1.0,CUS-1790886359,2018-10-25,Matthew,M,-37.84,145.17,,0063d66f-b665-435f-9282-ab648d9e68cd,-37.81,145.03,VIC,Kew,debit,authorized,794256cb2d5e4371a05d1508e1f84aaa,SALES-POS,30-40,2018,10,25,12,20,Thursday,14 days,80069.007
ACC-1349834573,39,60.0,18508.48,,CUS-1790886359,2018-10-25,Matthew,M,-37.84,145.17,,,,,,,debit,posted,e8bf8bd965a14a298b3620d498af0e19,PAYMENT,30-40,2018,10,25,14,0,Thursday,14 days,80069.007
ACC-1349834573,39,9.07,18499.41,1.0,CUS-1790886359,2018-10-26,Matthew,M,-37.84,145.17,,c5df2089-dfdc-412a-a7cb-e373eac13757,-37.79,144.89,VIC,Melbourne,debit,authorized,0082f5a029674a1ea6f69493ebefd4a4,POS,30-40,2018,10,26,19,19,Friday,14 days,80069.007
ACC-1349834573,39,46.5,18452.91,0.0,CUS-1790886359,2018-10-26,Matthew,M,-37.84,145.17,,68a27573-ee68-476d-873e-9663f7a5f804,-37.82,145,VIC,Richmond,debit,authorized,7e5876238b1b4891b23bf048fa7641eb,SALES-POS,30-40,2018,10,26,22,1,Friday,14 days,80069.007
ACC-1349834573,39,81.0,18356.5,,CUS-1790886359,2018-10-27,Matthew,M,-37.84,145.17,,,,,,,debit,posted,5f2eb39677ad400cbafc0a7863d0e73a,PAYMENT,30-40,2018,10,27,12,0,Saturday,14 days,80069.007
ACC-1349834573,39,15.41,18437.5,1.0,CUS-1790886359,2018-10-27,Matthew,M,-37.84,145.17,,5e3fdc60-650f-4013-b6b4-4c5d772d255c,-37.87,144.98,VIC,Saint Kilda,debit,authorized,7c76feb9a686449cb18c3330124933dc,POS,30-40,2018,10,27,12,19,Saturday,14 days,80069.007
ACC-1349834573,39,82.0,18274.5,,CUS-1790886359,2018-10-28,Matthew,M,-37.84,145.17,,,,,,,debit,posted,8d7edfc14aef4643b28be7053d4ee5f9,PAYMENT,30-40,2018,10,28,2,0,Sunday,14 days,80069.007
ACC-1349834573,39,33.0,18241.5,,CUS-1790886359,2018-10-29,Matthew,M,-37.84,145.17,,,,,,,debit,posted,89cef17829f54ddf8c47594b57aff984,INTER BANK,30-40,2018,10,29,3,0,Monday,14 days,80069.007
ACC-1349834573,39,34.0,18207.5,,CUS-1790886359,2018-10-30,Matthew,M,-37.84,145.17,,,,,,,debit,posted,81f8d17831474c54b745d5691f494737,PAYMENT,30-40,2018,10,30,20,0,Tuesday,14 days,80069.007
ACC-1349834573,39,48.0,18159.5,,CUS-1790886359,2018-10-31,Matthew,M,-37.84,145.17,,,,,,,debit,posted,63420050141144cfa5ba8e0664d5140d,PAYMENT,30-40,2018,10,31,19,0,Wednesday,14 days,80069.007
ACC-1349834573,39,32.0,18127.5,,CUS-1790886359,2018-10-31,Matthew,M,-37.84,145.17,,,,,,,debit,posted,df15d6f039554dcbb3ca02631ce22068,PAYMENT,30-40,2018,10,31,23,0,Wednesday,14 days,80069.007
ACC-964839203,21,26.75,27984.9,1.0,CUS-2059096722,2018-08-01,Michael,M,-36.07,146.92,,c6163a13-ed92-44bf-9bad-9535d4516888,-36.04,146.97,NSW,Lavington,debit,authorized,361e4d9928094aafa77d0a1e7e32b731,SALES-POS,20-30,2018,8,1,19,4,Wednesday,7 days,81353.286
ACC-964839203,21,31.37,27953.53,1.0,CUS-2059096722,2018-08-01,Michael,M,-36.07,146.92,,1b9ea2a4-61fe-4134-9042-b9b6d92aea7a,-19.25,146.81,QLD,North Ward,debit,authorized,219c4cbb3c4a4b5f92d1f83f1ad1c15b,SALES-POS,20-30,2018,8,1,19,43,Wednesday,7 days,81353.286
ACC-964839203,21,30.47,27923.06,1.0,CUS-2059096722,2018-08-02,Michael,M,-36.07,146.92,,da3deefd-e453-4ba6-9d32-54edf2dfd93d,-37.82,144.95,VIC,Docklands,debit,authorized,fbe3b2b4ceb54e3a83d89e0ec0644d9b,SALES-POS,20-30,2018,8,2,0,5,Thursday,7 days,81353.286
ACC-964839203,21,24.17,27898.89,0.0,CUS-2059096722,2018-08-02,Michael,M,-36.07,146.92,,bdd0294c-fd9f-408a-baca-143d4bd00884,-38.19,144.46,VIC,Leopold,debit,authorized,d3bbee0d1b5f4b39b9d28c2c377207dc,POS,20-30,2018,8,2,12,43,Thursday,7 days,81353.286
ACC-964839203,21,14.47,27884.42,1.0,CUS-2059096722,2018-08-02,Michael,M,-36.07,146.92,,38ffa834-11d6-461a-a748-bd3df9d4db57,-36.12,146.88,VIC,Wodonga,debit,authorized,f484507f5b0a46649ca51c8485b8c0f9,SALES-POS,20-30,2018,8,2,17,55,Thursday,7 days,81353.286
ACC-964839203,21,28.0,29416.62,,CUS-2059096722,2018-08-04,Michael,M,-36.07,146.92,,,,,,,debit,posted,e4b0391fea4d40a6acdc71686aee5686,PAYMENT,20-30,2018,8,4,4,0,Saturday,7 days,81353.286
ACC-964839203,21,42.0,29374.62,,CUS-2059096722,2018-08-05,Michael,M,-36.07,146.92,,,,,,,debit,posted,c3ff692c0db54d5e98ebaec73e980dbd,PAYMENT,20-30,2018,8,5,10,0,Sunday,7 days,81353.286
ACC-964839203,21,135.0,29239.62,,CUS-2059096722,2018-08-07,Michael,M,-36.07,146.92,,,,,,,debit,posted,aa681333675548a490519504286651b0,PAYMENT,20-30,2018,8,7,22,0,Tuesday,7 days,81353.286
ACC-964839203,21,19.59,29220.03,1.0,CUS-2059096722,2018-08-10,Michael,M,-36.07,146.92,,f702746f-5fa2-4abf-8d38-5b6c9ba13aee,-19.12,146.86,QLD,Magnetic Island,debit,authorized,b7f2bfb6b7c54c25b7998fdcd828786a,POS,20-30,2018,8,10,15,4,Friday,7 days,81353.286
ACC-964839203,21,9.62,30770.61,1.0,CUS-2059096722,2018-08-10,Michael,M,-36.07,146.92,,a0dcc65e-9de6-4862-8ab1-6b14a69a828a,-38.15,144.36,VIC,Geelong,debit,authorized,58c190bfec3747e9836bdf934836d42e,SALES-POS,20-30,2018,8,10,19,58,Friday,7 days,81353.286
ACC-964839203,21,47.9,30722.71,1.0,CUS-2059096722,2018-08-10,Michael,M,-36.07,146.92,,3f96e185-9525-4879-be2a-a1769b561b65,-37.96,146.89,VIC,Tinamba,debit,authorized,7fc0675ffd50476290b66a0353541bc2,POS,20-30,2018,8,10,21,11,Friday,7 days,81353.286
ACC-964839203,21,28.0,30694.71,,CUS-2059096722,2018-08-11,Michael,M,-36.07,146.92,,,,,,,debit,posted,bf21ceddccd44c78962fa004cee343dd,PAYMENT,20-30,2018,8,11,4,0,Saturday,7 days,81353.286
ACC-964839203,21,41.35,30653.36,1.0,CUS-2059096722,2018-08-11,Michael,M,-36.07,146.92,,53cdff41-efba-4078-8259-29d7c12dba90,-19.27,146.79,QLD,West End,debit,authorized,e7512456779547dfae15e765088da010,SALES-POS,20-30,2018,8,11,8,49,Saturday,7 days,81353.286
ACC-964839203,21,17.55,30635.81,1.0,CUS-2059096722,2018-08-11,Michael,M,-36.07,146.92,,cfc126d0-1078-4166-9c7b-d82d0333001a,-36.05,146.46,VIC,Rutherglen,debit,authorized,3b00b81c130643d587b2c7a7970a45d1,SALES-POS,20-30,2018,8,11,15,42,Saturday,7 days,81353.286
ACC-964839203,21,22.95,30612.86,1.0,CUS-2059096722,2018-08-11,Michael,M,-36.07,146.92,,a395aac1-6785-4e83-8a73-57c8c83612e3,-43.31,147.02,TAS,Dover,debit,authorized,227cf6599aa240708687f8670c5fda1a,SALES-POS,20-30,2018,8,11,16,6,Saturday,7 days,81353.286
ACC-964839203,21,28.48,30584.38,1.0,CUS-2059096722,2018-08-11,Michael,M,-36.07,146.92,,6b0a8d80-9b7a-410e-823d-f9300e69d44d,-19.27,146.81,QLD,Townsville City,debit,authorized,d00ff96a6e6a46b5af50e0d783812be7,POS,20-30,2018,8,11,17,30,Saturday,7 days,81353.286
ACC-964839203,21,42.0,30542.38,,CUS-2059096722,2018-08-12,Michael,M,-36.07,146.92,,,,,,,debit,posted,5ec2be74f5674555b2885bdb1db74904,PAYMENT,20-30,2018,8,12,10,0,Sunday,7 days,81353.286
ACC-964839203,21,54.98,30487.4,0.0,CUS-2059096722,2018-08-17,Michael,M,-36.07,146.92,,1f67fe13-88de-4730-a94c-3ccd989930a2,-37.81,144.97,VIC,Melbourne,debit,authorized,4a4e62a9b27c4ae79dd49976e07d0188,POS,20-30,2018,8,17,11,53,Friday,7 days,81353.286
ACC-964839203,21,16.63,30470.77,1.0,CUS-2059096722,2018-08-17,Michael,M,-36.07,146.92,,4cedbd15-1d1e-4a81-b568-afcd252b24a0,-38.21,145.34,VIC,Blind Bight,debit,authorized,90e9feacb22c4e9190bf677d92ac801e,POS,20-30,2018,8,17,13,47,Friday,7 days,81353.286
ACC-964839203,21,177.0,31853.97,,CUS-2059096722,2018-08-17,Michael,M,-36.07,146.92,,,,,,,debit,posted,77e47672ca18416daed01578fa383d1a,PAYMENT,20-30,2018,8,17,18,0,Friday,7 days,81353.286
ACC-964839203,21,24.77,31829.2,1.0,CUS-2059096722,2018-08-18,Michael,M,-36.07,146.92,,23cb82c8-9cb1-42dd-9cca-5063f245c90d,-41.3,146.95,TAS,Exeter,debit,authorized,27e2756dcd4443938f17e028501ccea1,POS,20-30,2018,8,18,3,45,Saturday,7 days,81353.286
ACC-964839203,21,28.0,31801.2,,CUS-2059096722,2018-08-18,Michael,M,-36.07,146.92,,,,,,,debit,posted,85a2a8cdcbdd493586669042387efcc8,PAYMENT,20-30,2018,8,18,4,0,Saturday,7 days,81353.286
ACC-964839203,21,32.64,31768.56,1.0,CUS-2059096722,2018-08-18,Michael,M,-36.07,146.92,,1b9ea2a4-61fe-4134-9042-b9b6d92aea7a,-19.25,146.81,QLD,North Ward,debit,authorized,f2053d34b37a413489004f7be06a421f,SALES-POS,20-30,2018,8,18,5,8,Saturday,7 days,81353.286
ACC-964839203,21,42.0,31726.56,,CUS-2059096722,2018-08-19,Michael,M,-36.07,146.92,,,,,,,debit,posted,936e9b1c10324168b7a63de7b6bf37fc,PAYMENT,20-30,2018,8,19,10,0,Sunday,7 days,81353.286
ACC-964839203,21,72.0,31654.56,,CUS-2059096722,2018-08-19,Michael,M,-36.07,146.92,,,,,,,debit,posted,b61ebe6027534c4389c6884903f1045a,PAYMENT,20-30,2018,8,19,14,0,Sunday,7 days,81353.286
ACC-964839203,21,78.55,31576.01,1.0,CUS-2059096722,2018-08-19,Michael,M,-36.07,146.92,,2c7371fe-dfdc-4693-8ac2-cb0e59cf7842,-38.15,145.12,VIC,Frankston,debit,authorized,4602788d8bc44e5c82abfb267044913f,SALES-POS,20-30,2018,8,19,21,26,Sunday,7 days,81353.286
ACC-964839203,21,32.23,31543.78,1.0,CUS-2059096722,2018-08-19,Michael,M,-36.07,146.92,,9967a7df-1da8-45cd-afc2-93059501b385,-35.98,137.18,SA,Vivonne Bay,debit,authorized,4ebac291663344fab39531e05b26c0c6,SALES-POS,20-30,2018,8,19,23,9,Sunday,7 days,81353.286
ACC-964839203,21,62.45,31481.33,1.0,CUS-2059096722,2018-08-23,Michael,M,-36.07,146.92,,3dc0e4cc-8e67-4816-a09e-d9d5f0b8e737,-19.27,146.78,QLD,Townsville City,debit,authorized,755be47687314e9f9b045b045a40b136,POS,20-30,2018,8,23,15,47,Thursday,7 days,81353.286
ACC-964839203,21,43.13,32998.4,1.0,CUS-2059096722,2018-08-24,Michael,M,-36.07,146.92,,c2cb19d2-a98f-4ade-8160-0f486085757b,-38.12,144.65,VIC,Portarlington,debit,authorized,2cc7e0123bf441e09cb4e63bd07f87aa,POS,20-30,2018,8,24,17,29,Friday,7 days,81353.286
ACC-964839203,21,35.4,32963.0,0.0,CUS-2059096722,2018-08-24,Michael,M,-36.07,146.92,,2c145a20-0d55-492f-8b2f-7e3235dfc1b5,-37.75,144.99,VIC,Thornbury,debit,authorized,733c446a8347429daa5e82ff7ab6401c,POS,20-30,2018,8,24,22,17,Friday,7 days,81353.286
ACC-964839203,21,28.0,32935.0,,CUS-2059096722,2018-08-25,Michael,M,-36.07,146.92,,,,,,,debit,posted,91f31c6f97014c1da5951bfb5bcf5bcf,PAYMENT,20-30,2018,8,25,4,0,Saturday,7 days,81353.286
ACC-964839203,21,42.0,32893.0,,CUS-2059096722,2018-08-26,Michael,M,-36.07,146.92,,,,,,,debit,posted,415dea7f607a4460a205caa518ec4a4b,PAYMENT,20-30,2018,8,26,10,0,Sunday,7 days,81353.286
ACC-964839203,21,28.0,34425.2,,CUS-2059096722,2018-09-01,Michael,M,-36.07,146.92,,,,,,,debit,posted,98a9d117fb2b44d5a59009c35f5fddb1,PAYMENT,20-30,2018,9,1,4,0,Saturday,7 days,81353.286
ACC-964839203,21,42.0,34383.2,,CUS-2059096722,2018-09-02,Michael,M,-36.07,146.92,,,,,,,debit,posted,8db1107faf13495bad97d8214b314a47,PAYMENT,20-30,2018,9,2,10,0,Sunday,7 days,81353.286
ACC-964839203,21,70.66,34312.54,1.0,CUS-2059096722,2018-09-03,Michael,M,-36.07,146.92,,31f0219e-ba45-44bc-b9b6-9f6e9d60e67d,-37.78,144.82,VIC,Albion,debit,authorized,9ccf19960ede4002968ea7ebb34dcf62,SALES-POS,20-30,2018,9,3,15,6,Monday,7 days,81353.286
ACC-964839203,21,31.82,34280.72,1.0,CUS-2059096722,2018-09-04,Michael,M,-36.07,146.92,,1614a051-3810-4fe3-8360-121aa527e153,-19.31,146.82,QLD,Townsville,debit,authorized,2644b8c6ccb943619c32369f059d9cce,POS,20-30,2018,9,4,8,6,Tuesday,7 days,81353.286
ACC-964839203,21,14.02,34266.7,1.0,CUS-2059096722,2018-09-04,Michael,M,-36.07,146.92,,f6711afd-e019-42a6-ad96-3eb7c956f977,-36.13,144.75,VIC,Echuca,debit,authorized,3e26a770dd924f8c86044450b88273ed,POS,20-30,2018,9,4,14,8,Tuesday,7 days,81353.286
ACC-964839203,21,40.87,34225.83,1.0,CUS-2059096722,2018-09-06,Michael,M,-36.07,146.92,,833b3b69-626f-4ec0-a770-b56bb3d95b4d,-37.75,144.77,VIC,Deer Park,debit,authorized,a3a250971ed349e9bab81d86b2526450,POS,20-30,2018,9,6,9,31,Thursday,7 days,81353.286
ACC-964839203,21,135.0,35651.03,,CUS-2059096722,2018-09-07,Michael,M,-36.07,146.92,,,,,,,debit,posted,8bf2c5302478481197227049258e457d,PAYMENT,20-30,2018,9,7,22,0,Friday,7 days,81353.286
ACC-964839203,21,28.0,35623.03,,CUS-2059096722,2018-09-08,Michael,M,-36.07,146.92,,,,,,,debit,posted,26b8cf611acd48108235acbd520321e6,PAYMENT,20-30,2018,9,8,4,0,Saturday,7 days,81353.286
ACC-964839203,21,1956.0,33667.03,,CUS-2059096722,2018-09-09,Michael,M,-36.07,146.92,,,,,,,debit,posted,a6a10b4c03524765b6ddd5c63d346c33,INTER BANK,20-30,2018,9,9,3,0,Sunday,7 days,81353.286
ACC-964839203,21,42.0,33625.03,,CUS-2059096722,2018-09-09,Michael,M,-36.07,146.92,,,,,,,debit,posted,b6990052ca2b4e809144eb140d71a647,PAYMENT,20-30,2018,9,9,10,0,Sunday,7 days,81353.286
ACC-964839203,21,15.12,33609.91,1.0,CUS-2059096722,2018-09-09,Michael,M,-36.07,146.92,,9e7acc06-fefa-4a4b-8018-691dea747044,-38.11,147.06,VIC,Sale,debit,authorized,8995774630df473891b92339af71c8a9,POS,20-30,2018,9,9,20,57,Sunday,7 days,81353.286
ACC-964839203,21,10.73,33599.18,1.0,CUS-2059096722,2018-09-09,Michael,M,-36.07,146.92,,abd3d83d-8741-4251-90d1-f4057f6ae24e,-37.98,145.08,VIC,Mentone,debit,authorized,4a07008348764b97a7a95f472be4cb57,SALES-POS,20-30,2018,9,9,21,17,Sunday,7 days,81353.286
ACC-964839203,21,11.44,33587.74,1.0,CUS-2059096722,2018-09-11,Michael,M,-36.07,146.92,,73481b19-b6d5-4216-a3ff-bfc2d199ea4e,-19.27,146.79,QLD,Hyde Park,debit,authorized,5db0b241736646a2a54a963bb4b8b1a5,SALES-POS,20-30,2018,9,11,11,49,Tuesday,7 days,81353.286
ACC-964839203,21,32.78,33554.96,1.0,CUS-2059096722,2018-09-13,Michael,M,-36.07,146.92,,f0e656b5-fcfc-44a1-b297-29826efcb2a4,-38.02,145.33,VIC,Berwick,debit,authorized,56c50b2767ff45139e3f9fc6c4e9db9f,POS,20-30,2018,9,13,22,25,Thursday,7 days,81353.286
ACC-964839203,21,85.49,33469.47,1.0,CUS-2059096722,2018-09-14,Michael,M,-36.07,146.92,,ef508b54-56af-402a-84ee-a831b0dbf0cf,-19.29,146.8,QLD,Townsville,debit,authorized,670daf5322504875a7b9254af69e4022,SALES-POS,20-30,2018,9,14,5,2,Friday,7 days,81353.286
ACC-964839203,21,28.0,35001.67,,CUS-2059096722,2018-09-15,Michael,M,-36.07,146.92,,,,,,,debit,posted,3c3f5fee0e934185852e7c4d71933ae4,PAYMENT,20-30,2018,9,15,4,0,Saturday,7 days,81353.286
ACC-964839203,21,42.0,34959.67,,CUS-2059096722,2018-09-16,Michael,M,-36.07,146.92,,,,,,,debit,posted,8dea9b73436e4da8a39434c0efc08d53,PAYMENT,20-30,2018,9,16,10,0,Sunday,7 days,81353.286
ACC-964839203,21,177.0,34782.67,,CUS-2059096722,2018-09-17,Michael,M,-36.07,146.92,,,,,,,debit,posted,b3d0e895ecb44b51be2e7a4aaa629658,PAYMENT,20-30,2018,9,17,18,0,Monday,7 days,81353.286
ACC-964839203,21,72.0,34710.67,,CUS-2059096722,2018-09-19,Michael,M,-36.07,146.92,,,,,,,debit,posted,636a6748b1454945bebc004e91375b27,PAYMENT,20-30,2018,9,19,14,0,Wednesday,7 days,81353.286
ACC-964839203,21,28.0,36242.87,,CUS-2059096722,2018-09-22,Michael,M,-36.07,146.92,,,,,,,debit,posted,e62b388915b04fe2815341e178f090c9,PAYMENT,20-30,2018,9,22,4,0,Saturday,7 days,81353.286
ACC-964839203,21,42.0,36200.87,,CUS-2059096722,2018-09-23,Michael,M,-36.07,146.92,,,,,,,debit,posted,ac441767455544ecb4ac0166547f920d,PAYMENT,20-30,2018,9,23,10,0,Sunday,7 days,81353.286
ACC-964839203,21,9.21,36191.66,1.0,CUS-2059096722,2018-09-25,Michael,M,-36.07,146.92,,3b2247ab-71d9-44fd-a4b3-f32b28f05a86,-37.91,145,VIC,Brighton,debit,authorized,a8b30f73d9e84bd48134f67a5ce558b9,POS,20-30,2018,9,25,10,59,Tuesday,7 days,81353.286
ACC-964839203,21,12.03,36179.63,0.0,CUS-2059096722,2018-09-25,Michael,M,-36.07,146.92,,0ddd541c-be04-4d46-bb42-830f81e11a8e,-37.91,145.02,VIC,Melbourne,debit,authorized,bce097a341cb44c2bc8db9b8f46d9ecc,POS,20-30,2018,9,25,16,44,Tuesday,7 days,81353.286
ACC-964839203,21,16.12,36163.51,1.0,CUS-2059096722,2018-09-25,Michael,M,-36.07,146.92,,b517a7f8-86b6-4b4d-a9fe-df43258ea44e,-38.1,145.17,VIC,Carrum Downs,debit,authorized,a1ef15fcb77340a2ace49628edffd0f5,POS,20-30,2018,9,25,22,10,Tuesday,7 days,81353.286
ACC-964839203,21,34.21,36129.3,1.0,CUS-2059096722,2018-09-26,Michael,M,-36.07,146.92,,b851566d-c0b8-46aa-88f8-b6822487196d,-37.85,144.99,VIC,Prahran,debit,authorized,15233afed17f44219e9c3a2ebf5bdcde,SALES-POS,20-30,2018,9,26,2,59,Wednesday,7 days,81353.286
ACC-964839203,21,26.72,36102.58,0.0,CUS-2059096722,2018-09-26,Michael,M,-36.07,146.92,,627fd34a-6375-45c6-bd73-3d6ee6991eb1,-37.95,145.08,VIC,Moorabbin,debit,authorized,4fc4b55cf0194f20bd0c7ad822a7758a,POS,20-30,2018,9,26,9,34,Wednesday,7 days,81353.286
ACC-964839203,21,17.54,36085.04,1.0,CUS-2059096722,2018-09-27,Michael,M,-36.07,146.92,,7052d8b7-7a37-48cd-ba91-1f5dcec208b0,-19.27,146.78,QLD,Currajong,debit,authorized,6e97df339e3f498bab58a953652e6b87,POS,20-30,2018,9,27,8,47,Thursday,7 days,81353.286
ACC-964839203,21,24.13,36060.91,1.0,CUS-2059096722,2018-09-27,Michael,M,-36.07,146.92,,3d720674-7197-4717-970e-77f5c813e81b,-37.98,145.07,VIC,Mentone,debit,authorized,dc3b064a423f40adb85d9e8eadbf64e2,POS,20-30,2018,9,27,9,10,Thursday,7 days,81353.286
ACC-964839203,21,5.73,36055.18,1.0,CUS-2059096722,2018-09-27,Michael,M,-36.07,146.92,,6bdb40f3-1779-4450-9969-badfb4ee02f4,-38.21,146.15,VIC,Trafalgar,debit,authorized,eb7b746d20424522b68697fb2c66f994,SALES-POS,20-30,2018,9,27,9,26,Thursday,7 days,81353.286
ACC-964839203,21,24.08,36031.1,1.0,CUS-2059096722,2018-09-27,Michael,M,-36.07,146.92,,436b4b33-23a6-4345-bc8d-978601b3a739,-38.1,144.35,VIC,Norlane,debit,authorized,5de80ede38fa4ae9a1d216d493d2a958,SALES-POS,20-30,2018,9,27,15,52,Thursday,7 days,81353.286
ACC-964839203,21,31.09,36000.01,1.0,CUS-2059096722,2018-09-27,Michael,M,-36.07,146.92,,dd91811c-6e00-4d2a-9356-7f04f1a7f020,-37.91,144.99,VIC,Brighton,debit,authorized,acec2cd419a54a34bfc420336fd2bdf7,POS,20-30,2018,9,27,17,19,Thursday,7 days,81353.286
ACC-964839203,21,28.0,37532.21,,CUS-2059096722,2018-09-29,Michael,M,-36.07,146.92,,,,,,,debit,posted,6310e2088cac4f02934ce78a8264e8c2,PAYMENT,20-30,2018,9,29,4,0,Saturday,7 days,81353.286
ACC-964839203,21,27.53,37504.68,1.0,CUS-2059096722,2018-09-29,Michael,M,-36.07,146.92,,6b0a8d80-9b7a-410e-823d-f9300e69d44d,-19.27,146.81,QLD,Townsville City,debit,authorized,86115c597b25491b96bc70d4afc044db,SALES-POS,20-30,2018,9,29,20,42,Saturday,7 days,81353.286
ACC-964839203,21,42.0,37446.35,,CUS-2059096722,2018-09-30,Michael,M,-36.07,146.92,,,,,,,debit,posted,4c9d60a11c044d119f6d4bb6b632d7aa,PAYMENT,20-30,2018,9,30,10,0,Sunday,7 days,81353.286
ACC-964839203,21,16.33,37488.35,1.0,CUS-2059096722,2018-09-30,Michael,M,-36.07,146.92,,ca076819-b61b-4cbd-8909-247c788d1cf1,-37.91,145.16,VIC,Ferntree Gully,debit,authorized,e9a9b845a3654c68bee04ebdfc06b813,SALES-POS,20-30,2018,9,30,10,15,Sunday,7 days,81353.286
ACC-964839203,21,25.07,37421.28,1.0,CUS-2059096722,2018-09-30,Michael,M,-36.07,146.92,,4b8e0a28-9819-4e38-ad83-131dc5dc7a79,-37.98,145.21,VIC,Dandenong,debit,authorized,63093fd8df09440faedb05cf76354d36,SALES-POS,20-30,2018,9,30,19,11,Sunday,7 days,81353.286
ACC-964839203,21,7.61,37413.67,0.0,CUS-2059096722,2018-10-01,Michael,M,-36.07,146.92,,7736a415-bf5b-4555-867c-0129250d5a90,-19.26,146.82,QLD,South Townsville,debit,authorized,96c6ee333f6e4831b354b18944b387bc,POS,20-30,2018,10,1,15,55,Monday,7 days,81353.286
ACC-964839203,21,3.52,37410.15,1.0,CUS-2059096722,2018-10-03,Michael,M,-36.07,146.92,,46b96912-20ca-4210-b5fa-65ac84940c91,-37.8,144.91,VIC,Footscray,debit,authorized,0829e97fe1c9435693ee3032a2219e49,SALES-POS,20-30,2018,10,3,18,13,Wednesday,7 days,81353.286
ACC-964839203,21,28.0,38942.35,,CUS-2059096722,2018-10-06,Michael,M,-36.07,146.92,,,,,,,debit,posted,428f0bef53d94acabaf719701e3ef209,PAYMENT,20-30,2018,10,6,4,0,Saturday,7 days,81353.286
ACC-964839203,21,42.0,38900.35,,CUS-2059096722,2018-10-07,Michael,M,-36.07,146.92,,,,,,,debit,posted,7bee386a2fbe4d658c003dbb835b095d,PAYMENT,20-30,2018,10,7,10,0,Sunday,7 days,81353.286
ACC-964839203,21,135.0,38765.35,,CUS-2059096722,2018-10-07,Michael,M,-36.07,146.92,,,,,,,debit,posted,90b3348a00cb4b23b223ba1ff6878de3,PAYMENT,20-30,2018,10,7,22,0,Sunday,7 days,81353.286
ACC-964839203,21,11.73,38753.62,1.0,CUS-2059096722,2018-10-08,Michael,M,-36.07,146.92,,9a10665e-b61b-4130-8951-b4db2a38edcd,-37.78,144.92,VIC,Ascot Vale,debit,authorized,5c42aa2654bf4ccc9c49dea503f14743,SALES-POS,20-30,2018,10,8,21,18,Monday,7 days,81353.286
ACC-964839203,21,28.0,40285.82,,CUS-2059096722,2018-10-13,Michael,M,-36.07,146.92,,,,,,,debit,posted,69f96ab93a3d47d8a38289a3d81aa58b,PAYMENT,20-30,2018,10,13,4,0,Saturday,7 days,81353.286
ACC-964839203,21,42.0,40243.82,,CUS-2059096722,2018-10-14,Michael,M,-36.07,146.92,,,,,,,debit,posted,7b0ed7d652674adca08ed946ee6c2795,PAYMENT,20-30,2018,10,14,10,0,Sunday,7 days,81353.286
ACC-964839203,21,44.76,40199.06,0.0,CUS-2059096722,2018-10-15,Michael,M,-36.07,146.92,,d7cf5e5e-8a03-47c8-9a11-db0bc650ceb9,-37.76,145.35,VIC,Lilydale,debit,authorized,7bdcfd4e0fc9427eb24df42fdf6b5a4f,SALES-POS,20-30,2018,10,15,23,27,Monday,7 days,81353.286
ACC-964839203,21,33.17,40165.89,1.0,CUS-2059096722,2018-10-16,Michael,M,-36.07,146.92,,379e1521-2ea5-425f-ad97-dee5854ba7bd,-19.16,146.86,QLD,Nelly Bay,debit,authorized,bdd6005f5c9948198b2a720b32982b24,POS,20-30,2018,10,16,10,33,Tuesday,7 days,81353.286
ACC-964839203,21,29.62,40136.27,1.0,CUS-2059096722,2018-10-17,Michael,M,-36.07,146.92,,3b4cef6e-7b92-41cb-92cb-2602d25486b6,-37.82,145.03,VIC,Hawthorn,debit,authorized,99a787b5aa7f4d66a28f37a8fe97e2f4,POS,20-30,2018,10,17,11,6,Wednesday,7 days,81353.286
ACC-964839203,21,6.9,40129.37,1.0,CUS-2059096722,2018-10-17,Michael,M,-36.07,146.92,,ebbf1381-bafe-4eb1-b0a3-27a37410f12b,-36.06,145.2,VIC,Nathalia,debit,authorized,2b60dea46afb43289e72b76dcc2370ff,POS,20-30,2018,10,17,14,50,Wednesday,7 days,81353.286
ACC-964839203,21,10.89,40118.48,1.0,CUS-2059096722,2018-10-17,Michael,M,-36.07,146.92,,63721c0d-ef24-4c23-98d0-722561c938ac,-37.78,144.89,VIC,Maribyrnong,debit,authorized,3907d8f1996d418fa866c36c3539e372,POS,20-30,2018,10,17,15,15,Wednesday,7 days,81353.286
ACC-964839203,21,177.0,39941.48,,CUS-2059096722,2018-10-17,Michael,M,-36.07,146.92,,,,,,,debit,posted,51f64c8c33784db5bf2d49d65a24d562,PAYMENT,20-30,2018,10,17,18,0,Wednesday,7 days,81353.286
ACC-964839203,21,85.76,39855.72,1.0,CUS-2059096722,2018-10-17,Michael,M,-36.07,146.92,,12199c94-c98a-454d-86c7-330b9d109260,-27.45,153.04,QLD,Newstead,debit,authorized,386911f41ff44c0c835e72b0ba751510,SALES-POS,20-30,2018,10,17,22,7,Wednesday,7 days,81353.286
ACC-964839203,21,13.78,39841.94,1.0,CUS-2059096722,2018-10-18,Michael,M,-36.07,146.92,,59e7a44d-cd53-41cb-8f09-5f8abe7164cd,-19.26,146.82,QLD,South Townsville,debit,authorized,4fa554186b7d4eaba2fa79b4e604903f,SALES-POS,20-30,2018,10,18,12,19,Thursday,7 days,81353.286
ACC-964839203,21,10.25,39831.69,1.0,CUS-2059096722,2018-10-18,Michael,M,-36.07,146.92,,7d629418-2abd-4e86-b866-1ba85ccf1014,-37.85,144.99,VIC,South Yarra,debit,authorized,4405d5541ffe4bc2bc1d79c9574e69fd,SALES-POS,20-30,2018,10,18,17,49,Thursday,7 days,81353.286
ACC-964839203,21,27.09,39804.6,1.0,CUS-2059096722,2018-10-18,Michael,M,-36.07,146.92,,a0477f9c-ace4-4a03-9553-0e2b0b9080c8,-37.95,145.04,VIC,Highett,debit,authorized,097ac11ffb264e98b9460a8e80a350c6,SALES-POS,20-30,2018,10,18,19,9,Thursday,7 days,81353.286
ACC-964839203,21,72.0,39732.6,,CUS-2059096722,2018-10-19,Michael,M,-36.07,146.92,,,,,,,debit,posted,88aa49774dfb4599a37e8efddcb93f74,PAYMENT,20-30,2018,10,19,14,0,Friday,7 days,81353.286
ACC-964839203,21,28.0,41264.8,,CUS-2059096722,2018-10-20,Michael,M,-36.07,146.92,,,,,,,debit,posted,ba68c9b1e38546f6b61d3f4cac2d3377,PAYMENT,20-30,2018,10,20,4,0,Saturday,7 days,81353.286
ACC-964839203,21,42.0,41222.8,,CUS-2059096722,2018-10-21,Michael,M,-36.07,146.92,,,,,,,debit,posted,3fcd581452d048529b5202ef31b44233,PAYMENT,20-30,2018,10,21,10,0,Sunday,7 days,81353.286
ACC-964839203,21,22.9,41199.9,1.0,CUS-2059096722,2018-10-22,Michael,M,-36.07,146.92,,a4ed3be6-20d8-4c32-a81b-7dd8fe50993e,-38.15,145.17,VIC,Frankston,debit,authorized,6e703e8b8dfe45ca99526b4aeedb17c0,SALES-POS,20-30,2018,10,22,21,21,Monday,7 days,81353.286
ACC-964839203,21,32.05,41167.85,1.0,CUS-2059096722,2018-10-23,Michael,M,-36.07,146.92,,d582810b-04c5-4fec-9016-ab0ee3c27e01,-37.84,144.69,VIC,Tarneit,debit,authorized,0249cba2ce284b7790426dfb1af17d85,POS,20-30,2018,10,23,21,9,Tuesday,7 days,81353.286
ACC-964839203,21,10.46,41157.39,1.0,CUS-2059096722,2018-10-24,Michael,M,-36.07,146.92,,5ed245da-0805-4fcf-b011-6c5f0d885cb2,-38.15,144.36,VIC,Geelong,debit,authorized,0e2464180695459f87b3c43372eeff2a,POS,20-30,2018,10,24,16,46,Wednesday,7 days,81353.286
ACC-964839203,21,24.93,41132.46,1.0,CUS-2059096722,2018-10-25,Michael,M,-36.07,146.92,,59f24819-82a5-4772-a88c-a023496d11dd,-38.15,144.36,VIC,Geelong,debit,authorized,f98177af516d4bc196e5ce183edc7dc0,POS,20-30,2018,10,25,1,24,Thursday,7 days,81353.286
ACC-964839203,21,21.74,41110.72,1.0,CUS-2059096722,2018-10-26,Michael,M,-36.07,146.92,,342e0729-4bb1-4a11-8275-a0c7ec77521d,-37.83,145.06,VIC,Camberwell,debit,authorized,6fd857ab973e4eeab38832138353df36,SALES-POS,20-30,2018,10,26,8,55,Friday,7 days,81353.286
ACC-964839203,21,28.0,42642.92,,CUS-2059096722,2018-10-27,Michael,M,-36.07,146.92,,,,,,,debit,posted,9a3a5f6c1576441880e7c182fef2833c,PAYMENT,20-30,2018,10,27,4,0,Saturday,7 days,81353.286
ACC-964839203,21,24.67,42618.25,0.0,CUS-2059096722,2018-10-27,Michael,M,-36.07,146.92,,49df5803-a47e-436f-bcb8-9e2d658c17eb,-36.47,147.01,VIC,Dederang,debit,authorized,7a3ce704a8934ee9bb6b717a3857e8ad,SALES-POS,20-30,2018,10,27,17,25,Saturday,7 days,81353.286
ACC-964839203,21,54.2,42564.05,1.0,CUS-2059096722,2018-10-27,Michael,M,-36.07,146.92,,00ac655f-0c7b-4f67-9ac9-26ee4c3a07ca,-36.02,146,VIC,Yarrawonga,debit,authorized,a50d7c7b9b5f47fbbc91760f2dc80637,POS,20-30,2018,10,27,22,59,Saturday,7 days,81353.286
ACC-964839203,21,42.0,42522.05,,CUS-2059096722,2018-10-28,Michael,M,-36.07,146.92,,,,,,,debit,posted,e566b8ffb7b646b2add101e7fb7430d8,PAYMENT,20-30,2018,10,28,10,0,Sunday,7 days,81353.286
ACC-964839203,21,16.44,42505.61,1.0,CUS-2059096722,2018-10-30,Michael,M,-36.07,146.92,,3fe81527-e10f-4341-a789-d227e7180dab,-38.1,145.19,VIC,Carrum Downs,debit,authorized,e9c6f77ec3ab4acf9e066a9f8003de83,POS,20-30,2018,10,30,21,46,Tuesday,7 days,81353.286
ACC-964839203,21,18.59,42487.02,1.0,CUS-2059096722,2018-10-31,Michael,M,-36.07,146.92,,bfe7e7dc-bb5d-4612-a768-d9411f62042b,-36.04,146.96,NSW,Lavington,debit,authorized,159927bcfeff434ab2f8399c8aadf0fe,SALES-POS,20-30,2018,10,31,10,15,Wednesday,7 days,81353.286
ACC-964839203,21,11.17,42475.85,0.0,CUS-2059096722,2018-10-31,Michael,M,-36.07,146.92,,1fadfa86-1a45-497c-a89b-48d42dec5f60,-37.98,145.05,VIC,Beaumaris,debit,authorized,7b62122d85f14008afe73aa064da5a0a,POS,20-30,2018,10,31,10,39,Wednesday,7 days,81353.286
ACC-964839203,21,45.95,42429.9,1.0,CUS-2059096722,2018-10-31,Michael,M,-36.07,146.92,,010eb8c1-e8e2-46d6-8315-a670d7489eb3,-37.86,145.03,VIC,Malvern,debit,authorized,e1eec8b692b34e03a595d18ef2480235,POS,20-30,2018,10,31,10,55,Wednesday,7 days,81353.286
ACC-964839203,21,32.12,42397.78,1.0,CUS-2059096722,2018-10-31,Michael,M,-36.07,146.92,,5c78a6f7-6d63-4b56-bd4a-8da9f39f9f2b,-16.51,145.46,QLD,Port Douglas,debit,authorized,84cdbe46f8d9462f869b44379dd256b2,POS,20-30,2018,10,31,11,2,Wednesday,7 days,81353.286
ACC-964839203,21,23.67,42374.11,1.0,CUS-2059096722,2018-10-31,Michael,M,-36.07,146.92,,5e259d30-80dd-44e9-8482-0af60cad13d8,-37.86,144.69,VIC,Hoppers Crossing,debit,authorized,313d47de17bd49679a53ec7737df420c,POS,20-30,2018,10,31,11,28,Wednesday,7 days,81353.286
ACC-964839203,21,31.72,42342.39,0.0,CUS-2059096722,2018-10-31,Michael,M,-36.07,146.92,,5c78a6f7-6d63-4b56-bd4a-8da9f39f9f2b,-16.51,145.46,QLD,Port Douglas,debit,authorized,e97559cac56743769b0dcfcc70548f8b,POS,20-30,2018,10,31,15,23,Wednesday,7 days,81353.286
ACC-80388494,28,9.21,823.53,1.0,CUS-1140341822,2018-08-01,Dustin,M,-37.42,144.97,,4ae2bdc0-e282-45f4-be7c-aa2853fda03b,-37.82,144.94,VIC,Docklands,debit,authorized,44f99c5dcf804f14842c2a9a957f3298,POS,20-30,2018,8,1,19,14,Wednesday,14 days,49966.154
ACC-80388494,28,46.36,777.17,1.0,CUS-1140341822,2018-08-06,Dustin,M,-37.42,144.97,,86f6f266-ca2e-4a5e-b563-2a40bda8d2e0,-37.82,144.96,VIC,Melbourne,debit,authorized,8ec9425a0f5745be8335243f47231068,POS,20-30,2018,8,6,10,42,Monday,14 days,49966.154
ACC-80388494,28,4.09,773.08,0.0,CUS-1140341822,2018-08-09,Dustin,M,-37.42,144.97,,3ee9f6f9-fa96-412f-99d5-938b72f749d1,-37.81,145.23,VIC,Ringwood,debit,authorized,831886b5ce6f4496af6c3677d1b2e507,SALES-POS,20-30,2018,8,9,7,50,Thursday,14 days,49966.154
ACC-80388494,28,31.26,741.82,1.0,CUS-1140341822,2018-08-09,Dustin,M,-37.42,144.97,,685828de-d4e5-44ce-b19b-d73d0ecd8da7,-37.85,144.71,VIC,Tarneit,debit,authorized,a8bedbcc6555460194b63e43b0a27645,SALES-POS,20-30,2018,8,9,22,32,Thursday,14 days,49966.154
ACC-80388494,28,11.72,2646.61,1.0,CUS-1140341822,2018-08-11,Dustin,M,-37.42,144.97,,8593016a-c17c-4c8d-9180-ba8b307fe0b6,-37.46,144.68,VIC,Riddells Creek,debit,authorized,76807d61090f437eabc7278b9ae637f1,POS,20-30,2018,8,11,21,38,Saturday,14 days,49966.154
ACC-80388494,28,8.19,2638.42,1.0,CUS-1140341822,2018-08-14,Dustin,M,-37.42,144.97,,b058eafd-52f8-4de8-8caa-5cac0144173a,-31.94,115.88,WA,Perth,debit,authorized,326edeed4c674d4095eb5b4c654c2613,SALES-POS,20-30,2018,8,14,22,11,Tuesday,14 days,49966.154
ACC-80388494,28,61.55,2576.87,1.0,CUS-1140341822,2018-08-15,Dustin,M,-37.42,144.97,,ac754056-ada8-4e02-a367-e4887140f24e,-37.81,144.97,VIC,Melbourne,debit,authorized,cebf733249dc4c178b3efee2e3655e6c,POS,20-30,2018,8,15,9,9,Wednesday,14 days,49966.154
ACC-80388494,28,15.35,2561.52,0.0,CUS-1140341822,2018-08-15,Dustin,M,-37.42,144.97,,d1c6546c-e9e3-433f-9f62-d955f805a852,-37.78,145.12,VIC,Doncaster,debit,authorized,0e3574ca3b274914b3d383eb09865d18,SALES-POS,20-30,2018,8,15,9,25,Wednesday,14 days,49966.154
ACC-80388494,28,7.59,2553.93,0.0,CUS-1140341822,2018-08-15,Dustin,M,-37.42,144.97,,fb4000b1-3358-4664-80ef-9cf4706c2381,-37.8,144.98,VIC,Fitzroy,debit,authorized,bfb91e55641d47f6a5e904e947fad849,SALES-POS,20-30,2018,8,15,11,6,Wednesday,14 days,49966.154
ACC-80388494,28,21.92,2532.01,1.0,CUS-1140341822,2018-08-15,Dustin,M,-37.42,144.97,,fe0cf915-6b9f-4a2d-aa8f-ae168826fa5c,-37.38,140.84,SA,Penola,debit,authorized,9ddf1b395bd8464e9f3b17cec510586c,SALES-POS,20-30,2018,8,15,11,48,Wednesday,14 days,49966.154
ACC-80388494,28,188.0,2344.01,,CUS-1140341822,2018-08-21,Dustin,M,-37.42,144.97,,,,,,,debit,posted,851023e524c24261aec4ca08a342eea1,PAYMENT,20-30,2018,8,21,2,0,Tuesday,14 days,49966.154
ACC-80388494,28,90.0,2254.01,,CUS-1140341822,2018-08-22,Dustin,M,-37.42,144.97,,,,,,,debit,posted,0b519b545bbf4b3e9502067dd915d8a1,INTER BANK,20-30,2018,8,22,11,0,Wednesday,14 days,49966.154
ACC-80388494,28,96.0,4074.52,,CUS-1140341822,2018-08-27,Dustin,M,-37.42,144.97,,,,,,,debit,posted,9b289b524c9844b89645f1a121165a64,PAYMENT,20-30,2018,8,27,4,0,Monday,14 days,49966.154
ACC-80388494,28,21.07,4053.45,1.0,CUS-1140341822,2018-09-01,Dustin,M,-37.42,144.97,,af49051a-591d-4b08-bd3c-27730b70ed37,-37.91,145.09,VIC,Oakleigh,debit,authorized,0298fe066c7243e2acd575613bedddb9,POS,20-30,2018,9,1,18,33,Saturday,14 days,49966.154
ACC-80388494,28,8.4,4045.05,1.0,CUS-1140341822,2018-09-03,Dustin,M,-37.42,144.97,,f54e8993-7ae0-4b69-9e65-6f43eb27d210,-37.81,144.97,VIC,Fitzroy,debit,authorized,5995b9cdc37b4774b95dd9cd4530079e,POS,20-30,2018,9,3,10,15,Monday,14 days,49966.154
ACC-80388494,28,25.52,4019.53,1.0,CUS-1140341822,2018-09-03,Dustin,M,-37.42,144.97,,5c17df84-8fa4-4f1b-b0de-30d8d855e144,-37.82,144.88,VIC,Yarraville,debit,authorized,f046a1b8e78c49a58d9e324dc67c5aad,SALES-POS,20-30,2018,9,3,10,32,Monday,14 days,49966.154
ACC-80388494,28,15.59,4003.94,1.0,CUS-1140341822,2018-09-03,Dustin,M,-37.42,144.97,,33de11be-d1af-410c-a6ca-e7ff735253f2,-33.91,151.17,NSW,Marrickville,debit,authorized,2d6984333772470b88dba4c2c5ecdd5a,POS,20-30,2018,9,3,20,31,Monday,14 days,49966.154
ACC-80388494,28,24.01,3979.93,1.0,CUS-1140341822,2018-09-04,Dustin,M,-37.42,144.97,,bfac8fdf-39fb-4300-9267-0a7097d3f365,-37.81,144.97,VIC,East Melbourne,debit,authorized,77dfd0ea900745819a25200f1194185b,SALES-POS,20-30,2018,9,4,9,42,Tuesday,14 days,49966.154
ACC-80388494,28,10.48,5885.96,1.0,CUS-1140341822,2018-09-13,Dustin,M,-37.42,144.97,,9550a2b5-7803-43af-b84f-856c9cee2455,-27.58,153.09,QLD,Eight Mile Plains,debit,authorized,b177332459424fcea481523c82e5888a,POS,20-30,2018,9,13,12,41,Thursday,14 days,49966.154
ACC-80388494,28,60.64,5825.32,1.0,CUS-1140341822,2018-09-15,Dustin,M,-37.42,144.97,,5cf787f7-83e4-4354-bae2-05be0334d290,-27.41,153.08,QLD,Eagle Farm,debit,authorized,2c5d3ab1f9ce445181c3c6fea0fb3660,POS,20-30,2018,9,15,18,41,Saturday,14 days,49966.154
ACC-80388494,28,251.48,5573.84,1.0,CUS-1140341822,2018-09-16,Dustin,M,-37.42,144.97,,01e137c0-b908-42e5-a904-0eaf8f12326f,-37.76,145.17,VIC,Doncaster East,debit,authorized,cd50891d739b49e3b9cba738e6da4b75,POS,20-30,2018,9,16,8,1,Sunday,14 days,49966.154
ACC-80388494,28,16.28,5557.56,1.0,CUS-1140341822,2018-09-16,Dustin,M,-37.42,144.97,,b601f995-0311-4957-b9b7-4c2ee08b5376,-37.81,144.97,VIC,Melbourne,debit,authorized,e9d04f7421944cd1b5e27e47c6692964,POS,20-30,2018,9,16,10,12,Sunday,14 days,49966.154
ACC-80388494,28,11.41,5546.15,1.0,CUS-1140341822,2018-09-20,Dustin,M,-37.42,144.97,,b3b5cd3e-27ce-4a49-b7d4-43f4ee0981bb,-37.81,145.04,VIC,Kew,debit,authorized,317201c37c104adaae5fb76335b7d078,POS,20-30,2018,9,20,8,25,Thursday,14 days,49966.154
ACC-80388494,28,12.42,5533.73,0.0,CUS-1140341822,2018-09-20,Dustin,M,-37.42,144.97,,a1dbeae7-c107-43c9-8d39-b7011109179d,-37.87,145.24,VIC,Wantirna South,debit,authorized,a584432b44bb43358907c7f649390108,POS,20-30,2018,9,20,10,35,Thursday,14 days,49966.154
ACC-80388494,28,106.41,5427.32,1.0,CUS-1140341822,2018-09-20,Dustin,M,-37.42,144.97,,142514bf-19ef-4bf7-a00d-aac13c51fbe9,-37.78,145.26,VIC,Ringwood,debit,authorized,214c0efffcda4fa29950400a36123c25,POS,20-30,2018,9,20,13,21,Thursday,14 days,49966.154
ACC-80388494,28,188.0,5239.32,,CUS-1140341822,2018-09-21,Dustin,M,-37.42,144.97,,,,,,,debit,posted,991c32d86c0b43fd969bce9158725060,PAYMENT,20-30,2018,9,21,2,0,Friday,14 days,49966.154
ACC-80388494,28,19.83,5219.49,1.0,CUS-1140341822,2018-09-21,Dustin,M,-37.42,144.97,,bbde3dae-ae79-4b6b-bb03-4d91a7f98b3b,-37.81,147.63,VIC,Eastwood,debit,authorized,55aa9989c0a44a54ab88c48466567d58,SALES-POS,20-30,2018,9,21,8,0,Friday,14 days,49966.154
ACC-80388494,28,90.0,7046.0,,CUS-1140341822,2018-09-22,Dustin,M,-37.42,144.97,,,,,,,debit,posted,7cb176e3a713489b83da65fafe9442a5,INTER BANK,20-30,2018,9,22,11,0,Saturday,14 days,49966.154
ACC-80388494,28,25.72,7020.28,1.0,CUS-1140341822,2018-09-22,Dustin,M,-37.42,144.97,,6f7dccf6-2327-4ce1-9a4d-a2c57201c2fa,-37.77,144.89,VIC,Maribyrnong,debit,authorized,8f47b522ba0240d1aefa3d2f085d2810,POS,20-30,2018,9,22,14,18,Saturday,14 days,49966.154
ACC-80388494,28,6.43,7013.85,1.0,CUS-1140341822,2018-09-23,Dustin,M,-37.42,144.97,,35b4eb35-f89c-4691-8d78-719ed4f4b397,-37.89,145.06,VIC,Carnegie,debit,authorized,e6654ff412d740c1b8e4aa641244ac16,POS,20-30,2018,9,23,9,19,Sunday,14 days,49966.154
ACC-80388494,28,1270.49,5743.36,0.0,CUS-1140341822,2018-09-23,Dustin,M,-37.42,144.97,,722430c6-39e6-4570-9323-3db6191e6548,-37.85,145.04,VIC,Malvern,debit,authorized,03ca580133cb482395cbfc391000ea8e,SALES-POS,20-30,2018,9,23,10,18,Sunday,14 days,49966.154
ACC-80388494,28,20.55,5722.81,1.0,CUS-1140341822,2018-09-24,Dustin,M,-37.42,144.97,,fa9aebb4-d28f-4708-9497-4cc24c1b9d9a,-37.42,144.56,VIC,Macedon,debit,authorized,93015ab8c9c14346ade2e6f84956cdda,SALES-POS,20-30,2018,9,24,12,16,Monday,14 days,49966.154
ACC-80388494,28,96.0,5626.81,,CUS-1140341822,2018-09-27,Dustin,M,-37.42,144.97,,,,,,,debit,posted,0c495055d3924e5fa52cb3cefcc7e7be,PAYMENT,20-30,2018,9,27,4,0,Thursday,14 days,49966.154
ACC-80388494,28,12.77,5614.04,1.0,CUS-1140341822,2018-10-05,Dustin,M,-37.42,144.97,,03a3ec31-b8b8-411a-b814-77ef8f4bfd33,-33.89,151.21,NSW,Surry Hills,debit,authorized,1ee945ed39074942a211a5aa62e14ac4,POS,20-30,2018,10,5,16,0,Friday,14 days,49966.154
ACC-80388494,28,26.93,7503.62,1.0,CUS-1140341822,2018-10-05,Dustin,M,-37.42,144.97,,fc133bc5-2c4a-4261-ba1e-6c6339a8363f,-33.87,151.21,NSW,Sydney,debit,authorized,7515607a3fbb454bb20e0eed03186ba6,SALES-POS,20-30,2018,10,5,20,14,Friday,14 days,49966.154
ACC-80388494,28,18.94,7484.68,0.0,CUS-1140341822,2018-10-05,Dustin,M,-37.42,144.97,,29f447d7-4a2c-48d3-84f8-e3db118fc62c,-37.82,144.96,VIC,Melbourne,debit,authorized,85ff236dd6394edcad72c061b9fee4a1,POS,20-30,2018,10,5,22,25,Friday,14 days,49966.154
ACC-80388494,28,8.99,7475.69,1.0,CUS-1140341822,2018-10-11,Dustin,M,-37.42,144.97,,37cd09c5-f238-4d32-8a60-03755b38b744,-27.53,153.1,QLD,Mansfield,debit,authorized,fec30f03eeab451ca9fe166c0f983b2b,POS,20-30,2018,10,11,1,46,Thursday,14 days,49966.154
ACC-80388494,28,11.76,7463.93,1.0,CUS-1140341822,2018-10-11,Dustin,M,-37.42,144.97,,f16b9716-836a-4185-9229-d2e8ca38d2a3,-37.86,144.98,VIC,Saint Kilda,debit,authorized,070d8dd6e739440a89f6542cebced55b,SALES-POS,20-30,2018,10,11,11,5,Thursday,14 days,49966.154
ACC-80388494,28,26.99,7436.94,1.0,CUS-1140341822,2018-10-11,Dustin,M,-37.42,144.97,,c32f30a1-cc6f-4946-8fc8-c8b65c98c013,-37.79,145.17,VIC,Doncaster East,debit,authorized,1e1b94f159484ba1962fe72671b0eb07,SALES-POS,20-30,2018,10,11,17,51,Thursday,14 days,49966.154
ACC-80388494,28,9.77,7427.17,1.0,CUS-1140341822,2018-10-12,Dustin,M,-37.42,144.97,,ca5ef04b-b754-4355-b724-f05037979c6b,-37.8,144.96,VIC,Carlton,debit,authorized,1fc62a6269444c9bb954dd73d87b4dc6,SALES-POS,20-30,2018,10,12,13,55,Friday,14 days,49966.154
ACC-80388494,28,15.29,7411.88,0.0,CUS-1140341822,2018-10-12,Dustin,M,-37.42,144.97,,2089536e-ac22-4557-9e32-11d7fe1af2ee,-37.81,144.96,VIC,Melbourne,debit,authorized,1aea43affe8048edad275788f310c835,SALES-POS,20-30,2018,10,12,16,57,Friday,14 days,49966.154
ACC-80388494,28,95.86,7316.02,1.0,CUS-1140341822,2018-10-12,Dustin,M,-37.42,144.97,,1ce1a016-b4fb-417d-b51f-b7e15466e331,-38.03,145.3,VIC,Narre Warren South,debit,authorized,fb137d1cb85549918b1cadc32de2740d,POS,20-30,2018,10,12,19,0,Friday,14 days,49966.154
ACC-80388494,28,24.14,7291.88,1.0,CUS-1140341822,2018-10-14,Dustin,M,-37.42,144.97,,1ac9bf19-2ef1-483c-aad6-f3318830519d,-37.88,145.22,VIC,Wantirna South,debit,authorized,e55e9dd25f2b40eaa46818b545eed815,POS,20-30,2018,10,14,9,23,Sunday,14 days,49966.154
ACC-80388494,28,25.75,7266.13,1.0,CUS-1140341822,2018-10-15,Dustin,M,-37.42,144.97,,fef69d73-ae2c-4a2a-813a-0411af20ad08,-37.4,144.59,VIC,Mount Macedon,debit,authorized,da5f7c99c4114e95b8fd7b6b324a68ab,POS,20-30,2018,10,15,8,58,Monday,14 days,49966.154
ACC-80388494,28,11.08,7255.05,1.0,CUS-1140341822,2018-10-16,Dustin,M,-37.42,144.97,,8f6ba2e6-3049-4545-a336-ba96cfb670ec,-37.72,145.01,VIC,Reservoir,debit,authorized,7ca51b35c152438486ef39bcd85cd8cf,POS,20-30,2018,10,16,21,23,Tuesday,14 days,49966.154
ACC-80388494,28,42.63,7212.42,1.0,CUS-1140341822,2018-10-16,Dustin,M,-37.42,144.97,,d35d0f8c-91f8-450f-990c-0b9f66b92ef3,-33.87,151.21,NSW,Sydney,debit,authorized,15fc471895c042cf85f3093cba064677,SALES-POS,20-30,2018,10,16,22,0,Tuesday,14 days,49966.154
ACC-80388494,28,46.96,7165.46,1.0,CUS-1140341822,2018-10-17,Dustin,M,-37.42,144.97,,b8e8c92e-b8ae-427c-ad12-350707c77b74,-37.86,145.05,VIC,Glen Iris,debit,authorized,2ef43b2327e94812a4a3861dd6fc8103,POS,20-30,2018,10,17,1,1,Wednesday,14 days,49966.154
ACC-80388494,28,47.01,7118.45,1.0,CUS-1140341822,2018-10-17,Dustin,M,-37.42,144.97,,86f6f266-ca2e-4a5e-b563-2a40bda8d2e0,-37.82,144.96,VIC,Melbourne,debit,authorized,c7dc2ca31ebd44f6beb736f82c16bba7,SALES-POS,20-30,2018,10,17,4,42,Wednesday,14 days,49966.154
ACC-80388494,28,1271.46,5846.99,1.0,CUS-1140341822,2018-10-18,Dustin,M,-37.42,144.97,,722430c6-39e6-4570-9323-3db6191e6548,-37.85,145.04,VIC,Malvern,debit,authorized,63b587d298e94949a23dc5a2808f609e,SALES-POS,20-30,2018,10,18,15,53,Thursday,14 days,49966.154
ACC-80388494,28,12.24,5834.75,0.0,CUS-1140341822,2018-10-18,Dustin,M,-37.42,144.97,,5d1d344f-30dc-468c-afc5-3fe3c241a550,-37.81,144.96,VIC,Melbourne,debit,authorized,27ec8fb12a184f0b88f452c030843f1b,POS,20-30,2018,10,18,20,9,Thursday,14 days,49966.154
ACC-80388494,28,6.73,5828.02,1.0,CUS-1140341822,2018-10-18,Dustin,M,-37.42,144.97,,b7775d17-b9b8-4d0e-9d66-20760f186f8f,-37.82,144.95,VIC,Melbourne,debit,authorized,3e2893a0eda04ddc9fa88e02e5675322,SALES-POS,20-30,2018,10,18,21,46,Thursday,14 days,49966.154
ACC-80388494,28,17.49,5810.53,1.0,CUS-1140341822,2018-10-19,Dustin,M,-37.42,144.97,,c7744039-42d4-42b8-9976-9efde3e18264,-37.86,145.08,VIC,Ashburton,debit,authorized,8bf44614ab154e89857f92ee993c015d,POS,20-30,2018,10,19,2,43,Friday,14 days,49966.154
ACC-80388494,28,54.8,5755.73,0.0,CUS-1140341822,2018-10-19,Dustin,M,-37.42,144.97,,2a61083e-9ff2-426f-8d3e-f48edcc6a4e6,-37.84,144.98,VIC,Melbourne,debit,authorized,251f84ecdaf344c9a2de7cc0512359a0,POS,20-30,2018,10,19,12,14,Friday,14 days,49966.154
ACC-80388494,28,13.76,5741.97,1.0,CUS-1140341822,2018-10-19,Dustin,M,-37.42,144.97,,d681ecf5-579b-4b94-b1aa-0808dbe4fa0a,-37.81,144.96,VIC,Melbourne,debit,authorized,6f004569d8544998a8f845f85dae9770,POS,20-30,2018,10,19,14,40,Friday,14 days,49966.154
ACC-80388494,28,53.13,7605.35,1.0,CUS-1140341822,2018-10-20,Dustin,M,-37.42,144.97,,37d3852c-39b1-4958-99e6-20658e47b693,-37.88,145.16,VIC,Glen Waverley,debit,authorized,699f2a571d88456cb047a752d3b05c9a,SALES-POS,20-30,2018,10,20,1,17,Saturday,14 days,49966.154
ACC-80388494,28,12.3,7593.05,1.0,CUS-1140341822,2018-10-20,Dustin,M,-37.42,144.97,,6f992a82-2718-4c13-998a-a161a1abf93a,-37.81,144.96,VIC,Melbourne,debit,authorized,3c1f0dab20a9491b9385ceec10be5574,SALES-POS,20-30,2018,10,20,2,11,Saturday,14 days,49966.154
ACC-80388494,28,27.54,7565.51,1.0,CUS-1140341822,2018-10-20,Dustin,M,-37.42,144.97,,b4cff616-0199-46b0-be22-3af073f2db42,-33.87,151.21,NSW,Sydney,debit,authorized,52544637d22c43189fa4684f7cb17c4e,POS,20-30,2018,10,20,16,37,Saturday,14 days,49966.154
ACC-80388494,28,103.56,7461.95,1.0,CUS-1140341822,2018-10-20,Dustin,M,-37.42,144.97,,4dba0b1c-b226-4169-8fa5-9844dfe9bf2c,-37.83,145.06,VIC,Camberwell,debit,authorized,d888c211cd7049c98a0f6af83e1c39ff,POS,20-30,2018,10,20,20,4,Saturday,14 days,49966.154
ACC-80388494,28,188.0,7273.95,,CUS-1140341822,2018-10-21,Dustin,M,-37.42,144.97,,,,,,,debit,posted,feb30f4949ed4825ab2ddecd6b98b15a,PAYMENT,20-30,2018,10,21,2,0,Sunday,14 days,49966.154
ACC-80388494,28,90.0,7183.95,,CUS-1140341822,2018-10-22,Dustin,M,-37.42,144.97,,,,,,,debit,posted,bb2ef65ece2346d8bfd089c0ffa8eba9,INTER BANK,20-30,2018,10,22,11,0,Monday,14 days,49966.154
ACC-80388494,28,46.46,7137.49,1.0,CUS-1140341822,2018-10-24,Dustin,M,-37.42,144.97,,c43bcdfc-1133-49c1-b76f-0a74497b8998,-37.83,145.03,VIC,Hawthorn,debit,authorized,8d8ba1b269ae4e72bb207c5742833b51,POS,20-30,2018,10,24,15,12,Wednesday,14 days,49966.154
ACC-80388494,28,4.57,7132.92,1.0,CUS-1140341822,2018-10-24,Dustin,M,-37.42,144.97,,0e976dfc-9444-4756-930f-164e5d5aaa21,-37.85,145.05,VIC,Hawthorn East,debit,authorized,1687587d961a4ae8ab6b5e2f2b6c81ba,SALES-POS,20-30,2018,10,24,15,31,Wednesday,14 days,49966.154
ACC-80388494,28,32.42,7100.5,1.0,CUS-1140341822,2018-10-24,Dustin,M,-37.42,144.97,,c9c1f612-a297-482f-9712-d0e9c611efd3,-37.81,144.97,VIC,Melbourne,debit,authorized,b6fb507c8c714b6e961e7fd1496b77a0,POS,20-30,2018,10,24,16,10,Wednesday,14 days,49966.154
ACC-80388494,28,12.53,7087.97,1.0,CUS-1140341822,2018-10-26,Dustin,M,-37.42,144.97,,3289fe78-47c2-47f2-a6ff-d2092de82f8e,-37.82,144.95,VIC,Docklands,debit,authorized,5bb0648ac9474b1cbd3e5bd127d9f2ff,POS,20-30,2018,10,26,9,51,Friday,14 days,49966.154
ACC-80388494,28,28.47,7059.5,1.0,CUS-1140341822,2018-10-27,Dustin,M,-37.42,144.97,,2ffe27a3-2d94-4e70-a58f-ada0b83fb55f,-37.89,145.08,VIC,Chadstone,debit,authorized,2c995a3ffde04bc2a9476892137ba3e2,POS,20-30,2018,10,27,1,38,Saturday,14 days,49966.154
ACC-80388494,28,96.0,6963.5,,CUS-1140341822,2018-10-27,Dustin,M,-37.42,144.97,,,,,,,debit,posted,6b7c005cb75e46aca972f61dc5d5b315,PAYMENT,20-30,2018,10,27,4,0,Saturday,14 days,49966.154
ACC-80388494,28,30.75,6932.75,1.0,CUS-1140341822,2018-10-27,Dustin,M,-37.42,144.97,,b320f505-a08d-4fae-b725-4579177f83ef,-37.95,145.17,VIC,Springvale,debit,authorized,00a3d95020e54ee3a5fd45fbad22f3ae,POS,20-30,2018,10,27,10,47,Saturday,14 days,49966.154
ACC-80388494,28,6.67,6926.08,0.0,CUS-1140341822,2018-10-27,Dustin,M,-37.42,144.97,,683e2ebd-865e-490d-98d2-18e77c9615e1,-37.76,145.35,VIC,Lilydale,debit,authorized,ac188161e5bd47ee85bf2ec09d584248,POS,20-30,2018,10,27,14,56,Saturday,14 days,49966.154
ACC-80388494,28,9.04,6917.04,1.0,CUS-1140341822,2018-10-28,Dustin,M,-37.42,144.97,,b710da7e-c30b-4e10-869c-edbd4d1c88ea,-37.86,145.08,VIC,Ashburton,debit,authorized,0403fe2d994745568066d75946c7292e,POS,20-30,2018,10,28,14,35,Sunday,14 days,49966.154
ACC-80388494,28,15.09,6901.95,1.0,CUS-1140341822,2018-10-28,Dustin,M,-37.42,144.97,,cfe241a7-c23f-4a36-b656-d24565195ff0,-37.77,144.92,VIC,Moonee Ponds,debit,authorized,77dcdc58ca8f44dfbb3de7b882755010,POS,20-30,2018,10,28,17,19,Sunday,14 days,49966.154
ACC-80388494,28,25.99,6875.96,0.0,CUS-1140341822,2018-10-28,Dustin,M,-37.42,144.97,,3b3b9d50-7177-47d3-9b7f-bf8a5329e5db,-37.91,145,VIC,Brighton,debit,authorized,127b8383cd05475cb015dd8d336d3931,POS,20-30,2018,10,28,18,16,Sunday,14 days,49966.154
ACC-80388494,28,11.97,6863.99,1.0,CUS-1140341822,2018-10-28,Dustin,M,-37.42,144.97,,8593016a-c17c-4c8d-9180-ba8b307fe0b6,-37.46,144.68,VIC,Riddells Creek,debit,authorized,4ce11d0296d34ca09fd7643ccd85ac93,SALES-POS,20-30,2018,10,28,21,55,Sunday,14 days,49966.154
ACC-80388494,28,23.55,6840.44,1.0,CUS-1140341822,2018-10-30,Dustin,M,-37.42,144.97,,d6f88591-a15b-436b-ab11-34aedfb4b5ac,-37.93,145.27,VIC,Rowville,debit,authorized,52861ebd0b444368a7b3d9db8c7da5f9,SALES-POS,20-30,2018,10,30,17,56,Tuesday,14 days,49966.154
ACC-80388494,28,20.18,6820.26,0.0,CUS-1140341822,2018-10-31,Dustin,M,-37.42,144.97,,df15103e-240f-4aa5-9f04-e39085169f6d,-37.77,145,VIC,Northcote,debit,authorized,a09cde717dc440bba6ca3021190830eb,SALES-POS,20-30,2018,10,31,11,17,Wednesday,14 days,49966.154
ACC-3881031190,37,23.86,445.04,1.0,CUS-3201519139,2018-08-01,Richard,M,-21.15,149.19,,fbf7bf9d-d2ed-4f83-a5e7-098cef476906,-21.03,149.16,QLD,Bucasia,debit,authorized,453c37a1b37a44ce92b932420a70769f,POS,30-40,2018,8,1,19,53,Wednesday,7 days,47801.964
ACC-3881031190,37,32.52,1329.27,0.0,CUS-3201519139,2018-08-03,Richard,M,-21.15,149.19,,98000e83-7a74-4b1d-b58a-1d23c05c795e,-35.35,149.25,NSW,Queanbeyan East,debit,authorized,4925f79176374d1ca96fd0488a70434f,POS,30-40,2018,8,3,15,31,Friday,7 days,47801.964
ACC-3881031190,37,32.56,1296.71,1.0,CUS-3201519139,2018-08-04,Richard,M,-21.15,149.19,,060440a9-38ef-400b-afe3-e84b6df24804,-35.35,149.23,NSW,Queanbeyan,debit,authorized,2df0b1ece52f4d0ba9d47d984737d259,SALES-POS,30-40,2018,8,4,13,40,Saturday,7 days,47801.964
ACC-3881031190,37,43.46,1253.25,1.0,CUS-3201519139,2018-08-04,Richard,M,-21.15,149.19,,5ff89e86-7943-46b9-a557-69da5ac35d9d,-35.34,149.08,ACT,Lyons,debit,authorized,7a5deb3f1fe84e08b9fa6f5d8a50daf6,SALES-POS,30-40,2018,8,4,15,8,Saturday,7 days,47801.964
ACC-3881031190,37,28.12,1225.13,1.0,CUS-3201519139,2018-08-05,Richard,M,-21.15,149.19,,796ca025-841b-4678-a2e8-b211b80cb6f8,-35.35,149.25,NSW,Queanbeyan,debit,authorized,58da65e463bd41039a47969fe0c7aba4,POS,30-40,2018,8,5,11,54,Sunday,7 days,47801.964
ACC-3881031190,37,50.57,1174.56,1.0,CUS-3201519139,2018-08-06,Richard,M,-21.15,149.19,,1f3d6cb7-6bc7-46e6-b2ef-44a95cb30fe8,-35.35,149.23,NSW,Queanbeyan,debit,authorized,42c8bcadc66a4e1b9854e2b2c127c49c,SALES-POS,30-40,2018,8,6,9,6,Monday,7 days,47801.964
ACC-3881031190,37,83.13,1091.43,0.0,CUS-3201519139,2018-08-08,Richard,M,-21.15,149.19,,d1fd252d-da95-466a-b81e-522494ec930d,-36.25,149.05,NSW,Dairymans Plains,debit,authorized,b0528e3c55524eeb9c9a2d829c3515fd,POS,30-40,2018,8,8,9,55,Wednesday,7 days,47801.964
ACC-3881031190,37,44.59,1046.84,1.0,CUS-3201519139,2018-08-08,Richard,M,-21.15,149.19,,5ff89e86-7943-46b9-a557-69da5ac35d9d,-35.34,149.08,ACT,Lyons,debit,authorized,d6fb24f4b7a94d49b018534206875040,POS,30-40,2018,8,8,16,37,Wednesday,7 days,47801.964
ACC-3881031190,37,86.0,3711.09,,CUS-3201519139,2018-08-24,Richard,M,-21.15,149.19,,,,,,,debit,posted,9ce694bdfff84719a53bfd34f83c16fa,INTER BANK,30-40,2018,8,24,2,0,Friday,7 days,47801.964
ACC-3881031190,37,135.0,3576.09,,CUS-3201519139,2018-08-27,Richard,M,-21.15,149.19,,,,,,,debit,posted,3cc2e61406014b88beb281d4a4fbd1a2,PAYMENT,30-40,2018,8,27,23,0,Monday,7 days,47801.964
ACC-3881031190,37,148.0,3428.09,,CUS-3201519139,2018-08-28,Richard,M,-21.15,149.19,,,,,,,debit,posted,424d3b8d558f441c98cceb9693070472,INTER BANK,30-40,2018,8,28,6,0,Tuesday,7 days,47801.964
ACC-3881031190,37,197.0,3231.09,,CUS-3201519139,2018-08-28,Richard,M,-21.15,149.19,,,,,,,debit,posted,772febd4026d4ff88c7b17cefa925209,PAYMENT,30-40,2018,8,28,13,0,Tuesday,7 days,47801.964
ACC-3881031190,37,86.0,6812.09,,CUS-3201519139,2018-09-24,Richard,M,-21.15,149.19,,,,,,,debit,posted,6a069187e35d4a88b2079e5dc0b5eb31,INTER BANK,30-40,2018,9,24,2,0,Monday,7 days,47801.964
ACC-3881031190,37,135.0,7593.84,,CUS-3201519139,2018-09-27,Richard,M,-21.15,149.19,,,,,,,debit,posted,d48f2f4036364c05a2118869108f905a,PAYMENT,30-40,2018,9,27,23,0,Thursday,7 days,47801.964
ACC-3881031190,37,148.0,7445.84,,CUS-3201519139,2018-09-28,Richard,M,-21.15,149.19,,,,,,,debit,posted,6d56e365f4da45bb9834564e9b99e495,INTER BANK,30-40,2018,9,28,6,0,Friday,7 days,47801.964
ACC-3881031190,37,197.0,7248.84,,CUS-3201519139,2018-09-28,Richard,M,-21.15,149.19,,,,,,,debit,posted,c8f4960b414b487fbde00df1b38ae1c1,PAYMENT,30-40,2018,9,28,13,0,Friday,7 days,47801.964
ACC-3881031190,37,73.37,9008.97,1.0,CUS-3201519139,2018-10-13,Richard,M,-21.15,149.19,,7d773c0a-fcfb-4c25-a130-ed817c7792f2,-35.35,149.23,NSW,Queanbeyan,debit,authorized,8530266f95d54f5c9ba65b32ed81a105,POS,30-40,2018,10,13,13,16,Saturday,7 days,47801.964
ACC-3881031190,37,17.4,8991.57,1.0,CUS-3201519139,2018-10-13,Richard,M,-21.15,149.19,,692cd3d5-4a16-42b6-be6d-dd50ec2d482e,-35.34,149.05,ACT,Weston,debit,authorized,63e2fcc1fe29461c84135628fd256b80,POS,30-40,2018,10,13,13,34,Saturday,7 days,47801.964
ACC-3881031190,37,201.53,8790.04,1.0,CUS-3201519139,2018-10-13,Richard,M,-21.15,149.19,,322f7d42-fd9c-4e99-896b-28b6eb1473b0,-27.46,153.03,QLD,Fortitude Valley,debit,authorized,2078b950455c4408b15b72a850590909,SALES-POS,30-40,2018,10,13,14,4,Saturday,7 days,47801.964
ACC-3881031190,37,81.92,8708.12,1.0,CUS-3201519139,2018-10-13,Richard,M,-21.15,149.19,,c6eccae1-6d7c-4f5d-9cdf-d718f1a4b9e1,-35.37,149.23,ACT,Queanbeyan,debit,authorized,685db1ba99124617b7cb76281095fbae,SALES-POS,30-40,2018,10,13,14,13,Saturday,7 days,47801.964
ACC-3881031190,37,1123.08,7585.04,1.0,CUS-3201519139,2018-10-13,Richard,M,-21.15,149.19,,b01312d6-4a99-41de-a09a-ab5cce65148c,-35.32,149.18,ACT,Fyshwick,debit,authorized,77ee1fe1b72747588f248222643fbe0e,POS,30-40,2018,10,13,18,34,Saturday,7 days,47801.964
ACC-3881031190,37,86.0,8415.79,,CUS-3201519139,2018-10-24,Richard,M,-21.15,149.19,,,,,,,debit,posted,c3589ca259eb431c8d1d4daf17b3f417,INTER BANK,30-40,2018,10,24,2,0,Wednesday,7 days,47801.964
ACC-3881031190,37,135.0,9197.54,,CUS-3201519139,2018-10-27,Richard,M,-21.15,149.19,,,,,,,debit,posted,f0baf6aae42f40e58be6836d49f85daa,PAYMENT,30-40,2018,10,27,23,0,Saturday,7 days,47801.964
ACC-3881031190,37,148.0,9049.54,,CUS-3201519139,2018-10-28,Richard,M,-21.15,149.19,,,,,,,debit,posted,0af1f9620f2548f9a6dfe39ea4ea6a39,INTER BANK,30-40,2018,10,28,6,0,Sunday,7 days,47801.964
ACC-3881031190,37,197.0,8852.54,,CUS-3201519139,2018-10-28,Richard,M,-21.15,149.19,,,,,,,debit,posted,6d96cc1640594fbd86bbc3d990d039dc,PAYMENT,30-40,2018,10,28,13,0,Sunday,7 days,47801.964
ACC-4281711154,42,36.0,35322.36,,CUS-3151318058,2018-08-01,Eric,M,-37.84,144.98,,,,,,,debit,posted,c8658e7c726f45ca8b3c3c78d1554700,PHONE BANK,40-50,2018,8,1,20,0,Wednesday,14 days,45828.879
ACC-4281711154,42,17.04,35305.32,1.0,CUS-3151318058,2018-08-02,Eric,M,-37.84,144.98,,727f70ec-7434-44fd-8cd7-0583a1b07097,-37.83,147.63,VIC,Bairnsdale,debit,authorized,fd425f772c094d8e9dd4802f3666c0bd,POS,40-50,2018,8,2,6,28,Thursday,14 days,45828.879
ACC-4281711154,42,51.24,35254.08,1.0,CUS-3151318058,2018-08-02,Eric,M,-37.84,144.98,,55c32c50-3700-4a0e-9c97-175e0db530cd,-37.98,146.79,VIC,Heyfield,debit,authorized,d538d7642455404396a804c8860ba989,POS,40-50,2018,8,2,11,57,Thursday,14 days,45828.879
ACC-4281711154,42,15.95,35238.13,1.0,CUS-3151318058,2018-08-02,Eric,M,-37.84,144.98,,9048af37-4a3d-496f-a9d6-25ce11dbe914,-37.78,144.82,VIC,Glengala,debit,authorized,524a13b89114402db4e18e47eca671d6,POS,40-50,2018,8,2,14,51,Thursday,14 days,45828.879
ACC-4281711154,42,32.8,35205.33,1.0,CUS-3151318058,2018-08-02,Eric,M,-37.84,144.98,,df08814b-3453-493e-8e5f-067ea52e1c22,-37.75,145.35,VIC,Lilydale,debit,authorized,6baeec052bc64cc395454952f40c57ef,SALES-POS,40-50,2018,8,2,23,57,Thursday,14 days,45828.879
ACC-4281711154,42,30.6,35174.73,0.0,CUS-3151318058,2018-08-03,Eric,M,-37.84,144.98,,57f84313-12c8-4d2f-9b89-ee61c26793d2,-37.82,144.97,VIC,Melbourne,debit,authorized,44f926029c4f42b081d0d3f371915214,SALES-POS,40-50,2018,8,3,8,55,Friday,14 days,45828.879
ACC-4281711154,42,29.96,35144.77,1.0,CUS-3151318058,2018-08-03,Eric,M,-37.84,144.98,,e8ed5495-c2a9-4576-83ff-9fcb600ad0b7,-37.88,145.04,VIC,Caulfield East,debit,authorized,ec2f204e2e164919b915deed933e1d48,SALES-POS,40-50,2018,8,3,14,16,Friday,14 days,45828.879
ACC-4281711154,42,1909.04,33235.73,1.0,CUS-3151318058,2018-08-04,Eric,M,-37.84,144.98,,21e5f1e5-92db-46b6-bf42-2039fd9cc52a,-37.8,145,VIC,Abbotsford,debit,authorized,68d4017532ce4d1ba9c163ce7e8568be,SALES-POS,40-50,2018,8,4,1,23,Saturday,14 days,45828.879
ACC-4281711154,42,38.63,33197.1,1.0,CUS-3151318058,2018-08-04,Eric,M,-37.84,144.98,,13eded63-7e1c-455c-a27b-27c47e39a1c6,-37.95,145.18,VIC,Noble Park,debit,authorized,a5c2fcfeb93a4cc081d8b2c00185267b,POS,40-50,2018,8,4,2,26,Saturday,14 days,45828.879
ACC-4281711154,42,37.0,33160.1,,CUS-3151318058,2018-08-04,Eric,M,-37.84,144.98,,,,,,,debit,posted,fe2c67d6819d4af294fff2abd85ce2ef,PAYMENT,40-50,2018,8,4,5,0,Saturday,14 days,45828.879
ACC-4281711154,42,52.0,33108.1,1.0,CUS-3151318058,2018-08-07,Eric,M,-37.84,144.98,,8caa374e-b525-4314-82e2-b8a4d8828490,-37.78,144.98,VIC,Carlton North,debit,authorized,e309f36d472e453883a00c706c705594,SALES-POS,40-50,2018,8,7,9,29,Tuesday,14 days,45828.879
ACC-4281711154,42,36.0,34829.92,,CUS-3151318058,2018-08-08,Eric,M,-37.84,144.98,,,,,,,debit,posted,cc89cbf0e52048b2a26099fdf6a5fa73,PHONE BANK,40-50,2018,8,8,20,0,Wednesday,14 days,45828.879
ACC-4281711154,42,37.0,34792.92,,CUS-3151318058,2018-08-11,Eric,M,-37.84,144.98,,,,,,,debit,posted,e7026a0000ad48e9a4f0ea9a4932dd9e,PAYMENT,40-50,2018,8,11,5,0,Saturday,14 days,45828.879
ACC-4281711154,42,36.0,34756.92,,CUS-3151318058,2018-08-15,Eric,M,-37.84,144.98,,,,,,,debit,posted,5de62163cf0246a78c994e47beb3a7b9,PHONE BANK,40-50,2018,8,15,20,0,Wednesday,14 days,45828.879
ACC-4281711154,42,37.0,34719.92,,CUS-3151318058,2018-08-18,Eric,M,-37.84,144.98,,,,,,,debit,posted,6b381135de7d46ff884285550aba8544,PAYMENT,40-50,2018,8,18,5,0,Saturday,14 days,45828.879
ACC-4281711154,42,36.0,36441.74,,CUS-3151318058,2018-08-22,Eric,M,-37.84,144.98,,,,,,,debit,posted,c50987e0a9ea41748f8afb33b408559e,PHONE BANK,40-50,2018,8,22,20,0,Wednesday,14 days,45828.879
ACC-4281711154,42,151.0,36290.74,,CUS-3151318058,2018-08-23,Eric,M,-37.84,144.98,,,,,,,debit,posted,d5a8b7ace4d2426887e2c625786414c4,PAYMENT,40-50,2018,8,23,20,0,Thursday,14 days,45828.879
ACC-4281711154,42,37.0,36253.74,,CUS-3151318058,2018-08-25,Eric,M,-37.84,144.98,,,,,,,debit,posted,6939b04ae33e486f94598dae5b71eb54,PAYMENT,40-50,2018,8,25,5,0,Saturday,14 days,45828.879
ACC-4281711154,42,168.0,36085.74,,CUS-3151318058,2018-08-27,Eric,M,-37.84,144.98,,,,,,,debit,posted,eae4b8bdee7d4cef9879282fbead7986,PAYMENT,40-50,2018,8,27,2,0,Monday,14 days,45828.879
ACC-4281711154,42,36.0,36049.74,,CUS-3151318058,2018-08-29,Eric,M,-37.84,144.98,,,,,,,debit,posted,dda1713896ee4823b094500fbdd074a8,PHONE BANK,40-50,2018,8,29,20,0,Wednesday,14 days,45828.879
ACC-4281711154,42,37.0,36012.74,,CUS-3151318058,2018-09-01,Eric,M,-37.84,144.98,,,,,,,debit,posted,7811819db0a44b48b9e50b90bfb3db92,PAYMENT,40-50,2018,9,1,5,0,Saturday,14 days,45828.879
ACC-4281711154,42,36.0,37734.56,,CUS-3151318058,2018-09-05,Eric,M,-37.84,144.98,,,,,,,debit,posted,185aef1bf14a465bb0625e610fbd0d17,PHONE BANK,40-50,2018,9,5,20,0,Wednesday,14 days,45828.879
ACC-4281711154,42,37.0,37697.56,,CUS-3151318058,2018-09-08,Eric,M,-37.84,144.98,,,,,,,debit,posted,85dda87e9f3640e8a7d277aa833f0aaf,PAYMENT,40-50,2018,9,8,5,0,Saturday,14 days,45828.879
ACC-4281711154,42,36.0,37661.56,,CUS-3151318058,2018-09-12,Eric,M,-37.84,144.98,,,,,,,debit,posted,6c3ba8dc7d4249ac8ef48f990eb3efaf,PHONE BANK,40-50,2018,9,12,20,0,Wednesday,14 days,45828.879
ACC-4281711154,42,37.0,37624.56,,CUS-3151318058,2018-09-15,Eric,M,-37.84,144.98,,,,,,,debit,posted,f880bbcc055a46bbbe6b09852dd0e15a,PAYMENT,40-50,2018,9,15,5,0,Saturday,14 days,45828.879
ACC-4281711154,42,36.0,39346.38,,CUS-3151318058,2018-09-19,Eric,M,-37.84,144.98,,,,,,,debit,posted,8d6cae14f22042fe9498fc1a9f959e1c,PHONE BANK,40-50,2018,9,19,20,0,Wednesday,14 days,45828.879
ACC-4281711154,42,37.0,39309.38,,CUS-3151318058,2018-09-22,Eric,M,-37.84,144.98,,,,,,,debit,posted,d52d2efab89b4e6b85f43f6d5d756ba5,PAYMENT,40-50,2018,9,22,5,0,Saturday,14 days,45828.879
ACC-4281711154,42,151.0,39158.38,,CUS-3151318058,2018-09-23,Eric,M,-37.84,144.98,,,,,,,debit,posted,7ad6dea490764d85ba8c3dc44070aba9,PAYMENT,40-50,2018,9,23,20,0,Sunday,14 days,45828.879
ACC-4281711154,42,36.0,39122.38,,CUS-3151318058,2018-09-26,Eric,M,-37.84,144.98,,,,,,,debit,posted,ff9767cc8f074a299de69c95696756e4,PHONE BANK,40-50,2018,9,26,20,0,Wednesday,14 days,45828.879
ACC-4281711154,42,168.0,38954.38,,CUS-3151318058,2018-09-27,Eric,M,-37.84,144.98,,,,,,,debit,posted,a7e20747304b47e2acdc3c5e30a44e02,PAYMENT,40-50,2018,9,27,2,0,Thursday,14 days,45828.879
ACC-4281711154,42,37.0,38917.38,,CUS-3151318058,2018-09-29,Eric,M,-37.84,144.98,,,,,,,debit,posted,62b963c7fd094e689b1809f2e63dcf35,PAYMENT,40-50,2018,9,29,5,0,Saturday,14 days,45828.879
ACC-4281711154,42,36.0,40639.2,,CUS-3151318058,2018-10-03,Eric,M,-37.84,144.98,,,,,,,debit,posted,6f54a9cbdd35408c8f20461b5cf40128,PHONE BANK,40-50,2018,10,3,20,0,Wednesday,14 days,45828.879
ACC-4281711154,42,37.0,40602.2,,CUS-3151318058,2018-10-06,Eric,M,-37.84,144.98,,,,,,,debit,posted,9fb4b3ba9e474ae88e159b5675ae4c74,PAYMENT,40-50,2018,10,6,5,0,Saturday,14 days,45828.879
ACC-4281711154,42,36.0,40566.2,,CUS-3151318058,2018-10-10,Eric,M,-37.84,144.98,,,,,,,debit,posted,9429d2670f47403ab129906581242381,PHONE BANK,40-50,2018,10,10,20,0,Wednesday,14 days,45828.879
ACC-4281711154,42,37.0,40529.2,,CUS-3151318058,2018-10-13,Eric,M,-37.84,144.98,,,,,,,debit,posted,a909d14233ca413b943b7370a8b86884,PAYMENT,40-50,2018,10,13,5,0,Saturday,14 days,45828.879
ACC-4281711154,42,36.0,42251.02,,CUS-3151318058,2018-10-17,Eric,M,-37.84,144.98,,,,,,,debit,posted,f9434b7eff9f4f9fab7a6b34919478d2,PHONE BANK,40-50,2018,10,17,20,0,Wednesday,14 days,45828.879
ACC-4281711154,42,37.0,42214.02,,CUS-3151318058,2018-10-20,Eric,M,-37.84,144.98,,,,,,,debit,posted,cdee7c78ef5d4fd297e3acdf063689a6,PAYMENT,40-50,2018,10,20,5,0,Saturday,14 days,45828.879
ACC-4281711154,42,151.0,42063.02,,CUS-3151318058,2018-10-23,Eric,M,-37.84,144.98,,,,,,,debit,posted,976947f8906d4a7b9e17d2b11dead57e,PAYMENT,40-50,2018,10,23,20,0,Tuesday,14 days,45828.879
ACC-4281711154,42,36.0,42027.02,,CUS-3151318058,2018-10-24,Eric,M,-37.84,144.98,,,,,,,debit,posted,17598114fa564d13a2e7200d733305ee,PHONE BANK,40-50,2018,10,24,20,0,Wednesday,14 days,45828.879
ACC-4281711154,42,168.0,41859.02,,CUS-3151318058,2018-10-27,Eric,M,-37.84,144.98,,,,,,,debit,posted,f014c79b7b7e4528be8688af00980b09,PAYMENT,40-50,2018,10,27,2,0,Saturday,14 days,45828.879
ACC-4281711154,42,37.0,41822.02,,CUS-3151318058,2018-10-27,Eric,M,-37.84,144.98,,,,,,,debit,posted,e3db3399a65a46ee8edf696b649f95a0,PAYMENT,40-50,2018,10,27,5,0,Saturday,14 days,45828.879
ACC-4281711154,42,36.0,43543.84,,CUS-3151318058,2018-10-31,Eric,M,-37.84,144.98,,,,,,,debit,posted,4f784598b47b4c0e8856e28bd4363bcc,PHONE BANK,40-50,2018,10,31,20,0,Wednesday,14 days,45828.879
ACC-3536132544,41,43.0,1679.94,,CUS-2348881191,2018-08-01,Heather,F,-37.79,144.93,,,,,,,debit,posted,49eca434ba8b4f2eb68fcfe625ba2c1b,INTER BANK,40-50,2018,8,1,21,0,Wednesday,14 days,54789.368
ACC-3536132544,41,22.0,1657.94,,CUS-2348881191,2018-08-02,Heather,F,-37.79,144.93,,,,,,,debit,posted,859557e6ddfe423595075ed1cd73ed49,PAYMENT,40-50,2018,8,2,4,0,Thursday,14 days,54789.368
ACC-3536132544,41,107.67,1550.27,1.0,CUS-2348881191,2018-08-02,Heather,F,-37.79,144.93,,ec141b19-89cc-42cb-9c0b-4493ab9a80b5,-37.8,144.96,VIC,Parkville,debit,authorized,02e98a1a6fb94e2583dfd8a84bd152bc,POS,40-50,2018,8,2,15,10,Thursday,14 days,54789.368
ACC-3536132544,41,109.0,1441.27,,CUS-2348881191,2018-08-02,Heather,F,-37.79,144.93,,,,,,,debit,posted,38ace9b55b6340cca0731875d79ee75a,INTER BANK,40-50,2018,8,2,22,0,Thursday,14 days,54789.368
ACC-3536132544,41,33.0,1408.27,,CUS-2348881191,2018-08-03,Heather,F,-37.79,144.93,,,,,,,debit,posted,113b67876bb84ab78c93709345747c34,PAYMENT,40-50,2018,8,3,11,0,Friday,14 days,54789.368
ACC-3536132544,41,95.23,1313.04,1.0,CUS-2348881191,2018-08-05,Heather,F,-37.79,144.93,,fc049c40-473f-4a92-8685-4d1c2999595b,-37.95,145.14,VIC,Springvale,debit,authorized,87866f45a87f4d1ea30479105f9ce1c3,SALES-POS,40-50,2018,8,5,9,44,Sunday,14 days,54789.368
ACC-3536132544,41,14.24,1298.8,1.0,CUS-2348881191,2018-08-06,Heather,F,-37.79,144.93,,9a7f1a91-761c-455b-8ca4-e2f46e8eb590,-37.7,144.78,VIC,Taylors Lakes,debit,authorized,7309e42490784ea4945ea08cd3b58552,SALES-POS,40-50,2018,8,6,10,13,Monday,14 days,54789.368
ACC-3536132544,41,22.85,1275.95,1.0,CUS-2348881191,2018-08-06,Heather,F,-37.79,144.93,,9b51932f-67a6-4b29-90f9-4b0740e640a3,-37.88,145.27,VIC,Ferntree Gully,debit,authorized,4f447d4800d3479a94c79a05afadd806,POS,40-50,2018,8,6,18,56,Monday,14 days,54789.368
ACC-3536132544,41,36.82,1239.13,1.0,CUS-2348881191,2018-08-06,Heather,F,-37.79,144.93,,fd56fb7c-7050-46f7-8da6-ced3f2a8f219,-37.79,145.06,VIC,Balwyn North,debit,authorized,a98cc4c6f0734a89a3227ce7b7abd6e8,POS,40-50,2018,8,6,21,59,Monday,14 days,54789.368
ACC-3536132544,41,43.0,1196.13,,CUS-2348881191,2018-08-08,Heather,F,-37.79,144.93,,,,,,,debit,posted,2fce8a0ea1ec4301b343c9d48649bc79,INTER BANK,40-50,2018,8,8,21,0,Wednesday,14 days,54789.368
ACC-3536132544,41,22.0,1174.13,,CUS-2348881191,2018-08-09,Heather,F,-37.79,144.93,,,,,,,debit,posted,8aed7bc5980c4d479b0d49fb9e15b567,PAYMENT,40-50,2018,8,9,4,0,Thursday,14 days,54789.368
ACC-3536132544,41,38.96,3236.68,1.0,CUS-2348881191,2018-08-09,Heather,F,-37.79,144.93,,496bc96a-4a77-47e6-ad1d-0782db826584,-37.69,144.57,VIC,Melton West,debit,authorized,80a0e712f0a84ddc8e177a506b5ae5b5,POS,40-50,2018,8,9,14,1,Thursday,14 days,54789.368
ACC-3536132544,41,16.29,3220.39,1.0,CUS-2348881191,2018-08-10,Heather,F,-37.79,144.93,,a45c5479-9ad3-4f8a-ae04-e46013aec0c5,-37.95,145.55,VIC,Gembrook,debit,authorized,553cdc746fea48de8fd84c523dbd0cc5,SALES-POS,40-50,2018,8,10,9,43,Friday,14 days,54789.368
ACC-3536132544,41,33.0,3153.3,,CUS-2348881191,2018-08-10,Heather,F,-37.79,144.93,,,,,,,debit,posted,19b9546efb0643e398166f3b67cb2781,PAYMENT,40-50,2018,8,10,11,0,Friday,14 days,54789.368
ACC-3536132544,41,34.09,3186.3,1.0,CUS-2348881191,2018-08-10,Heather,F,-37.79,144.93,,6e34ad31-2ef3-4b0b-be99-8b6f38dde842,-37.93,145.04,VIC,Moorabbin,debit,authorized,590397c5cf6842368d48da07915703a4,POS,40-50,2018,8,10,11,54,Friday,14 days,54789.368
ACC-3536132544,41,31.82,3121.48,0.0,CUS-2348881191,2018-08-11,Heather,F,-37.79,144.93,,ed5bf651-1c4f-4e04-a68b-9513e3c3dd8f,-37.88,147.99,VIC,Lakes Entrance,debit,authorized,2053ce5049b843a498493d35c64684ec,SALES-POS,40-50,2018,8,11,12,44,Saturday,14 days,54789.368
ACC-3536132544,41,23.66,3097.82,1.0,CUS-2348881191,2018-08-12,Heather,F,-37.79,144.93,,932b9301-65da-4718-aa78-679daba791fb,-37.78,145.13,VIC,Doncaster,debit,authorized,92c6a4e56f534f9aa889c1fa4af81556,POS,40-50,2018,8,12,19,43,Sunday,14 days,54789.368
ACC-3536132544,41,12.64,3085.18,1.0,CUS-2348881191,2018-08-13,Heather,F,-37.79,144.93,,a8538841-fa57-4618-b6f5-ae51662bffe5,-37.77,144.96,VIC,Brunswick,debit,authorized,dddd77d6636c4b8497f088db92fa9073,POS,40-50,2018,8,13,9,36,Monday,14 days,54789.368
ACC-3536132544,41,11.29,3073.89,1.0,CUS-2348881191,2018-08-13,Heather,F,-37.79,144.93,,65e6eece-7402-414a-9b22-890a82ef8626,-37.81,144.96,VIC,Melbourne,debit,authorized,89e63a72a9dd45afaf589561fbb76cd1,POS,40-50,2018,8,13,10,54,Monday,14 days,54789.368
ACC-3536132544,41,42.78,3031.11,1.0,CUS-2348881191,2018-08-13,Heather,F,-37.79,144.93,,dca69e7f-551f-49a1-baf6-732f61a230de,-37.82,145.18,VIC,Nunawading,debit,authorized,f120aa91f635461bb69753da7690e225,SALES-POS,40-50,2018,8,13,21,53,Monday,14 days,54789.368
ACC-3536132544,41,43.0,2988.11,,CUS-2348881191,2018-08-15,Heather,F,-37.79,144.93,,,,,,,debit,posted,c552e0a633ed40cc9ab41993bd1a668c,INTER BANK,40-50,2018,8,15,21,0,Wednesday,14 days,54789.368
ACC-3536132544,41,45.63,2882.75,1.0,CUS-2348881191,2018-08-17,Heather,F,-37.79,144.93,,bce20df2-d87c-40b3-b4b3-0b01d1e7a902,-37.6,143.84,VIC,Sebastopol,debit,authorized,5a2c2dbe2c76486a82fdad847bc1fc46,SALES-POS,40-50,2018,8,17,0,42,Friday,14 days,54789.368
ACC-3536132544,41,33.0,2849.75,,CUS-2348881191,2018-08-17,Heather,F,-37.79,144.93,,,,,,,debit,posted,9ff93b35ee4241709e3ed9835850198f,PAYMENT,40-50,2018,8,17,11,0,Friday,14 days,54789.368
ACC-3536132544,41,1629.0,1220.75,,CUS-2348881191,2018-08-18,Heather,F,-37.79,144.93,,,,,,,debit,posted,6a8ffa82b1ea4a229cf8842981af9c96,PHONE BANK,40-50,2018,8,18,11,0,Saturday,14 days,54789.368
ACC-3536132544,41,11.93,1208.82,1.0,CUS-2348881191,2018-08-19,Heather,F,-37.79,144.93,,d1c2e94b-035e-484e-9b71-2e5bb3daac70,-37.91,145.35,VIC,Belgrave,debit,authorized,ee225df4f9aa4805bc521f4385b82515,SALES-POS,40-50,2018,8,19,16,50,Sunday,14 days,54789.368
ACC-3536132544,41,33.52,1175.3,1.0,CUS-2348881191,2018-08-19,Heather,F,-37.79,144.93,,4023bfe4-3398-4701-b9a9-479f45aa3598,-37.87,145.09,VIC,Ashwood,debit,authorized,ee59c259a84d4bd3a1979eb6a5a2ff30,POS,40-50,2018,8,19,18,57,Sunday,14 days,54789.368
ACC-3536132544,41,67.98,1107.32,0.0,CUS-2348881191,2018-08-19,Heather,F,-37.79,144.93,,02bfa4be-b888-46e7-9008-b34955941295,-37.94,145,VIC,Hampton,debit,authorized,2b8cfaac9e204a9d8a0c73a91b9610df,SALES-POS,40-50,2018,8,19,22,31,Sunday,14 days,54789.368
ACC-3536132544,41,16.49,1090.83,1.0,CUS-2348881191,2018-08-20,Heather,F,-37.79,144.93,,80d45a7d-1075-4057-9a44-6bce7e5f63df,-37.81,144.94,VIC,Docklands,debit,authorized,2911721ba44540aea000dcf5ada50aea,POS,40-50,2018,8,20,21,3,Monday,14 days,54789.368
ACC-3536132544,41,24.51,1066.32,1.0,CUS-2348881191,2018-08-21,Heather,F,-37.79,144.93,,7f3c7a08-1428-47ab-a59e-49ae1a26cff4,-37.76,145.07,VIC,Heidelberg,debit,authorized,aae09674ae4e456a88cd8174841f6145,SALES-POS,40-50,2018,8,21,6,19,Tuesday,14 days,54789.368
ACC-3536132544,41,20.61,1045.71,1.0,CUS-2348881191,2018-08-21,Heather,F,-37.79,144.93,,51102373-6333-421b-b675-4f4d442ba06d,-37.81,145.23,VIC,Eastland,debit,authorized,63ce20db0bea4745abd342899039204d,POS,40-50,2018,8,21,14,51,Tuesday,14 days,54789.368
ACC-3536132544,41,9.08,1036.63,1.0,CUS-2348881191,2018-08-21,Heather,F,-37.79,144.93,,2ee17ea7-70e8-40a3-8a95-056ceb1dde29,-37.78,145.31,VIC,Mooroolbark,debit,authorized,990105b99d9f42faa6a11055c29838b9,SALES-POS,40-50,2018,8,21,16,52,Tuesday,14 days,54789.368
ACC-3536132544,41,30.23,1006.4,0.0,CUS-2348881191,2018-08-22,Heather,F,-37.79,144.93,,d49c7364-41a4-4a48-be59-a2034aa21419,-37.88,144.68,VIC,Hoppers Crossing,debit,authorized,e15ebc633d6c4ff5a1372eee7e8c327e,SALES-POS,40-50,2018,8,22,9,19,Wednesday,14 days,54789.368
ACC-3536132544,41,43.0,963.4,,CUS-2348881191,2018-08-22,Heather,F,-37.79,144.93,,,,,,,debit,posted,0e0404f7129c47e19e6708caabfd2493,INTER BANK,40-50,2018,8,22,21,0,Wednesday,14 days,54789.368
ACC-3536132544,41,22.0,941.4,,CUS-2348881191,2018-08-23,Heather,F,-37.79,144.93,,,,,,,debit,posted,789bc12669b346ce9a70fd204ab8f846,PAYMENT,40-50,2018,8,23,4,0,Thursday,14 days,54789.368
ACC-3536132544,41,33.0,3009.91,,CUS-2348881191,2018-08-24,Heather,F,-37.79,144.93,,,,,,,debit,posted,80bef502f7eb41b7ba53dce76a3078b4,PAYMENT,40-50,2018,8,24,11,0,Friday,14 days,54789.368
ACC-3536132544,41,17.8,2992.11,0.0,CUS-2348881191,2018-08-24,Heather,F,-37.79,144.93,,2f86a69f-bc2f-4a08-b56f-c039248827ac,-37.86,145.28,VIC,Boronia,debit,authorized,e2767178c13b445d8bb93ff3eba1ddd1,POS,40-50,2018,8,24,23,47,Friday,14 days,54789.368
ACC-3536132544,41,9.9,2982.21,1.0,CUS-2348881191,2018-08-27,Heather,F,-37.79,144.93,,7c94cdd9-dbe9-433a-bbb8-ea81e447b432,-37.69,144.56,VIC,Melton West,debit,authorized,0668193ffdc54e8798302bceddccd49c,SALES-POS,40-50,2018,8,27,9,10,Monday,14 days,54789.368
ACC-3536132544,41,65.71,2916.5,0.0,CUS-2348881191,2018-08-29,Heather,F,-37.79,144.93,,b952dc05-e859-4ade-b09f-1a138db6d88b,-37.73,144.9,VIC,Strathmore,debit,authorized,e1ccdeb718a647988edd8e076a8ceac4,SALES-POS,40-50,2018,8,29,9,3,Wednesday,14 days,54789.368
ACC-3536132544,41,49.41,2867.09,1.0,CUS-2348881191,2018-08-29,Heather,F,-37.79,144.93,,c60b616f-96d9-4a9e-a7e7-b38b2f83b266,-37.81,144.89,VIC,Seddon,debit,authorized,8207a441b3084beca7c5c7d159b456bf,POS,40-50,2018,8,29,14,20,Wednesday,14 days,54789.368
ACC-3536132544,41,43.0,2824.09,,CUS-2348881191,2018-08-29,Heather,F,-37.79,144.93,,,,,,,debit,posted,81c7a997760a4ffb8bbd22079fa1244f,INTER BANK,40-50,2018,8,29,21,0,Wednesday,14 days,54789.368
ACC-3536132544,41,13.45,2810.64,1.0,CUS-2348881191,2018-08-29,Heather,F,-37.79,144.93,,236b298f-f2c8-487e-b399-38ae6959a2bd,-37.78,145.58,VIC,Launching Place,debit,authorized,b257c60840de445ebb7498a95fccf3ff,POS,40-50,2018,8,29,23,28,Wednesday,14 days,54789.368
ACC-3536132544,41,22.0,2788.64,,CUS-2348881191,2018-08-30,Heather,F,-37.79,144.93,,,,,,,debit,posted,97f4f967cbf340faa884c838b335f497,PAYMENT,40-50,2018,8,30,4,0,Thursday,14 days,54789.368
ACC-3536132544,41,15.53,2773.11,1.0,CUS-2348881191,2018-08-30,Heather,F,-37.79,144.93,,29f0b89e-fba1-4e6d-8104-f13078787ede,-37.83,140.78,SA,Mount Gambier,debit,authorized,77e5860af77d4f5d9c06ed2b3d596204,POS,40-50,2018,8,30,9,17,Thursday,14 days,54789.368
ACC-3536132544,41,33.0,2740.11,,CUS-2348881191,2018-08-31,Heather,F,-37.79,144.93,,,,,,,debit,posted,f326190d2de34c538ac2bd5ba2f3003f,PAYMENT,40-50,2018,8,31,11,0,Friday,14 days,54789.368
ACC-3536132544,41,20.4,2719.71,1.0,CUS-2348881191,2018-09-01,Heather,F,-37.79,144.93,,f7e32ec1-8be1-4cc9-bed6-9968d20f0f9c,-37.65,145.02,VIC,Epping,debit,authorized,745df73418ea4b119364225f5589520a,SALES-POS,40-50,2018,9,1,14,23,Saturday,14 days,54789.368
ACC-3536132544,41,30.5,2689.21,0.0,CUS-2348881191,2018-09-02,Heather,F,-37.79,144.93,,60098adb-5a6a-46c8-ae27-f9837e4405ea,-37.82,144.95,VIC,Melbourne,debit,authorized,e0264ad1ff934ef99b3404b5d3466481,SALES-POS,40-50,2018,9,2,9,9,Sunday,14 days,54789.368
ACC-3536132544,41,25.73,2663.48,1.0,CUS-2348881191,2018-09-02,Heather,F,-37.79,144.93,,497ca549-1d9a-44c6-8d02-5c041e809440,-37.85,144.99,VIC,Windsor,debit,authorized,a63aaa62a3e44782b38e811517a6c341,SALES-POS,40-50,2018,9,2,10,35,Sunday,14 days,54789.368
ACC-3536132544,41,98.76,2564.72,1.0,CUS-2348881191,2018-09-02,Heather,F,-37.79,144.93,,98f8bc1c-462f-4adb-9fbc-c135364ff429,-37.56,143.86,VIC,Ballarat Central,debit,authorized,0b115ff2284b42e5b3fa5275f0f2c50c,POS,40-50,2018,9,2,21,41,Sunday,14 days,54789.368
ACC-3536132544,41,109.0,2435.85,,CUS-2348881191,2018-09-02,Heather,F,-37.79,144.93,,,,,,,debit,posted,6f8f067e746646159b5dd985259f451b,INTER BANK,40-50,2018,9,2,22,0,Sunday,14 days,54789.368
ACC-3536132544,41,19.87,2544.85,1.0,CUS-2348881191,2018-09-02,Heather,F,-37.79,144.93,,e91d53ff-54bd-4a99-9161-c77d8f43d82c,-37.83,147.62,VIC,Bairnsdale,debit,authorized,36872bb160bd4d769df5ca8d335ea425,SALES-POS,40-50,2018,9,2,22,43,Sunday,14 days,54789.368
ACC-3536132544,41,23.84,2412.01,1.0,CUS-2348881191,2018-09-03,Heather,F,-37.79,144.93,,56bf7d92-9b46-4fd8-9d5b-15fff15c95db,-37.76,145.31,VIC,Chirnside Park,debit,authorized,6c0a377596994d7b85605afe8a38dd3d,SALES-POS,40-50,2018,9,3,13,31,Monday,14 days,54789.368
ACC-3536132544,41,41.57,2370.44,1.0,CUS-2348881191,2018-09-03,Heather,F,-37.79,144.93,,ca74915b-4aca-4bfe-9b5c-2c2193e9426e,-37.82,144.96,VIC,Melbourne,debit,authorized,d80135731a37443ab4d7f4e7ccfa0ec7,POS,40-50,2018,9,3,21,14,Monday,14 days,54789.368
ACC-3536132544,41,43.0,2327.44,,CUS-2348881191,2018-09-05,Heather,F,-37.79,144.93,,,,,,,debit,posted,d7e8ca604ef04463a0d45bc6d91272e0,INTER BANK,40-50,2018,9,5,21,0,Wednesday,14 days,54789.368
ACC-3536132544,41,22.0,2305.44,,CUS-2348881191,2018-09-06,Heather,F,-37.79,144.93,,,,,,,debit,posted,a3883f695f084835ac92dfe19ce8d7cd,PAYMENT,40-50,2018,9,6,4,0,Thursday,14 days,54789.368
ACC-3536132544,41,228.08,4178.87,1.0,CUS-2348881191,2018-09-06,Heather,F,-37.79,144.93,,8546d6b4-0a0a-46eb-95b4-7c75815acb17,-37.82,144.96,VIC,Melbourne,debit,authorized,0fa4dc0288514808b289c90ae2fd9b53,POS,40-50,2018,9,6,18,1,Thursday,14 days,54789.368
ACC-3536132544,41,33.0,4145.87,,CUS-2348881191,2018-09-07,Heather,F,-37.79,144.93,,,,,,,debit,posted,3a6047957caf4b7ca6db7aaddfbceaf5,PAYMENT,40-50,2018,9,7,11,0,Friday,14 days,54789.368
ACC-3536132544,41,43.0,4102.87,,CUS-2348881191,2018-09-12,Heather,F,-37.79,144.93,,,,,,,debit,posted,e14fd534e54f449daa69cbfc4e11727f,INTER BANK,40-50,2018,9,12,21,0,Wednesday,14 days,54789.368
ACC-3536132544,41,22.0,4080.87,,CUS-2348881191,2018-09-13,Heather,F,-37.79,144.93,,,,,,,debit,posted,cec0d3b449044c7094752e510c62029b,PAYMENT,40-50,2018,9,13,4,0,Thursday,14 days,54789.368
ACC-3536132544,41,46.26,4034.61,1.0,CUS-2348881191,2018-09-14,Heather,F,-37.79,144.93,,3d724a98-a268-4630-afa4-03d37ac87e83,-37.82,145.17,VIC,Nunawading,debit,authorized,cf38a3c4c7294eef88998101fbe55db6,SALES-POS,40-50,2018,9,14,2,21,Friday,14 days,54789.368
ACC-3536132544,41,33.0,4001.61,,CUS-2348881191,2018-09-14,Heather,F,-37.79,144.93,,,,,,,debit,posted,671862c148d84735992a2b2d73c7444d,PAYMENT,40-50,2018,9,14,11,0,Friday,14 days,54789.368
ACC-3536132544,41,38.5,3963.11,1.0,CUS-2348881191,2018-09-15,Heather,F,-37.79,144.93,,c4c6020c-b9ab-4868-b6c4-7a6bed751010,-37.78,145.46,VIC,Seville,debit,authorized,8ab20cc3030b41d29d178cc7567e7ed5,POS,40-50,2018,9,15,4,46,Saturday,14 days,54789.368
ACC-3536132544,41,43.0,3920.11,,CUS-2348881191,2018-09-19,Heather,F,-37.79,144.93,,,,,,,debit,posted,9ec8a8091f124a7e8c552ce1957e02e4,INTER BANK,40-50,2018,9,19,21,0,Wednesday,14 days,54789.368
ACC-3536132544,41,22.0,3898.11,,CUS-2348881191,2018-09-20,Heather,F,-37.79,144.93,,,,,,,debit,posted,26ef5a3c50474394b54886cb30f60241,PAYMENT,40-50,2018,9,20,4,0,Thursday,14 days,54789.368
ACC-3536132544,41,34.4,5965.22,1.0,CUS-2348881191,2018-09-21,Heather,F,-37.79,144.93,,3c448602-e0d2-4ea4-8c79-89dd34f1e95f,-37.88,145.27,VIC,Ferntree Gully,debit,authorized,885c0dc877114f12a89b64faaf26d833,SALES-POS,40-50,2018,9,21,9,15,Friday,14 days,54789.368
ACC-3536132544,41,54.59,5910.63,1.0,CUS-2348881191,2018-09-21,Heather,F,-37.79,144.93,,eff3a2d0-61ab-45af-9b7f-9b304f2e87ee,-37.84,145.27,VIC,Bayswater,debit,authorized,c79953c7ad084f15a3ca3e2f5eff207f,SALES-POS,40-50,2018,9,21,10,38,Friday,14 days,54789.368
ACC-3536132544,41,33.0,5877.63,,CUS-2348881191,2018-09-21,Heather,F,-37.79,144.93,,,,,,,debit,posted,78dae9450270457aa26f74313c2a30c2,PAYMENT,40-50,2018,9,21,11,0,Friday,14 days,54789.368
ACC-3536132544,41,98.83,5778.8,1.0,CUS-2348881191,2018-09-21,Heather,F,-37.79,144.93,,5fa60a42-096d-4d97-b830-fb70f449dd4a,-26.75,153.13,QLD,Birtinya,debit,authorized,d1e7a64ee48149279deaeb4e9608c1a9,SALES-POS,40-50,2018,9,21,20,47,Friday,14 days,54789.368
ACC-3536132544,41,30.38,5748.42,1.0,CUS-2348881191,2018-09-21,Heather,F,-37.79,144.93,,1a62cc95-5da2-4d2a-990b-c297c2405195,-37.98,145.13,VIC,Dingley Village,debit,authorized,2d824a4355e64ada8eee77596f38565e,SALES-POS,40-50,2018,9,21,22,17,Friday,14 days,54789.368
ACC-3536132544,41,10.27,5738.15,1.0,CUS-2348881191,2018-09-22,Heather,F,-37.79,144.93,,8518e2c6-a212-47ba-8430-7487d085037c,-37.8,145.09,VIC,Balwyn North,debit,authorized,852c1ccca69442789c1af8acb0e5b391,SALES-POS,40-50,2018,9,22,4,1,Saturday,14 days,54789.368
ACC-3536132544,41,29.75,5708.4,1.0,CUS-2348881191,2018-09-23,Heather,F,-37.79,144.93,,a521c358-723d-44e7-b97e-0560066ac96c,-37.91,145.12,VIC,Clayton,debit,authorized,eb45b2ddc7674dd786a1fc010f88cac9,POS,40-50,2018,9,23,16,39,Sunday,14 days,54789.368
ACC-3536132544,41,23.68,5684.72,1.0,CUS-2348881191,2018-09-23,Heather,F,-37.79,144.93,,73903428-2d9a-4549-868a-2049e3e6aea4,-37.81,144.97,VIC,Melbourne,debit,authorized,6d89bf7d322344218bd63aec36f91bee,POS,40-50,2018,9,23,17,37,Sunday,14 days,54789.368
ACC-3536132544,41,43.0,5641.72,,CUS-2348881191,2018-09-26,Heather,F,-37.79,144.93,,,,,,,debit,posted,a6f9c6d5ce3945b9b14e25262958da15,INTER BANK,40-50,2018,9,26,21,0,Wednesday,14 days,54789.368
ACC-3536132544,41,22.0,5619.72,,CUS-2348881191,2018-09-27,Heather,F,-37.79,144.93,,,,,,,debit,posted,52620166a86647c4aa800d4c7aacb4ac,PAYMENT,40-50,2018,9,27,4,0,Thursday,14 days,54789.368
ACC-3536132544,41,24.15,5595.57,1.0,CUS-2348881191,2018-09-27,Heather,F,-37.79,144.93,,607713c3-d3b3-4a4c-a131-0d5e464c1981,-37.86,145.03,VIC,Malvern,debit,authorized,b814d24f2b53411aa03c849a5f2e4275,SALES-POS,40-50,2018,9,27,8,14,Thursday,14 days,54789.368
ACC-3536132544,41,22.26,5573.31,1.0,CUS-2348881191,2018-09-28,Heather,F,-37.79,144.93,,1cc1dabd-b5a0-4369-a85e-942e411eefcd,-37.65,145.02,VIC,Epping,debit,authorized,dcc5ccd10d964729b0ba920af542e052,POS,40-50,2018,9,28,9,24,Friday,14 days,54789.368
ACC-3536132544,41,33.0,5540.31,,CUS-2348881191,2018-09-28,Heather,F,-37.79,144.93,,,,,,,debit,posted,266e0a26400f4166a747a20b1901fcad,PAYMENT,40-50,2018,9,28,11,0,Friday,14 days,54789.368
ACC-3536132544,41,13.16,5527.15,1.0,CUS-2348881191,2018-09-29,Heather,F,-37.79,144.93,,b5bc74d0-3e25-4fa1-82b2-c2b7e8874bf6,-38.11,147.09,VIC,Sale,debit,authorized,bf463d0b6843450d827ee13398a196c6,SALES-POS,40-50,2018,9,29,11,29,Saturday,14 days,54789.368
ACC-3536132544,41,20.22,5506.93,1.0,CUS-2348881191,2018-09-30,Heather,F,-37.79,144.93,,62a97634-26c0-4828-a968-56c2a401f6ee,-37.78,145.46,VIC,Seville,debit,authorized,68305440302b46d19721f9c86781319c,SALES-POS,40-50,2018,9,30,22,34,Sunday,14 days,54789.368
ACC-3536132544,41,109.0,5397.93,,CUS-2348881191,2018-10-02,Heather,F,-37.79,144.93,,,,,,,debit,posted,ef33ab44799e4d4fb147c2b2df69a185,INTER BANK,40-50,2018,10,2,22,0,Tuesday,14 days,54789.368
ACC-3536132544,41,27.98,5369.95,1.0,CUS-2348881191,2018-10-03,Heather,F,-37.79,144.93,,f6e8b59e-54b9-41ba-af26-5ede2934c234,-37.97,145.15,VIC,Springvale South,debit,authorized,1ee18d7c6e114c48822051c44cfa847d,POS,40-50,2018,10,3,10,31,Wednesday,14 days,54789.368
ACC-3536132544,41,28.3,5341.65,1.0,CUS-2348881191,2018-10-03,Heather,F,-37.79,144.93,,8bd580ef-757c-45ad-b72b-773a8ecb3401,-37.8,144.97,VIC,Carlton,debit,authorized,3503942f91ef48d0a84f8607cd8c59bf,SALES-POS,40-50,2018,10,3,11,12,Wednesday,14 days,54789.368
ACC-3536132544,41,28.38,5313.27,1.0,CUS-2348881191,2018-10-03,Heather,F,-37.79,144.93,,1ca61973-836c-4281-b8aa-65a65d366aaf,-37.9,145.09,VIC,Oakleigh,debit,authorized,a93c30402f2d4a50855e43696fd83205,SALES-POS,40-50,2018,10,3,12,0,Wednesday,14 days,54789.368
ACC-3536132544,41,43.0,5270.27,,CUS-2348881191,2018-10-03,Heather,F,-37.79,144.93,,,,,,,debit,posted,fab3bf166a53403fa11e4cd62054897b,INTER BANK,40-50,2018,10,3,21,0,Wednesday,14 days,54789.368
ACC-3536132544,41,22.0,5248.27,,CUS-2348881191,2018-10-04,Heather,F,-37.79,144.93,,,,,,,debit,posted,2030511aecb442a5b4838882d2f20eae,PAYMENT,40-50,2018,10,4,4,0,Thursday,14 days,54789.368
ACC-3536132544,41,16.13,5232.14,1.0,CUS-2348881191,2018-10-04,Heather,F,-37.79,144.93,,448201e0-41c0-4b9e-bbd2-1e7e73ce5b7f,-37.84,144.98,VIC,Melbourne,debit,authorized,b3508ee3b2d3451cbbd2d9eb22bf7447,SALES-POS,40-50,2018,10,4,9,9,Thursday,14 days,54789.368
ACC-3536132544,41,17.41,7316.24,1.0,CUS-2348881191,2018-10-04,Heather,F,-37.79,144.93,,a114392c-e324-4316-887b-16846facad41,-38.11,147.07,VIC,Sale,debit,authorized,26f03a59f2bf42be9a02a523fe84da29,POS,40-50,2018,10,4,13,13,Thursday,14 days,54789.368
ACC-3536132544,41,53.24,7263.0,1.0,CUS-2348881191,2018-10-04,Heather,F,-37.79,144.93,,3c5b0f0a-c9a7-4728-afd2-ad2057375228,-37.78,145.32,VIC,Mooroolbark,debit,authorized,61b60f44a758465899ad9fd9cd15e59d,POS,40-50,2018,10,4,17,51,Thursday,14 days,54789.368
ACC-3536132544,41,33.0,7230.0,,CUS-2348881191,2018-10-05,Heather,F,-37.79,144.93,,,,,,,debit,posted,16aa0de4bb074912974c929e615816f0,PAYMENT,40-50,2018,10,5,11,0,Friday,14 days,54789.368
ACC-3536132544,41,59.05,7170.95,1.0,CUS-2348881191,2018-10-05,Heather,F,-37.79,144.93,,538ea8d2-0c4d-481e-a027-b017f13ea4b4,-37.76,145.08,VIC,Bulleen,debit,authorized,877b837ea61f4ce59cf33e97ebf9e102,POS,40-50,2018,10,5,15,1,Friday,14 days,54789.368
ACC-3536132544,41,14.79,7156.16,1.0,CUS-2348881191,2018-10-06,Heather,F,-37.79,144.93,,66d798ac-f635-4c07-869d-95376ec05761,-37.91,145.15,VIC,Clayton,debit,authorized,0372ea89bda24c82b7f0bd3e61989148,SALES-POS,40-50,2018,10,6,17,13,Saturday,14 days,54789.368
ACC-3536132544,41,67.53,7088.63,1.0,CUS-2348881191,2018-10-07,Heather,F,-37.79,144.93,,6adc87d5-fc3e-4d9c-9532-e9ba8f1f092f,-37.78,145,VIC,Northcote,debit,authorized,621767c23269412bacb800db0b7b1d67,POS,40-50,2018,10,7,1,7,Sunday,14 days,54789.368
ACC-3536132544,41,26.95,7061.68,1.0,CUS-2348881191,2018-10-07,Heather,F,-37.79,144.93,,677acb2f-cfde-4b59-9ae3-08fb21bb393c,-37.82,144.96,VIC,Melbourne,debit,authorized,8fd3272fa54e4a6e8621fd37e3612ec7,SALES-POS,40-50,2018,10,7,3,55,Sunday,14 days,54789.368
ACC-3536132544,41,129.76,6931.92,0.0,CUS-2348881191,2018-10-08,Heather,F,-37.79,144.93,,bcc8035c-6300-4953-b19d-ca2ec063162b,-37.84,144.96,VIC,South Melbourne,debit,authorized,f24e797d628c47f6950160f2d4281017,SALES-POS,40-50,2018,10,8,21,31,Monday,14 days,54789.368
ACC-3536132544,41,60.26,6871.66,1.0,CUS-2348881191,2018-10-09,Heather,F,-37.79,144.93,,916b2544-6af9-4b19-85f6-d478891dde86,-37.71,145.15,VIC,Eltham,debit,authorized,e461dfadccb94277848179f25af530e8,POS,40-50,2018,10,9,15,53,Tuesday,14 days,54789.368
ACC-3536132544,41,27.86,6843.8,1.0,CUS-2348881191,2018-10-09,Heather,F,-37.79,144.93,,6f6529ab-ec81-49a1-bcb9-fd4462368270,-37.89,145.14,VIC,Mount Waverley,debit,authorized,cdcfa53c13a848ef9573d5c678799466,SALES-POS,40-50,2018,10,9,22,23,Tuesday,14 days,54789.368
ACC-3536132544,41,23.14,6820.66,1.0,CUS-2348881191,2018-10-10,Heather,F,-37.79,144.93,,bb518a7e-78c0-49df-89c7-1901da66f246,-38.08,145.25,VIC,Lyndhurst,debit,authorized,4cb7e1edf6ce4214adf8898ce51590a5,SALES-POS,40-50,2018,10,10,4,30,Wednesday,14 days,54789.368
ACC-3536132544,41,43.0,6777.66,,CUS-2348881191,2018-10-10,Heather,F,-37.79,144.93,,,,,,,debit,posted,cdb1bf1790f7489089bb000129dcee7e,INTER BANK,40-50,2018,10,10,21,0,Wednesday,14 days,54789.368
ACC-3536132544,41,22.0,6755.66,,CUS-2348881191,2018-10-11,Heather,F,-37.79,144.93,,,,,,,debit,posted,5beb6e656b114e6da48907233e78498c,PAYMENT,40-50,2018,10,11,4,0,Thursday,14 days,54789.368
ACC-3536132544,41,31.7,6723.96,0.0,CUS-2348881191,2018-10-11,Heather,F,-37.79,144.93,,c77582df-30ab-41aa-a723-bac5ec5ad037,-37.88,145.22,VIC,Wantirna South,debit,authorized,af722fadc3394b1c9429517ec5712cf8,POS,40-50,2018,10,11,13,27,Thursday,14 days,54789.368
ACC-3536132544,41,33.0,6690.96,,CUS-2348881191,2018-10-12,Heather,F,-37.79,144.93,,,,,,,debit,posted,87501de0278c4cd5a15b48292ec849fe,PAYMENT,40-50,2018,10,12,11,0,Friday,14 days,54789.368
ACC-3536132544,41,43.0,6647.96,,CUS-2348881191,2018-10-17,Heather,F,-37.79,144.93,,,,,,,debit,posted,be3ab64639dc4e04b8bafce540c8b8e2,INTER BANK,40-50,2018,10,17,21,0,Wednesday,14 days,54789.368
ACC-3536132544,41,22.0,6625.96,,CUS-2348881191,2018-10-18,Heather,F,-37.79,144.93,,,,,,,debit,posted,081e1b1516d742159a2d11cc9625c746,PAYMENT,40-50,2018,10,18,4,0,Thursday,14 days,54789.368
ACC-3536132544,41,33.0,8694.47,,CUS-2348881191,2018-10-19,Heather,F,-37.79,144.93,,,,,,,debit,posted,9d0ef7c8bffa4709be861878f172c446,PAYMENT,40-50,2018,10,19,11,0,Friday,14 days,54789.368
ACC-3536132544,41,131.73,8562.74,0.0,CUS-2348881191,2018-10-21,Heather,F,-37.79,144.93,,98b1745c-e4d7-4363-8c2a-9d04ca89f1e4,-37.82,144.97,VIC,Melbourne,debit,authorized,fc62f458e6764f15a3c6361400b5dd22,SALES-POS,40-50,2018,10,21,23,53,Sunday,14 days,54789.368
ACC-3536132544,41,34.66,8528.08,1.0,CUS-2348881191,2018-10-22,Heather,F,-37.79,144.93,,e37ce39f-47f3-4371-9e1f-f029449547cc,-37.74,145.31,VIC,Chirnside Park,debit,authorized,52778f0193e445f28d9f3ae79aabd89a,POS,40-50,2018,10,22,11,58,Monday,14 days,54789.368
ACC-3536132544,41,10.94,8517.14,1.0,CUS-2348881191,2018-10-23,Heather,F,-37.79,144.93,,dfe0ab17-6b66-460c-b731-001226f7a8e7,-37.8,144.96,VIC,Carlton,debit,authorized,698cf288adac4462b4b880db7a14653c,SALES-POS,40-50,2018,10,23,9,25,Tuesday,14 days,54789.368
ACC-3536132544,41,43.0,8474.14,,CUS-2348881191,2018-10-24,Heather,F,-37.79,144.93,,,,,,,debit,posted,9a0b8566f04240e4ad4cc58f2bef17bc,INTER BANK,40-50,2018,10,24,21,0,Wednesday,14 days,54789.368
ACC-3536132544,41,22.0,8452.14,,CUS-2348881191,2018-10-25,Heather,F,-37.79,144.93,,,,,,,debit,posted,d534d20143d6434ca8c38bdf5e4332eb,PAYMENT,40-50,2018,10,25,4,0,Thursday,14 days,54789.368
ACC-3536132544,41,26.3,8425.84,1.0,CUS-2348881191,2018-10-25,Heather,F,-37.79,144.93,,2be31ea9-1909-4173-80e6-6ab1a2d3ad13,-37.85,145.04,VIC,Malvern,debit,authorized,bbc1682f3bfc4c1eabede613e1c4c9b2,POS,40-50,2018,10,25,9,55,Thursday,14 days,54789.368
ACC-3536132544,41,51.65,8374.19,1.0,CUS-2348881191,2018-10-25,Heather,F,-37.79,144.93,,bbbb441c-8b2a-47aa-aaa9-7edec39dae37,-37.84,145.12,VIC,Box Hill South,debit,authorized,50118aff69d943878f18e15c3ac9433d,POS,40-50,2018,10,25,11,31,Thursday,14 days,54789.368
ACC-3536132544,41,38.87,8335.32,1.0,CUS-2348881191,2018-10-26,Heather,F,-37.79,144.93,,b0bfc66e-5739-461d-bf38-b02bd1c3b9ec,-37.7,145.1,VIC,Greensborough,debit,authorized,45114ac7b7f74ba4bb5a152650a973f5,POS,40-50,2018,10,26,7,44,Friday,14 days,54789.368
ACC-3536132544,41,22.37,8312.95,0.0,CUS-2348881191,2018-10-26,Heather,F,-37.79,144.93,,144d3c22-44c2-4dc3-8077-a850796e6043,-37.84,144.78,VIC,Laverton North,debit,authorized,cb441cbc33af4759a7ed842821397d6d,SALES-POS,40-50,2018,10,26,8,29,Friday,14 days,54789.368
ACC-3536132544,41,33.0,8279.95,,CUS-2348881191,2018-10-26,Heather,F,-37.79,144.93,,,,,,,debit,posted,2cbf0ecbdca04830a45a8fa9ce816fdd,PAYMENT,40-50,2018,10,26,11,0,Friday,14 days,54789.368
ACC-3536132544,41,109.68,8170.27,0.0,CUS-2348881191,2018-10-30,Heather,F,-37.79,144.93,,e7102f80-2949-4579-8e34-45a97474dcd9,-37.95,145.05,VIC,Highett,debit,authorized,4f5502701547461382ef6dce26846468,POS,40-50,2018,10,30,9,55,Tuesday,14 days,54789.368
ACC-3536132544,41,43.0,8127.27,,CUS-2348881191,2018-10-31,Heather,F,-37.79,144.93,,,,,,,debit,posted,450ec9a5778f41ecb1a8774601185a0c,INTER BANK,40-50,2018,10,31,21,0,Wednesday,14 days,54789.368
ACC-1217063613,27,7.29,34.97,1.0,CUS-1739931018,2018-08-01,Kimberly,F,-37.82,147.61,,92495e0a-61df-4c3d-9e2d-083ef2efed00,-37.67,144.84,VIC,Tullamarine,debit,authorized,3067a11e2cee4f2a97e4974249bbebb7,SALES-POS,20-30,2018,8,1,21,1,Wednesday,30 days,59174.043333333335
ACC-1217063613,27,20.0,14.97,,CUS-1739931018,2018-08-06,Kimberly,F,-37.82,147.61,,,,,,,debit,posted,643701e7d40b4c97a1f091d7bea890be,INTER BANK,20-30,2018,8,6,23,0,Monday,30 days,59174.043333333335
ACC-1217063613,27,14.73,0.24,1.0,CUS-1739931018,2018-08-07,Kimberly,F,-37.82,147.61,,a39e17e7-8ca2-4a62-8ad7-6e7c841fc579,-38.02,144.41,VIC,Lara,debit,authorized,38a2377f941d4504a96a8d6541d897d6,POS,20-30,2018,8,7,9,25,Tuesday,30 days,59174.043333333335
ACC-1217063613,27,20.0,4843.86,,CUS-1739931018,2018-10-01,Kimberly,F,-37.82,147.61,,,,,,,debit,posted,429e76b88ac54439a2f0ad6bef3627e1,INTER BANK,20-30,2018,10,1,23,0,Monday,30 days,59174.043333333335
ACC-1217063613,27,15.38,4828.48,1.0,CUS-1739931018,2018-10-04,Kimberly,F,-37.82,147.61,,66a0231a-2397-4bf1-ba73-5b8ec0b069b4,-37.86,145.03,VIC,Malvern,debit,authorized,383837e5f63840cd87ed918eae1f1225,POS,20-30,2018,10,4,11,39,Thursday,30 days,59174.043333333335
ACC-1217063613,27,19.55,4808.93,1.0,CUS-1739931018,2018-10-04,Kimberly,F,-37.82,147.61,,49c35605-04d0-4fec-993d-de6bce1e4871,-37.79,145.16,VIC,Doncaster East,debit,authorized,427bb57b3e9a4fb1aefcdb10d4b116ce,POS,20-30,2018,10,4,14,38,Thursday,30 days,59174.043333333335
ACC-1217063613,27,39.96,4768.97,1.0,CUS-1739931018,2018-10-04,Kimberly,F,-37.82,147.61,,b500a057-1d66-4769-b99a-b45163256045,-37.8,144.98,VIC,Fitzroy,debit,authorized,f0f53902bd164688a9ee64fad6bfab93,SALES-POS,20-30,2018,10,4,15,36,Thursday,30 days,59174.043333333335
ACC-1217063613,27,11.98,4756.99,1.0,CUS-1739931018,2018-10-04,Kimberly,F,-37.82,147.61,,e1f6407e-16d6-4779-99b5-52ee31a6dad8,-37.8,145.04,VIC,Kew,debit,authorized,a721b1e4ce4e46d3babd3f1b06a9fd9a,SALES-POS,20-30,2018,10,4,19,34,Thursday,30 days,59174.043333333335
ACC-1217063613,27,165.0,4591.99,,CUS-1739931018,2018-10-05,Kimberly,F,-37.82,147.61,,,,,,,debit,posted,be827c5c573442d19e8559f54f17aba2,PAYMENT,20-30,2018,10,5,18,0,Friday,30 days,59174.043333333335
ACC-1217063613,27,20.0,4571.99,,CUS-1739931018,2018-10-08,Kimberly,F,-37.82,147.61,,,,,,,debit,posted,4f6df7712e764ea89950d87079646ac7,INTER BANK,20-30,2018,10,8,23,0,Monday,30 days,59174.043333333335
ACC-1217063613,27,16.74,4555.25,0.0,CUS-1739931018,2018-10-12,Kimberly,F,-37.82,147.61,,c585ab9b-68e1-41e0-8033-1caf773e748f,-37.9,145.09,VIC,Oakleigh,debit,authorized,7a017134204b48d1a2a0b6bcd8e56c1e,POS,20-30,2018,10,12,13,36,Friday,30 days,59174.043333333335
ACC-1217063613,27,7.06,4548.19,1.0,CUS-1739931018,2018-10-12,Kimberly,F,-37.82,147.61,,5a214e57-7e9b-4ec0-942c-fb2d891eb607,-37.77,144.89,VIC,Maribyrnong,debit,authorized,3944fc8bbb5e4272a21a0a6547656ef3,SALES-POS,20-30,2018,10,12,21,43,Friday,30 days,59174.043333333335
ACC-1217063613,27,14.5,4533.69,1.0,CUS-1739931018,2018-10-13,Kimberly,F,-37.82,147.61,,71608821-0caf-49b2-a851-1591d212ac27,-37.7,145.07,VIC,Bundoora,debit,authorized,0f9a96053fa149099da7cfc137bb39c1,SALES-POS,20-30,2018,10,13,9,47,Saturday,30 days,59174.043333333335
ACC-1217063613,27,22.91,4510.78,1.0,CUS-1739931018,2018-10-14,Kimberly,F,-37.82,147.61,,6a6c7c64-28f0-4286-8cd0-bffeaa33972c,-22.82,147.64,QLD,Clermont,debit,authorized,426a54c4b0a743c0a2fedbb42a96907a,POS,20-30,2018,10,14,11,33,Sunday,30 days,59174.043333333335
ACC-1217063613,27,81.41,4429.37,1.0,CUS-1739931018,2018-10-14,Kimberly,F,-37.82,147.61,,f75d1ba6-c916-4906-92f6-d8beb6e19339,-37.83,145.02,VIC,Burnley,debit,authorized,7cf32080816b4b94948a90224c03d827,POS,20-30,2018,10,14,15,23,Sunday,30 days,59174.043333333335
ACC-1217063613,27,11.06,4418.31,0.0,CUS-1739931018,2018-10-14,Kimberly,F,-37.82,147.61,,d5696f32-4a46-47f7-83af-ae638ffeb05f,-37.64,144.93,VIC,Roxburgh Park,debit,authorized,7cd9bc583baf40f882254cf7ec6ed642,SALES-POS,20-30,2018,10,14,17,23,Sunday,30 days,59174.043333333335
ACC-1217063613,27,20.0,4398.31,,CUS-1739931018,2018-10-15,Kimberly,F,-37.82,147.61,,,,,,,debit,posted,a723584ba66240c28256c6c4a6e1cdb3,INTER BANK,20-30,2018,10,15,23,0,Monday,30 days,59174.043333333335
ACC-1217063613,27,155.0,4243.31,,CUS-1739931018,2018-10-16,Kimberly,F,-37.82,147.61,,,,,,,debit,posted,666cf73c9a974d9eaf340aab6b99965c,INTER BANK,20-30,2018,10,16,19,0,Tuesday,30 days,59174.043333333335
ACC-1217063613,27,8.16,4235.15,0.0,CUS-1739931018,2018-10-20,Kimberly,F,-37.82,147.61,,c9a1d8c2-3d58-4bf4-a2a9-bb3671358c2c,-37.68,144.58,VIC,Melton,debit,authorized,d1703583612940e9818d9ec8a64bf371,POS,20-30,2018,10,20,21,53,Saturday,30 days,59174.043333333335
ACC-1217063613,27,20.0,4215.15,,CUS-1739931018,2018-10-22,Kimberly,F,-37.82,147.61,,,,,,,debit,posted,91ac28fe5f134587b7618af3a0154c28,INTER BANK,20-30,2018,10,22,23,0,Monday,30 days,59174.043333333335
ACC-1217063613,27,173.0,4042.15,,CUS-1739931018,2018-10-24,Kimberly,F,-37.82,147.61,,,,,,,debit,posted,1cf8d3beea034c749c1af7231dba693b,PAYMENT,20-30,2018,10,24,6,0,Wednesday,30 days,59174.043333333335
ACC-1217063613,27,41.75,8864.02,1.0,CUS-1739931018,2018-10-27,Kimberly,F,-37.82,147.61,,3ae083e7-fb3f-48eb-b2d6-3254c345eaf5,-37.86,145.03,VIC,Malvern,debit,authorized,93ca686b688d477b9f3b51c30093ca46,POS,20-30,2018,10,27,11,36,Saturday,30 days,59174.043333333335
ACC-1217063613,27,20.0,8844.02,,CUS-1739931018,2018-10-29,Kimberly,F,-37.82,147.61,,,,,,,debit,posted,0aaa8212ec3d41339ba834f284935f3b,INTER BANK,20-30,2018,10,29,23,0,Monday,30 days,59174.043333333335
ACC-3771436525,20,27.82,614.93,1.0,CUS-3325710106,2018-08-01,Derek,M,-37.92,145.04,,d2c81d3b-0816-4809-88e0-32d1451a8aa3,-37.83,145.06,VIC,Camberwell,debit,authorized,753965c7dfc54261851cf247a6e9f7e7,POS,<20,2018,8,1,21,19,Wednesday,7 days,57341.5
ACC-3771436525,20,11.3,603.63,1.0,CUS-3325710106,2018-08-03,Derek,M,-37.92,145.04,,1747aff3-3680-463b-9ec1-5a1005817e83,-38.11,145.28,VIC,Cranbourne,debit,authorized,99f57faaac154f2aae2a0436cade61d1,SALES-POS,<20,2018,8,3,14,24,Friday,7 days,57341.5
ACC-3771436525,20,26.15,577.48,0.0,CUS-3325710106,2018-08-03,Derek,M,-37.92,145.04,,ddf730bc-ba3a-43ea-a891-767447ddd563,-37.81,144.96,VIC,Melbourne,debit,authorized,c579c2ebcfa94d42a0e1c0b791c10386,SALES-POS,<20,2018,8,3,17,0,Friday,7 days,57341.5
ACC-3771436525,20,49.0,528.48,,CUS-3325710106,2018-08-05,Derek,M,-37.92,145.04,,,,,,,debit,posted,9cd247ab17454dd1a657d74d37fe450e,PAYMENT,<20,2018,8,5,7,0,Sunday,7 days,57341.5
ACC-3771436525,20,25.75,1602.43,1.0,CUS-3325710106,2018-08-08,Derek,M,-37.92,145.04,,0e6cc3d2-7109-4fb2-8440-fa69523e539b,-37.85,145.11,VIC,Burwood,debit,authorized,cffd3edf213e4da6b3ff039e71f32550,POS,<20,2018,8,8,11,15,Wednesday,7 days,57341.5
ACC-3771436525,20,6.69,1595.74,1.0,CUS-3325710106,2018-08-08,Derek,M,-37.92,145.04,,af4a347d-be60-4f6e-86c2-5ea13ac4e064,-37.83,144.98,VIC,South Yarra,debit,authorized,ef04fc76c46f4230b7a3c7b277aab12c,SALES-POS,<20,2018,8,8,20,54,Wednesday,7 days,57341.5
ACC-3771436525,20,8.45,1587.29,1.0,CUS-3325710106,2018-08-09,Derek,M,-37.92,145.04,,96589143-d9f3-4a5f-afad-5776e7eab217,-37.81,144.93,VIC,West Melbourne,debit,authorized,557d0dae47a24e7cac724b3adc84e8a7,SALES-POS,<20,2018,8,9,4,23,Thursday,7 days,57341.5
ACC-3771436525,20,24.27,1563.02,1.0,CUS-3325710106,2018-08-10,Derek,M,-37.92,145.04,,825813df-2fd4-4c13-9be5-e77abc299ae4,-37.95,145.15,VIC,Springvale,debit,authorized,3ae916dfdc704f3e91d67404a584b7e2,SALES-POS,<20,2018,8,10,13,50,Friday,7 days,57341.5
ACC-3771436525,20,10.31,1552.71,1.0,CUS-3325710106,2018-08-11,Derek,M,-37.92,145.04,,31e3fdf2-a64a-4e3a-b920-ec535cd28855,-37.85,145.15,VIC,Burwood East,debit,authorized,5d0d4d16e39b4bc7bc0d0bcd0ce39180,SALES-POS,<20,2018,8,11,10,49,Saturday,7 days,57341.5
ACC-3771436525,20,21.3,1531.41,1.0,CUS-3325710106,2018-08-11,Derek,M,-37.92,145.04,,4384864e-6e27-4b68-948e-1d5f0d60a38a,-37.81,145.23,VIC,Ringwood,debit,authorized,d6eb2deff13d48f8b0772c2cbd208d32,POS,<20,2018,8,11,11,17,Saturday,7 days,57341.5
ACC-3771436525,20,1239.0,292.41,,CUS-3325710106,2018-08-11,Derek,M,-37.92,145.04,,,,,,,debit,posted,ded0fd964f0748d98b08ab852b88c5b9,PAYMENT,<20,2018,8,11,17,0,Saturday,7 days,57341.5
ACC-3771436525,20,49.0,243.41,,CUS-3325710106,2018-08-12,Derek,M,-37.92,145.04,,,,,,,debit,posted,484284542630408fa2d896f353309e31,PAYMENT,<20,2018,8,12,7,0,Sunday,7 days,57341.5
ACC-3771436525,20,168.0,75.41,,CUS-3325710106,2018-08-13,Derek,M,-37.92,145.04,,,,,,,debit,posted,df70913c4e8d4173bf8148958ab8c9ec,PAYMENT,<20,2018,8,13,2,0,Monday,7 days,57341.5
ACC-3771436525,20,20.54,54.87,1.0,CUS-3325710106,2018-08-14,Derek,M,-37.92,145.04,,61adfa09-d7b9-4301-b95b-9cbf6dc34d01,-38.1,147.07,VIC,Sale,debit,authorized,8bcd2c6c2c51422fa29d17954972cd6c,SALES-POS,<20,2018,8,14,11,28,Tuesday,7 days,57341.5
ACC-3771436525,20,16.41,1138.16,1.0,CUS-3325710106,2018-08-15,Derek,M,-37.92,145.04,,4d218962-62cb-45d1-89a2-b1a49c02a8d8,-37.79,145.09,VIC,Balwyn North,debit,authorized,4d18993d279d4aa7b3034a40d713b225,POS,<20,2018,8,15,19,29,Wednesday,7 days,57341.5
ACC-3771436525,20,8.61,1092.84,1.0,CUS-3325710106,2018-08-17,Derek,M,-37.92,145.04,,bfbd3275-116a-4319-bab3-4901b7bae8e8,-37.94,145.21,VIC,Dandenong North,debit,authorized,4c80273c585344778c8720f1e76675e9,SALES-POS,<20,2018,8,17,9,4,Friday,7 days,57341.5
ACC-3771436525,20,101.56,991.28,1.0,CUS-3325710106,2018-08-17,Derek,M,-37.92,145.04,,bcc8035c-6300-4953-b19d-ca2ec063162b,-37.84,144.96,VIC,South Melbourne,debit,authorized,93596b14ad1a4172865b4719885ead98,SALES-POS,<20,2018,8,17,14,43,Friday,7 days,57341.5
ACC-3771436525,20,95.67,895.61,1.0,CUS-3325710106,2018-08-17,Derek,M,-37.92,145.04,,dbc85115-6239-4bf2-8379-ece6d7a66ac9,-37.84,144.97,VIC,South Melbourne,debit,authorized,def3148668104b75ba1c3964db3341b3,SALES-POS,<20,2018,8,17,15,16,Friday,7 days,57341.5
ACC-3771436525,20,198.5,697.11,1.0,CUS-3325710106,2018-08-17,Derek,M,-37.92,145.04,,c51ef0f5-d6ef-4b80-8217-cd059aee74e1,-33.87,151.2,NSW,Sydney,debit,authorized,490d71dace6a421bae8bfa6203070553,SALES-POS,<20,2018,8,17,15,32,Friday,7 days,57341.5
ACC-3771436525,20,17.7,679.41,1.0,CUS-3325710106,2018-08-17,Derek,M,-37.92,145.04,,7a8bd56c-d50b-4b51-8bcb-cf09dc3b124e,-37.77,144.89,VIC,Maribyrnong,debit,authorized,77c39acfcf8c4eea83440961a81ce8a7,SALES-POS,<20,2018,8,17,19,29,Friday,7 days,57341.5
ACC-3771436525,20,30.55,648.86,1.0,CUS-3325710106,2018-08-18,Derek,M,-37.92,145.04,,f69cc4ef-7fbc-4c83-a40f-c07f54ae7fc1,-38.03,145.21,VIC,Dandenong South,debit,authorized,c490ae8ce6334976bbdf814ece6dd96c,POS,<20,2018,8,18,7,30,Saturday,7 days,57341.5
ACC-3771436525,20,14.6,634.26,1.0,CUS-3325710106,2018-08-18,Derek,M,-37.92,145.04,,985dd446-a4e7-4690-a0fb-1a4aeac93952,-37.81,144.97,VIC,Melbourne,debit,authorized,01fae826ee9d4efdb0c024d5089d6b79,POS,<20,2018,8,18,16,24,Saturday,7 days,57341.5
ACC-3771436525,20,6.31,627.95,1.0,CUS-3325710106,2018-08-18,Derek,M,-37.92,145.04,,ab9e36df-3ba4-4968-b19d-587eede7f2be,-37.83,144.85,VIC,Altona North,debit,authorized,99b9c31da76e472e8e93701e8956e826,POS,<20,2018,8,18,18,44,Saturday,7 days,57341.5
ACC-3771436525,20,24.42,603.53,0.0,CUS-3325710106,2018-08-18,Derek,M,-37.92,145.04,,e9888890-71de-4be4-8199-bc6216959d53,-37.81,145.23,VIC,Ringwood,debit,authorized,1b05b63f7303471f8a003597e2c9f4ef,POS,<20,2018,8,18,19,25,Saturday,7 days,57341.5
ACC-3771436525,20,19.08,584.45,0.0,CUS-3325710106,2018-08-19,Derek,M,-37.92,145.04,,fd1c9a34-9224-4338-9716-e8f10005b83a,-27.43,153,QLD,Alderley,debit,authorized,cd5f98eac8444c398fa0b4e13a7c316d,SALES-POS,<20,2018,8,19,0,24,Sunday,7 days,57341.5
ACC-3771436525,20,49.0,535.45,,CUS-3325710106,2018-08-19,Derek,M,-37.92,145.04,,,,,,,debit,posted,9bb225555efd4bca9af048bd0982307d,PAYMENT,<20,2018,8,19,7,0,Sunday,7 days,57341.5
ACC-3771436525,20,18.16,517.29,0.0,CUS-3325710106,2018-08-19,Derek,M,-37.92,145.04,,e4fd1b04-9985-4d3e-ac70-2cfcd93b5ad5,-37.87,145.24,VIC,Wantirna South,debit,authorized,67b146704ca0434684b3e92d3a0cf1c0,SALES-POS,<20,2018,8,19,12,34,Sunday,7 days,57341.5
ACC-3771436525,20,3.1,514.19,1.0,CUS-3325710106,2018-08-19,Derek,M,-37.92,145.04,,892b083a-f5ac-42f6-9b27-62c7283b2f0c,-37.8,144.89,VIC,Footscray,debit,authorized,c31548ffd8784c70b263e211c867c41d,SALES-POS,<20,2018,8,19,13,33,Sunday,7 days,57341.5
ACC-3771436525,20,22.06,492.13,0.0,CUS-3325710106,2018-08-19,Derek,M,-37.92,145.04,,a0e61432-2b0f-40dd-83f1-c25342d85fb5,-37.81,144.96,VIC,Melbourne,debit,authorized,5f9bef00d2bf4b06ad1b159c219b7eaf,POS,<20,2018,8,19,21,53,Sunday,7 days,57341.5
ACC-3771436525,20,18.69,473.44,1.0,CUS-3325710106,2018-08-20,Derek,M,-37.92,145.04,,450383c0-a70a-4ef2-8381-3fa1d3e86523,-37.81,147.63,VIC,Eastwood,debit,authorized,e343a8e2d9494364b307dc5495e07729,POS,<20,2018,8,20,10,31,Monday,7 days,57341.5
ACC-3771436525,20,28.22,445.22,1.0,CUS-3325710106,2018-08-21,Derek,M,-37.92,145.04,,f8404f44-f730-4531-abf3-a05bfe5dccd3,-37.78,145.29,VIC,Croydon,debit,authorized,d06097d75f394d7ab167257c5ec7359f,POS,<20,2018,8,21,10,45,Tuesday,7 days,57341.5
ACC-3771436525,20,20.88,1524.04,1.0,CUS-3325710106,2018-08-24,Derek,M,-37.92,145.04,,ef130174-82fc-4379-b3d9-19a82cde8aa4,-37.89,145.09,VIC,Oakleigh,debit,authorized,1cae42b1129d4d8a8c54d0a26f416c90,POS,<20,2018,8,24,22,52,Friday,7 days,57341.5
ACC-3771436525,20,49.0,1475.04,,CUS-3325710106,2018-08-26,Derek,M,-37.92,145.04,,,,,,,debit,posted,4233044b32024811b816f6eea053fc59,PAYMENT,<20,2018,8,26,7,0,Sunday,7 days,57341.5
ACC-3771436525,20,16.6,2558.14,1.0,CUS-3325710106,2018-08-31,Derek,M,-37.92,145.04,,741b088c-4a16-42a3-b4d6-3b9a5e018613,-37.77,144.97,VIC,Brunswick East,debit,authorized,4783fc6636134fdaa4a3273c7d1a62c7,SALES-POS,<20,2018,8,31,11,19,Friday,7 days,57341.5
ACC-3771436525,20,31.56,2526.58,1.0,CUS-3325710106,2018-08-31,Derek,M,-37.92,145.04,,4cc213cb-2959-47b0-83a4-924d99e26216,-37.89,145.09,VIC,Oakleigh,debit,authorized,e6a3a2c5d69b47bebe9c6e3d4d173e44,SALES-POS,<20,2018,8,31,19,11,Friday,7 days,57341.5
ACC-3771436525,20,132.58,2394.0,0.0,CUS-3325710106,2018-08-31,Derek,M,-37.92,145.04,,660292cf-7b01-4be6-b1be-9277e7ca4290,-33.87,151.2,NSW,Sydney,debit,authorized,22cc457f720d4a638430e9dbf72f506b,POS,<20,2018,8,31,22,9,Friday,7 days,57341.5
ACC-3771436525,20,14.45,2379.55,1.0,CUS-3325710106,2018-08-31,Derek,M,-37.92,145.04,,c0821855-94c7-4780-be17-2c03ba190657,-37.88,145.05,VIC,Malvern East,debit,authorized,9785644a187947128d8baa8875aff133,SALES-POS,<20,2018,8,31,22,29,Friday,7 days,57341.5
ACC-3771436525,20,22.52,2357.03,1.0,CUS-3325710106,2018-09-01,Derek,M,-37.92,145.04,,0bccc0f0-5538-4fdc-8897-63e5b07a68d2,-37.82,144.97,VIC,Melbourne,debit,authorized,cc5039b1ea7e4407a2eb1fa751a756b5,POS,<20,2018,9,1,2,32,Saturday,7 days,57341.5
ACC-3771436525,20,2.98,2354.05,1.0,CUS-3325710106,2018-09-01,Derek,M,-37.92,145.04,,1c2da096-2a2a-4a01-b6ad-0aaa87787ec3,-38.1,145.32,VIC,Clyde North,debit,authorized,15a4fa261dec48478717cf1db667ad9f,POS,<20,2018,9,1,5,22,Saturday,7 days,57341.5
ACC-3771436525,20,13.69,2340.36,1.0,CUS-3325710106,2018-09-01,Derek,M,-37.92,145.04,,88ab68ca-28ea-4baf-9719-04fd94cb7628,-37.74,144.9,VIC,North Essendon,debit,authorized,0c909e32f9bb4f4ebf4d16627f17ad08,POS,<20,2018,9,1,9,8,Saturday,7 days,57341.5
ACC-3771436525,20,15.84,2324.52,1.0,CUS-3325710106,2018-09-01,Derek,M,-37.92,145.04,,ee6f52f2-b39d-497f-84ff-5bab1e80dda6,-37.89,145.08,VIC,Malvern East,debit,authorized,15a8c89ca3ea41edadabe5160463446d,POS,<20,2018,9,1,9,37,Saturday,7 days,57341.5
ACC-3771436525,20,28.76,2295.76,0.0,CUS-3325710106,2018-09-01,Derek,M,-37.92,145.04,,a14b058d-1c59-4c98-b71f-044d65cdd118,-38.1,145.18,VIC,Carrum Downs,debit,authorized,879bc2dd2f1145f49edb90108663efd6,SALES-POS,<20,2018,9,1,10,17,Saturday,7 days,57341.5
ACC-3771436525,20,21.34,2274.42,0.0,CUS-3325710106,2018-09-01,Derek,M,-37.92,145.04,,df39e155-fa65-4da8-a339-13a91b6841e0,-37.87,144.98,VIC,Saint Kilda,debit,authorized,515eaae556294278ba709f8b46c2bbdc,POS,<20,2018,9,1,15,29,Saturday,7 days,57341.5
ACC-3771436525,20,98.97,2175.45,0.0,CUS-3325710106,2018-09-01,Derek,M,-37.92,145.04,,7b3f4761-3330-4537-8c58-96949bc12314,-37.81,144.96,VIC,Melbourne,debit,authorized,99bf9916cff94720adfff5dc704852b3,SALES-POS,<20,2018,9,1,21,26,Saturday,7 days,57341.5
ACC-3771436525,20,49.0,2126.45,,CUS-3325710106,2018-09-02,Derek,M,-37.92,145.04,,,,,,,debit,posted,c487b7013d0b4f7d897dd5cfec23ff11,PAYMENT,<20,2018,9,2,7,0,Sunday,7 days,57341.5
ACC-3771436525,20,9.33,2117.12,0.0,CUS-3325710106,2018-09-04,Derek,M,-37.92,145.04,,ec86fe38-13d5-45f6-935d-5304604fd6e9,-37.82,144.96,VIC,Melbourne,debit,authorized,e6652cf8bc4d4c069da7961832beca90,POS,<20,2018,9,4,1,2,Tuesday,7 days,57341.5
ACC-3771436525,20,11.04,3205.78,0.0,CUS-3325710106,2018-09-08,Derek,M,-37.92,145.04,,f956e328-ee48-45d4-a029-881c62ca44ff,-37.88,145.04,VIC,Caulfield East,debit,authorized,2f10d9638c60407f81f335e5221fadac,POS,<20,2018,9,8,18,55,Saturday,7 days,57341.5
ACC-3771436525,20,15.98,3189.8,1.0,CUS-3325710106,2018-09-08,Derek,M,-37.92,145.04,,238774cb-e57c-4054-815a-be7606a52038,-37.83,140.78,SA,Mount Gambier,debit,authorized,fe29e7c8a9d94cff901aa6acae971e29,POS,<20,2018,9,8,20,20,Saturday,7 days,57341.5
ACC-3771436525,20,11.97,3177.83,1.0,CUS-3325710106,2018-09-08,Derek,M,-37.92,145.04,,ed8dbb74-8cca-47c6-b4d1-cec1c9b5e337,-37.82,144.95,VIC,Docklands,debit,authorized,3a0e113337314a5e83f34cdbeeaa17e3,SALES-POS,<20,2018,9,8,20,53,Saturday,7 days,57341.5
ACC-3771436525,20,49.0,3128.83,,CUS-3325710106,2018-09-09,Derek,M,-37.92,145.04,,,,,,,debit,posted,395c38623b374535adcb2d4631f6b3f8,PAYMENT,<20,2018,9,9,7,0,Sunday,7 days,57341.5
ACC-3771436525,20,48.84,3079.99,1.0,CUS-3325710106,2018-09-09,Derek,M,-37.92,145.04,,c144ea52-6b42-4480-9691-9dacf2b0891b,-37.82,144.89,VIC,Yarraville,debit,authorized,4578b631fbf948f988a111b3b951301e,SALES-POS,<20,2018,9,9,9,8,Sunday,7 days,57341.5
ACC-3771436525,20,14.83,3065.16,1.0,CUS-3325710106,2018-09-09,Derek,M,-37.92,145.04,,4bb74c96-f899-4b0c-81ff-8d0d2be302ef,-37.81,144.97,VIC,Melbourne,debit,authorized,468ad171de8740fa93b35b1b56c4c84d,SALES-POS,<20,2018,9,9,14,57,Sunday,7 days,57341.5
ACC-3771436525,20,168.0,3996.86,,CUS-3325710106,2018-09-13,Derek,M,-37.92,145.04,,,,,,,debit,posted,06d85d7cb8f74474b9e8ae36fadce0c9,PAYMENT,<20,2018,9,13,2,0,Thursday,7 days,57341.5
ACC-3771436525,20,49.0,3947.86,,CUS-3325710106,2018-09-16,Derek,M,-37.92,145.04,,,,,,,debit,posted,643813e2bc414d3aa46135ebae57180c,PAYMENT,<20,2018,9,16,7,0,Sunday,7 days,57341.5
ACC-3771436525,20,7.91,3939.95,1.0,CUS-3325710106,2018-09-16,Derek,M,-37.92,145.04,,da6078a6-3810-4a9b-bc13-ca2f48c9565b,-37.78,145.08,VIC,Bulleen,debit,authorized,0731d8b445d143888ddf7b604f25376b,POS,<20,2018,9,16,13,4,Sunday,7 days,57341.5
ACC-3771436525,20,15.34,3924.61,1.0,CUS-3325710106,2018-09-17,Derek,M,-37.92,145.04,,a6709743-af53-4d35-a5ae-d529b9ad399d,-33.86,151.21,NSW,Sydney,debit,authorized,8b71b38408974b98b9496c981ce2bc59,POS,<20,2018,9,17,10,24,Monday,7 days,57341.5
ACC-3771436525,20,15.84,3908.77,1.0,CUS-3325710106,2018-09-17,Derek,M,-37.92,145.04,,e6afc403-4665-4659-adde-a0d8d9051e9c,-37.8,144.98,VIC,Fitzroy,debit,authorized,a67b659e935d40759b044467f146611c,POS,<20,2018,9,17,21,5,Monday,7 days,57341.5
ACC-3771436525,20,23.66,3885.11,1.0,CUS-3325710106,2018-09-17,Derek,M,-37.92,145.04,,e9f5301e-34d7-472b-93fc-58f95441845d,-37.76,144.94,VIC,Brunswick West,debit,authorized,09229b99371c4812b30ea901039bb64a,SALES-POS,<20,2018,9,17,23,7,Monday,7 days,57341.5
ACC-3771436525,20,32.65,3852.46,1.0,CUS-3325710106,2018-09-18,Derek,M,-37.92,145.04,,32b84984-c087-4220-88ed-781fd3163573,-37.86,144.69,VIC,Hoppers Crossing,debit,authorized,372dc0b36ab34a439ac62e2a11b3f2ac,POS,<20,2018,9,18,6,3,Tuesday,7 days,57341.5
ACC-3771436525,20,26.28,3826.18,1.0,CUS-3325710106,2018-09-18,Derek,M,-37.92,145.04,,10c8d949-460b-4da9-819e-68feccf8949c,-37.8,145.28,VIC,Croydon,debit,authorized,afed856d004d4006a8c1ad279617e12b,POS,<20,2018,9,18,8,25,Tuesday,7 days,57341.5
ACC-3771436525,20,40.15,3786.03,1.0,CUS-3325710106,2018-09-18,Derek,M,-37.92,145.04,,3e319dad-fdc1-4283-a9aa-9d475c8fbab6,-37.77,144.89,VIC,Maribyrnong,debit,authorized,ca31e501118b4e3b8e68161ae5217348,SALES-POS,<20,2018,9,18,8,54,Tuesday,7 days,57341.5
ACC-3771436525,20,7.61,3778.42,1.0,CUS-3325710106,2018-09-18,Derek,M,-37.92,145.04,,fcf5c03b-d2cd-4db2-b651-f85210f5b3a9,-37.8,144.98,VIC,Fitzroy,debit,authorized,235f903cfed04242a96c6c991118abb5,POS,<20,2018,9,18,10,32,Tuesday,7 days,57341.5
ACC-3771436525,20,22.22,3756.2,1.0,CUS-3325710106,2018-09-18,Derek,M,-37.92,145.04,,c7bdbb16-87dc-4857-9882-82eca7eaa9c2,-37.83,144.95,VIC,South Wharf,debit,authorized,36b9d69d896a4412bad0fe86130eb21e,POS,<20,2018,9,18,13,38,Tuesday,7 days,57341.5
ACC-3771436525,20,9.0,4846.9,1.0,CUS-3325710106,2018-09-20,Derek,M,-37.92,145.04,,f54e8993-7ae0-4b69-9e65-6f43eb27d210,-37.81,144.97,VIC,Fitzroy,debit,authorized,85811a5520de420fb6de7b9f306a5b51,POS,<20,2018,9,20,4,58,Thursday,7 days,57341.5
ACC-3771436525,20,6.04,4840.86,1.0,CUS-3325710106,2018-09-20,Derek,M,-37.92,145.04,,ef4ec0b9-93e5-4374-bfa2-a1cded0c1670,-37.84,145.2,VIC,Vermont,debit,authorized,667a42e1ce704177b937500c4037db1f,POS,<20,2018,9,20,11,19,Thursday,7 days,57341.5
ACC-3771436525,20,22.66,4818.2,1.0,CUS-3325710106,2018-09-20,Derek,M,-37.92,145.04,,641687b0-7958-4bd7-99a8-6d25e18bde46,-37.83,145.08,VIC,Canterbury,debit,authorized,fc52462f6d64452ea2fc81d0f6429c90,SALES-POS,<20,2018,9,20,15,56,Thursday,7 days,57341.5
ACC-3771436525,20,211.15,4607.05,1.0,CUS-3325710106,2018-09-20,Derek,M,-37.92,145.04,,97b564f0-fb0a-4ad4-99c3-e85ff34eafa7,-37.79,144.93,VIC,Kensington,debit,authorized,246656266a0a41fba27ec30335b50a4a,SALES-POS,<20,2018,9,20,17,1,Thursday,7 days,57341.5
ACC-3771436525,20,17.62,4589.43,1.0,CUS-3325710106,2018-09-20,Derek,M,-37.92,145.04,,c5330572-8d74-4658-ba4d-e965094ab166,-37.8,144.9,VIC,Footscray,debit,authorized,8fd9b65c999c4b1a91797ed325a92f92,SALES-POS,<20,2018,9,20,17,53,Thursday,7 days,57341.5
ACC-3771436525,20,13.0,4576.43,1.0,CUS-3325710106,2018-09-20,Derek,M,-37.92,145.04,,ad1404e0-42fe-4df6-ab2b-ed1b8fd73c1a,-37.82,144.95,VIC,Docklands,debit,authorized,8bf6842010e046efb9ea88a5bcecc02f,POS,<20,2018,9,20,23,42,Thursday,7 days,57341.5
ACC-3771436525,20,9.69,4566.74,1.0,CUS-3325710106,2018-09-21,Derek,M,-37.92,145.04,,94af0f57-45d9-498a-afdc-3e2ede08c20d,-37.82,144.97,VIC,Melbourne,debit,authorized,8109d07a9be84cd19b28d72b6fc83f5f,SALES-POS,<20,2018,9,21,6,54,Friday,7 days,57341.5
ACC-3771436525,20,39.17,4527.57,0.0,CUS-3325710106,2018-09-21,Derek,M,-37.92,145.04,,d6191103-722d-4593-b4e2-b6d4bf7a40b5,-33.86,151.2,NSW,Sydney,debit,authorized,fb7fb07c6a8843eca7908439298b8344,SALES-POS,<20,2018,9,21,8,45,Friday,7 days,57341.5
ACC-3771436525,20,72.7,4454.87,1.0,CUS-3325710106,2018-09-21,Derek,M,-37.92,145.04,,accc7dc4-650d-444a-a496-45cbe2403caf,-37.84,144.99,VIC,South Yarra,debit,authorized,a3199f6d22114c4988444fbcd0c04074,SALES-POS,<20,2018,9,21,11,58,Friday,7 days,57341.5
ACC-3771436525,20,9.85,4445.02,1.0,CUS-3325710106,2018-09-21,Derek,M,-37.92,145.04,,424e95f4-f020-4f98-9cdc-b80178f01e1d,-37.77,145.11,VIC,Templestowe Lower,debit,authorized,2afd2c5e10ed4f8995f23d7ac96b3952,POS,<20,2018,9,21,12,28,Friday,7 days,57341.5
ACC-3771436525,20,63.49,4381.53,1.0,CUS-3325710106,2018-09-22,Derek,M,-37.92,145.04,,db23d39e-b726-4baf-bded-fd7bf30af2c5,-37.88,145.17,VIC,Glen Waverley,debit,authorized,72f1590caf07405080fb7acbca3e2a1b,SALES-POS,<20,2018,9,22,13,45,Saturday,7 days,57341.5
ACC-3771436525,20,30.24,4351.29,1.0,CUS-3325710106,2018-09-22,Derek,M,-37.92,145.04,,99de3c07-fc81-4cde-bfbc-d652d621e26f,-33.86,151.21,NSW,Sydney,debit,authorized,756011fd6b1b4a56a849453f9437bfdb,POS,<20,2018,9,22,17,57,Saturday,7 days,57341.5
ACC-3771436525,20,19.98,4331.31,1.0,CUS-3325710106,2018-09-22,Derek,M,-37.92,145.04,,80093cfc-3524-4332-8687-65ecff733965,-37.74,144.8,VIC,Melbourne,debit,authorized,5a201b5042454309b7671c3b99447481,SALES-POS,<20,2018,9,22,21,7,Saturday,7 days,57341.5
ACC-3771436525,20,49.0,4249.83,,CUS-3325710106,2018-09-23,Derek,M,-37.92,145.04,,,,,,,debit,posted,19086753979d4460a8687d124b89d253,PAYMENT,<20,2018,9,23,7,0,Sunday,7 days,57341.5
ACC-3771436525,20,32.48,4298.83,1.0,CUS-3325710106,2018-09-23,Derek,M,-37.92,145.04,,f624a383-3e17-4bf2-a917-e5764c94068f,-37.91,145.04,VIC,Mckinnon,debit,authorized,4311839a0fc643ac945bc7d479dcdae2,SALES-POS,<20,2018,9,23,7,23,Sunday,7 days,57341.5
ACC-3771436525,20,13.57,4236.26,1.0,CUS-3325710106,2018-09-23,Derek,M,-37.92,145.04,,6a93813b-6cad-4bf6-94bc-2e7b0a6ff0d2,-37.81,144.97,VIC,Melbourne,debit,authorized,7a2a94b3083d4c09a1cbe465c9561c9d,POS,<20,2018,9,23,8,6,Sunday,7 days,57341.5
ACC-3771436525,20,21.67,4214.59,1.0,CUS-3325710106,2018-09-23,Derek,M,-37.92,145.04,,284c24d9-bceb-4f99-ae4b-e96b1b452c74,-37.81,145.14,VIC,Box Hill North,debit,authorized,1c79d221c7ae42d79ccdc7129cc81722,POS,<20,2018,9,23,8,53,Sunday,7 days,57341.5
ACC-3771436525,20,14.56,4200.03,1.0,CUS-3325710106,2018-09-23,Derek,M,-37.92,145.04,,2cd339fb-71bc-481a-aa09-16ecef51cd56,-37.81,144.97,VIC,Melbourne,debit,authorized,07222aef19e1424d84167550cbd96504,SALES-POS,<20,2018,9,23,14,25,Sunday,7 days,57341.5
ACC-3771436525,20,22.62,4177.41,1.0,CUS-3325710106,2018-09-23,Derek,M,-37.92,145.04,,83832282-13a3-4f4f-ac57-69d60f30294b,-37.98,145.06,VIC,Mentone,debit,authorized,68a31c4c2c1946deaa3bd25475dff344,POS,<20,2018,9,23,15,57,Sunday,7 days,57341.5
ACC-3771436525,20,21.65,4155.76,1.0,CUS-3325710106,2018-09-23,Derek,M,-37.92,145.04,,d22c0bb7-5406-403f-a9bc-3e4d01f51df8,-33.85,151.03,NSW,Auburn,debit,authorized,5a69ef86b7e54c58949098fb3dc70985,POS,<20,2018,9,23,21,52,Sunday,7 days,57341.5
ACC-3771436525,20,32.14,4123.62,0.0,CUS-3325710106,2018-09-24,Derek,M,-37.92,145.04,,b856d775-6d6e-4248-820e-40378b0e7516,-37.74,145.03,VIC,Preston,debit,authorized,72e4ec586e7e4f1387b06a37c7b9a543,POS,<20,2018,9,24,9,30,Monday,7 days,57341.5
ACC-3771436525,20,22.28,4101.34,1.0,CUS-3325710106,2018-09-24,Derek,M,-37.92,145.04,,a20827bf-4aa3-4845-99ef-14a0f887f5c6,-35.22,149.14,ACT,Mitchell,debit,authorized,ebe4d12593784cdb905dd729045b3b73,POS,<20,2018,9,24,21,46,Monday,7 days,57341.5
ACC-3771436525,20,22.41,4078.93,1.0,CUS-3325710106,2018-09-25,Derek,M,-37.92,145.04,,2c7c42ec-73a2-479e-8e2c-0f84cba09a76,-37.77,145.04,VIC,Ivanhoe,debit,authorized,2d44c2bcb2a44068bea95b765a55640c,SALES-POS,<20,2018,9,25,11,16,Tuesday,7 days,57341.5
ACC-3771436525,20,27.91,5150.72,1.0,CUS-3325710106,2018-09-25,Derek,M,-37.92,145.04,,a038df8c-bade-40e9-b864-9371758a8745,-33.87,151.2,NSW,Pyrmont,debit,authorized,0b628ca264384849bbfd05a8e1a2da4b,POS,<20,2018,9,25,19,6,Tuesday,7 days,57341.5
ACC-3771436525,20,19.53,5131.19,0.0,CUS-3325710106,2018-09-26,Derek,M,-37.92,145.04,,c6299974-d50a-4eea-8b23-a567df6e28ed,-37.8,144.97,VIC,Carlton,debit,authorized,1ddfe6da9e5d4c52a376960b8770835a,POS,<20,2018,9,26,7,24,Wednesday,7 days,57341.5
ACC-3771436525,20,25.82,5105.37,1.0,CUS-3325710106,2018-09-26,Derek,M,-37.92,145.04,,e1318054-6edd-4607-b008-22200e86a315,-33.87,151.21,NSW,Sydney,debit,authorized,027149abd7de4110964fc2b7d20674b3,SALES-POS,<20,2018,9,26,9,26,Wednesday,7 days,57341.5
ACC-3771436525,20,34.97,5070.4,1.0,CUS-3325710106,2018-09-26,Derek,M,-37.92,145.04,,6ae42e47-a7d8-43cd-89b5-63bbabb4d992,-37.79,145.13,VIC,Doncaster,debit,authorized,d547614d4c3740d4ba26e9612b3c7888,SALES-POS,<20,2018,9,26,9,30,Wednesday,7 days,57341.5
ACC-3771436525,20,48.47,5021.93,1.0,CUS-3325710106,2018-09-26,Derek,M,-37.92,145.04,,957f68cc-0d5b-42d7-9101-d9ca1982c0ef,-37.81,144.97,VIC,Melbourne,debit,authorized,dfc6e553bd944a7183d60074735d7b29,SALES-POS,<20,2018,9,26,11,50,Wednesday,7 days,57341.5
ACC-3771436525,20,36.85,4985.08,1.0,CUS-3325710106,2018-09-26,Derek,M,-37.92,145.04,,692d143c-720b-4ea8-8378-1890b495eab9,-37.74,145.03,VIC,Preston,debit,authorized,2a6fcac0df234b7d813aac9f61c20209,POS,<20,2018,9,26,14,41,Wednesday,7 days,57341.5
ACC-3771436525,20,14.78,4970.3,1.0,CUS-3325710106,2018-09-28,Derek,M,-37.92,145.04,,e5821689-3704-4c9c-96e9-75dfe8ac0e55,-37.8,144.98,VIC,Fitzroy,debit,authorized,e7b4e1c9301341aa8c984be868b8d802,SALES-POS,<20,2018,9,28,2,55,Friday,7 days,57341.5
ACC-3771436525,20,46.91,4923.39,1.0,CUS-3325710106,2018-09-28,Derek,M,-37.92,145.04,,b080fff2-53e2-4e2d-b1d2-17f3fe5b5b2e,-37.68,144.92,VIC,Broadmeadows,debit,authorized,e9b212fb3cf5456e9e54e8b444b9bb6d,SALES-POS,<20,2018,9,28,14,21,Friday,7 days,57341.5
ACC-3771436525,20,9.53,4913.86,0.0,CUS-3325710106,2018-09-28,Derek,M,-37.92,145.04,,b2617e94-95dc-4950-ae28-7eabc14ebbcb,-37.79,144.95,VIC,Parkville,debit,authorized,332549c0adaa444d9bd8ef7c5ea33176,SALES-POS,<20,2018,9,28,18,19,Friday,7 days,57341.5
ACC-3771436525,20,11.46,4902.4,1.0,CUS-3325710106,2018-09-28,Derek,M,-37.92,145.04,,9a10665e-b61b-4130-8951-b4db2a38edcd,-37.78,144.92,VIC,Ascot Vale,debit,authorized,6a7c44bb9173489ab5c43c1246104ab0,POS,<20,2018,9,28,18,40,Friday,7 days,57341.5
ACC-3771436525,20,19.8,4882.6,1.0,CUS-3325710106,2018-09-29,Derek,M,-37.92,145.04,,37fe8e9e-8581-4972-9348-26f890f02bee,-37.88,145,VIC,Ripponlea,debit,authorized,4acfdd9a72724927b914a85fba33fa41,POS,<20,2018,9,29,22,56,Saturday,7 days,57341.5
ACC-3771436525,20,17.79,4864.81,1.0,CUS-3325710106,2018-09-29,Derek,M,-37.92,145.04,,49fa43b1-9131-4d8a-a8ce-74a8c1284cf7,-37.82,144.96,VIC,Melbourne,debit,authorized,d90517d6debc44a591402356eca40245,SALES-POS,<20,2018,9,29,23,47,Saturday,7 days,57341.5
ACC-3771436525,20,49.0,4815.81,,CUS-3325710106,2018-09-30,Derek,M,-37.92,145.04,,,,,,,debit,posted,c58c3c908f6149a6bfd2fc84f05d8014,PAYMENT,<20,2018,9,30,7,0,Sunday,7 days,57341.5
ACC-3771436525,20,20.53,4795.28,1.0,CUS-3325710106,2018-09-30,Derek,M,-37.92,145.04,,4bd07f33-ea69-4e9b-9bc7-c02177d95150,-37.77,144.89,VIC,Maribyrnong,debit,authorized,3cca990621934af0bdbed3b27a8bced5,POS,<20,2018,9,30,13,48,Sunday,7 days,57341.5
ACC-3771436525,20,817.0,3978.28,,CUS-3325710106,2018-10-02,Derek,M,-37.92,145.04,,,,,,,debit,posted,54aec3555740491e8c15dd3342f3e74e,PAYMENT,<20,2018,10,2,5,0,Tuesday,7 days,57341.5
ACC-3771436525,20,11.54,5066.44,1.0,CUS-3325710106,2018-10-06,Derek,M,-37.92,145.04,,feb0c3e2-c8ca-450f-9b7f-3dc378fbd34f,-37.93,145.25,VIC,Rowville,debit,authorized,6bcb401500754c3d8aed43fc78e75164,POS,<20,2018,10,6,20,35,Saturday,7 days,57341.5
ACC-3771436525,20,5.98,5060.46,1.0,CUS-3325710106,2018-10-06,Derek,M,-37.92,145.04,,fcb5fe43-6f63-4dd6-a526-5e2bcab67da2,-37.82,144.96,VIC,Melbourne,debit,authorized,f744e5df43ad4923b686d5bc736e2a06,SALES-POS,<20,2018,10,6,21,27,Saturday,7 days,57341.5
ACC-3771436525,20,49.0,5011.46,,CUS-3325710106,2018-10-07,Derek,M,-37.92,145.04,,,,,,,debit,posted,d9cfa58f93e64baf80159a2d120d14e1,PAYMENT,<20,2018,10,7,7,0,Sunday,7 days,57341.5
ACC-3771436525,20,9.26,5002.2,1.0,CUS-3325710106,2018-10-08,Derek,M,-37.92,145.04,,a071fbe0-788d-46dc-a3a2-71ee19e8670a,-37.77,144.92,VIC,Ascot Vale,debit,authorized,4533a2ec3ca94be79bfafca0c80e0b49,POS,<20,2018,10,8,20,50,Monday,7 days,57341.5
ACC-3771436525,20,12.09,4990.11,1.0,CUS-3325710106,2018-10-08,Derek,M,-37.92,145.04,,a4f2e1b9-aebb-46b8-af8c-063aaf19b013,-37.87,144.99,VIC,Balaclava,debit,authorized,5f6b7f4e9db64c4d9fe0cfab13cb12da,SALES-POS,<20,2018,10,8,22,16,Monday,7 days,57341.5
ACC-3771436525,20,29.78,4960.33,1.0,CUS-3325710106,2018-10-09,Derek,M,-37.92,145.04,,04ffe970-f440-4f47-bdd5-ba5ffe56db6b,-37.83,147.63,VIC,Bairnsdale,debit,authorized,22f3af6043cb497e9ea8c5a414e750a1,POS,<20,2018,10,9,0,21,Tuesday,7 days,57341.5
ACC-3771436525,20,25.59,4934.74,1.0,CUS-3325710106,2018-10-09,Derek,M,-37.92,145.04,,49c35605-04d0-4fec-993d-de6bce1e4871,-37.79,145.16,VIC,Doncaster East,debit,authorized,242490f39eb24e49b65edfaef9c12373,SALES-POS,<20,2018,10,9,1,59,Tuesday,7 days,57341.5
ACC-3771436525,20,33.13,4901.61,1.0,CUS-3325710106,2018-10-09,Derek,M,-37.92,145.04,,45216199-f3a3-450b-ae2e-177f0d09a5c5,-37.79,144.93,VIC,Flemington,debit,authorized,518c5d9b320744a28761b34923cd306a,POS,<20,2018,10,9,10,5,Tuesday,7 days,57341.5
ACC-3771436525,20,20.2,4881.41,0.0,CUS-3325710106,2018-10-09,Derek,M,-37.92,145.04,,c22d6980-a3dd-4518-9658-3f1e3313102c,-37.92,145.06,VIC,Bentleigh East,debit,authorized,5485b2fdde9a4904ac93cf1cdbd230cf,SALES-POS,<20,2018,10,9,10,48,Tuesday,7 days,57341.5
ACC-3771436525,20,168.0,5813.11,,CUS-3325710106,2018-10-13,Derek,M,-37.92,145.04,,,,,,,debit,posted,c14de83bb5894ecdaf2d5a737a6817a7,PAYMENT,<20,2018,10,13,2,0,Saturday,7 days,57341.5
ACC-3771436525,20,49.0,5764.11,,CUS-3325710106,2018-10-14,Derek,M,-37.92,145.04,,,,,,,debit,posted,dd3882258e584539bd1cdc4b0f13960e,PAYMENT,<20,2018,10,14,7,0,Sunday,7 days,57341.5
ACC-3771436525,20,7.84,5756.27,1.0,CUS-3325710106,2018-10-14,Derek,M,-37.92,145.04,,4533f924-6d16-48cc-b96b-d784a2473fb9,-34.86,138.65,SA,Windsor Gardens,debit,authorized,d8e222086c4144ff801ca11b81c0c360,POS,<20,2018,10,14,11,49,Sunday,7 days,57341.5
ACC-3771436525,20,21.73,5734.54,0.0,CUS-3325710106,2018-10-14,Derek,M,-37.92,145.04,,90f629b8-20c4-42ee-b4b3-20e2bad655c3,-37.74,145.03,VIC,Preston,debit,authorized,bbcfa23d9e7748f8936ef5de2d68648d,POS,<20,2018,10,14,17,34,Sunday,7 days,57341.5
ACC-3771436525,20,13.77,5720.77,1.0,CUS-3325710106,2018-10-16,Derek,M,-37.92,145.04,,3ef3e960-8530-42ef-9b05-637cc78b1d9e,-37.84,144.98,VIC,Melbourne,debit,authorized,881852b2661942689d25baf8704cadaa,SALES-POS,<20,2018,10,16,9,28,Tuesday,7 days,57341.5
ACC-3771436525,20,21.91,6798.56,1.0,CUS-3325710106,2018-10-20,Derek,M,-37.92,145.04,,7917b4c2-560c-45b8-941a-89f803e8d67a,-37.88,145.22,VIC,Wantirna South,debit,authorized,2e6ee2084098454f9a3de4e731ca541a,SALES-POS,<20,2018,10,20,23,19,Saturday,7 days,57341.5
ACC-3771436525,20,14.73,6783.83,1.0,CUS-3325710106,2018-10-21,Derek,M,-37.92,145.04,,e91d53ff-54bd-4a99-9161-c77d8f43d82c,-37.83,147.62,VIC,Bairnsdale,debit,authorized,c6db39aa72b84449ab88951222040745,SALES-POS,<20,2018,10,21,4,49,Sunday,7 days,57341.5
ACC-3771436525,20,49.0,6734.83,,CUS-3325710106,2018-10-21,Derek,M,-37.92,145.04,,,,,,,debit,posted,7730d946d329424cbd98de711bff8b6e,PAYMENT,<20,2018,10,21,7,0,Sunday,7 days,57341.5
ACC-3771436525,20,21.19,6713.64,1.0,CUS-3325710106,2018-10-21,Derek,M,-37.92,145.04,,9bf1a1f0-92a2-4492-ab6d-e541bee98d43,-37.81,145.23,VIC,Ringwood,debit,authorized,c2d63c4e60f64addbc4a99ad09cfc719,SALES-POS,<20,2018,10,21,11,32,Sunday,7 days,57341.5
ACC-3771436525,20,39.61,6674.03,1.0,CUS-3325710106,2018-10-23,Derek,M,-37.92,145.04,,128a4561-435b-4489-832b-04b87d5c14ca,-37.86,145.29,VIC,Boronia,debit,authorized,9ebe7d0f86d44b428bff6083beeef822,SALES-POS,<20,2018,10,23,9,38,Tuesday,7 days,57341.5
ACC-3771436525,20,26.44,7747.29,1.0,CUS-3325710106,2018-10-24,Derek,M,-37.92,145.04,,adc6d252-4f87-4daa-99ac-e290fda9df4f,-37.82,144.95,VIC,South Wharf,debit,authorized,f4b6a9c91a3347b59d3018e2e73a75d8,SALES-POS,<20,2018,10,24,9,26,Wednesday,7 days,57341.5
ACC-3771436525,20,31.5,7715.79,0.0,CUS-3325710106,2018-10-26,Derek,M,-37.92,145.04,,e58a6e08-d5dd-4146-9b9b-6aedd7e98905,-37.75,144.95,VIC,Brunswick West,debit,authorized,b33b61cf065f4c059150084eb2ce5ab5,SALES-POS,<20,2018,10,26,18,15,Friday,7 days,57341.5
ACC-3771436525,20,0.1,7715.69,0.0,CUS-3325710106,2018-10-27,Derek,M,-37.92,145.04,,bc513677-92d4-4ed4-b8d1-9a35a806e335,-37.85,145.04,VIC,Malvern,debit,authorized,cce50d62571a417f8df6f74e9e11072c,SALES-POS,<20,2018,10,27,18,53,Saturday,7 days,57341.5
ACC-3771436525,20,38.62,7677.07,1.0,CUS-3325710106,2018-10-27,Derek,M,-37.92,145.04,,9d604ce4-fb57-40e4-8502-2008f83bc5da,-37.72,145.08,VIC,Macleod,debit,authorized,ca8b71a36b9643188e8103f52003ad86,SALES-POS,<20,2018,10,27,19,51,Saturday,7 days,57341.5
ACC-3771436525,20,21.45,7655.62,0.0,CUS-3325710106,2018-10-27,Derek,M,-37.92,145.04,,b7e9a378-6c2e-4fee-b200-39c619b55e27,-37.82,144.96,VIC,Melbourne,debit,authorized,40e31326e26245d29bb6ee0e22b4bd6a,SALES-POS,<20,2018,10,27,20,8,Saturday,7 days,57341.5
ACC-3771436525,20,10.22,7645.4,1.0,CUS-3325710106,2018-10-27,Derek,M,-37.92,145.04,,d5ca6ad2-aae2-4e1d-bcb4-af288c718fb8,-37.95,145.02,VIC,Hampton,debit,authorized,f2acf8b68a0945359511c2716d4009fe,SALES-POS,<20,2018,10,27,21,42,Saturday,7 days,57341.5
ACC-3771436525,20,13.42,7631.98,1.0,CUS-3325710106,2018-10-27,Derek,M,-37.92,145.04,,5e3fdc60-650f-4013-b6b4-4c5d772d255c,-37.87,144.98,VIC,Saint Kilda,debit,authorized,45039df05c3e4057b4e66ef3c4fcd8a1,SALES-POS,<20,2018,10,27,22,45,Saturday,7 days,57341.5
ACC-3771436525,20,49.0,7582.98,,CUS-3325710106,2018-10-28,Derek,M,-37.92,145.04,,,,,,,debit,posted,5f69d32520e4428bb743b9457e141c2f,PAYMENT,<20,2018,10,28,7,0,Sunday,7 days,57341.5
ACC-2897221629,23,19.04,94.45,1.0,CUS-511326734,2018-08-01,Scott,M,-34.37,150.90,,a1faef96-3162-4cb0-bbd6-ec5771644123,-33.91,151.01,NSW,Yagoona,debit,authorized,65eebe02143248789fd503b381ff78b4,POS,20-30,2018,8,1,22,55,Wednesday,7 days,51241.307
ACC-2897221629,23,7.49,86.96,1.0,CUS-511326734,2018-08-02,Scott,M,-34.37,150.90,,d7e1cb79-1d10-4d11-a077-1f85b9f02b68,-34.04,150.73,NSW,Narellan,debit,authorized,33f1a5e76791481ba87822af875c9237,SALES-POS,20-30,2018,8,2,13,18,Thursday,7 days,51241.307
ACC-2897221629,23,67.89,19.07,0.0,CUS-511326734,2018-08-03,Scott,M,-34.37,150.90,,cf85a430-11ab-4461-a872-98d7f9290df7,-34.44,138.82,SA,Freeling,debit,authorized,5316e74c04bb42bda67e2c646d6c2deb,SALES-POS,20-30,2018,8,3,9,3,Friday,7 days,51241.307
ACC-2897221629,23,14.62,4.45,1.0,CUS-511326734,2018-08-04,Scott,M,-34.37,150.90,,7af23a92-3b44-4157-be22-8d64d1f410c7,-33.87,151.21,NSW,Sydney,debit,authorized,76c24f7139e5427bb089a8b1af70cbfe,SALES-POS,20-30,2018,8,4,14,32,Saturday,7 days,51241.307
ACC-2897221629,23,31.39,955.77,1.0,CUS-511326734,2018-08-12,Scott,M,-34.37,150.90,,15d424a4-9e07-4397-9b44-5e51cf7f0445,-33.92,151.19,NSW,Alexandria,debit,authorized,f56309c6b4e54ac9a7b89a32a9845c81,POS,20-30,2018,8,12,15,32,Sunday,7 days,51241.307
ACC-2897221629,23,42.0,913.77,,CUS-511326734,2018-08-12,Scott,M,-34.37,150.90,,,,,,,debit,posted,6c05db8cb95f453eaaf70d6693bd92b9,PAYMENT,20-30,2018,8,12,20,0,Sunday,7 days,51241.307
ACC-2897221629,23,9.31,904.46,0.0,CUS-511326734,2018-08-13,Scott,M,-34.37,150.90,,783be575-8b6b-4823-be6a-35092df788fe,-33.73,150.95,NSW,Bella Vista,debit,authorized,c1ff6cdc31b54ddca823b706f8cf5a17,POS,20-30,2018,8,13,8,46,Monday,7 days,51241.307
ACC-2897221629,23,32.78,871.68,1.0,CUS-511326734,2018-08-13,Scott,M,-34.37,150.90,,5c307474-227b-4344-b307-54ef0e0e8826,-33.77,150.67,NSW,Jamisontown,debit,authorized,23cdd8bba3d14e6baa3124d691d4c6a1,SALES-POS,20-30,2018,8,13,15,43,Monday,7 days,51241.307
ACC-2897221629,23,7.74,863.94,1.0,CUS-511326734,2018-08-14,Scott,M,-34.37,150.90,,dfefa6cc-94ec-4d12-8583-e7d71a7fc8f4,-33.84,151.04,NSW,Silverwater,debit,authorized,c581c46d7f6c4372ad8042c98ddbebf4,POS,20-30,2018,8,14,4,56,Tuesday,7 days,51241.307
ACC-2897221629,23,22.87,841.07,1.0,CUS-511326734,2018-08-14,Scott,M,-34.37,150.90,,f521141e-006c-4aa9-a589-9994ff20e55a,-33.79,150.97,NSW,Old Toongabbie,debit,authorized,2aefa413dc1741b282178d1c0ea4c773,SALES-POS,20-30,2018,8,14,8,25,Tuesday,7 days,51241.307
ACC-2897221629,23,6.41,1817.37,0.0,CUS-511326734,2018-08-15,Scott,M,-34.37,150.90,,ae55cc4d-87ed-47cc-9f9e-ea993cb640d9,-33.83,150.99,NSW,Merrylands,debit,authorized,eb816ed24e1546ffa85b1bc03dd8a5a6,SALES-POS,20-30,2018,8,15,10,32,Wednesday,7 days,51241.307
ACC-2897221629,23,32.32,1785.05,1.0,CUS-511326734,2018-08-15,Scott,M,-34.37,150.90,,fe257a32-9aaf-4689-a309-23d952424071,-37.82,144.96,VIC,Melbourne,debit,authorized,1a3c9278f14e4814a1a65e3d868f7d20,POS,20-30,2018,8,15,18,6,Wednesday,7 days,51241.307
ACC-2897221629,23,16.08,1632.34,1.0,CUS-511326734,2018-08-17,Scott,M,-34.37,150.90,,46a04124-f584-48d8-a1b9-b37f0baefc3e,-34.46,149.47,NSW,Crookwell,debit,authorized,ebaa2a8b735849209db5e4c0aaa8aa2a,SALES-POS,20-30,2018,8,17,8,1,Friday,7 days,51241.307
ACC-2897221629,23,13.83,1618.51,1.0,CUS-511326734,2018-08-17,Scott,M,-34.37,150.90,,445529ac-db9b-4fce-a4e4-a389e6d09f91,-33.91,150.8,NSW,Austral,debit,authorized,68050b3744b5479bb86616d602247e3d,POS,20-30,2018,8,17,9,30,Friday,7 days,51241.307
ACC-2897221629,23,73.0,1545.51,,CUS-511326734,2018-08-17,Scott,M,-34.37,150.90,,,,,,,debit,posted,37b3a8601998455aa09897bdb772e7c9,PAYMENT,20-30,2018,8,17,22,0,Friday,7 days,51241.307
ACC-2897221629,23,94.0,1451.51,,CUS-511326734,2018-08-18,Scott,M,-34.37,150.90,,,,,,,debit,posted,0c17499eb22241efac7163951b206d31,INTER BANK,20-30,2018,8,18,13,0,Saturday,7 days,51241.307
ACC-2897221629,23,18.78,1432.73,1.0,CUS-511326734,2018-08-18,Scott,M,-34.37,150.90,,1dcf2fcf-5f95-47b1-883b-7af53d477a3b,-33.63,150.79,NSW,South Windsor,debit,authorized,278d5ac18d7e48af842baaab5101b836,POS,20-30,2018,8,18,17,19,Saturday,7 days,51241.307
ACC-2897221629,23,13.2,1419.53,1.0,CUS-511326734,2018-08-18,Scott,M,-34.37,150.90,,3922185e-265b-494b-bdbb-31c8ac72864d,-33.94,151.18,NSW,Sydney,debit,authorized,ad0e148c291742b59ebee7dfa6269ca7,SALES-POS,20-30,2018,8,18,21,7,Saturday,7 days,51241.307
ACC-2897221629,23,42.0,1377.53,,CUS-511326734,2018-08-19,Scott,M,-34.37,150.90,,,,,,,debit,posted,d873ebbb45dd46f38dd84d9636c3d12b,PAYMENT,20-30,2018,8,19,20,0,Sunday,7 days,51241.307
ACC-2897221629,23,99.0,2261.24,,CUS-511326734,2018-08-22,Scott,M,-34.37,150.90,,,,,,,debit,posted,58e34bbc8f654650acd6b32aabcc4595,INTER BANK,20-30,2018,8,22,12,0,Wednesday,7 days,51241.307
ACC-2897221629,23,17.63,2243.61,1.0,CUS-511326734,2018-08-26,Scott,M,-34.37,150.90,,e0f6a222-0585-4b68-80e6-300a88ff8ad5,-33.93,151.09,NSW,Roselands,debit,authorized,fe24939340bf4085a3bd3c68d1690b98,POS,20-30,2018,8,26,9,1,Sunday,7 days,51241.307
ACC-2897221629,23,42.0,2201.61,,CUS-511326734,2018-08-26,Scott,M,-34.37,150.90,,,,,,,debit,posted,fe5c1053b597451fba5eefe3283fa262,PAYMENT,20-30,2018,8,26,20,0,Sunday,7 days,51241.307
ACC-2897221629,23,165.0,2036.61,,CUS-511326734,2018-08-27,Scott,M,-34.37,150.90,,,,,,,debit,posted,17cc7952b7674eaa899bf0c679b73148,PAYMENT,20-30,2018,8,27,14,0,Monday,7 days,51241.307
ACC-2897221629,23,19.03,3000.29,1.0,CUS-511326734,2018-08-29,Scott,M,-34.37,150.90,,64f5d0e8-21a6-4430-807c-2f116a06f85c,-33.91,151.03,NSW,Yagoona,debit,authorized,71bc09b7e6e444f9b4e05f6abd0636de,POS,20-30,2018,8,29,9,30,Wednesday,7 days,51241.307
ACC-2897221629,23,19.8,2980.49,1.0,CUS-511326734,2018-08-29,Scott,M,-34.37,150.90,,2fa2d309-7f93-4e78-9888-e209790efed2,-34.54,138.75,SA,Roseworthy,debit,authorized,511b126c89f048d99a70e47c11af76c1,POS,20-30,2018,8,29,10,33,Wednesday,7 days,51241.307
ACC-2897221629,23,5.65,2974.84,0.0,CUS-511326734,2018-08-29,Scott,M,-34.37,150.90,,41a54bc6-ca5b-452a-abf3-970ec2abf10a,-33.75,150.85,NSW,Glendenning,debit,authorized,a809a25024d943189d7c3da5b3a4570b,POS,20-30,2018,8,29,12,32,Wednesday,7 days,51241.307
ACC-2897221629,23,47.4,2927.44,1.0,CUS-511326734,2018-08-31,Scott,M,-34.37,150.90,,51c6ffc4-622f-48c2-a82a-5787cdff3d63,-33.83,151.05,NSW,Silverwater,debit,authorized,d69c902305f14bf98a018276ba0cb066,SALES-POS,20-30,2018,8,31,0,32,Friday,7 days,51241.307
ACC-2897221629,23,20.15,2907.29,1.0,CUS-511326734,2018-08-31,Scott,M,-34.37,150.90,,0d05f6d3-b8cd-4c32-b997-22cf8eb5019b,-34.34,150.91,NSW,Bulli,debit,authorized,1be305f0f35e4c01b67a0597109745e3,SALES-POS,20-30,2018,8,31,9,6,Friday,7 days,51241.307
ACC-2897221629,23,10.67,2896.62,1.0,CUS-511326734,2018-08-31,Scott,M,-34.37,150.90,,0cb0d502-bc1d-4405-ad2a-44e856c4ec41,-33.83,151.2,NSW,Crows Nest,debit,authorized,12f9cd44e8fe4bfd94cb51360a8f78bc,POS,20-30,2018,8,31,9,55,Friday,7 days,51241.307
ACC-2897221629,23,85.84,2810.78,1.0,CUS-511326734,2018-09-01,Scott,M,-34.37,150.90,,86bbe984-a9a6-48a8-a449-c59edbdf7032,-33.81,151.02,NSW,Parramatta,debit,authorized,d451a84695e6409b8e92dd45f0f28832,POS,20-30,2018,9,1,1,8,Saturday,7 days,51241.307
ACC-2897221629,23,23.98,2786.8,1.0,CUS-511326734,2018-09-01,Scott,M,-34.37,150.90,,c74f36a4-3ddb-47b4-9125-98671a3d904e,-33.65,151.05,NSW,Galston,debit,authorized,0590f45aba9048f9adf85c6b23dc48bc,SALES-POS,20-30,2018,9,1,14,45,Saturday,7 days,51241.307
ACC-2897221629,23,13.69,2773.11,1.0,CUS-511326734,2018-09-01,Scott,M,-34.37,150.90,,25ba61f5-a9e8-4330-8a4e-74246f6e631d,-33.91,151.17,NSW,Marrickville,debit,authorized,43e1b23ad5234ca484d01229faae864f,SALES-POS,20-30,2018,9,1,17,40,Saturday,7 days,51241.307
ACC-2897221629,23,7.05,2766.06,1.0,CUS-511326734,2018-09-01,Scott,M,-34.37,150.90,,75ecb1a9-7214-44b3-b547-60fe12510d7c,-33.72,151.04,NSW,Cherrybrook,debit,authorized,f4c11223578147be93d769581a76769e,POS,20-30,2018,9,1,19,18,Saturday,7 days,51241.307
ACC-2897221629,23,9.38,2756.68,0.0,CUS-511326734,2018-09-01,Scott,M,-34.37,150.90,,dea2fd5f-f8d8-476d-a324-5855744663bf,-33.84,151.21,NSW,Neutral Bay,debit,authorized,9654e4cb997d43f79d56f8a26be536d3,SALES-POS,20-30,2018,9,1,22,49,Saturday,7 days,51241.307
ACC-2897221629,23,42.0,2680.83,,CUS-511326734,2018-09-02,Scott,M,-34.37,150.90,,,,,,,debit,posted,50f4573320a640dcbecc43452eeafabc,PAYMENT,20-30,2018,9,2,20,0,Sunday,7 days,51241.307
ACC-2897221629,23,33.85,2722.83,0.0,CUS-511326734,2018-09-02,Scott,M,-34.37,150.90,,e04fee7c-8e11-44e3-8fdd-574dbd5be4a5,-34.04,151.14,NSW,Woolooware,debit,authorized,d361e06af5224900abfabcfcc5ec5215,SALES-POS,20-30,2018,9,2,20,16,Sunday,7 days,51241.307
ACC-2897221629,23,18.41,2662.42,1.0,CUS-511326734,2018-09-02,Scott,M,-34.37,150.90,,5723fe96-24c1-41ca-a549-322f75fc6785,-33.69,151.02,NSW,Dural,debit,authorized,b2bac49780f14905aec9296cf617bc5d,SALES-POS,20-30,2018,9,2,21,23,Sunday,7 days,51241.307
ACC-2897221629,23,11.35,2651.07,1.0,CUS-511326734,2018-09-04,Scott,M,-34.37,150.90,,499b1c74-d767-43d6-a084-b20d00010c70,-33.77,150.91,NSW,Blacktown,debit,authorized,c83db5c79e2d4c668b83a31d90711e72,SALES-POS,20-30,2018,9,4,10,11,Tuesday,7 days,51241.307
ACC-2897221629,23,15.51,3618.27,0.0,CUS-511326734,2018-09-08,Scott,M,-34.37,150.90,,0aca15c9-1ae2-4c0a-8792-c4c5f8982494,-33.9,151.14,NSW,Summer Hill,debit,authorized,593ac4d8091d44c18428f52e7c650f86,POS,20-30,2018,9,8,23,12,Saturday,7 days,51241.307
ACC-2897221629,23,15.97,3602.3,1.0,CUS-511326734,2018-09-09,Scott,M,-34.37,150.90,,7c33de5f-eb5d-4278-a44e-d09495d1c82d,-33.78,150.93,NSW,Seven Hills,debit,authorized,30f07ae6be3a4cb8aaf43250cb41f2c2,POS,20-30,2018,9,9,9,30,Sunday,7 days,51241.307
ACC-2897221629,23,19.99,3582.31,1.0,CUS-511326734,2018-09-09,Scott,M,-34.37,150.90,,5a3c3a04-69ec-4c07-beb1-64e96cd3bceb,-33.66,115.36,WA,Busselton,debit,authorized,d10e8fec0ef04177a1e0fd104db7327b,SALES-POS,20-30,2018,9,9,15,10,Sunday,7 days,51241.307
ACC-2897221629,23,42.0,3540.31,,CUS-511326734,2018-09-09,Scott,M,-34.37,150.90,,,,,,,debit,posted,3eeaa1f5dfc3428ca2e65255a92bbed1,PAYMENT,20-30,2018,9,9,20,0,Sunday,7 days,51241.307
ACC-2897221629,23,8.57,3531.74,0.0,CUS-511326734,2018-09-10,Scott,M,-34.37,150.90,,8bc68bf5-eeb3-4a42-b018-13c419820fda,-33.82,151.01,NSW,Parramatta,debit,authorized,24c8a503449f451496b3fc58dfec5f1d,POS,20-30,2018,9,10,7,8,Monday,7 days,51241.307
ACC-2897221629,23,16.11,3515.63,0.0,CUS-511326734,2018-09-10,Scott,M,-34.37,150.90,,a25213a7-e817-44c8-8077-7e84b332e8a3,-23.13,150.74,QLD,Yeppoon,debit,authorized,3c4ebe06623a4f6ba7ca80603d68c2b7,POS,20-30,2018,9,10,13,46,Monday,7 days,51241.307
ACC-2897221629,23,26.11,4472.23,1.0,CUS-511326734,2018-09-12,Scott,M,-34.37,150.90,,cff3c7d0-7fbd-4c73-aa56-503b52150a9c,-33.73,150.98,NSW,Castle Hill,debit,authorized,9f68e95c58bd47efb2db0df7e9817b19,POS,20-30,2018,9,12,7,34,Wednesday,7 days,51241.307
ACC-2897221629,23,36.93,4435.3,1.0,CUS-511326734,2018-09-12,Scott,M,-34.37,150.90,,1e52168e-2ec5-4c70-91f9-db84de1715d9,-33.78,151.13,NSW,Macquarie Park,debit,authorized,032c99e8fbb044048065cc0c2278f033,POS,20-30,2018,9,12,17,52,Wednesday,7 days,51241.307
ACC-2897221629,23,5.41,4429.89,1.0,CUS-511326734,2018-09-13,Scott,M,-34.37,150.90,,79383131-7121-47ef-8a83-1f051318c92f,-33.76,151.15,NSW,Gordon,debit,authorized,526e50935f334504bad297e950e6d71b,SALES-POS,20-30,2018,9,13,9,1,Thursday,7 days,51241.307
ACC-2897221629,23,27.46,4402.43,1.0,CUS-511326734,2018-09-13,Scott,M,-34.37,150.90,,3716e385-33dd-4645-bd4d-6a6e42dcf6eb,-33.65,115.35,WA,Busselton,debit,authorized,6cc239d172944b968654fe6f130d42f0,POS,20-30,2018,9,13,18,11,Thursday,7 days,51241.307
ACC-2897221629,23,7.92,4394.51,0.0,CUS-511326734,2018-09-14,Scott,M,-34.37,150.90,,48bd5e29-8fb8-49c3-954e-1fb7c8c29646,-33.72,151.07,NSW,Westleigh,debit,authorized,51f369a6c9544535aa4e6824d9eb5f23,SALES-POS,20-30,2018,9,14,1,33,Friday,7 days,51241.307
ACC-2897221629,23,73.71,4320.8,1.0,CUS-511326734,2018-09-14,Scott,M,-34.37,150.90,,a7362ad4-39ad-40ed-a2c8-646ae8b1568d,-37.83,144.95,VIC,South Melbourne,debit,authorized,3840b6cec49c4c4398db63f790c99ab6,SALES-POS,20-30,2018,9,14,17,59,Friday,7 days,51241.307
ACC-2897221629,23,42.0,4278.8,,CUS-511326734,2018-09-16,Scott,M,-34.37,150.90,,,,,,,debit,posted,b70cf30b2fde4a41ab4f4bcc876a4e79,PAYMENT,20-30,2018,9,16,20,0,Sunday,7 days,51241.307
ACC-2897221629,23,73.0,4205.8,,CUS-511326734,2018-09-17,Scott,M,-34.37,150.90,,,,,,,debit,posted,c2318251c4864497a2a616c1adb7a4a6,PAYMENT,20-30,2018,9,17,22,0,Monday,7 days,51241.307
ACC-2897221629,23,94.0,4111.8,,CUS-511326734,2018-09-18,Scott,M,-34.37,150.90,,,,,,,debit,posted,6751290eeae942fcb7d893fc5796bf49,INTER BANK,20-30,2018,9,18,13,0,Tuesday,7 days,51241.307
ACC-2897221629,23,5.36,5089.15,1.0,CUS-511326734,2018-09-19,Scott,M,-34.37,150.90,,9e374454-85d1-4685-8d0e-a88274a31e51,-33.86,151.21,NSW,Sydney,debit,authorized,82aa72dbfd6545de80d0f4390e29e17f,POS,20-30,2018,9,19,22,1,Wednesday,7 days,51241.307
ACC-2897221629,23,4.79,5084.36,1.0,CUS-511326734,2018-09-20,Scott,M,-34.37,150.90,,5964d2b3-5967-4c0e-afdb-37f9fd523d23,-33.82,151,NSW,Parramatta,debit,authorized,782c8284fe2f46aba1e26b5f67207f9e,POS,20-30,2018,9,20,1,33,Thursday,7 days,51241.307
ACC-2897221629,23,18.23,5066.13,1.0,CUS-511326734,2018-09-20,Scott,M,-34.37,150.90,,7b56f8a3-0751-497d-baad-ee2027461b0c,-33.68,151.31,NSW,Mona Vale,debit,authorized,882cefad4b704258a754374572884113,SALES-POS,20-30,2018,9,20,9,27,Thursday,7 days,51241.307
ACC-2897221629,23,4.68,5061.45,0.0,CUS-511326734,2018-09-21,Scott,M,-34.37,150.90,,08c9b3df-8797-4d02-8c6c-3e402c654375,-33.82,151.2,NSW,Crows Nest,debit,authorized,07ae513c2fc04c7f9b02d6e2e73100f4,SALES-POS,20-30,2018,9,21,8,23,Friday,7 days,51241.307
ACC-2897221629,23,99.0,4962.45,,CUS-511326734,2018-09-22,Scott,M,-34.37,150.90,,,,,,,debit,posted,a9c18b0c16b149d2ab1f3f71de287540,INTER BANK,20-30,2018,9,22,12,0,Saturday,7 days,51241.307
ACC-2897221629,23,16.41,4946.04,1.0,CUS-511326734,2018-09-22,Scott,M,-34.37,150.90,,afc10575-a978-432c-bf68-a80bc07ccca8,-33.87,151.21,NSW,Sydney,debit,authorized,9750a3dd0de544148621cb1243d8d04c,SALES-POS,20-30,2018,9,22,19,13,Saturday,7 days,51241.307
ACC-2897221629,23,9.27,4936.77,1.0,CUS-511326734,2018-09-23,Scott,M,-34.37,150.90,,07f4ae29-7ea0-4fc0-9c36-ebfdc7ac1042,-33.77,150.7,NSW,South Penrith,debit,authorized,0562914220c94bce81524da4a0bfecd7,POS,20-30,2018,9,23,3,48,Sunday,7 days,51241.307
ACC-2897221629,23,20.78,4915.99,0.0,CUS-511326734,2018-09-23,Scott,M,-34.37,150.90,,5b69624b-b549-4426-89c2-9d65f517e1b7,-33.85,150.9,NSW,Wetherill Park,debit,authorized,5607719c460b42749b81250156c542e4,POS,20-30,2018,9,23,9,14,Sunday,7 days,51241.307
ACC-2897221629,23,8.2,4907.79,1.0,CUS-511326734,2018-09-23,Scott,M,-34.37,150.90,,5eaf5637-e53b-42d1-b3d2-ee473a60bab3,-33.78,151.05,NSW,Carlingford,debit,authorized,7470591293624cd9b13a8987e281db22,SALES-POS,20-30,2018,9,23,10,3,Sunday,7 days,51241.307
ACC-2897221629,23,14.18,4893.61,0.0,CUS-511326734,2018-09-23,Scott,M,-34.37,150.90,,9d2006a1-2ce9-4109-98fe-bee5bfa8e455,-33.91,151.16,NSW,Marrickville,debit,authorized,1354025d13db45139d5201a23009b034,SALES-POS,20-30,2018,9,23,11,26,Sunday,7 days,51241.307
ACC-2897221629,23,21.45,4872.16,1.0,CUS-511326734,2018-09-23,Scott,M,-34.37,150.90,,87898f6b-97a4-4a26-80a8-c15f0322af30,-27.49,153.03,QLD,Woolloongabba,debit,authorized,9fd7b7b085ea4770875907a6448b3dc2,SALES-POS,20-30,2018,9,23,17,55,Sunday,7 days,51241.307
ACC-2897221629,23,42.0,4830.16,,CUS-511326734,2018-09-23,Scott,M,-34.37,150.90,,,,,,,debit,posted,8ee2904f6dd743009a8a7b7c07bc3429,PAYMENT,20-30,2018,9,23,20,0,Sunday,7 days,51241.307
ACC-2897221629,23,16.26,4813.9,0.0,CUS-511326734,2018-09-24,Scott,M,-34.37,150.90,,5506f02a-c1dd-43c5-ad15-d97619f7dd4f,-33.92,151.23,NSW,Kingsford,debit,authorized,7ad9b53381b747ecbfcb066b71f586d6,POS,20-30,2018,9,24,15,51,Monday,7 days,51241.307
ACC-2897221629,23,165.0,5631.61,,CUS-511326734,2018-09-27,Scott,M,-34.37,150.90,,,,,,,debit,posted,eade8664158c4fc79ca6e61246e24341,PAYMENT,20-30,2018,9,27,14,0,Thursday,7 days,51241.307
ACC-2897221629,23,42.0,5589.61,,CUS-511326734,2018-09-30,Scott,M,-34.37,150.90,,,,,,,debit,posted,4481e45c25e947bc9ec6aa2d80265713,PAYMENT,20-30,2018,9,30,20,0,Sunday,7 days,51241.307
ACC-2897221629,23,19.35,6552.97,1.0,CUS-511326734,2018-10-04,Scott,M,-34.37,150.90,,47143238-3ae0-4ae0-8fb8-6898a6315a4e,-33.75,150.88,NSW,Woodcroft,debit,authorized,0c71515f98d64d8e96b3a9eac2242cf9,SALES-POS,20-30,2018,10,4,9,38,Thursday,7 days,51241.307
ACC-2897221629,23,42.32,6510.65,1.0,CUS-511326734,2018-10-04,Scott,M,-34.37,150.90,,2cc53184-c4f2-43b9-84bd-7a6127f6a781,-33.64,150.29,NSW,Blackheath,debit,authorized,8ed9b66f23b1452793f19c24ba43e596,SALES-POS,20-30,2018,10,4,19,53,Thursday,7 days,51241.307
ACC-2897221629,23,23.04,6487.61,1.0,CUS-511326734,2018-10-04,Scott,M,-34.37,150.90,,763736c6-3daa-45e0-acfb-aed69217643a,-33.94,151.02,NSW,Revesby,debit,authorized,095245e230bc477a9ef9899c1fb26f99,SALES-POS,20-30,2018,10,4,21,31,Thursday,7 days,51241.307
ACC-2897221629,23,16.82,6470.79,1.0,CUS-511326734,2018-10-05,Scott,M,-34.37,150.90,,4d1ee286-7ec9-4820-9357-89da6d19de23,-33.83,151.22,NSW,Neutral Bay,debit,authorized,5d71f69c752c4503b9f80a87893efd65,SALES-POS,20-30,2018,10,5,4,56,Friday,7 days,51241.307
ACC-2897221629,23,3.49,6467.3,1.0,CUS-511326734,2018-10-05,Scott,M,-34.37,150.90,,fbf660a4-8d1c-4235-abb7-bf2a1501b7bc,-33.84,151.2,NSW,North Sydney,debit,authorized,5526615555894ca78fadd4f1dea3ee9d,SALES-POS,20-30,2018,10,5,9,26,Friday,7 days,51241.307
ACC-2897221629,23,4.87,6462.43,1.0,CUS-511326734,2018-10-05,Scott,M,-34.37,150.90,,5cf2d58b-6d30-4194-b1fc-f329ebb45283,-33.9,150.86,NSW,Sydney,debit,authorized,5ead3a11dff847f2b682a62d7e1e01b6,SALES-POS,20-30,2018,10,5,10,15,Friday,7 days,51241.307
ACC-2897221629,23,61.17,6401.26,0.0,CUS-511326734,2018-10-07,Scott,M,-34.37,150.90,,f4cfc3c1-9926-47ad-b094-d912f325ae3f,-33.87,151.21,NSW,Sydney,debit,authorized,a83609468c9a4742b7392c229994d7db,SALES-POS,20-30,2018,10,7,18,28,Sunday,7 days,51241.307
ACC-2897221629,23,42.0,6359.26,,CUS-511326734,2018-10-07,Scott,M,-34.37,150.90,,,,,,,debit,posted,ccc79bbf90104ff188130fc00622a9ee,PAYMENT,20-30,2018,10,7,20,0,Sunday,7 days,51241.307
ACC-2897221629,23,5.87,6353.39,1.0,CUS-511326734,2018-10-07,Scott,M,-34.37,150.90,,a15feb7d-10d1-48a3-a771-6a20d69dc640,-33.87,151.21,NSW,Sydney,debit,authorized,3255310bcfa94c0aa985bb2803b7900d,SALES-POS,20-30,2018,10,7,22,9,Sunday,7 days,51241.307
ACC-2897221629,23,12.44,6340.95,1.0,CUS-511326734,2018-10-08,Scott,M,-34.37,150.90,,b890d24c-7dfc-404e-877f-b38dc3c444c0,-33.73,151.16,NSW,Saint Ives,debit,authorized,141ce5bccef3445a939298b8e6b31519,SALES-POS,20-30,2018,10,8,13,9,Monday,7 days,51241.307
ACC-2897221629,23,6.04,7317.62,1.0,CUS-511326734,2018-10-10,Scott,M,-34.37,150.90,,308ac76c-03d3-4de8-b593-4eec154824c3,-33.92,151.09,NSW,Belmore,debit,authorized,da8c78d93e51426cbcfd9921a42baa3f,SALES-POS,20-30,2018,10,10,9,5,Wednesday,7 days,51241.307
ACC-2897221629,23,303.78,7013.84,1.0,CUS-511326734,2018-10-11,Scott,M,-34.37,150.90,,b45868cb-4890-4e2f-a8a1-0a8990f2cbab,-34.93,138.6,SA,Adelaide,debit,authorized,0528fb217faa493e965c72b7ee20a749,POS,20-30,2018,10,11,4,24,Thursday,7 days,51241.307
ACC-2897221629,23,10.72,7003.12,0.0,CUS-511326734,2018-10-11,Scott,M,-34.37,150.90,,292e93da-32c9-4ff5-99d8-ece20e035015,-33.87,151.2,NSW,Sydney,debit,authorized,8b563dd86278405cad1deec6a4f1d0e4,POS,20-30,2018,10,11,14,53,Thursday,7 days,51241.307
ACC-2897221629,23,22.69,6980.43,1.0,CUS-511326734,2018-10-12,Scott,M,-34.37,150.90,,33d65e54-188b-4582-ae5e-ee1d50778c75,-33.95,151.14,NSW,Rockdale,debit,authorized,35e65e05f49a46a8ab1d60ce66739fe2,POS,20-30,2018,10,12,9,49,Friday,7 days,51241.307
ACC-2897221629,23,14.66,6965.77,0.0,CUS-511326734,2018-10-12,Scott,M,-34.37,150.90,,2e3869ab-998a-449d-80b1-f2734088b068,-33.74,150.81,NSW,Emerton,debit,authorized,0b9ce6e29e0e47ba8fd9aa2be02003ce,SALES-POS,20-30,2018,10,12,17,44,Friday,7 days,51241.307
ACC-2897221629,23,38.16,6927.61,0.0,CUS-511326734,2018-10-13,Scott,M,-34.37,150.90,,ae5f353c-afd0-4ed5-a4e3-d8b5bf48b5ec,-34.92,138.6,SA,Adelaide,debit,authorized,d3a8055b36f049bdae27ef2f48aaea1b,SALES-POS,20-30,2018,10,13,17,45,Saturday,7 days,51241.307
ACC-2897221629,23,42.0,6885.61,,CUS-511326734,2018-10-14,Scott,M,-34.37,150.90,,,,,,,debit,posted,de9e7c7cd19e47bab3a86eb0cda12ed3,PAYMENT,20-30,2018,10,14,20,0,Sunday,7 days,51241.307
ACC-2897221629,23,18.06,6867.55,1.0,CUS-511326734,2018-10-15,Scott,M,-34.37,150.90,,4b3f541f-17ea-4686-9d2f-c138c2884a7d,-33.91,150.92,NSW,Warwick Farm,debit,authorized,98a2ff3b76a74bfa8526c3fb1aecd3d9,POS,20-30,2018,10,15,7,25,Monday,7 days,51241.307
ACC-2897221629,23,73.0,7777.26,,CUS-511326734,2018-10-17,Scott,M,-34.37,150.90,,,,,,,debit,posted,abe4d4a735ca4eaeaf9b6dceb2fbec2e,PAYMENT,20-30,2018,10,17,22,0,Wednesday,7 days,51241.307
ACC-2897221629,23,94.0,7683.26,,CUS-511326734,2018-10-18,Scott,M,-34.37,150.90,,,,,,,debit,posted,faeded4baf9b42e683a55a31ee36a247,INTER BANK,20-30,2018,10,18,13,0,Thursday,7 days,51241.307
ACC-2897221629,23,8.58,7674.68,1.0,CUS-511326734,2018-10-21,Scott,M,-34.37,150.90,,fbad8b2e-513f-4a34-b9a6-841953d98ab0,-33.87,151.19,NSW,Pyrmont,debit,authorized,51852cc2eb33468e909c3fc860131cfd,POS,20-30,2018,10,21,15,8,Sunday,7 days,51241.307
ACC-2897221629,23,42.0,7632.68,,CUS-511326734,2018-10-21,Scott,M,-34.37,150.90,,,,,,,debit,posted,73320dc260a14e7ead6fecc619513760,PAYMENT,20-30,2018,10,21,20,0,Sunday,7 days,51241.307
ACC-2897221629,23,99.0,7533.68,,CUS-511326734,2018-10-22,Scott,M,-34.37,150.90,,,,,,,debit,posted,147e70b1cc9f46c9892924cb227cff1d,INTER BANK,20-30,2018,10,22,12,0,Monday,7 days,51241.307
ACC-2897221629,23,165.0,8351.39,,CUS-511326734,2018-10-27,Scott,M,-34.37,150.90,,,,,,,debit,posted,d635db080963454ba5ac9aaeff60c6a9,PAYMENT,20-30,2018,10,27,14,0,Saturday,7 days,51241.307
ACC-2897221629,23,42.0,8309.39,,CUS-511326734,2018-10-28,Scott,M,-34.37,150.90,,,,,,,debit,posted,b299272961714054991ed61d1b1ef557,PAYMENT,20-30,2018,10,28,20,0,Sunday,7 days,51241.307
ACC-2897221629,23,17.97,8291.42,1.0,CUS-511326734,2018-10-30,Scott,M,-34.37,150.90,,c59cbde1-07ce-4b17-a5fa-e815eb9bc514,-33.83,151.21,NSW,Crows Nest,debit,authorized,4a7a2248c06c429aa99d4aec4dfffd01,POS,20-30,2018,10,30,9,28,Tuesday,7 days,51241.307
ACC-2897221629,23,348.21,8925.92,1.0,CUS-511326734,2018-10-31,Scott,M,-34.37,150.90,,d5635ec1-7e0d-40c1-a0ec-f560ad82d400,-33.81,151.13,NSW,East Ryde,debit,authorized,e4ea3360d90840a09a72ba2a34271618,POS,20-30,2018,10,31,11,49,Wednesday,7 days,51241.307
ACC-2897221629,23,14.06,8911.86,1.0,CUS-511326734,2018-10-31,Scott,M,-34.37,150.90,,f93ebe4b-1c5a-4b11-8666-1f539e553707,-33.8,151.14,NSW,North Ryde,debit,authorized,40a08a2c72ed487fbffa4706e60a1287,SALES-POS,20-30,2018,10,31,15,15,Wednesday,7 days,51241.307
ACC-2988263882,44,157.0,1884.41,,CUS-1233833708,2018-08-01,Michael,M,-37.90,145.18,,,,,,,debit,posted,33ae744f14ac48a0abbe19b14c9f0f61,PAYMENT,40-50,2018,8,1,23,0,Wednesday,7 days,31094.35
ACC-2988263882,44,19.84,2460.9,1.0,CUS-1233833708,2018-08-03,Michael,M,-37.90,145.18,,ee96af71-5733-4792-936d-dc0bbee34169,-37.82,145.12,VIC,Box Hill,debit,authorized,679320d2837f467fa02e9742c7507202,SALES-POS,40-50,2018,8,3,3,6,Friday,7 days,31094.35
ACC-2988263882,44,9.02,2451.88,0.0,CUS-1233833708,2018-08-03,Michael,M,-37.90,145.18,,73858146-0d91-430d-aff1-45668d6fcaf3,-38.07,145.3,VIC,Narre Warren South,debit,authorized,8a36f2fc53cb417aa1879620bcf06c44,SALES-POS,40-50,2018,8,3,8,13,Friday,7 days,31094.35
ACC-2988263882,44,21.8,2430.08,0.0,CUS-1233833708,2018-08-06,Michael,M,-37.90,145.18,,9af334fc-dbb6-4a51-845e-3f41c7bc8331,-37.96,145.05,VIC,Cheltenham,debit,authorized,56fbca669a5a4d82815ab2b320df36e8,SALES-POS,40-50,2018,8,6,21,9,Monday,7 days,31094.35
ACC-2988263882,44,15.76,2414.32,1.0,CUS-1233833708,2018-08-08,Michael,M,-37.90,145.18,,7fbd6363-a171-4ce6-ad92-c59fd7991396,-33.86,151.06,NSW,Lidcombe,debit,authorized,aba4863607c343028579a5cf29560ea9,SALES-POS,40-50,2018,8,8,16,55,Wednesday,7 days,31094.35
ACC-2988263882,44,12.09,2998.56,1.0,CUS-1233833708,2018-08-11,Michael,M,-37.90,145.18,,a8bd02e5-5456-4768-9b87-b35052118bdf,-37.8,144.9,VIC,Footscray,debit,authorized,f612dd6faf7848eb8751617630063fa7,POS,40-50,2018,8,11,17,42,Saturday,7 days,31094.35
ACC-2988263882,44,25.85,2972.71,1.0,CUS-1233833708,2018-08-13,Michael,M,-37.90,145.18,,607e71c0-5ebc-4a78-9a71-906d68fcaa04,-37.83,145.17,VIC,Forest Hill,debit,authorized,9d9002ff975040c5b5e16d474dad1dec,SALES-POS,40-50,2018,8,13,9,45,Monday,7 days,31094.35
ACC-2988263882,44,197.0,3372.04,,CUS-1233833708,2018-08-17,Michael,M,-37.90,145.18,,,,,,,debit,posted,9813b324e4834965a6b9cd9c1b2e66eb,PAYMENT,40-50,2018,8,17,6,0,Friday,7 days,31094.35
ACC-2988263882,44,27.68,3344.36,0.0,CUS-1233833708,2018-08-18,Michael,M,-37.90,145.18,,445e31a5-811d-480d-911c-7d9e15df6c1d,-37.87,144.78,VIC,Altona Meadows,debit,authorized,81513aab0d0b472c8234566ad5dee6d0,SALES-POS,40-50,2018,8,18,22,57,Saturday,7 days,31094.35
ACC-2988263882,44,35.84,3308.52,1.0,CUS-1233833708,2018-08-21,Michael,M,-37.90,145.18,,3ee2bf96-5720-4513-b119-37634cc7563d,-37.7,144.57,VIC,Melton South,debit,authorized,40bf060718264e38bf34f412f649d82c,SALES-POS,40-50,2018,8,21,1,48,Tuesday,7 days,31094.35
ACC-2988263882,44,18.53,3289.99,1.0,CUS-1233833708,2018-08-21,Michael,M,-37.90,145.18,,30e3d257-c16c-42ba-b2b9-078ce56716e8,-37.69,144.88,VIC,Tullamarine,debit,authorized,175633b0122b407393061b6c5da34eb6,SALES-POS,40-50,2018,8,21,9,2,Tuesday,7 days,31094.35
ACC-2988263882,44,81.95,3208.04,0.0,CUS-1233833708,2018-08-21,Michael,M,-37.90,145.18,,71fa5a6c-c7a3-4b36-9509-501b3b4f6dc1,-37.83,145.05,VIC,Hawthorn East,debit,authorized,3f2d9aaa7bd6423499e37ca9fe807cae,POS,40-50,2018,8,21,9,23,Tuesday,7 days,31094.35
ACC-2988263882,44,34.53,3173.51,1.0,CUS-1233833708,2018-08-22,Michael,M,-37.90,145.18,,05345a7f-6262-4bf6-a96d-d90c4e0ae8b8,-37.76,144.97,VIC,Brunswick East,debit,authorized,0193ccb1e2214d1685c89763d9f8509d,SALES-POS,40-50,2018,8,22,15,49,Wednesday,7 days,31094.35
ACC-2988263882,44,157.0,4209.17,,CUS-1233833708,2018-09-01,Michael,M,-37.90,145.18,,,,,,,debit,posted,ef286d7e0d6f42099dbb7c3cc2f48897,PAYMENT,40-50,2018,9,1,23,0,Saturday,7 days,31094.35
ACC-2988263882,44,53.65,4155.52,1.0,CUS-1233833708,2018-09-02,Michael,M,-37.90,145.18,,392389f2-0068-4ec2-b95d-c229e0893935,-37.75,144.91,VIC,Essendon,debit,authorized,ed2f183d7f56464daa7743ec78ac8942,POS,40-50,2018,9,2,8,16,Sunday,7 days,31094.35
ACC-2988263882,44,26.33,4129.19,1.0,CUS-1233833708,2018-09-02,Michael,M,-37.90,145.18,,948749e3-471e-4a8f-92ad-73e934b95ec4,-33.87,151.21,NSW,Sydney,debit,authorized,849b254a63364dcdbec744df319bf122,POS,40-50,2018,9,2,9,43,Sunday,7 days,31094.35
ACC-2988263882,44,197.0,5124.85,,CUS-1233833708,2018-09-17,Michael,M,-37.90,145.18,,,,,,,debit,posted,1534ee1bd1ac484390df3d449cc151e2,PAYMENT,40-50,2018,9,17,6,0,Monday,7 days,31094.35
ACC-2988263882,44,157.0,6160.51,,CUS-1233833708,2018-10-01,Michael,M,-37.90,145.18,,,,,,,debit,posted,48905f6a2133480f938bf1b4bda519ab,PAYMENT,40-50,2018,10,1,23,0,Monday,7 days,31094.35
ACC-2988263882,44,28.78,6728.06,0.0,CUS-1233833708,2018-10-06,Michael,M,-37.90,145.18,,5d427229-a4bd-403f-8b33-e283e439b73f,-37.81,144.89,VIC,Seddon,debit,authorized,b8b83a4e502c4fad9788abc3bdc7c9e7,POS,40-50,2018,10,6,2,36,Saturday,7 days,31094.35
ACC-2988263882,44,26.11,6701.95,1.0,CUS-1233833708,2018-10-06,Michael,M,-37.90,145.18,,a827fd32-6bb6-4b26-a85f-976e84c03373,-37.71,145.08,VIC,Watsonia,debit,authorized,a34bde7b63b74671a133c5af01caec1e,POS,40-50,2018,10,6,11,46,Saturday,7 days,31094.35
ACC-2988263882,44,17.47,6684.48,1.0,CUS-1233833708,2018-10-06,Michael,M,-37.90,145.18,,f384be2a-f321-478b-bf51-e55a6b1446f7,-37.67,144.84,VIC,Melbourne Airport,debit,authorized,e5f6a9098b0843658dc610a2a0d06abf,POS,40-50,2018,10,6,20,6,Saturday,7 days,31094.35
ACC-2988263882,44,16.07,6668.41,1.0,CUS-1233833708,2018-10-06,Michael,M,-37.90,145.18,,14bd3444-8b8e-4a12-a834-04bf3f8808a1,-37.74,144.97,VIC,Coburg,debit,authorized,8e430f52dc1c435ea9c53ef0b90dc84d,POS,40-50,2018,10,6,20,28,Saturday,7 days,31094.35
ACC-2988263882,44,32.15,6636.26,1.0,CUS-1233833708,2018-10-06,Michael,M,-37.90,145.18,,541ca120-5600-48cd-adca-3e638d2baffb,-27.97,153.41,QLD,Southport,debit,authorized,b3c274977a4d4d2f90c19896a70614aa,POS,40-50,2018,10,6,21,8,Saturday,7 days,31094.35
ACC-2988263882,44,13.06,6623.2,1.0,CUS-1233833708,2018-10-09,Michael,M,-37.90,145.18,,66905292-e14e-484f-97c0-1e8c41ed1ede,-37.81,144.96,VIC,Melbourne,debit,authorized,3f2ee8a4ac7f45628c33e9539aaf21f5,SALES-POS,40-50,2018,10,9,9,53,Tuesday,7 days,31094.35
ACC-2988263882,44,114.49,6508.71,1.0,CUS-1233833708,2018-10-09,Michael,M,-37.90,145.18,,aedfddb2-b3b2-46bc-a2be-22b6733fe7b8,-37.77,144.82,VIC,Sunshine North,debit,authorized,fe2d526ca59f48f9a90da9b74bec712a,SALES-POS,40-50,2018,10,9,11,12,Tuesday,7 days,31094.35
ACC-2988263882,44,133.64,6375.07,0.0,CUS-1233833708,2018-10-10,Michael,M,-37.90,145.18,,073485ff-1c68-4d35-9961-7e4b026df860,-37.81,144.97,VIC,Melbourne,debit,authorized,4a9c3e5b49754a47b98f8f3a5905b4fc,SALES-POS,40-50,2018,10,10,15,26,Wednesday,7 days,31094.35
ACC-2988263882,44,41.16,6333.91,1.0,CUS-1233833708,2018-10-11,Michael,M,-37.90,145.18,,36f05897-b5aa-47c2-bd53-55d9a45885da,-37.86,145.2,VIC,Vermont South,debit,authorized,b0d5b6791c2e49fb8486ccc3645b5d77,POS,40-50,2018,10,11,8,32,Thursday,7 days,31094.35
ACC-2988263882,44,68.54,6861.7,1.0,CUS-1233833708,2018-10-12,Michael,M,-37.90,145.18,,2d3f9099-eb95-48d7-8e34-ef4c4f1e492b,-37.83,144.99,VIC,Cremorne,debit,authorized,d46093eaa10e4df98e37c27aeb81203e,SALES-POS,40-50,2018,10,12,21,0,Friday,7 days,31094.35
ACC-2988263882,44,15.61,6846.09,1.0,CUS-1233833708,2018-10-13,Michael,M,-37.90,145.18,,c853cedf-5ab2-4252-a20f-51b76de236e6,-37.69,144.6,VIC,Melton,debit,authorized,ddeba821a05c4205ae87e45199255eb1,SALES-POS,40-50,2018,10,13,13,52,Saturday,7 days,31094.35
ACC-2988263882,44,26.63,6819.46,1.0,CUS-1233833708,2018-10-13,Michael,M,-37.90,145.18,,60098adb-5a6a-46c8-ae27-f9837e4405ea,-37.82,144.95,VIC,Melbourne,debit,authorized,47e319b2142b46f5892fc57e87c49869,POS,40-50,2018,10,13,14,21,Saturday,7 days,31094.35
ACC-2988263882,44,197.0,6622.46,,CUS-1233833708,2018-10-17,Michael,M,-37.90,145.18,,,,,,,debit,posted,b0fc1280b49d4284877d01adae9e1cc3,PAYMENT,40-50,2018,10,17,6,0,Wednesday,7 days,31094.35
ACC-2988263882,44,1251.0,5967.79,,CUS-1233833708,2018-10-25,Michael,M,-37.90,145.18,,,,,,,debit,posted,0e891c029745461b86465d1a3ec6ba45,PAYMENT,40-50,2018,10,25,2,0,Thursday,7 days,31094.35
ACC-37709441,18,32.06,128.21,1.0,CUS-3336454548,2018-08-02,Charles,M,-28.01,153.41,,1f4c3ff2-1948-4aff-872b-9e35bde43ac9,-27.95,153.38,QLD,Arundel,debit,authorized,9b024ce9e0be41b5adc21ef3c3a269d0,SALES-POS,<20,2018,8,2,2,16,Thursday,14 days,107733.139
ACC-37709441,18,20.42,107.79,1.0,CUS-3336454548,2018-08-02,Charles,M,-28.01,153.41,,ef4a6ac7-a816-48d8-b30b-3985aff88a64,-27.94,153.4,QLD,Labrador,debit,authorized,9d139ea68c034588a0fa95eb77e3b8a4,POS,<20,2018,8,2,11,29,Thursday,14 days,107733.139
ACC-37709441,18,15.31,92.48,1.0,CUS-3336454548,2018-08-02,Charles,M,-28.01,153.41,,af9c548f-6075-4e00-887b-6aa2d7714e84,-28.05,153.41,QLD,Mermaid Waters,debit,authorized,cc7b3f7fc568408ea1bda1e87ddd9581,SALES-POS,<20,2018,8,2,13,36,Thursday,14 days,107733.139
ACC-37709441,18,27.0,65.48,,CUS-3336454548,2018-08-03,Charles,M,-28.01,153.41,,,,,,,debit,posted,9eff869ca2de4bb5badfad6ce13f8324,PAYMENT,<20,2018,8,3,20,0,Friday,14 days,107733.139
ACC-37709441,18,6.81,58.67,1.0,CUS-3336454548,2018-08-04,Charles,M,-28.01,153.41,,49e0801d-8708-42bc-b967-7a8a9ba8495a,-28.1,153.4,QLD,Reedy Creek,debit,authorized,ef85fffdb99f4357b4389add3087d813,POS,<20,2018,8,4,13,5,Saturday,14 days,107733.139
ACC-37709441,18,45.0,13.67,,CUS-3336454548,2018-08-04,Charles,M,-28.01,153.41,,,,,,,debit,posted,8c4309cd34c7467db37bff8ce168912e,INTER BANK,<20,2018,8,4,14,0,Saturday,14 days,107733.139
ACC-37709441,18,7.18,6.49,1.0,CUS-3336454548,2018-08-06,Charles,M,-28.01,153.41,,92b064b0-5bc8-48f9-9294-7145b058d4e6,-27.82,153.32,QLD,Pimpama,debit,authorized,81e6b8c735bd4afb892211f9e8d7ff62,SALES-POS,<20,2018,8,6,20,7,Monday,14 days,107733.139
ACC-37709441,18,2.87,4135.85,1.0,CUS-3336454548,2018-08-07,Charles,M,-28.01,153.41,,62a327c6-f9ec-41c7-bbdd-06c756f1c8b9,-27.98,153.43,QLD,Main Beach,debit,authorized,24c07eaba29e41f793203a7c51358126,POS,<20,2018,8,7,21,51,Tuesday,14 days,107733.139
ACC-37709441,18,27.0,4108.85,,CUS-3336454548,2018-08-10,Charles,M,-28.01,153.41,,,,,,,debit,posted,c5e6c3ff8c624a69b8ab5525ef674bbc,PAYMENT,<20,2018,8,10,20,0,Friday,14 days,107733.139
ACC-37709441,18,186.0,3922.85,,CUS-3336454548,2018-08-11,Charles,M,-28.01,153.41,,,,,,,debit,posted,ed74c40e142047068de5c04b37c75117,PAYMENT,<20,2018,8,11,2,0,Saturday,14 days,107733.139
ACC-37709441,18,45.0,3877.85,,CUS-3336454548,2018-08-11,Charles,M,-28.01,153.41,,,,,,,debit,posted,f4e7cffc1db6403787e695dd08c6c375,INTER BANK,<20,2018,8,11,14,0,Saturday,14 days,107733.139
ACC-37709441,18,21.0,3856.85,,CUS-3336454548,2018-08-11,Charles,M,-28.01,153.41,,,,,,,debit,posted,f72178f672684d23a7f569f31fca36f3,PHONE BANK,<20,2018,8,11,16,0,Saturday,14 days,107733.139
ACC-37709441,18,40.0,3816.85,,CUS-3336454548,2018-08-12,Charles,M,-28.01,153.41,,,,,,,debit,posted,347243bb90224c2eb411edbaf0018c9c,INTER BANK,<20,2018,8,12,14,0,Sunday,14 days,107733.139
ACC-37709441,18,27.0,3789.85,,CUS-3336454548,2018-08-12,Charles,M,-28.01,153.41,,,,,,,debit,posted,61373dc70bfc4813b3ba77077178fa87,INTER BANK,<20,2018,8,12,19,0,Sunday,14 days,107733.139
ACC-37709441,18,55.0,3734.85,,CUS-3336454548,2018-08-13,Charles,M,-28.01,153.41,,,,,,,debit,posted,117eec4ce1f146139714b3d1036f2eb8,PAYMENT,<20,2018,8,13,19,0,Monday,14 days,107733.139
ACC-37709441,18,27.0,3707.85,,CUS-3336454548,2018-08-17,Charles,M,-28.01,153.41,,,,,,,debit,posted,a34607569c124bec9acbbb775cbd7f3d,PAYMENT,<20,2018,8,17,20,0,Friday,14 days,107733.139
ACC-37709441,18,24.98,3682.87,1.0,CUS-3336454548,2018-08-18,Charles,M,-28.01,153.41,,328b4301-ddf2-495c-94fc-7f1cf84340be,-27.91,153.4,QLD,Runaway Bay,debit,authorized,969c3df4458149d69a2c512c0d340586,POS,<20,2018,8,18,9,49,Saturday,14 days,107733.139
ACC-37709441,18,9.67,3673.2,1.0,CUS-3336454548,2018-08-18,Charles,M,-28.01,153.41,,8902f350-190c-43a7-b8cf-8784e654c6fb,-27.97,153.42,QLD,Southport,debit,authorized,f93ad453fa46432781a8032cd4687ce0,SALES-POS,<20,2018,8,18,12,42,Saturday,14 days,107733.139
ACC-37709441,18,45.0,3628.2,,CUS-3336454548,2018-08-18,Charles,M,-28.01,153.41,,,,,,,debit,posted,1d69ba6e45144701b0b2578b9d839986,INTER BANK,<20,2018,8,18,14,0,Saturday,14 days,107733.139
ACC-37709441,18,21.0,3607.2,,CUS-3336454548,2018-08-18,Charles,M,-28.01,153.41,,,,,,,debit,posted,3bde14f0300b45e9b2bc56c130c417e1,PHONE BANK,<20,2018,8,18,16,0,Saturday,14 days,107733.139
ACC-37709441,18,13.74,3593.46,1.0,CUS-3336454548,2018-08-19,Charles,M,-28.01,153.41,,946f3a3f-4c0d-4761-af5e-9378354ac0c3,-28.08,153.39,QLD,Robina,debit,authorized,33a2c840f648406587c17762998b31cb,SALES-POS,<20,2018,8,19,8,51,Sunday,14 days,107733.139
ACC-37709441,18,17.06,3576.4,1.0,CUS-3336454548,2018-08-19,Charles,M,-28.01,153.41,,beeb6931-4e16-45cc-a6e0-30c23cf76d55,-27.95,153.35,QLD,Arundel,debit,authorized,ce26e0e77efc4973a5f4f4aec30097f0,SALES-POS,<20,2018,8,19,11,20,Sunday,14 days,107733.139
ACC-37709441,18,14.38,3562.02,0.0,CUS-3336454548,2018-08-19,Charles,M,-28.01,153.41,,7c17f828-06c8-438b-8e02-99302091faa6,-28.06,153.44,QLD,Mermaid Beach,debit,authorized,d9ac941ebbc74634aa6cad0401067077,SALES-POS,<20,2018,8,19,11,48,Sunday,14 days,107733.139
ACC-37709441,18,28.1,3533.92,0.0,CUS-3336454548,2018-08-19,Charles,M,-28.01,153.41,,d3db185c-b962-42fd-ab56-067af8ffa754,-28.08,153.39,QLD,Robina,debit,authorized,93bbc53e88bc428d819b3b8c911ff813,POS,<20,2018,8,19,13,53,Sunday,14 days,107733.139
ACC-37709441,18,40.0,3493.92,,CUS-3336454548,2018-08-19,Charles,M,-28.01,153.41,,,,,,,debit,posted,58aa0dba817b44e3a863c81f3b92ef76,INTER BANK,<20,2018,8,19,14,0,Sunday,14 days,107733.139
ACC-37709441,18,27.0,3466.92,,CUS-3336454548,2018-08-19,Charles,M,-28.01,153.41,,,,,,,debit,posted,947655b6064c4747ac5ed6524d8a62ee,INTER BANK,<20,2018,8,19,19,0,Sunday,14 days,107733.139
ACC-37709441,18,55.0,3411.92,,CUS-3336454548,2018-08-20,Charles,M,-28.01,153.41,,,,,,,debit,posted,b083451e75ee4a31975e49f90d13dd5c,PAYMENT,<20,2018,8,20,19,0,Monday,14 days,107733.139
ACC-37709441,18,13.48,7530.67,1.0,CUS-3336454548,2018-08-21,Charles,M,-28.01,153.41,,6714d0be-9a69-4d2c-8d45-c8fc84df9eaa,-37.82,144.97,VIC,Melbourne,debit,authorized,98fde09c98144ff8bab085dddf687833,POS,<20,2018,8,21,20,25,Tuesday,14 days,107733.139
ACC-37709441,18,30.72,7499.95,1.0,CUS-3336454548,2018-08-21,Charles,M,-28.01,153.41,,b3617a04-39ff-46d4-a951-cbf0ce3376ff,-28.09,153.42,QLD,Varsity Lakes,debit,authorized,9c9d953bbec1425fa78bdad9b9781746,POS,<20,2018,8,21,21,1,Tuesday,14 days,107733.139
ACC-37709441,18,5.34,7494.61,1.0,CUS-3336454548,2018-08-22,Charles,M,-28.01,153.41,,8c17f994-bf4e-4045-ad13-7cbf4173eea4,-28.77,114.61,WA,Geraldton,debit,authorized,a39546d6c8b94b4eb53bc9711875bbd5,POS,<20,2018,8,22,10,8,Wednesday,14 days,107733.139
ACC-37709441,18,173.0,7321.61,,CUS-3336454548,2018-08-22,Charles,M,-28.01,153.41,,,,,,,debit,posted,cd8be7e6dd6e43468dc34b9908655d67,PAYMENT,<20,2018,8,22,12,0,Wednesday,14 days,107733.139
ACC-37709441,18,101.0,7220.61,,CUS-3336454548,2018-08-23,Charles,M,-28.01,153.41,,,,,,,debit,posted,45466b2db72b4da294b5a6d260fbead9,INTER BANK,<20,2018,8,23,3,0,Thursday,14 days,107733.139
ACC-37709441,18,21.65,7198.96,1.0,CUS-3336454548,2018-08-23,Charles,M,-28.01,153.41,,c0fb68c6-935b-47ae-8594-e3da036d0f94,-28,153.36,QLD,Gold Coast,debit,authorized,af5bf8b0c76c49468b4d16aca1103b83,SALES-POS,<20,2018,8,23,11,47,Thursday,14 days,107733.139
ACC-37709441,18,29.16,7169.8,1.0,CUS-3336454548,2018-08-23,Charles,M,-28.01,153.41,,32aac8ce-69eb-407d-bbbc-cb40571549f8,-33.84,151.21,NSW,North Sydney,debit,authorized,c723ef6de58d49218910ea63afc9feec,POS,<20,2018,8,23,19,45,Thursday,14 days,107733.139
ACC-37709441,18,27.0,7142.8,,CUS-3336454548,2018-08-24,Charles,M,-28.01,153.41,,,,,,,debit,posted,6e873ad75b7c40c6bf0661c053c684d0,PAYMENT,<20,2018,8,24,20,0,Friday,14 days,107733.139
ACC-37709441,18,45.0,7097.8,,CUS-3336454548,2018-08-25,Charles,M,-28.01,153.41,,,,,,,debit,posted,bd6d3229c2d245ca86f3e244fe963967,INTER BANK,<20,2018,8,25,14,0,Saturday,14 days,107733.139
ACC-37709441,18,21.0,7076.8,,CUS-3336454548,2018-08-25,Charles,M,-28.01,153.41,,,,,,,debit,posted,438f5675c1d44503aca21b2997fe8e9a,PHONE BANK,<20,2018,8,25,16,0,Saturday,14 days,107733.139
ACC-37709441,18,40.0,7036.8,,CUS-3336454548,2018-08-26,Charles,M,-28.01,153.41,,,,,,,debit,posted,3ca46415f724470f88bfa8b265119506,INTER BANK,<20,2018,8,26,14,0,Sunday,14 days,107733.139
ACC-37709441,18,27.0,7009.8,,CUS-3336454548,2018-08-26,Charles,M,-28.01,153.41,,,,,,,debit,posted,c557f881e1214a39b12cc6d37006f4d7,INTER BANK,<20,2018,8,26,19,0,Sunday,14 days,107733.139
ACC-37709441,18,55.0,6954.8,,CUS-3336454548,2018-08-27,Charles,M,-28.01,153.41,,,,,,,debit,posted,285d20def816416a8d0867ab6ede92de,PAYMENT,<20,2018,8,27,19,0,Monday,14 days,107733.139
ACC-37709441,18,21.39,6933.41,1.0,CUS-3336454548,2018-08-28,Charles,M,-28.01,153.41,,8d7196ad-1377-4169-b035-42cbf36a7907,-27.93,153.34,QLD,Helensvale,debit,authorized,fd112995c9ad49eaa24c65fbbff4d9de,SALES-POS,<20,2018,8,28,9,56,Tuesday,14 days,107733.139
ACC-37709441,18,6.17,6927.24,0.0,CUS-3336454548,2018-08-28,Charles,M,-28.01,153.41,,368aab5c-85e7-42b3-8610-de85628a74ed,-29.44,153.36,NSW,Yamba,debit,authorized,4d74ee000e184213a63ea57dcd26d9dc,SALES-POS,<20,2018,8,28,16,14,Tuesday,14 days,107733.139
ACC-37709441,18,6.62,6920.62,1.0,CUS-3336454548,2018-08-29,Charles,M,-28.01,153.41,,4f26fd31-c711-4f76-8e98-3edee26af677,-28.08,153.39,QLD,Robina,debit,authorized,bda01e787bca4d2d92659623ef73e2d4,SALES-POS,<20,2018,8,29,1,9,Wednesday,14 days,107733.139
ACC-37709441,18,18.23,6902.39,1.0,CUS-3336454548,2018-08-29,Charles,M,-28.01,153.41,,ddf112bb-15d5-4c0f-a0c5-5aa73fcd7ac7,-28.03,153.39,QLD,Clear Island Waters,debit,authorized,c4f6e2fac92846398d4de51c5eecc576,POS,<20,2018,8,29,9,8,Wednesday,14 days,107733.139
ACC-37709441,18,9.73,6892.66,1.0,CUS-3336454548,2018-08-30,Charles,M,-28.01,153.41,,0a8608b7-efba-401b-b675-e17c4a802ba4,-28.03,153.43,QLD,Broadbeach,debit,authorized,cdc87f94dc70414d919bd57f8a89828b,POS,<20,2018,8,30,9,11,Thursday,14 days,107733.139
ACC-37709441,18,11.86,6880.8,0.0,CUS-3336454548,2018-08-30,Charles,M,-28.01,153.41,,9ddc1fae-1d52-4ecf-a212-a7f9c950b963,-28.08,153.39,QLD,Robina,debit,authorized,249fb572f9014d0d805f363e42e079d9,SALES-POS,<20,2018,8,30,15,45,Thursday,14 days,107733.139
ACC-37709441,18,31.77,6849.03,1.0,CUS-3336454548,2018-08-30,Charles,M,-28.01,153.41,,c8fd614c-ccd6-41aa-ab6b-ea19681818bf,-27.9,153.29,QLD,Upper Coomera,debit,authorized,3d0a21f02ea2446d9bde8ad2cae7a359,SALES-POS,<20,2018,8,30,22,49,Thursday,14 days,107733.139
ACC-37709441,18,27.0,6822.03,,CUS-3336454548,2018-08-31,Charles,M,-28.01,153.41,,,,,,,debit,posted,fb1f021b3cee44868d988d8e3a8b5e08,PAYMENT,<20,2018,8,31,20,0,Friday,14 days,107733.139
ACC-37709441,18,13.39,6808.64,1.0,CUS-3336454548,2018-09-01,Charles,M,-28.01,153.41,,e1c0331f-3ec5-4d0b-85ad-1ef31a5eb6a1,-28.04,153.43,QLD,Mermaid Beach,debit,authorized,c3e677761e61426ba5ffebd4ccbfad5a,SALES-POS,<20,2018,9,1,12,39,Saturday,14 days,107733.139
ACC-37709441,18,45.0,6763.64,,CUS-3336454548,2018-09-01,Charles,M,-28.01,153.41,,,,,,,debit,posted,713999d9a12c4d22967a1e3315d4b487,INTER BANK,<20,2018,9,1,14,0,Saturday,14 days,107733.139
ACC-37709441,18,21.0,6742.64,,CUS-3336454548,2018-09-01,Charles,M,-28.01,153.41,,,,,,,debit,posted,51d1a92e56ea4fb0907821d73113e642,PHONE BANK,<20,2018,9,1,16,0,Saturday,14 days,107733.139
ACC-37709441,18,23.09,6719.55,0.0,CUS-3336454548,2018-09-01,Charles,M,-28.01,153.41,,96771859-4bff-4c75-8db7-0132179e1380,-27.97,153.42,QLD,Southport,debit,authorized,489e482ad801469492da973680bc43cc,POS,<20,2018,9,1,17,24,Saturday,14 days,107733.139
ACC-37709441,18,7.71,6711.84,1.0,CUS-3336454548,2018-09-02,Charles,M,-28.01,153.41,,92b064b0-5bc8-48f9-9294-7145b058d4e6,-27.82,153.32,QLD,Pimpama,debit,authorized,d75e274f265349df99c1ce268e7b129e,SALES-POS,<20,2018,9,2,2,31,Sunday,14 days,107733.139
ACC-37709441,18,80.9,6630.94,1.0,CUS-3336454548,2018-09-02,Charles,M,-28.01,153.41,,26c92de4-4848-4c65-aba4-f33884e7545a,-27.99,153.39,QLD,Ashmore,debit,authorized,7cf8b2e6e87d4a588a7cf98063a6323e,POS,<20,2018,9,2,9,38,Sunday,14 days,107733.139
ACC-37709441,18,40.0,6590.94,,CUS-3336454548,2018-09-02,Charles,M,-28.01,153.41,,,,,,,debit,posted,298afaf3391d4841ae0f4f80ae1e27a7,INTER BANK,<20,2018,9,2,14,0,Sunday,14 days,107733.139
ACC-37709441,18,27.0,6563.94,,CUS-3336454548,2018-09-02,Charles,M,-28.01,153.41,,,,,,,debit,posted,55c01d92d53e41b4987c0efca6c9a50d,INTER BANK,<20,2018,9,2,19,0,Sunday,14 days,107733.139
ACC-37709441,18,55.0,6508.94,,CUS-3336454548,2018-09-03,Charles,M,-28.01,153.41,,,,,,,debit,posted,afd5d49f404c4550a511f225ce75e7bd,PAYMENT,<20,2018,9,3,19,0,Monday,14 days,107733.139
ACC-37709441,18,9.48,6499.46,1.0,CUS-3336454548,2018-09-04,Charles,M,-28.01,153.41,,3ae539ca-2824-413c-b978-e87360b047ea,-27.91,153.4,QLD,Runaway Bay,debit,authorized,f87a733477c0444fb4dbe0794e22beb9,POS,<20,2018,9,4,8,32,Tuesday,14 days,107733.139
ACC-37709441,18,26.0,10605.69,1.0,CUS-3336454548,2018-09-05,Charles,M,-28.01,153.41,,dd2927c4-ccc2-4aa7-be03-ca93ae8f77ad,-27.98,152.55,QLD,Aratula,debit,authorized,8731f02e4dbc4a6badd6343f2bb2f14f,SALES-POS,<20,2018,9,5,17,51,Wednesday,14 days,107733.139
ACC-37709441,18,50.49,10555.2,1.0,CUS-3336454548,2018-09-05,Charles,M,-28.01,153.41,,0c374f9f-684a-4ad0-a528-fb0530b69eb3,-27.94,153.31,QLD,Pacific Pines,debit,authorized,c852c650326a4af8a9b81a7460749a16,POS,<20,2018,9,5,18,36,Wednesday,14 days,107733.139
ACC-37709441,18,19.0,10536.2,1.0,CUS-3336454548,2018-09-06,Charles,M,-28.01,153.41,,dc5e5fbf-40de-4d28-91a2-c32f51b986d6,-27.98,153.41,QLD,Southport,debit,authorized,afd344799fe84fcca518909cfd1af8cc,POS,<20,2018,9,6,1,19,Thursday,14 days,107733.139
ACC-37709441,18,6.77,10529.43,1.0,CUS-3336454548,2018-09-07,Charles,M,-28.01,153.41,,d2ed2ec3-a995-4fcf-99f9-1b85ca2c917d,-27.93,153.39,QLD,Biggera Waters,debit,authorized,18a4612eae0c41f39e96f0153dd1296f,POS,<20,2018,9,7,14,13,Friday,14 days,107733.139
ACC-37709441,18,8.93,10520.5,1.0,CUS-3336454548,2018-09-07,Charles,M,-28.01,153.41,,31ba1ad6-009c-4b64-8bac-89197be8fd94,-27.93,153.34,QLD,Helensvale,debit,authorized,49a093e9de2b497da6a1fd9520399dec,POS,<20,2018,9,7,19,32,Friday,14 days,107733.139
ACC-37709441,18,27.0,10493.5,,CUS-3336454548,2018-09-07,Charles,M,-28.01,153.41,,,,,,,debit,posted,95b839b4595f451c84320e43c24a1e22,PAYMENT,<20,2018,9,7,20,0,Friday,14 days,107733.139
ACC-37709441,18,14.6,10478.9,1.0,CUS-3336454548,2018-09-08,Charles,M,-28.01,153.41,,58ca4138-eccc-44ed-b9f4-89f52f586b07,-27.94,153.4,QLD,Biggera Waters,debit,authorized,f91071549be946a0a1a1d412f181ca49,POS,<20,2018,9,8,11,6,Saturday,14 days,107733.139
ACC-37709441,18,45.0,10433.9,,CUS-3336454548,2018-09-08,Charles,M,-28.01,153.41,,,,,,,debit,posted,309be93f6f89458f907b8903055c0661,INTER BANK,<20,2018,9,8,14,0,Saturday,14 days,107733.139
ACC-37709441,18,21.0,10412.9,,CUS-3336454548,2018-09-08,Charles,M,-28.01,153.41,,,,,,,debit,posted,54f24c11c2bb4388a9dc6cc8bf04742a,PHONE BANK,<20,2018,9,8,16,0,Saturday,14 days,107733.139
ACC-37709441,18,40.0,10372.9,,CUS-3336454548,2018-09-09,Charles,M,-28.01,153.41,,,,,,,debit,posted,0087743aad824c89bcabbd039bd55f82,INTER BANK,<20,2018,9,9,14,0,Sunday,14 days,107733.139
ACC-37709441,18,27.0,10345.9,,CUS-3336454548,2018-09-09,Charles,M,-28.01,153.41,,,,,,,debit,posted,44d246f9d574410f917232e44bbd170b,INTER BANK,<20,2018,9,9,19,0,Sunday,14 days,107733.139
ACC-37709441,18,55.0,10290.9,,CUS-3336454548,2018-09-10,Charles,M,-28.01,153.41,,,,,,,debit,posted,632eaeacdf154b6790447a65868b58d2,PAYMENT,<20,2018,9,10,19,0,Monday,14 days,107733.139
ACC-37709441,18,186.0,10104.9,,CUS-3336454548,2018-09-11,Charles,M,-28.01,153.41,,,,,,,debit,posted,7af84d5c61c34ea88f15d53f09e8e1b8,PAYMENT,<20,2018,9,11,2,0,Tuesday,14 days,107733.139
ACC-37709441,18,27.0,10077.9,,CUS-3336454548,2018-09-14,Charles,M,-28.01,153.41,,,,,,,debit,posted,fa3ab7c7740446e08aa127d6fb87057d,PAYMENT,<20,2018,9,14,20,0,Friday,14 days,107733.139
ACC-37709441,18,45.0,10032.9,,CUS-3336454548,2018-09-15,Charles,M,-28.01,153.41,,,,,,,debit,posted,b9baff06c43f41beb48d0d026e325fce,INTER BANK,<20,2018,9,15,14,0,Saturday,14 days,107733.139
ACC-37709441,18,21.0,10011.9,,CUS-3336454548,2018-09-15,Charles,M,-28.01,153.41,,,,,,,debit,posted,431897d9ef3940aaa839d2967c22c037,PHONE BANK,<20,2018,9,15,16,0,Saturday,14 days,107733.139
ACC-37709441,18,40.0,9971.9,,CUS-3336454548,2018-09-16,Charles,M,-28.01,153.41,,,,,,,debit,posted,0580b30833314325b7715f9c49693239,INTER BANK,<20,2018,9,16,14,0,Sunday,14 days,107733.139
ACC-37709441,18,27.0,9944.9,,CUS-3336454548,2018-09-16,Charles,M,-28.01,153.41,,,,,,,debit,posted,57c13d164fa5493f88f8782c42b131c9,INTER BANK,<20,2018,9,16,19,0,Sunday,14 days,107733.139
ACC-37709441,18,55.0,9889.9,,CUS-3336454548,2018-09-17,Charles,M,-28.01,153.41,,,,,,,debit,posted,79345c04c2be4b9fb0cd37912df2abfc,PAYMENT,<20,2018,9,17,19,0,Monday,14 days,107733.139
ACC-37709441,18,48.76,13973.37,1.0,CUS-3336454548,2018-09-19,Charles,M,-28.01,153.41,,d7160c68-7371-411c-aa52-9c0f39f5fff1,-34.77,138.63,SA,Salisbury Downs,debit,authorized,c9c418a3aa7f4ab491642edb6e694d16,POS,<20,2018,9,19,17,58,Wednesday,14 days,107733.139
ACC-37709441,18,3.83,13969.54,1.0,CUS-3336454548,2018-09-19,Charles,M,-28.01,153.41,,ccd5a4a3-4226-4a54-a21d-4855be23e33a,-27.95,153.2,QLD,Tamborine Mountain,debit,authorized,fe67338dd35c47edb289b4e5d7cceff3,SALES-POS,<20,2018,9,19,23,43,Wednesday,14 days,107733.139
ACC-37709441,18,1.64,13967.9,1.0,CUS-3336454548,2018-09-20,Charles,M,-28.01,153.41,,6ea10976-582a-43c5-8bb9-0662f0217237,-28.03,153.43,QLD,Broadbeach,debit,authorized,b5e69967d0074ba8a4cd1d73f6c68598,SALES-POS,<20,2018,9,20,10,7,Thursday,14 days,107733.139
ACC-37709441,18,17.58,13950.32,1.0,CUS-3336454548,2018-09-20,Charles,M,-28.01,153.41,,f97bc810-6886-4cbc-a79c-48ab1f6285aa,-28.02,153.43,QLD,Broadbeach,debit,authorized,a5f664fa024a499293f20aad48f6d488,SALES-POS,<20,2018,9,20,20,44,Thursday,14 days,107733.139
ACC-37709441,18,27.7,13922.62,1.0,CUS-3336454548,2018-09-21,Charles,M,-28.01,153.41,,ed7a908d-e7ba-48c5-9b41-5b4835b13247,-28.08,153.39,QLD,Robina,debit,authorized,e81e3d68738d4b298e0a2740dae03688,POS,<20,2018,9,21,10,21,Friday,14 days,107733.139
ACC-37709441,18,18.53,13904.09,0.0,CUS-3336454548,2018-09-21,Charles,M,-28.01,153.41,,8020a6f5-714a-430e-8bdc-56e165d7f8da,-28.01,153.34,QLD,Highland Park,debit,authorized,3818b3112a6d430c9cbd61e12daf6078,POS,<20,2018,9,21,17,53,Friday,14 days,107733.139
ACC-37709441,18,27.0,13877.09,,CUS-3336454548,2018-09-21,Charles,M,-28.01,153.41,,,,,,,debit,posted,c05dd7cea897424da0b6dac4bcfca889,PAYMENT,<20,2018,9,21,20,0,Friday,14 days,107733.139
ACC-37709441,18,173.0,13704.09,,CUS-3336454548,2018-09-22,Charles,M,-28.01,153.41,,,,,,,debit,posted,4210e6070d4c4ed290a3b18069042ae4,PAYMENT,<20,2018,9,22,12,0,Saturday,14 days,107733.139
ACC-37709441,18,45.0,13659.09,,CUS-3336454548,2018-09-22,Charles,M,-28.01,153.41,,,,,,,debit,posted,06e2cd360d02456cb77591c9524a23c0,INTER BANK,<20,2018,9,22,14,0,Saturday,14 days,107733.139
ACC-37709441,18,21.0,13638.09,,CUS-3336454548,2018-09-22,Charles,M,-28.01,153.41,,,,,,,debit,posted,515e888b5c884871aa2354129be86ac7,PHONE BANK,<20,2018,9,22,16,0,Saturday,14 days,107733.139
ACC-37709441,18,101.0,13537.09,,CUS-3336454548,2018-09-23,Charles,M,-28.01,153.41,,,,,,,debit,posted,651ba2bb33a44d4ba53e23b55d5da1a1,INTER BANK,<20,2018,9,23,3,0,Sunday,14 days,107733.139
ACC-37709441,18,40.0,13497.09,,CUS-3336454548,2018-09-23,Charles,M,-28.01,153.41,,,,,,,debit,posted,1b92104743af46159b1556fb512aefe7,INTER BANK,<20,2018,9,23,14,0,Sunday,14 days,107733.139
ACC-37709441,18,26.63,13470.46,1.0,CUS-3336454548,2018-09-23,Charles,M,-28.01,153.41,,328b4301-ddf2-495c-94fc-7f1cf84340be,-27.91,153.4,QLD,Runaway Bay,debit,authorized,83a5857b80c34bdab7146f043edbcc40,SALES-POS,<20,2018,9,23,18,47,Sunday,14 days,107733.139
ACC-37709441,18,27.0,13443.46,,CUS-3336454548,2018-09-23,Charles,M,-28.01,153.41,,,,,,,debit,posted,3d603cfc2ecb48a1a3fcb7f5a3b6fc0b,INTER BANK,<20,2018,9,23,19,0,Sunday,14 days,107733.139
ACC-37709441,18,13.77,13429.69,1.0,CUS-3336454548,2018-09-23,Charles,M,-28.01,153.41,,ebb3087a-75c4-4dea-8354-9be1c746d6cb,-27.89,152.02,QLD,Pilton,debit,authorized,a714c9e9cfca4019969d163dfedc2563,SALES-POS,<20,2018,9,23,23,13,Sunday,14 days,107733.139
ACC-37709441,18,12.32,13417.37,1.0,CUS-3336454548,2018-09-24,Charles,M,-28.01,153.41,,230b43a1-dd38-401e-9acc-b32925f5b5a7,-27.89,153.31,QLD,Oxenford,debit,authorized,a988f192fccd4199b96e8a100ebdf273,POS,<20,2018,9,24,9,51,Monday,14 days,107733.139
ACC-37709441,18,17.38,13399.99,1.0,CUS-3336454548,2018-09-24,Charles,M,-28.01,153.41,,f9b5a280-e4fd-466b-ac0b-57a15e7687d9,-27.95,153.41,QLD,Labrador,debit,authorized,867c4d14ad544179afbb6f4bf0b2e5c1,SALES-POS,<20,2018,9,24,15,30,Monday,14 days,107733.139
ACC-37709441,18,11.66,13388.33,0.0,CUS-3336454548,2018-09-24,Charles,M,-28.01,153.41,,b27689af-4d1e-49b2-b3af-4139ac5d2b6c,-27.94,153.37,VIC,Arundel,debit,authorized,20127dea0e2c418c82f7cd64d2d65d07,POS,<20,2018,9,24,17,55,Monday,14 days,107733.139
ACC-37709441,18,55.0,13333.33,,CUS-3336454548,2018-09-24,Charles,M,-28.01,153.41,,,,,,,debit,posted,8811f820a6dc42908f1005b7ec2dd717,PAYMENT,<20,2018,9,24,19,0,Monday,14 days,107733.139
ACC-37709441,18,95.45,13237.88,1.0,CUS-3336454548,2018-09-25,Charles,M,-28.01,153.41,,d1f233cc-3f37-4c24-a188-7d842a11bb3d,-37.81,144.96,VIC,Melbourne,debit,authorized,b6a86da371c4483da62b50fad29552e2,POS,<20,2018,9,25,9,3,Tuesday,14 days,107733.139
ACC-37709441,18,8.71,13229.17,0.0,CUS-3336454548,2018-09-25,Charles,M,-28.01,153.41,,31ba1ad6-009c-4b64-8bac-89197be8fd94,-27.93,153.34,QLD,Helensvale,debit,authorized,7ddd011b7b1140429f596c7d4bd37713,POS,<20,2018,9,25,9,11,Tuesday,14 days,107733.139
ACC-37709441,18,6.86,13222.31,0.0,CUS-3336454548,2018-09-25,Charles,M,-28.01,153.41,,03db6880-5402-4194-8937-4357650a5909,-28.07,153.42,QLD,Robina,debit,authorized,b8a90172b410498ab743840a578d43e0,SALES-POS,<20,2018,9,25,13,28,Tuesday,14 days,107733.139
ACC-37709441,18,27.0,13195.31,,CUS-3336454548,2018-09-28,Charles,M,-28.01,153.41,,,,,,,debit,posted,17296e30f6964b358670e8f71e62f178,PAYMENT,<20,2018,9,28,20,0,Friday,14 days,107733.139
ACC-37709441,18,45.0,13150.31,,CUS-3336454548,2018-09-29,Charles,M,-28.01,153.41,,,,,,,debit,posted,c51e488c80844e3591583bf106d38a57,INTER BANK,<20,2018,9,29,14,0,Saturday,14 days,107733.139
ACC-37709441,18,21.0,13129.31,,CUS-3336454548,2018-09-29,Charles,M,-28.01,153.41,,,,,,,debit,posted,730dd9ca774941f1bda0bfad7c77ae01,PHONE BANK,<20,2018,9,29,16,0,Saturday,14 days,107733.139
ACC-37709441,18,40.0,13089.31,,CUS-3336454548,2018-09-30,Charles,M,-28.01,153.41,,,,,,,debit,posted,bf872a7bcde94024bf985f5a274b8fbd,INTER BANK,<20,2018,9,30,14,0,Sunday,14 days,107733.139
ACC-37709441,18,27.0,13062.31,,CUS-3336454548,2018-09-30,Charles,M,-28.01,153.41,,,,,,,debit,posted,ba1fd4f5aee24238aaa3bbe57b98ab97,INTER BANK,<20,2018,9,30,19,0,Sunday,14 days,107733.139
ACC-37709441,18,55.0,13007.31,,CUS-3336454548,2018-10-01,Charles,M,-28.01,153.41,,,,,,,debit,posted,563c4bb6994640ca8286f5e305c8ef20,PAYMENT,<20,2018,10,1,19,0,Monday,14 days,107733.139
ACC-37709441,18,27.0,17112.54,,CUS-3336454548,2018-10-05,Charles,M,-28.01,153.41,,,,,,,debit,posted,74310dfc29a5463196216e1b43b805ab,PAYMENT,<20,2018,10,5,20,0,Friday,14 days,107733.139
ACC-37709441,18,45.0,17067.54,,CUS-3336454548,2018-10-06,Charles,M,-28.01,153.41,,,,,,,debit,posted,fc484102d7154c4188f3752a249466da,INTER BANK,<20,2018,10,6,14,0,Saturday,14 days,107733.139
ACC-37709441,18,21.0,17046.54,,CUS-3336454548,2018-10-06,Charles,M,-28.01,153.41,,,,,,,debit,posted,7c88dd4e1cc747c0aac2cc5921a79dad,PHONE BANK,<20,2018,10,6,16,0,Saturday,14 days,107733.139
ACC-37709441,18,40.0,17006.54,,CUS-3336454548,2018-10-07,Charles,M,-28.01,153.41,,,,,,,debit,posted,3295554b700c40cab90284352f5ce7c7,INTER BANK,<20,2018,10,7,14,0,Sunday,14 days,107733.139
ACC-37709441,18,27.0,16979.54,,CUS-3336454548,2018-10-07,Charles,M,-28.01,153.41,,,,,,,debit,posted,c7524bf33e134a498599dc2593bbf767,INTER BANK,<20,2018,10,7,19,0,Sunday,14 days,107733.139
ACC-37709441,18,55.0,16924.54,,CUS-3336454548,2018-10-08,Charles,M,-28.01,153.41,,,,,,,debit,posted,83e05bd7202b4d5caed0858ecd92a886,PAYMENT,<20,2018,10,8,19,0,Monday,14 days,107733.139
ACC-37709441,18,186.0,16738.54,,CUS-3336454548,2018-10-11,Charles,M,-28.01,153.41,,,,,,,debit,posted,2544c9572c824dd5966d43b30528a6f3,PAYMENT,<20,2018,10,11,2,0,Thursday,14 days,107733.139
ACC-37709441,18,27.0,16711.54,,CUS-3336454548,2018-10-12,Charles,M,-28.01,153.41,,,,,,,debit,posted,a84ffbb9908d46c5839528e2f34666fb,PAYMENT,<20,2018,10,12,20,0,Friday,14 days,107733.139
ACC-37709441,18,45.0,16666.54,,CUS-3336454548,2018-10-13,Charles,M,-28.01,153.41,,,,,,,debit,posted,ef01d8ff845947d3a7f51478aa3bd3e6,INTER BANK,<20,2018,10,13,14,0,Saturday,14 days,107733.139
ACC-37709441,18,21.0,16645.54,,CUS-3336454548,2018-10-13,Charles,M,-28.01,153.41,,,,,,,debit,posted,9fd5890017cf428c838ea27bac989b7a,PHONE BANK,<20,2018,10,13,16,0,Saturday,14 days,107733.139
ACC-37709441,18,40.0,16605.54,,CUS-3336454548,2018-10-14,Charles,M,-28.01,153.41,,,,,,,debit,posted,ac9d7aac52da458fb9702e0eeec0505a,INTER BANK,<20,2018,10,14,14,0,Sunday,14 days,107733.139
ACC-37709441,18,27.0,16578.54,,CUS-3336454548,2018-10-14,Charles,M,-28.01,153.41,,,,,,,debit,posted,f51b4f9069604f5297e1da856ff9b429,INTER BANK,<20,2018,10,14,19,0,Sunday,14 days,107733.139
ACC-37709441,18,7.11,16571.43,1.0,CUS-3336454548,2018-10-14,Charles,M,-28.01,153.41,,95729e27-6bcb-422a-a3bf-ddb1aa204c7c,-27.97,153.38,QLD,Southport,debit,authorized,87e47b812e704a55ae58b117a1b738ea,POS,<20,2018,10,14,21,47,Sunday,14 days,107733.139
ACC-37709441,18,8.85,16562.58,1.0,CUS-3336454548,2018-10-15,Charles,M,-28.01,153.41,,0ff64be8-4ef8-497e-bf5e-5f7b970474e8,-27.9,153.28,QLD,Upper Coomera,debit,authorized,9321390e4c394bb4a03bac47aa24afd7,POS,<20,2018,10,15,8,33,Monday,14 days,107733.139
ACC-37709441,18,55.0,16507.58,,CUS-3336454548,2018-10-15,Charles,M,-28.01,153.41,,,,,,,debit,posted,52cfdc071662448ebfc03c81aeaaaf40,PAYMENT,<20,2018,10,15,19,0,Monday,14 days,107733.139
ACC-37709441,18,27.0,20612.81,,CUS-3336454548,2018-10-19,Charles,M,-28.01,153.41,,,,,,,debit,posted,076dbfcde68240a4a04f31783e6fd1e8,PAYMENT,<20,2018,10,19,20,0,Friday,14 days,107733.139
ACC-37709441,18,45.0,20567.81,,CUS-3336454548,2018-10-20,Charles,M,-28.01,153.41,,,,,,,debit,posted,c238bfc4de1a41fc870bcee2fa4470e7,INTER BANK,<20,2018,10,20,14,0,Saturday,14 days,107733.139
ACC-37709441,18,21.0,20546.81,,CUS-3336454548,2018-10-20,Charles,M,-28.01,153.41,,,,,,,debit,posted,86dced32fc8d481caca927790e2392ce,PHONE BANK,<20,2018,10,20,16,0,Saturday,14 days,107733.139
ACC-37709441,18,40.0,20506.81,,CUS-3336454548,2018-10-21,Charles,M,-28.01,153.41,,,,,,,debit,posted,4ca6bb153fe7438f95a78ad54af665dd,INTER BANK,<20,2018,10,21,14,0,Sunday,14 days,107733.139
ACC-37709441,18,27.0,20479.81,,CUS-3336454548,2018-10-21,Charles,M,-28.01,153.41,,,,,,,debit,posted,59499bb323c6463ea582db26b6f6f3de,INTER BANK,<20,2018,10,21,19,0,Sunday,14 days,107733.139
ACC-37709441,18,173.0,20306.81,,CUS-3336454548,2018-10-22,Charles,M,-28.01,153.41,,,,,,,debit,posted,0ae3c62a5bdd4a9a9dc311ce068d4e2a,PAYMENT,<20,2018,10,22,12,0,Monday,14 days,107733.139
ACC-37709441,18,55.0,20251.81,,CUS-3336454548,2018-10-22,Charles,M,-28.01,153.41,,,,,,,debit,posted,043a67d347eb491a86b5062a22e9a994,PAYMENT,<20,2018,10,22,19,0,Monday,14 days,107733.139
ACC-37709441,18,101.0,20150.81,,CUS-3336454548,2018-10-23,Charles,M,-28.01,153.41,,,,,,,debit,posted,0c0d8d77bdee4af28b0bca30c0f3cccb,INTER BANK,<20,2018,10,23,3,0,Tuesday,14 days,107733.139
ACC-37709441,18,12.28,20138.53,1.0,CUS-3336454548,2018-10-25,Charles,M,-28.01,153.41,,7c091d9b-2e6f-48b1-b682-05f0d46f4875,-28.04,153.42,QLD,Broadbeach Waters,debit,authorized,1c8a039ac5674d90a747213c5fd27476,POS,<20,2018,10,25,16,49,Thursday,14 days,107733.139
ACC-37709441,18,8.58,20129.95,1.0,CUS-3336454548,2018-10-25,Charles,M,-28.01,153.41,,36667e0b-9c3b-463e-8030-8fee972c3aea,-27.96,153.38,QLD,Southport,debit,authorized,34fa7901dc5f459eac3488e454f14a12,POS,<20,2018,10,25,23,26,Thursday,14 days,107733.139
ACC-37709441,18,50.08,20079.87,0.0,CUS-3336454548,2018-10-26,Charles,M,-28.01,153.41,,4ffa903b-455f-4193-9d80-d54b92d6bc18,-28,153.43,QLD,Surfers Paradise,debit,authorized,69f4e271ac224acf923abfad600669b3,SALES-POS,<20,2018,10,26,8,42,Friday,14 days,107733.139
ACC-37709441,18,27.0,20052.87,,CUS-3336454548,2018-10-26,Charles,M,-28.01,153.41,,,,,,,debit,posted,3a8a14485f0a40de8fe17764b9d0ec20,PAYMENT,<20,2018,10,26,20,0,Friday,14 days,107733.139
ACC-37709441,18,6.11,20046.76,1.0,CUS-3336454548,2018-10-27,Charles,M,-28.01,153.41,,c385274f-a366-46c8-819b-b78addc3a289,-28.04,151.98,QLD,Allora,debit,authorized,720b5c6f6eaa476eafdab41f142f4e69,SALES-POS,<20,2018,10,27,10,26,Saturday,14 days,107733.139
ACC-37709441,18,45.0,20001.76,,CUS-3336454548,2018-10-27,Charles,M,-28.01,153.41,,,,,,,debit,posted,b5117d476a244512b1a632fdfa12f5a8,INTER BANK,<20,2018,10,27,14,0,Saturday,14 days,107733.139
ACC-37709441,18,21.0,19980.76,,CUS-3336454548,2018-10-27,Charles,M,-28.01,153.41,,,,,,,debit,posted,ad5c53695ba44db1bd93e8a0294be0bb,PHONE BANK,<20,2018,10,27,16,0,Saturday,14 days,107733.139
ACC-37709441,18,40.0,19940.76,,CUS-3336454548,2018-10-28,Charles,M,-28.01,153.41,,,,,,,debit,posted,3ca8a9abaa3d416ea3fbdea1ff944e25,INTER BANK,<20,2018,10,28,14,0,Sunday,14 days,107733.139
ACC-37709441,18,27.0,19913.76,,CUS-3336454548,2018-10-28,Charles,M,-28.01,153.41,,,,,,,debit,posted,882b2600c47c4c08bfefb442ddf92e22,INTER BANK,<20,2018,10,28,19,0,Sunday,14 days,107733.139
ACC-37709441,18,55.0,19858.76,,CUS-3336454548,2018-10-29,Charles,M,-28.01,153.41,,,,,,,debit,posted,9686310465ed44938c76b85bf1a9e5cb,PAYMENT,<20,2018,10,29,19,0,Monday,14 days,107733.139
ACC-1523339231,40,47.0,54980.99,,CUS-1816693151,2018-08-02,Tim,M,-31.90,115.83,,,,,,,debit,posted,f4c6f64c5abb4073a6827e22706e2521,PAYMENT,30-40,2018,8,2,3,0,Thursday,0 days,116340.40333333334
ACC-1523339231,40,131.0,54849.99,,CUS-1816693151,2018-08-03,Tim,M,-31.90,115.83,,,,,,,debit,posted,77cd8c2610704fc9afc4f58d94b7f9e3,PAYMENT,30-40,2018,8,3,7,0,Friday,0 days,116340.40333333334
ACC-1523339231,40,40.0,54809.99,,CUS-1816693151,2018-08-03,Tim,M,-31.90,115.83,,,,,,,debit,posted,d6c0f9cdf2aa4d5f8cd0a0ceab96c491,PAYMENT,30-40,2018,8,3,14,0,Friday,0 days,116340.40333333334
ACC-1523339231,40,111.51,54698.48,1.0,CUS-1816693151,2018-08-03,Tim,M,-31.90,115.83,,9a15c5c4-022f-4b3f-a586-a4c628060cb7,-31.78,115.97,WA,Ellenbrook,debit,authorized,b2d35cf0d8224134ae38418c058a04ae,POS,30-40,2018,8,3,18,14,Friday,0 days,116340.40333333334
ACC-1523339231,40,39.66,54658.82,1.0,CUS-1816693151,2018-08-03,Tim,M,-31.90,115.83,,46f01e38-8326-4739-bbd0-cd611306eede,-31.95,115.84,WA,West Perth,debit,authorized,dfec26762aa146c291e015a2a69e271b,POS,30-40,2018,8,3,21,2,Friday,0 days,116340.40333333334
ACC-1523339231,40,39.0,54619.82,,CUS-1816693151,2018-08-05,Tim,M,-31.90,115.83,,,,,,,debit,posted,f4f5ff363bec4546b94bf17a9bf782e3,INTER BANK,30-40,2018,8,5,6,0,Sunday,0 days,116340.40333333334
ACC-1523339231,40,18.11,54601.71,1.0,CUS-1816693151,2018-08-05,Tim,M,-31.90,115.83,,132bb88f-e830-4f91-aec0-fcb44bbf95c9,-31.74,115.77,WA,Joondalup,debit,authorized,a6278292ea114c31ac7a397822ebb064,POS,30-40,2018,8,5,16,44,Sunday,0 days,116340.40333333334
ACC-1523339231,40,183.0,54418.71,,CUS-1816693151,2018-08-06,Tim,M,-31.90,115.83,,,,,,,debit,posted,3738a36293574938872a3a6e19d16b5e,PAYMENT,30-40,2018,8,6,2,0,Monday,0 days,116340.40333333334
ACC-1523339231,40,47.0,54371.71,,CUS-1816693151,2018-08-09,Tim,M,-31.90,115.83,,,,,,,debit,posted,c3301bd32b1a47698c138f8003e4db87,PAYMENT,30-40,2018,8,9,3,0,Thursday,0 days,116340.40333333334
ACC-1523339231,40,88.0,54283.71,,CUS-1816693151,2018-08-09,Tim,M,-31.90,115.83,,,,,,,debit,posted,df83d3498a3f4fdb91dce6fe785a5026,INTER BANK,30-40,2018,8,9,21,0,Thursday,0 days,116340.40333333334
ACC-1523339231,40,37.34,54246.37,1.0,CUS-1816693151,2018-08-10,Tim,M,-31.90,115.83,,09b806c9-d6e2-4029-b3dd-ff919952fae5,-32.15,116.02,WA,Armadale,debit,authorized,06026b679cf34f349f2664097cf486c5,POS,30-40,2018,8,10,9,15,Friday,0 days,116340.40333333334
ACC-1523339231,40,40.0,54206.37,,CUS-1816693151,2018-08-10,Tim,M,-31.90,115.83,,,,,,,debit,posted,7b230d4a47d044c3978ac4123d7f0b50,PAYMENT,30-40,2018,8,10,14,0,Friday,0 days,116340.40333333334
ACC-1523339231,40,78.82,54127.55,0.0,CUS-1816693151,2018-08-11,Tim,M,-31.90,115.83,,58cd3120-ac03-4968-9c6d-0f3523469769,-31.97,152.58,NSW,Old Bar,debit,authorized,d0690dd320644c2b8dd37a11f4f2c5e0,POS,30-40,2018,8,11,15,53,Saturday,0 days,116340.40333333334
ACC-1523339231,40,39.0,54088.55,,CUS-1816693151,2018-08-12,Tim,M,-31.90,115.83,,,,,,,debit,posted,6c41cc8c9daa43fc8c6c9cd6ddef3111,INTER BANK,30-40,2018,8,12,6,0,Sunday,0 days,116340.40333333334
ACC-1523339231,40,50.36,54038.19,0.0,CUS-1816693151,2018-08-12,Tim,M,-31.90,115.83,,f725b6d4-5c60-4a59-be30-dcc1f3903f0e,-32.33,115.75,WA,Warnbro,debit,authorized,5b314b1b240c49a9979fdad697df358e,SALES-POS,30-40,2018,8,12,10,6,Sunday,0 days,116340.40333333334
ACC-1523339231,40,81.77,53956.42,1.0,CUS-1816693151,2018-08-14,Tim,M,-31.90,115.83,,d4911018-03cd-4457-9d9d-f2877fe6d955,-33.87,151.21,NSW,Sydney,debit,authorized,1d50f18932424d439be0e69c712351c8,SALES-POS,30-40,2018,8,14,19,1,Tuesday,0 days,116340.40333333334
ACC-1523339231,40,19.18,53937.24,1.0,CUS-1816693151,2018-08-15,Tim,M,-31.90,115.83,,34063d0b-561b-4506-9086-90f1f7b5d9b7,-32.13,115.87,WA,Jandakot,debit,authorized,6c0a93c6c1b64236a0740558d5f17188,SALES-POS,30-40,2018,8,15,14,8,Wednesday,0 days,116340.40333333334
ACC-1523339231,40,40.0,53850.24,,CUS-1816693151,2018-08-17,Tim,M,-31.90,115.83,,,,,,,debit,posted,d6d58578ead54a47a81c4ada2077ed4e,PAYMENT,30-40,2018,8,17,14,0,Friday,0 days,116340.40333333334
ACC-1523339231,40,39.0,53811.24,,CUS-1816693151,2018-08-19,Tim,M,-31.90,115.83,,,,,,,debit,posted,77117d8b61bf4fe8af4fd0675ef858f0,INTER BANK,30-40,2018,8,19,6,0,Sunday,0 days,116340.40333333334
ACC-1523339231,40,47.0,62600.22,,CUS-1816693151,2018-08-23,Tim,M,-31.90,115.83,,,,,,,debit,posted,dc239454f7274211a48e2bb4319108ed,PAYMENT,30-40,2018,8,23,3,0,Thursday,0 days,116340.40333333334
ACC-1523339231,40,40.0,62560.22,,CUS-1816693151,2018-08-24,Tim,M,-31.90,115.83,,,,,,,debit,posted,835d1acd3c74493cae7added60b77f5f,PAYMENT,30-40,2018,8,24,14,0,Friday,0 days,116340.40333333334
ACC-1523339231,40,156.0,62404.22,,CUS-1816693151,2018-08-25,Tim,M,-31.90,115.83,,,,,,,debit,posted,9aa84604782d46bdb163a21afb6c58c8,PAYMENT,30-40,2018,8,25,2,0,Saturday,0 days,116340.40333333334
ACC-1523339231,40,39.0,62365.22,,CUS-1816693151,2018-08-26,Tim,M,-31.90,115.83,,,,,,,debit,posted,f3ced20fc92a4ebcb4ac46f3b048d496,INTER BANK,30-40,2018,8,26,6,0,Sunday,0 days,116340.40333333334
ACC-1523339231,40,76.0,62289.22,,CUS-1816693151,2018-08-27,Tim,M,-31.90,115.83,,,,,,,debit,posted,1ff16b7112104f9999144e78f891b0cc,PAYMENT,30-40,2018,8,27,17,0,Monday,0 days,116340.40333333334
ACC-1523339231,40,47.0,62242.22,,CUS-1816693151,2018-08-30,Tim,M,-31.90,115.83,,,,,,,debit,posted,3dfd2b61ad7b4905980c5987a095ca49,PAYMENT,30-40,2018,8,30,3,0,Thursday,0 days,116340.40333333334
ACC-1523339231,40,40.0,62202.22,,CUS-1816693151,2018-08-31,Tim,M,-31.90,115.83,,,,,,,debit,posted,9b8bd5b1999e4e4f88b9883d469a332b,PAYMENT,30-40,2018,8,31,14,0,Friday,0 days,116340.40333333334
ACC-1523339231,40,39.0,62163.22,,CUS-1816693151,2018-09-02,Tim,M,-31.90,115.83,,,,,,,debit,posted,0865216cc6114b4390f6402e6fe00402,INTER BANK,30-40,2018,9,2,6,0,Sunday,0 days,116340.40333333334
ACC-1523339231,40,131.0,62032.22,,CUS-1816693151,2018-09-03,Tim,M,-31.90,115.83,,,,,,,debit,posted,9d93a6df4b5b4b70a761a6ce29abb263,PAYMENT,30-40,2018,9,3,7,0,Monday,0 days,116340.40333333334
ACC-1523339231,40,183.0,61849.22,,CUS-1816693151,2018-09-06,Tim,M,-31.90,115.83,,,,,,,debit,posted,3edf167130b74aa48851dce30cfe294f,PAYMENT,30-40,2018,9,6,2,0,Thursday,0 days,116340.40333333334
ACC-1523339231,40,47.0,61802.22,,CUS-1816693151,2018-09-06,Tim,M,-31.90,115.83,,,,,,,debit,posted,83b112eba5d041608834bb794787df55,PAYMENT,30-40,2018,9,6,3,0,Thursday,0 days,116340.40333333334
ACC-1523339231,40,40.0,61762.22,,CUS-1816693151,2018-09-07,Tim,M,-31.90,115.83,,,,,,,debit,posted,67fb3e4066094b028191130bf4493a0b,PAYMENT,30-40,2018,9,7,14,0,Friday,0 days,116340.40333333334
ACC-1523339231,40,39.0,61723.22,,CUS-1816693151,2018-09-09,Tim,M,-31.90,115.83,,,,,,,debit,posted,c1d4052e51df4cbb8f9537c7f564336e,INTER BANK,30-40,2018,9,9,6,0,Sunday,0 days,116340.40333333334
ACC-1523339231,40,88.0,61635.22,,CUS-1816693151,2018-09-09,Tim,M,-31.90,115.83,,,,,,,debit,posted,36d94b3b5fd34b2fa91c282fb00e79c1,INTER BANK,30-40,2018,9,9,21,0,Sunday,0 days,116340.40333333334
ACC-1523339231,40,47.0,61588.22,,CUS-1816693151,2018-09-13,Tim,M,-31.90,115.83,,,,,,,debit,posted,049678dec92c4184a3d2547c4769acf1,PAYMENT,30-40,2018,9,13,3,0,Thursday,0 days,116340.40333333334
ACC-1523339231,40,9.6,61578.62,1.0,CUS-1816693151,2018-09-14,Tim,M,-31.90,115.83,,68ad62a0-9970-4b22-8d51-6257b882f2ec,-31.84,115.84,WA,Girrawheen,debit,authorized,e0fdc85cfe9d47fc80e454b2d42bfda4,SALES-POS,30-40,2018,9,14,8,49,Friday,0 days,116340.40333333334
ACC-1523339231,40,40.0,61538.62,,CUS-1816693151,2018-09-14,Tim,M,-31.90,115.83,,,,,,,debit,posted,b4287875e3e2489a9fcdb5412fb2d565,PAYMENT,30-40,2018,9,14,14,0,Friday,0 days,116340.40333333334
ACC-1523339231,40,45.82,61492.8,1.0,CUS-1816693151,2018-09-15,Tim,M,-31.90,115.83,,cebbf265-3b20-46f6-9ca5-6ce7fa174435,-31.95,115.85,WA,Perth,debit,authorized,443fb4adfc224d1892cc3f38e161c717,SALES-POS,30-40,2018,9,15,20,29,Saturday,0 days,116340.40333333334
ACC-1523339231,40,39.0,61453.8,,CUS-1816693151,2018-09-16,Tim,M,-31.90,115.83,,,,,,,debit,posted,a16fa090f83c433c8e8978521090fc05,INTER BANK,30-40,2018,9,16,6,0,Sunday,0 days,116340.40333333334
ACC-1523339231,40,47.0,61406.8,,CUS-1816693151,2018-09-20,Tim,M,-31.90,115.83,,,,,,,debit,posted,f60e33b562064e4e852d707b88fac1bd,PAYMENT,30-40,2018,9,20,3,0,Thursday,0 days,116340.40333333334
ACC-1523339231,40,40.0,70202.78,,CUS-1816693151,2018-09-21,Tim,M,-31.90,115.83,,,,,,,debit,posted,410d0f5af4484842b56080cdf5e2054b,PAYMENT,30-40,2018,9,21,14,0,Friday,0 days,116340.40333333334
ACC-1523339231,40,39.0,70163.78,,CUS-1816693151,2018-09-23,Tim,M,-31.90,115.83,,,,,,,debit,posted,ab0d2e1d1da14b5b87e65e9f8300943a,INTER BANK,30-40,2018,9,23,6,0,Sunday,0 days,116340.40333333334
ACC-1523339231,40,156.0,70007.78,,CUS-1816693151,2018-09-25,Tim,M,-31.90,115.83,,,,,,,debit,posted,e487074e99d04375ab9a6e8db4c73fe2,PAYMENT,30-40,2018,9,25,2,0,Tuesday,0 days,116340.40333333334
ACC-1523339231,40,47.0,69960.78,,CUS-1816693151,2018-09-27,Tim,M,-31.90,115.83,,,,,,,debit,posted,9e3988bf79fe4331b0a519a7c26dc989,PAYMENT,30-40,2018,9,27,3,0,Thursday,0 days,116340.40333333334
ACC-1523339231,40,76.0,69884.78,,CUS-1816693151,2018-09-27,Tim,M,-31.90,115.83,,,,,,,debit,posted,6256b5f499b34a01bc74ce57a2d56b4e,PAYMENT,30-40,2018,9,27,17,0,Thursday,0 days,116340.40333333334
ACC-1523339231,40,40.0,69844.78,,CUS-1816693151,2018-09-28,Tim,M,-31.90,115.83,,,,,,,debit,posted,e9952bce82c34e5bb5c38253d8113aad,PAYMENT,30-40,2018,9,28,14,0,Friday,0 days,116340.40333333334
ACC-1523339231,40,200.01,69644.77,1.0,CUS-1816693151,2018-09-29,Tim,M,-31.90,115.83,,7c0ed0d1-0976-4859-9793-49e2083165a5,-31.95,141.47,NSW,Broken Hill,debit,authorized,062e055d96dc4106bab7a682407d54da,SALES-POS,30-40,2018,9,29,1,4,Saturday,0 days,116340.40333333334
ACC-1523339231,40,42.76,69602.01,0.0,CUS-1816693151,2018-09-29,Tim,M,-31.90,115.83,,b4f2b65f-632d-4d1c-87c7-3f23526b0d15,-31.97,116.05,WA,Kalamunda,debit,authorized,a0eed5615f294eba96435402ce8d3c57,SALES-POS,30-40,2018,9,29,3,59,Saturday,0 days,116340.40333333334
ACC-1523339231,40,39.0,69563.01,,CUS-1816693151,2018-09-30,Tim,M,-31.90,115.83,,,,,,,debit,posted,e33ea66956e544cfa880b3a63f3f7bfd,INTER BANK,30-40,2018,9,30,6,0,Sunday,0 days,116340.40333333334
ACC-1523339231,40,33.52,69529.49,1.0,CUS-1816693151,2018-09-30,Tim,M,-31.90,115.83,,d0adbe7b-aa59-45b0-bdb5-73e49ef5ea2c,-31.8,115.75,WA,Whitfords,debit,authorized,90a1bc76520f448782cc7998b1aed836,SALES-POS,30-40,2018,9,30,22,18,Sunday,0 days,116340.40333333334
ACC-1523339231,40,65.81,69463.68,1.0,CUS-1816693151,2018-10-01,Tim,M,-31.90,115.83,,2fc9454b-d17d-4564-bee1-343a42d4a807,-31.67,115.74,WA,Neerabup,debit,authorized,07506bcf2fd94f5da8ee0855a9e0ff91,POS,30-40,2018,10,1,10,0,Monday,0 days,116340.40333333334
ACC-1523339231,40,35.96,69427.72,1.0,CUS-1816693151,2018-10-01,Tim,M,-31.90,115.83,,0354f2a7-56b2-4339-8cd3-0c9ac54eb387,-32.04,115.77,WA,East Fremantle,debit,authorized,02605724ab7a4ef7a85d0c4d5e7c1691,POS,30-40,2018,10,1,13,0,Monday,0 days,116340.40333333334
ACC-1523339231,40,20.35,69407.37,0.0,CUS-1816693151,2018-10-02,Tim,M,-31.90,115.83,,ae16f982-0f9d-4165-84cd-493d8afc0a81,-31.89,116.01,WA,Midland,debit,authorized,5cb5fc2c2e524b468c1d2131da59b062,POS,30-40,2018,10,2,4,39,Tuesday,0 days,116340.40333333334
ACC-1523339231,40,261.26,69146.11,1.0,CUS-1816693151,2018-10-02,Tim,M,-31.90,115.83,,acb77539-e479-4f85-b231-0330e17f620f,-27.47,153.02,QLD,Petrie Terrace,debit,authorized,8bafda0add5f4585928402224227c220,SALES-POS,30-40,2018,10,2,9,9,Tuesday,0 days,116340.40333333334
ACC-1523339231,40,131.0,69015.11,,CUS-1816693151,2018-10-03,Tim,M,-31.90,115.83,,,,,,,debit,posted,759a1f105b7d4182861ec421831a10ca,PAYMENT,30-40,2018,10,3,7,0,Wednesday,0 days,116340.40333333334
ACC-1523339231,40,47.0,68968.11,,CUS-1816693151,2018-10-04,Tim,M,-31.90,115.83,,,,,,,debit,posted,c4edb367fb4844988c94e250168f2134,PAYMENT,30-40,2018,10,4,3,0,Thursday,0 days,116340.40333333334
ACC-1523339231,40,12.24,68955.87,0.0,CUS-1816693151,2018-10-04,Tim,M,-31.90,115.83,,1fb3599d-bbef-412a-91a0-3104271e99f5,-31.74,115.77,WA,Joondalup,debit,authorized,2ec2326889a54e21b64de76db426b371,POS,30-40,2018,10,4,7,46,Thursday,0 days,116340.40333333334
ACC-1523339231,40,40.0,68915.87,,CUS-1816693151,2018-10-05,Tim,M,-31.90,115.83,,,,,,,debit,posted,04932cd535174f7781b4522e7e9d6c6f,PAYMENT,30-40,2018,10,5,14,0,Friday,0 days,116340.40333333334
ACC-1523339231,40,183.0,68732.87,,CUS-1816693151,2018-10-06,Tim,M,-31.90,115.83,,,,,,,debit,posted,d003e7dcbf6847c7bf513c9cab19ebeb,PAYMENT,30-40,2018,10,6,2,0,Saturday,0 days,116340.40333333334
ACC-1523339231,40,68.42,68664.45,1.0,CUS-1816693151,2018-10-06,Tim,M,-31.90,115.83,,74986e8f-58e8-4dc2-8d45-d79f5b63ba27,-31.95,115.87,WA,East Perth,debit,authorized,fb7cee7e78b04fdb9d550b8cc5e1827c,POS,30-40,2018,10,6,11,23,Saturday,0 days,116340.40333333334
ACC-1523339231,40,39.0,68625.45,,CUS-1816693151,2018-10-07,Tim,M,-31.90,115.83,,,,,,,debit,posted,38d344a0472f43798d236cf239954868,INTER BANK,30-40,2018,10,7,6,0,Sunday,0 days,116340.40333333334
ACC-1523339231,40,88.0,68537.45,,CUS-1816693151,2018-10-09,Tim,M,-31.90,115.83,,,,,,,debit,posted,059b2107f4034b7584f0a0704ce2fac8,INTER BANK,30-40,2018,10,9,21,0,Tuesday,0 days,116340.40333333334
ACC-1523339231,40,53.26,68484.19,1.0,CUS-1816693151,2018-10-10,Tim,M,-31.90,115.83,,0bee35e7-b6d4-44ea-a9d7-c025acdc3d0e,-31.82,115.76,WA,Sorrento,debit,authorized,904c0fb500e44792860f8ca9e2fe7206,SALES-POS,30-40,2018,10,10,2,29,Wednesday,0 days,116340.40333333334
ACC-1523339231,40,92.86,68391.33,1.0,CUS-1816693151,2018-10-10,Tim,M,-31.90,115.83,,1f67fe13-88de-4730-a94c-3ccd989930a2,-37.81,144.97,VIC,Melbourne,debit,authorized,aa3d56ebacd04a38b2106bb0f018f773,POS,30-40,2018,10,10,9,59,Wednesday,0 days,116340.40333333334
ACC-1523339231,40,47.0,68344.33,,CUS-1816693151,2018-10-11,Tim,M,-31.90,115.83,,,,,,,debit,posted,42bef8def1614cb591a68ea27922d8e9,PAYMENT,30-40,2018,10,11,3,0,Thursday,0 days,116340.40333333334
ACC-1523339231,40,40.0,68304.33,,CUS-1816693151,2018-10-12,Tim,M,-31.90,115.83,,,,,,,debit,posted,a204851273da4078a30bdd1c707c8d4d,PAYMENT,30-40,2018,10,12,14,0,Friday,0 days,116340.40333333334
ACC-1523339231,40,39.0,68265.33,,CUS-1816693151,2018-10-14,Tim,M,-31.90,115.83,,,,,,,debit,posted,4846a0dd40714e85aa4be946954e477c,INTER BANK,30-40,2018,10,14,6,0,Sunday,0 days,116340.40333333334
ACC-1523339231,40,47.0,68218.33,,CUS-1816693151,2018-10-18,Tim,M,-31.90,115.83,,,,,,,debit,posted,18e5a8ae3dd542f2b592c2265e909ac4,PAYMENT,30-40,2018,10,18,3,0,Thursday,0 days,116340.40333333334
ACC-1523339231,40,40.0,85850.29,,CUS-1816693151,2018-10-19,Tim,M,-31.90,115.83,,,,,,,debit,posted,f30989c717e94a7b9731397cc9c5436e,PAYMENT,30-40,2018,10,19,14,0,Friday,0 days,116340.40333333334
ACC-1523339231,40,39.0,85811.29,,CUS-1816693151,2018-10-21,Tim,M,-31.90,115.83,,,,,,,debit,posted,bd1ea3210fd14f4db389d805fbda4453,INTER BANK,30-40,2018,10,21,6,0,Sunday,0 days,116340.40333333334
ACC-1523339231,40,156.0,85655.29,,CUS-1816693151,2018-10-25,Tim,M,-31.90,115.83,,,,,,,debit,posted,deefbfc3881c4fc9a279d8e3213fd151,PAYMENT,30-40,2018,10,25,2,0,Thursday,0 days,116340.40333333334
ACC-1523339231,40,47.0,85608.29,,CUS-1816693151,2018-10-25,Tim,M,-31.90,115.83,,,,,,,debit,posted,9dfddb92316e4d1c9543e2324016bce0,PAYMENT,30-40,2018,10,25,3,0,Thursday,0 days,116340.40333333334
ACC-1523339231,40,40.0,85568.29,,CUS-1816693151,2018-10-26,Tim,M,-31.90,115.83,,,,,,,debit,posted,5fb9911206a74d8bbc0f5c7c27b17183,PAYMENT,30-40,2018,10,26,14,0,Friday,0 days,116340.40333333334
ACC-1523339231,40,76.0,85492.29,,CUS-1816693151,2018-10-27,Tim,M,-31.90,115.83,,,,,,,debit,posted,e995732a754a4fc8b6c728310b437906,PAYMENT,30-40,2018,10,27,17,0,Saturday,0 days,116340.40333333334
ACC-1523339231,40,39.0,85453.29,,CUS-1816693151,2018-10-28,Tim,M,-31.90,115.83,,,,,,,debit,posted,66b617118c3a47838de472ffb72b9bf4,INTER BANK,30-40,2018,10,28,6,0,Sunday,0 days,116340.40333333334
ACC-3021093232,30,36.07,128.76,1.0,CUS-55310383,2018-08-02,Melissa,F,-29.47,149.83,,fe257a32-9aaf-4689-a309-23d952424071,-37.82,144.96,VIC,Melbourne,debit,authorized,a809195edcaf46568fc7f9cf06933c40,SALES-POS,20-30,2018,8,2,3,57,Thursday,7 days,85343.257
ACC-3021093232,30,22.87,105.89,1.0,CUS-55310383,2018-08-02,Melissa,F,-29.47,149.83,,59ba0b94-0a95-4a8c-b11c-7ee934e3ea4d,-31.95,115.84,WA,West Perth,debit,authorized,b4b58e755d284654aae8a45c0bb6f480,SALES-POS,20-30,2018,8,2,19,42,Thursday,7 days,85343.257
ACC-3021093232,30,12.83,93.06,1.0,CUS-55310383,2018-08-03,Melissa,F,-29.47,149.83,,83e9c28d-62ce-4459-859c-eb9955700f6b,-30.32,149.78,NSW,Narrabri,debit,authorized,9ee6122df1ba424db508181c8932e200,SALES-POS,20-30,2018,8,3,11,51,Friday,7 days,85343.257
ACC-3021093232,30,8.26,84.8,1.0,CUS-55310383,2018-08-04,Melissa,F,-29.47,149.83,,7a47b653-e78d-49a1-bde2-7612784ff994,-29.46,153.2,NSW,Maclean,debit,authorized,187fc99fb4564111957f6c797b16389b,POS,20-30,2018,8,4,23,42,Saturday,7 days,85343.257
ACC-3021093232,30,5.04,79.76,0.0,CUS-55310383,2018-08-06,Melissa,F,-29.47,149.83,,d2849fda-17f4-4201-8b71-0387f97c9380,-23.72,149.67,QLD,Duaringa,debit,authorized,43139d7f2987452991c0cf7df3a8fb62,SALES-POS,20-30,2018,8,6,1,29,Monday,7 days,85343.257
ACC-3021093232,30,35.41,44.35,1.0,CUS-55310383,2018-08-06,Melissa,F,-29.47,149.83,,3279b53b-e267-4afd-92a6-eec26e5c423d,-29.46,149.84,NSW,Moree,debit,authorized,dbbe626603844d25865928c5be8e3e99,SALES-POS,20-30,2018,8,6,9,41,Monday,7 days,85343.257
ACC-3021093232,30,23.27,3294.52,0.0,CUS-55310383,2018-08-15,Melissa,F,-29.47,149.83,,0c1ffe7f-8a0e-4d5f-b91d-78577b9b40a2,-36.67,149.84,NSW,Bega,debit,authorized,6fb34694154a4855bab0eacec13c6b8d,SALES-POS,20-30,2018,8,15,17,31,Wednesday,7 days,85343.257
ACC-3021093232,30,26.21,2970.06,1.0,CUS-55310383,2018-08-17,Melissa,F,-29.47,149.83,,5de37acb-2c49-4023-9a6c-c460d60d3574,-29.43,153.33,NSW,Yamba,debit,authorized,c21034a805c94850a791315ef151c823,SALES-POS,20-30,2018,8,17,18,0,Friday,7 days,85343.257
ACC-3021093232,30,46.5,2923.56,1.0,CUS-55310383,2018-08-18,Melissa,F,-29.47,149.83,,c517e9ce-fba4-4269-ac69-739d51ef969b,-30.52,151.67,NSW,Armidale,debit,authorized,620d0fbef29646d5aeba0de92b37b59b,POS,20-30,2018,8,18,21,59,Saturday,7 days,85343.257
ACC-3021093232,30,23.09,2900.47,1.0,CUS-55310383,2018-08-20,Melissa,F,-29.47,149.83,,e533a428-ea67-4c2d-9648-81749350fcd5,-36.67,149.84,NSW,Bega,debit,authorized,0aced8df3abe4cdba89cc0af0ffdd094,POS,20-30,2018,8,20,10,59,Monday,7 days,85343.257
ACC-3021093232,30,71.4,4465.79,0.0,CUS-55310383,2018-08-22,Melissa,F,-29.47,149.83,,22c89deb-d382-45dd-b5bb-2c95d52f2fe5,-34.74,149.73,NSW,Goulburn,debit,authorized,beeb04e8b63342e5a062574c14d5f47f,SALES-POS,20-30,2018,8,22,10,23,Wednesday,7 days,85343.257
ACC-3021093232,30,155.0,4310.79,,CUS-55310383,2018-08-22,Melissa,F,-29.47,149.83,,,,,,,debit,posted,23afaae33b6e4bb2bb10b7f50bb52ba1,INTER BANK,20-30,2018,8,22,18,0,Wednesday,7 days,85343.257
ACC-3021093232,30,423.09,3887.7,1.0,CUS-55310383,2018-08-22,Melissa,F,-29.47,149.83,,7dee69cf-5736-4247-bccb-f9a0892ae760,-37.72,144.85,VIC,Keilor Park,debit,authorized,d12c016b28d94f7e879a92a5ee560a5b,SALES-POS,20-30,2018,8,22,19,13,Wednesday,7 days,85343.257
ACC-3021093232,30,47.16,3840.54,0.0,CUS-55310383,2018-08-23,Melissa,F,-29.47,149.83,,7b7d9bd7-6683-44df-aa06-6b586edf869d,-33.87,151.21,NSW,Sydney,debit,authorized,b412ff32668e43de90a6463f3b353892,SALES-POS,20-30,2018,8,23,16,0,Thursday,7 days,85343.257
ACC-3021093232,30,24.23,3816.31,0.0,CUS-55310383,2018-08-23,Melissa,F,-29.47,149.83,,15000b67-8368-4c71-a382-0478cd55cffb,-32.86,149.97,NSW,Kandos,debit,authorized,4e4f9078a620423b8c87f9f1a5981c54,POS,20-30,2018,8,23,17,58,Thursday,7 days,85343.257
ACC-3021093232,30,23.89,3792.42,1.0,CUS-55310383,2018-08-23,Melissa,F,-29.47,149.83,,0feb215c-4518-4180-8395-451ed6533a69,-34.75,149.72,NSW,Goulburn,debit,authorized,3a72f781202e4ab286d7032171bc31c6,POS,20-30,2018,8,23,23,58,Thursday,7 days,85343.257
ACC-3021093232,30,23.33,3769.09,1.0,CUS-55310383,2018-08-24,Melissa,F,-29.47,149.83,,106e1272-44ab-4dcb-a438-dd98e0071e51,-37.06,149.9,NSW,Eden,debit,authorized,b8ca1f423d194cd4b45b6691fbb8ec44,SALES-POS,20-30,2018,8,24,18,41,Friday,7 days,85343.257
ACC-3021093232,30,131.0,3638.09,,CUS-55310383,2018-08-26,Melissa,F,-29.47,149.83,,,,,,,debit,posted,c4d7cc7ea716448ca5acd9a3c0127248,PAYMENT,20-30,2018,8,26,21,0,Sunday,7 days,85343.257
ACC-3021093232,30,86.54,3551.55,1.0,CUS-55310383,2018-08-27,Melissa,F,-29.47,149.83,,d076eb9a-abe5-4936-8182-d626bf62d504,-33.87,151.21,NSW,Sydney,debit,authorized,cdd9f7737cda40b9904e226bfc4605d1,POS,20-30,2018,8,27,9,6,Monday,7 days,85343.257
ACC-3021093232,30,15.61,5172.66,1.0,CUS-55310383,2018-08-27,Melissa,F,-29.47,149.83,,36849d50-8b9e-4074-b907-e4ab21901ee2,-33.84,151,NSW,Merrylands,debit,authorized,8eb0413c8d96415daba0053d9ea19aa1,SALES-POS,20-30,2018,8,27,15,16,Monday,7 days,85343.257
ACC-3021093232,30,1841.0,6605.1,,CUS-55310383,2018-09-14,Melissa,F,-29.47,149.83,,,,,,,debit,posted,6ea3318ddbb94a7eab05ebbf8328a762,PAYMENT,20-30,2018,9,14,4,0,Friday,7 days,85343.257
ACC-3021093232,30,193.0,6412.1,,CUS-55310383,2018-09-16,Melissa,F,-29.47,149.83,,,,,,,debit,posted,22a786f90a9d434198dae360c7c45ba0,PAYMENT,20-30,2018,9,16,12,0,Sunday,7 days,85343.257
ACC-3021093232,30,155.0,7893.82,,CUS-55310383,2018-09-22,Melissa,F,-29.47,149.83,,,,,,,debit,posted,a06978bdd5cb4fd8afa12a6b31a41d7a,INTER BANK,20-30,2018,9,22,18,0,Saturday,7 days,85343.257
ACC-3021093232,30,131.0,9399.54,,CUS-55310383,2018-09-26,Melissa,F,-29.47,149.83,,,,,,,debit,posted,79abfd2c08a349af8da4c8f25a2d9ba8,PAYMENT,20-30,2018,9,26,21,0,Wednesday,7 days,85343.257
ACC-3021093232,30,1852.0,7547.54,,CUS-55310383,2018-09-27,Melissa,F,-29.47,149.83,,,,,,,debit,posted,90ee11a61f70460490117b0a6bf845fd,PAYMENT,20-30,2018,9,27,4,0,Thursday,7 days,85343.257
ACC-3021093232,30,57.1,7490.44,1.0,CUS-55310383,2018-10-01,Melissa,F,-29.47,149.83,,ee91fac0-4244-4b5e-a395-d569f703bee9,-37.82,144.99,VIC,Richmond,debit,authorized,8c69a4d1a0b24dcab146de8a77f7b8df,POS,20-30,2018,10,1,9,8,Monday,7 days,85343.257
ACC-3021093232,30,23.77,9103.39,1.0,CUS-55310383,2018-10-03,Melissa,F,-29.47,149.83,,0c1ffe7f-8a0e-4d5f-b91d-78577b9b40a2,-36.67,149.84,NSW,Bega,debit,authorized,194d0d66b13f48d186b0e9d871728227,SALES-POS,20-30,2018,10,3,11,48,Wednesday,7 days,85343.257
ACC-3021093232,30,28.16,9075.23,1.0,CUS-55310383,2018-10-05,Melissa,F,-29.47,149.83,,79f70d82-40bc-4e16-a74d-f2545bb6f3dd,-30.35,149.76,NSW,Narrabri,debit,authorized,7d24bb0e00014aa890729630ea3e1614,POS,20-30,2018,10,5,21,1,Friday,7 days,85343.257
ACC-3021093232,30,24.13,9051.1,0.0,CUS-55310383,2018-10-06,Melissa,F,-29.47,149.83,,810744c3-c292-4d3c-b9ee-1ee0305c7950,-34.72,149.74,NSW,Goulburn,debit,authorized,c2863506a000418d8dc74f77cabdb498,SALES-POS,20-30,2018,10,6,11,31,Saturday,7 days,85343.257
ACC-3021093232,30,34.92,10652.9,1.0,CUS-55310383,2018-10-11,Melissa,F,-29.47,149.83,,0df261db-a2db-4152-b84a-db84131db852,-29.43,153.33,NSW,Yamba,debit,authorized,96ec226274734e1e9a4b253f319a83cb,POS,20-30,2018,10,11,17,24,Thursday,7 days,85343.257
ACC-3021093232,30,9.27,10643.63,0.0,CUS-55310383,2018-10-11,Melissa,F,-29.47,149.83,,ae5366f9-cc5a-4d42-afb4-24d070b3cb24,-29.43,153.33,NSW,Yamba,debit,authorized,1030ef4bd4c4400a80fb70c825a05db7,POS,20-30,2018,10,11,20,7,Thursday,7 days,85343.257
ACC-3021093232,30,741.51,9902.12,1.0,CUS-55310383,2018-10-12,Melissa,F,-29.47,149.83,,e155d0b7-5ba5-463b-b844-84759027eea6,-37.89,145.17,VIC,Glen Waverley,debit,authorized,1ce633669fc540f7906c528f47851d58,SALES-POS,20-30,2018,10,12,14,45,Friday,7 days,85343.257
ACC-3021093232,30,51.92,9850.2,1.0,CUS-55310383,2018-10-13,Melissa,F,-29.47,149.83,,4d4a87fc-a840-450f-ac8d-d96c7bc5ec31,-33.79,151.13,NSW,Macquarie Park,debit,authorized,f67f79b99d9142259d1bad49bc07abc0,POS,20-30,2018,10,13,14,37,Saturday,7 days,85343.257
ACC-3021093232,30,23.31,9826.89,1.0,CUS-55310383,2018-10-14,Melissa,F,-29.47,149.83,,0c1ffe7f-8a0e-4d5f-b91d-78577b9b40a2,-36.67,149.84,NSW,Bega,debit,authorized,55a957595ac842d4aecfd5e24902e8ba,POS,20-30,2018,10,14,10,29,Sunday,7 days,85343.257
ACC-3021093232,30,28.81,9798.08,1.0,CUS-55310383,2018-10-14,Melissa,F,-29.47,149.83,,79f70d82-40bc-4e16-a74d-f2545bb6f3dd,-30.35,149.76,NSW,Narrabri,debit,authorized,b442b9dc2bb24569b51e504bd18cf9b4,POS,20-30,2018,10,14,14,15,Sunday,7 days,85343.257
ACC-3021093232,30,193.0,11241.8,,CUS-55310383,2018-10-16,Melissa,F,-29.47,149.83,,,,,,,debit,posted,8f6d326a1cdc491bb06cc254d292f614,PAYMENT,20-30,2018,10,16,12,0,Tuesday,7 days,85343.257
ACC-3021093232,30,7.08,11234.72,0.0,CUS-55310383,2018-10-21,Melissa,F,-29.47,149.83,,b6d0f324-1572-4a02-87be-7f22f97f5d4c,-36.67,149.85,NSW,Bega,debit,authorized,41fe73d9c418427ba23b64a049fb1d6b,POS,20-30,2018,10,21,20,8,Sunday,7 days,85343.257
ACC-3021093232,30,68.19,11166.53,1.0,CUS-55310383,2018-10-21,Melissa,F,-29.47,149.83,,9c7a33fe-c1e9-48cd-b740-26325adc0457,-33.87,151.21,NSW,Sydney,debit,authorized,402cd21d2e2f4a11b7a559f87442d584,POS,20-30,2018,10,21,21,0,Sunday,7 days,85343.257
ACC-3021093232,30,35.94,11130.59,1.0,CUS-55310383,2018-10-22,Melissa,F,-29.47,149.83,,8f49e7a9-c5ca-4c7a-81dc-911ec5e52ba6,-37.71,145.15,VIC,Ringwood,debit,authorized,6ff0aa576c604940bf1f0ca700849c4b,SALES-POS,20-30,2018,10,22,9,36,Monday,7 days,85343.257
ACC-3021093232,30,27.73,11102.86,1.0,CUS-55310383,2018-10-22,Melissa,F,-29.47,149.83,,7ce5471b-363c-46ab-b398-ca517347829a,-33.87,151.21,NSW,Sydney,debit,authorized,529bdf3e174c48649b34ccd03b88e7ca,POS,20-30,2018,10,22,14,11,Monday,7 days,85343.257
ACC-3021093232,30,155.0,12584.58,,CUS-55310383,2018-10-22,Melissa,F,-29.47,149.83,,,,,,,debit,posted,67c1cbb7a55544e1be50cd8f791fc183,INTER BANK,20-30,2018,10,22,18,0,Monday,7 days,85343.257
ACC-3021093232,30,131.0,12453.58,,CUS-55310383,2018-10-26,Melissa,F,-29.47,149.83,,,,,,,debit,posted,7775247463054bacb76e3465c826eaf3,PAYMENT,20-30,2018,10,26,21,0,Friday,7 days,85343.257
ACC-3021093232,30,26.37,14063.93,1.0,CUS-55310383,2018-10-31,Melissa,F,-29.47,149.83,,0b368022-8ffe-4a59-b7e9-d7799cb496d5,-29.63,153.03,NSW,Ulmarra,debit,authorized,9b4309cfcae94b3496acf7708efb156c,SALES-POS,20-30,2018,10,31,20,47,Wednesday,7 days,85343.257
ACC-3021093232,30,9.79,14054.14,0.0,CUS-55310383,2018-10-31,Melissa,F,-29.47,149.83,,32aa73dc-b7c2-4161-b14d-6271b96ce792,-37.81,145.23,VIC,Ringwood,debit,authorized,f2e3e695c2ee4c50a4c8747f852cbe2e,POS,20-30,2018,10,31,23,9,Wednesday,7 days,85343.257
ACC-2270192619,20,39.0,6630.82,,CUS-2110742437,2018-08-02,Darren,M,-35.27,138.56,,,,,,,debit,posted,56530202274846da8195d47dc6068fd7,PAYMENT,<20,2018,8,2,4,0,Thursday,0 days,39854.84166666666
ACC-2270192619,20,11.57,6619.25,1.0,CUS-2110742437,2018-08-02,Darren,M,-35.27,138.56,,b36f8bb7-228a-4726-aa4f-519fcf8c54a3,-34.98,138.52,SA,Glenelg East,debit,authorized,a1a03bdd46a94c23b12f93a0c815b741,POS,<20,2018,8,2,23,27,Thursday,0 days,39854.84166666666
ACC-2270192619,20,8.51,6610.74,1.0,CUS-2110742437,2018-08-03,Darren,M,-35.27,138.56,,2b508339-198f-4998-b8d5-c0f4ebf33f89,-34.84,138.48,SA,Semaphore,debit,authorized,dad053818237459aad84ec349e0f57e8,SALES-POS,<20,2018,8,3,5,2,Friday,0 days,39854.84166666666
ACC-2270192619,20,39.0,9598.69,,CUS-2110742437,2018-08-07,Darren,M,-35.27,138.56,,,,,,,debit,posted,3a4e3c0034da4fb9baf289aea7506174,PAYMENT,<20,2018,8,7,7,0,Tuesday,0 days,39854.84166666666
ACC-2270192619,20,5.76,9592.93,1.0,CUS-2110742437,2018-08-08,Darren,M,-35.27,138.56,,f7563074-d4a6-4652-bc3c-10159d5033cb,-35.34,149.08,ACT,Lyons,debit,authorized,2307a3a3df4b4e66a8e21f0c7b41a2ec,SALES-POS,<20,2018,8,8,9,51,Wednesday,0 days,39854.84166666666
ACC-2270192619,20,18.04,9574.89,1.0,CUS-2110742437,2018-08-08,Darren,M,-35.27,138.56,,9e5d4631-0079-4e80-8d7d-b28ba8a28ba7,-35.3,149.07,ACT,Weston Creek,debit,authorized,67ba12fed7c640e9abe086e17f83bccc,POS,<20,2018,8,8,19,11,Wednesday,0 days,39854.84166666666
ACC-2270192619,20,13.68,9561.21,1.0,CUS-2110742437,2018-08-08,Darren,M,-35.27,138.56,,af80e38b-8bb8-4f42-b72d-8bde88500420,-34.92,117.23,WA,Denmark,debit,authorized,d4cfbbce31ef45a1910c391b72863b00,POS,<20,2018,8,8,22,3,Wednesday,0 days,39854.84166666666
ACC-2270192619,20,39.0,9522.21,,CUS-2110742437,2018-08-09,Darren,M,-35.27,138.56,,,,,,,debit,posted,fa5c4e7cc6624ffcad80536c4087c9cf,PAYMENT,<20,2018,8,9,4,0,Thursday,0 days,39854.84166666666
ACC-2270192619,20,24.98,9497.23,1.0,CUS-2110742437,2018-08-11,Darren,M,-35.27,138.56,,57e114dc-f1d4-4d64-af4d-c8184d3b73b0,-35.08,138.87,SA,Mount Barker,debit,authorized,4694fcf3c0b14940b74597a5e0d643b8,SALES-POS,<20,2018,8,11,14,21,Saturday,0 days,39854.84166666666
ACC-2270192619,20,21.65,9475.58,0.0,CUS-2110742437,2018-08-11,Darren,M,-35.27,138.56,,4f333982-d8b3-400b-abee-a60dab451977,-35.1,138.55,SA,Woodcroft,debit,authorized,9fa7d0d56545436689e0cd074bc54695,POS,<20,2018,8,11,22,19,Saturday,0 days,39854.84166666666
ACC-2270192619,20,5.27,9470.31,1.0,CUS-2110742437,2018-08-13,Darren,M,-35.27,138.56,,abfff73c-c3bc-4c4f-9186-97089567a434,-35.21,149.05,ACT,Melba,debit,authorized,3424bdb434b34853963ab5c2d14d94f5,SALES-POS,<20,2018,8,13,9,15,Monday,0 days,39854.84166666666
ACC-2270192619,20,39.0,9431.31,,CUS-2110742437,2018-08-14,Darren,M,-35.27,138.56,,,,,,,debit,posted,f0f23b3f52a349a4a0fa3b7bdcc3c381,PAYMENT,<20,2018,8,14,7,0,Tuesday,0 days,39854.84166666666
ACC-2270192619,20,22.12,9274.18,1.0,CUS-2110742437,2018-08-17,Darren,M,-35.27,138.56,,17d7f8e6-549e-467e-8c93-64cbe5d289d0,-35.21,149.07,ACT,Evatt,debit,authorized,b11a738f38e14df6bf8401a10430147f,SALES-POS,<20,2018,8,17,16,42,Friday,0 days,39854.84166666666
ACC-2270192619,20,39.0,9235.18,,CUS-2110742437,2018-08-21,Darren,M,-35.27,138.56,,,,,,,debit,posted,c7f35ea7b85f44338559126ed7a171c1,PAYMENT,<20,2018,8,21,7,0,Tuesday,0 days,39854.84166666666
ACC-2270192619,20,39.0,9196.18,,CUS-2110742437,2018-08-23,Darren,M,-35.27,138.56,,,,,,,debit,posted,6454d996faf444b283cf76e00b6d43f0,PAYMENT,<20,2018,8,23,4,0,Thursday,0 days,39854.84166666666
ACC-2270192619,20,18.98,9177.2,1.0,CUS-2110742437,2018-08-24,Darren,M,-35.27,138.56,,a5c3ad8c-2cea-4e6e-9007-9ac607f6a1cc,-34.76,138.65,SA,Salisbury,debit,authorized,d0ac541bd34b4a08b1ac4b8fd9393f3f,POS,<20,2018,8,24,7,31,Friday,0 days,39854.84166666666
ACC-2270192619,20,39.0,9138.2,,CUS-2110742437,2018-08-28,Darren,M,-35.27,138.56,,,,,,,debit,posted,04eed4d18e2245cb8d425ee50e39c181,PAYMENT,<20,2018,8,28,7,0,Tuesday,0 days,39854.84166666666
ACC-2270192619,20,39.0,9099.2,,CUS-2110742437,2018-08-30,Darren,M,-35.27,138.56,,,,,,,debit,posted,764efbc6f0c544bfa1627f67053417f4,PAYMENT,<20,2018,8,30,4,0,Thursday,0 days,39854.84166666666
ACC-2270192619,20,10.11,9089.09,1.0,CUS-2110742437,2018-08-30,Darren,M,-35.27,138.56,,1f7c911e-b78f-4a8f-9e68-77104639248c,-34.92,138.6,SA,Adelaide,debit,authorized,f66e84d1f97147d5a171ca17a37e3767,SALES-POS,<20,2018,8,30,10,21,Thursday,0 days,39854.84166666666
ACC-2270192619,20,22.92,9066.17,1.0,CUS-2110742437,2018-08-31,Darren,M,-35.27,138.56,,ce609109-2426-49c9-9455-223c71e06797,-35.33,149.17,ACT,Fyshwick,debit,authorized,d160d736588544e1b839d4a839d32345,SALES-POS,<20,2018,8,31,17,21,Friday,0 days,39854.84166666666
ACC-2270192619,20,13.31,9052.86,1.0,CUS-2110742437,2018-08-31,Darren,M,-35.27,138.56,,7d49a08a-6a87-409a-9353-ae2476f3f5ea,-35.28,149.13,ACT,Canberra,debit,authorized,46077b1eb09342138ae4115439ec7ae9,POS,<20,2018,8,31,22,19,Friday,0 days,39854.84166666666
ACC-2270192619,20,7.59,9045.27,1.0,CUS-2110742437,2018-08-31,Darren,M,-35.27,138.56,,a92e41a3-6cc6-4367-baba-43247a332def,-35.35,149.24,NSW,Queanbeyan,debit,authorized,f0d22c8764554c048f3a560bd4d7e91f,POS,<20,2018,8,31,23,58,Friday,0 days,39854.84166666666
ACC-2270192619,20,23.76,9021.51,1.0,CUS-2110742437,2018-09-02,Darren,M,-35.27,138.56,,a851a118-cfad-4232-8dec-f528125fc2a1,-34.88,138.59,SA,Prospect,debit,authorized,6d662e6220444c88afdec9ad01fdffe4,POS,<20,2018,9,2,12,28,Sunday,0 days,39854.84166666666
ACC-2270192619,20,39.0,8982.51,,CUS-2110742437,2018-09-04,Darren,M,-35.27,138.56,,,,,,,debit,posted,3c74a1b1b034466d80084fcdba3fc618,PAYMENT,<20,2018,9,4,7,0,Tuesday,0 days,39854.84166666666
ACC-2270192619,20,39.0,8943.51,,CUS-2110742437,2018-09-06,Darren,M,-35.27,138.56,,,,,,,debit,posted,adcb468713414896b60bda7bbfe95b0f,PAYMENT,<20,2018,9,6,4,0,Thursday,0 days,39854.84166666666
ACC-2270192619,20,6.51,11963.95,1.0,CUS-2110742437,2018-09-06,Darren,M,-35.27,138.56,,e2b62c1c-4d7a-4973-86ee-9cc81f0298f0,-34.92,138.61,SA,Adelaide,debit,authorized,b7a99d6e102040a6a503aa50a9dfb0c1,SALES-POS,<20,2018,9,6,23,25,Thursday,0 days,39854.84166666666
ACC-2270192619,20,14.8,11949.15,1.0,CUS-2110742437,2018-09-08,Darren,M,-35.27,138.56,,f064d22e-3780-467a-ab9e-8d60a7729877,-34.87,138.58,SA,Kilburn,debit,authorized,1948415de01049ef9fceb18127506e99,SALES-POS,<20,2018,9,8,16,22,Saturday,0 days,39854.84166666666
ACC-2270192619,20,39.0,11910.15,,CUS-2110742437,2018-09-11,Darren,M,-35.27,138.56,,,,,,,debit,posted,99c1b5779c86483c958a6912611ede1e,PAYMENT,<20,2018,9,11,7,0,Tuesday,0 days,39854.84166666666
ACC-2270192619,20,33.11,11877.04,0.0,CUS-2110742437,2018-09-12,Darren,M,-35.27,138.56,,5846c59f-de05-48dc-adf8-132f5b5e0752,-35.02,138.62,SA,Blackwood,debit,authorized,241981dbbb304d909e17495a7217e943,SALES-POS,<20,2018,9,12,8,39,Wednesday,0 days,39854.84166666666
ACC-2270192619,20,39.0,11838.04,,CUS-2110742437,2018-09-13,Darren,M,-35.27,138.56,,,,,,,debit,posted,742f3c33e9564db8a6b77143f191c27d,PAYMENT,<20,2018,9,13,4,0,Thursday,0 days,39854.84166666666
ACC-2270192619,20,39.0,11799.04,,CUS-2110742437,2018-09-18,Darren,M,-35.27,138.56,,,,,,,debit,posted,f75b84b5213247d18d96f542617859a1,PAYMENT,<20,2018,9,18,7,0,Tuesday,0 days,39854.84166666666
ACC-2270192619,20,9.01,11790.03,1.0,CUS-2110742437,2018-09-19,Darren,M,-35.27,138.56,,4a9092f7-260a-4ac8-b6ef-f751eaaf71d2,-34.92,138.6,SA,Adelaide,debit,authorized,65f390ecc2494e4686a30ca311ef4c8a,POS,<20,2018,9,19,2,11,Wednesday,0 days,39854.84166666666
ACC-2270192619,20,7.96,11782.07,1.0,CUS-2110742437,2018-09-19,Darren,M,-35.27,138.56,,7f91b94c-2473-4cdb-b83f-f7a9412b880b,-35.27,149.13,ACT,Braddon,debit,authorized,273e450aa4624cb3b7d1f8159d4db8e0,SALES-POS,<20,2018,9,19,9,55,Wednesday,0 days,39854.84166666666
ACC-2270192619,20,39.0,11731.92,,CUS-2110742437,2018-09-20,Darren,M,-35.27,138.56,,,,,,,debit,posted,20425d7aa47a4410bff418b351db27a7,PAYMENT,<20,2018,9,20,4,0,Thursday,0 days,39854.84166666666
ACC-2270192619,20,11.15,11770.92,1.0,CUS-2110742437,2018-09-20,Darren,M,-35.27,138.56,,8873aa3e-bf5a-48e5-8781-05888d95fd80,-35.1,138.53,SA,Reynella,debit,authorized,9412ce29dcc048079f4203c29daa85de,POS,<20,2018,9,20,4,33,Thursday,0 days,39854.84166666666
ACC-2270192619,20,6.49,11725.43,1.0,CUS-2110742437,2018-09-21,Darren,M,-35.27,138.56,,13f6f06c-14be-4f90-b258-20408ff820b6,-34.93,138.6,SA,Adelaide,debit,authorized,1e86bbccbf2c41bd8f10d1982da499a6,POS,<20,2018,9,21,20,58,Friday,0 days,39854.84166666666
ACC-2270192619,20,39.0,11686.43,,CUS-2110742437,2018-09-25,Darren,M,-35.27,138.56,,,,,,,debit,posted,09813dc267f34400a1f3e255b84ad23b,PAYMENT,<20,2018,9,25,7,0,Tuesday,0 days,39854.84166666666
ACC-2270192619,20,39.0,11647.43,,CUS-2110742437,2018-09-27,Darren,M,-35.27,138.56,,,,,,,debit,posted,21202893b76a410995f59b56024a83d8,PAYMENT,<20,2018,9,27,4,0,Thursday,0 days,39854.84166666666
ACC-2270192619,20,14.5,11632.93,1.0,CUS-2110742437,2018-10-01,Darren,M,-35.27,138.56,,0fcc77fc-b605-42ec-8d1a-87625e577cbd,-35.02,138.54,SA,Oaklands Park,debit,authorized,8df5bd795285402ea7e783d272a884f2,POS,<20,2018,10,1,9,23,Monday,0 days,39854.84166666666
ACC-2270192619,20,39.0,11593.93,,CUS-2110742437,2018-10-02,Darren,M,-35.27,138.56,,,,,,,debit,posted,7c9a156ab15e469997c32cb843550601,PAYMENT,<20,2018,10,2,7,0,Tuesday,0 days,39854.84166666666
ACC-2270192619,20,39.0,11554.93,,CUS-2110742437,2018-10-04,Darren,M,-35.27,138.56,,,,,,,debit,posted,182a528001684af1bbb50bd2e2b4d86c,PAYMENT,<20,2018,10,4,4,0,Thursday,0 days,39854.84166666666
ACC-2270192619,20,133.1,11421.83,0.0,CUS-2110742437,2018-10-04,Darren,M,-35.27,138.56,,02c972f6-e4d7-46e3-8dcc-6e9a3db1b03f,-35.33,149.18,ACT,Fyshwick,debit,authorized,c7649ae7b09d40d39286aefc4dd68c51,POS,<20,2018,10,4,5,35,Thursday,0 days,39854.84166666666
ACC-2270192619,20,18.34,17457.39,1.0,CUS-2110742437,2018-10-07,Darren,M,-35.27,138.56,,5c1311c7-4a3c-4b97-af22-e8479cc3b5fe,-34.92,138.59,SA,Adelaide,debit,authorized,489aa7f2648a40e1a515ce6fafb92333,SALES-POS,<20,2018,10,7,11,35,Sunday,0 days,39854.84166666666
ACC-2270192619,20,39.0,17418.39,,CUS-2110742437,2018-10-09,Darren,M,-35.27,138.56,,,,,,,debit,posted,7bf6d7c0b7604d0c9f8f0685ef3f79c6,PAYMENT,<20,2018,10,9,7,0,Tuesday,0 days,39854.84166666666
ACC-2270192619,20,39.0,17379.39,,CUS-2110742437,2018-10-11,Darren,M,-35.27,138.56,,,,,,,debit,posted,0937234cd3fa4cec93603fadd5cf1dd4,PAYMENT,<20,2018,10,11,4,0,Thursday,0 days,39854.84166666666
ACC-2270192619,20,39.0,17340.39,,CUS-2110742437,2018-10-16,Darren,M,-35.27,138.56,,,,,,,debit,posted,63687ee5a3674370857f30a6ea80f60a,PAYMENT,<20,2018,10,16,7,0,Tuesday,0 days,39854.84166666666
ACC-2270192619,20,18.12,17322.27,1.0,CUS-2110742437,2018-10-17,Darren,M,-35.27,138.56,,90335606-32de-4756-a99f-c8eafbf1f11e,-35.08,150.66,NSW,Vincentia,debit,authorized,ca102a06ec4b4c57966ca28498fbc995,POS,<20,2018,10,17,16,27,Wednesday,0 days,39854.84166666666
ACC-2270192619,20,39.0,17283.27,,CUS-2110742437,2018-10-18,Darren,M,-35.27,138.56,,,,,,,debit,posted,e4cbaa73dbaa4db6b9e36d707158eed6,PAYMENT,<20,2018,10,18,4,0,Thursday,0 days,39854.84166666666
ACC-2270192619,20,15.64,17267.63,1.0,CUS-2110742437,2018-10-18,Darren,M,-35.27,138.56,,26bdb9c2-f818-431b-853e-78ce1b811a06,-34.92,138.61,SA,Adelaide,debit,authorized,0c8b4c6132184568a842911a9c543e27,SALES-POS,<20,2018,10,18,18,55,Thursday,0 days,39854.84166666666
ACC-2270192619,20,22.57,17245.06,1.0,CUS-2110742437,2018-10-19,Darren,M,-35.27,138.56,,898cce21-e7fb-466f-ae3f-946efc514eab,-34.76,138.64,SA,Salisbury,debit,authorized,cfcd6e81528b451f8b45fce7b760e5d2,SALES-POS,<20,2018,10,19,8,38,Friday,0 days,39854.84166666666
ACC-2270192619,20,22.89,17222.17,1.0,CUS-2110742437,2018-10-19,Darren,M,-35.27,138.56,,24f4ff22-2ad7-4d26-80d1-58cf66962f8f,-34.9,138.66,SA,Firle,debit,authorized,8af6fb9f5e6846fb9ccb1c54ce797294,POS,<20,2018,10,19,15,27,Friday,0 days,39854.84166666666
ACC-2270192619,20,39.0,17183.17,,CUS-2110742437,2018-10-23,Darren,M,-35.27,138.56,,,,,,,debit,posted,121ec8d554ef4a3a9a403277ba83b945,PAYMENT,<20,2018,10,23,7,0,Tuesday,0 days,39854.84166666666
ACC-2270192619,20,39.0,17144.17,,CUS-2110742437,2018-10-25,Darren,M,-35.27,138.56,,,,,,,debit,posted,a0a3729ffa5e489faeebeb637caa7acb,PAYMENT,<20,2018,10,25,4,0,Thursday,0 days,39854.84166666666
ACC-2270192619,20,39.0,17105.17,,CUS-2110742437,2018-10-30,Darren,M,-35.27,138.56,,,,,,,debit,posted,791c5c36854b47c88d3cdf122b9aaaed,PAYMENT,<20,2018,10,30,7,0,Tuesday,0 days,39854.84166666666
ACC-211792489,30,47.0,3117.58,,CUS-497688347,2018-08-02,Jacqueline,F,-34.93,138.63,,,,,,,debit,posted,a6f0f98713ea4e048542d32ce38f642a,PAYMENT,20-30,2018,8,2,6,0,Thursday,61 days,29874.641666666663
ACC-211792489,30,70.5,3047.08,0.0,CUS-497688347,2018-08-02,Jacqueline,F,-34.93,138.63,,7d3affdd-ac47-4894-bf45-292e4b9f67b7,-34.76,149.72,NSW,Goulburn,debit,authorized,367480eb01f046c18feed88b514e288e,POS,20-30,2018,8,2,11,46,Thursday,61 days,29874.641666666663
ACC-211792489,30,38.86,3008.22,1.0,CUS-497688347,2018-08-02,Jacqueline,F,-34.93,138.63,,66482c86-57d7-4aee-af3e-76100e7518e3,-34.96,138.75,SA,Uraidla,debit,authorized,3d3de230ced947adb8ecbbe6776e5086,POS,20-30,2018,8,2,12,10,Thursday,61 days,29874.641666666663
ACC-211792489,30,78.16,2930.06,0.0,CUS-497688347,2018-08-05,Jacqueline,F,-34.93,138.63,,12f057bf-5ea0-4321-b25c-09262c25676e,-34.68,138.71,SA,Blakeview,debit,authorized,75f59eb578584d83b788d62fb8f22c99,SALES-POS,20-30,2018,8,5,14,41,Sunday,61 days,29874.641666666663
ACC-211792489,30,22.0,2908.06,,CUS-497688347,2018-08-05,Jacqueline,F,-34.93,138.63,,,,,,,debit,posted,a19bfe6cfe70414d8151e23e812156e6,PAYMENT,20-30,2018,8,5,17,0,Sunday,61 days,29874.641666666663
ACC-211792489,30,47.0,2861.06,,CUS-497688347,2018-08-09,Jacqueline,F,-34.93,138.63,,,,,,,debit,posted,0b4c4ed41d274ffc9826323fbbc5501c,PAYMENT,20-30,2018,8,9,6,0,Thursday,61 days,29874.641666666663
ACC-211792489,30,49.34,2811.72,1.0,CUS-497688347,2018-08-11,Jacqueline,F,-34.93,138.63,,ef64849c-4508-41c4-9e1e-271951107897,-34.88,138.49,SA,West Lakes,debit,authorized,1b4ec19e636f484fa72e990157332a18,POS,20-30,2018,8,11,11,48,Saturday,61 days,29874.641666666663
ACC-211792489,30,39.87,2771.85,1.0,CUS-497688347,2018-08-11,Jacqueline,F,-34.93,138.63,,d3b57603-2d50-4448-9694-413eb956b679,-34.95,138.52,SA,West Beach,debit,authorized,2454d8fba75e469791ecffeec031666b,SALES-POS,20-30,2018,8,11,14,36,Saturday,61 days,29874.641666666663
ACC-211792489,30,22.0,2749.85,,CUS-497688347,2018-08-12,Jacqueline,F,-34.93,138.63,,,,,,,debit,posted,d2d1662091a94e12a88ff18273e02567,PAYMENT,20-30,2018,8,12,17,0,Sunday,61 days,29874.641666666663
ACC-211792489,30,149.0,2600.85,,CUS-497688347,2018-08-14,Jacqueline,F,-34.93,138.63,,,,,,,debit,posted,4d446dca31cf4e84b646be37d02c28df,PAYMENT,20-30,2018,8,14,3,0,Tuesday,61 days,29874.641666666663
ACC-211792489,30,26.49,2574.36,1.0,CUS-497688347,2018-08-15,Jacqueline,F,-34.93,138.63,,416a7cbf-3853-43f0-b8d6-dfd20f0b4301,-34.96,138.64,SA,Glen Osmond,debit,authorized,66bf39e2b4374639a929f5b1828cdf90,SALES-POS,20-30,2018,8,15,22,20,Wednesday,61 days,29874.641666666663
ACC-211792489,30,38.94,2456.46,0.0,CUS-497688347,2018-08-17,Jacqueline,F,-34.93,138.63,,935836d0-4b82-4fd8-82fc-4857007610a3,-34.88,150.6,NSW,Nowra,debit,authorized,e45b35fbdb6f4ddca9c7c3452f66bbde,SALES-POS,20-30,2018,8,17,4,48,Friday,61 days,29874.641666666663
ACC-211792489,30,43.6,2412.86,1.0,CUS-497688347,2018-08-17,Jacqueline,F,-34.93,138.63,,20fab51c-fa45-4c52-9b15-8fa53c9fecd7,-35.24,149.06,ACT,Belconnen,debit,authorized,eab87dddaa804f828f8b2f611e7204fb,SALES-POS,20-30,2018,8,17,11,24,Friday,61 days,29874.641666666663
ACC-211792489,30,24.63,2388.23,1.0,CUS-497688347,2018-08-17,Jacqueline,F,-34.93,138.63,,416a7cbf-3853-43f0-b8d6-dfd20f0b4301,-34.96,138.64,SA,Glen Osmond,debit,authorized,ae94ae7654f04dedb6cfa1256af55793,POS,20-30,2018,8,17,17,50,Friday,61 days,29874.641666666663
ACC-211792489,30,52.78,2335.45,1.0,CUS-497688347,2018-08-18,Jacqueline,F,-34.93,138.63,,f3192528-53d8-4e5d-ac01-0505f24ac559,-35.14,138.5,SA,Noarlunga Centre,debit,authorized,6092cf1b87234c98a5e58360cf2861ae,POS,20-30,2018,8,18,4,13,Saturday,61 days,29874.641666666663
ACC-211792489,30,28.58,2306.87,0.0,CUS-497688347,2018-08-18,Jacqueline,F,-34.93,138.63,,d6da0a73-531c-4df4-9afa-90c883149a9f,-35.01,148.11,NSW,Gundagai,debit,authorized,8cb8e0e917eb47f2a09e15fb85d7d1bb,SALES-POS,20-30,2018,8,18,14,13,Saturday,61 days,29874.641666666663
ACC-211792489,30,15.89,2290.98,1.0,CUS-497688347,2018-08-18,Jacqueline,F,-34.93,138.63,,bed523c1-151f-49db-a94a-18234207fb0d,-35.22,149.04,ACT,Florey,debit,authorized,b7bd316dfe4f4a74940b711f6f072eab,SALES-POS,20-30,2018,8,18,23,22,Saturday,61 days,29874.641666666663
ACC-211792489,30,80.4,2210.58,1.0,CUS-497688347,2018-08-19,Jacqueline,F,-34.93,138.63,,745e87e1-2454-4028-bec9-ee97ff30f8c0,-35.02,117.88,WA,Albany,debit,authorized,75d22df36ea64c4796e64b814cd67cc0,POS,20-30,2018,8,19,1,12,Sunday,61 days,29874.641666666663
ACC-211792489,30,168.0,2042.58,,CUS-497688347,2018-08-19,Jacqueline,F,-34.93,138.63,,,,,,,debit,posted,70ee663b4fd844cb9cd2aeea23eda0ca,PAYMENT,20-30,2018,8,19,7,0,Sunday,61 days,29874.641666666663
ACC-211792489,30,22.0,2020.58,,CUS-497688347,2018-08-19,Jacqueline,F,-34.93,138.63,,,,,,,debit,posted,14d5777755e3488aa8ccd41d4ef39157,PAYMENT,20-30,2018,8,19,17,0,Sunday,61 days,29874.641666666663
ACC-211792489,30,46.51,1974.07,1.0,CUS-497688347,2018-08-19,Jacqueline,F,-34.93,138.63,,32b3ba2b-745a-4b3b-aeba-f1306fc259f7,-34.83,138.61,SA,Pooraka,debit,authorized,2f14f67d451549b9a3210390dc0a7320,POS,20-30,2018,8,19,19,51,Sunday,61 days,29874.641666666663
ACC-211792489,30,86.46,1887.61,1.0,CUS-497688347,2018-08-20,Jacqueline,F,-34.93,138.63,,d060e8b3-1209-40fa-9c33-46b3a84eaacd,-34.88,138.49,SA,West Lakes,debit,authorized,83783d48facd45db84219a0745c86f85,SALES-POS,20-30,2018,8,20,23,41,Monday,61 days,29874.641666666663
ACC-211792489,30,47.0,1840.61,,CUS-497688347,2018-08-23,Jacqueline,F,-34.93,138.63,,,,,,,debit,posted,af642736a785409caf900e4f68ee4f16,PAYMENT,20-30,2018,8,23,6,0,Thursday,61 days,29874.641666666663
ACC-211792489,30,19.52,1821.09,1.0,CUS-497688347,2018-08-23,Jacqueline,F,-34.93,138.63,,bf78c4a2-a256-4e77-a17d-e889a47ac204,-35.22,138.54,SA,Mclaren Vale,debit,authorized,9afac8e670944ff1afd5f2eda9987fa7,POS,20-30,2018,8,23,15,1,Thursday,61 days,29874.641666666663
ACC-211792489,30,60.58,6671.41,0.0,CUS-497688347,2018-08-24,Jacqueline,F,-34.93,138.63,,6a64a888-392f-470e-a798-b090a9db45e7,-34.95,138.55,SA,Netley,debit,authorized,8d262f011143493f966b5ff56fe022fa,SALES-POS,20-30,2018,8,24,23,24,Friday,61 days,29874.641666666663
ACC-211792489,30,22.89,6648.52,1.0,CUS-497688347,2018-08-25,Jacqueline,F,-34.93,138.63,,a497bb91-7ba5-4095-af21-9f7dd2df393f,-35.03,138.56,SA,Darlington,debit,authorized,7845b40f34cd40e8a3d889fe44ac13ea,SALES-POS,20-30,2018,8,25,7,57,Saturday,61 days,29874.641666666663
ACC-211792489,30,22.9,6625.62,1.0,CUS-497688347,2018-08-26,Jacqueline,F,-34.93,138.63,,61bd7354-f2de-4839-a4db-896e7edcd333,-35.03,117.88,WA,Albany,debit,authorized,ed03f3a0ebb4470eb8bbc67d2cd41968,SALES-POS,20-30,2018,8,26,9,47,Sunday,61 days,29874.641666666663
ACC-211792489,30,22.0,6603.62,,CUS-497688347,2018-08-26,Jacqueline,F,-34.93,138.63,,,,,,,debit,posted,31576090a7814e92aeb186fceade3831,PAYMENT,20-30,2018,8,26,17,0,Sunday,61 days,29874.641666666663
ACC-211792489,30,25.54,6578.08,1.0,CUS-497688347,2018-08-27,Jacqueline,F,-34.93,138.63,,cf063d0f-4c5c-45fc-ae90-5b0ed790be59,-35.12,139.27,SA,Murray Bridge,debit,authorized,85806eba3d5644299ed4ad309a9d5094,SALES-POS,20-30,2018,8,27,9,19,Monday,61 days,29874.641666666663
ACC-211792489,30,13.32,6564.76,0.0,CUS-497688347,2018-08-27,Jacqueline,F,-34.93,138.63,,1eb2779c-f9b3-4265-879f-e8cd10243744,-34.96,138.58,SA,Black Forest,debit,authorized,b358ce4d32eb4f8a95ad62bee36bc70a,POS,20-30,2018,8,27,9,27,Monday,61 days,29874.641666666663
ACC-211792489,30,47.0,6517.76,,CUS-497688347,2018-08-30,Jacqueline,F,-34.93,138.63,,,,,,,debit,posted,b20bf63452a342ac8c987d74faf58157,PAYMENT,20-30,2018,8,30,6,0,Thursday,61 days,29874.641666666663
ACC-211792489,30,15.2,6502.56,0.0,CUS-497688347,2018-08-30,Jacqueline,F,-34.93,138.63,,cb51887f-7267-4e74-8c5f-d170cedfe943,-34.88,138.66,SA,Campbelltown,debit,authorized,51f6b2d77a3d4e91bb00c38d0af12ff9,POS,20-30,2018,8,30,15,13,Thursday,61 days,29874.641666666663
ACC-211792489,30,51.59,6450.97,1.0,CUS-497688347,2018-08-31,Jacqueline,F,-34.93,138.63,,bcf97b8e-b78f-489d-9703-cb0cfb4b23b9,-34.94,138.64,SA,Glenside,debit,authorized,1bbf240e0f9748748a2e8a46107d2b91,SALES-POS,20-30,2018,8,31,8,17,Friday,61 days,29874.641666666663
ACC-211792489,30,28.46,6422.51,1.0,CUS-497688347,2018-08-31,Jacqueline,F,-34.93,138.63,,60d76015-c18d-4d8d-a6a9-8ce46669fafb,-34.95,138.61,SA,Hyde Park,debit,authorized,f55c5b75c3664f25ad71a1b0c9acd93b,SALES-POS,20-30,2018,8,31,19,33,Friday,61 days,29874.641666666663
ACC-211792489,30,22.0,6400.51,,CUS-497688347,2018-09-02,Jacqueline,F,-34.93,138.63,,,,,,,debit,posted,896a45fbe1c04884bffdf46d1d37f060,PAYMENT,20-30,2018,9,2,17,0,Sunday,61 days,29874.641666666663
ACC-211792489,30,14.97,6385.54,1.0,CUS-497688347,2018-09-05,Jacqueline,F,-34.93,138.63,,57b0bc49-13e4-4c70-b87e-fceec1ae6fd1,-34.96,138.57,SA,Kurralta Park,debit,authorized,22e844167d0846a2a7b52685fbe16207,POS,20-30,2018,9,5,8,9,Wednesday,61 days,29874.641666666663
ACC-211792489,30,47.0,6338.54,,CUS-497688347,2018-09-06,Jacqueline,F,-34.93,138.63,,,,,,,debit,posted,9cae174d1bbe461da8d11592153e999c,PAYMENT,20-30,2018,9,6,6,0,Thursday,61 days,29874.641666666663
ACC-211792489,30,45.41,6293.13,1.0,CUS-497688347,2018-09-09,Jacqueline,F,-34.93,138.63,,e6a12933-3c5e-4c2f-8844-ab53b1ab862f,-35.12,147.33,NSW,Ashmont,debit,authorized,9b504108a1674abba4ba058b761a6319,SALES-POS,20-30,2018,9,9,16,46,Sunday,61 days,29874.641666666663
ACC-211792489,30,22.0,6271.13,,CUS-497688347,2018-09-09,Jacqueline,F,-34.93,138.63,,,,,,,debit,posted,c0d4d5621cf943959437a379b26e1b21,PAYMENT,20-30,2018,9,9,17,0,Sunday,61 days,29874.641666666663
ACC-211792489,30,121.82,6149.31,1.0,CUS-497688347,2018-09-10,Jacqueline,F,-34.93,138.63,,d745e2a5-f129-47a4-b733-db2f94124359,-34.97,149.03,NSW,Murrumbateman,debit,authorized,22200ce880c04390b0329a25fac107e4,SALES-POS,20-30,2018,9,10,10,40,Monday,61 days,29874.641666666663
ACC-211792489,30,58.61,6090.7,1.0,CUS-497688347,2018-09-12,Jacqueline,F,-34.93,138.63,,39a1e428-8dc0-4cbc-8512-86162c660c51,-35.04,150.67,NSW,Huskisson,debit,authorized,ddd77724685b42b299821474c3a56424,SALES-POS,20-30,2018,9,12,8,29,Wednesday,61 days,29874.641666666663
ACC-211792489,30,0.1,6090.6,0.0,CUS-497688347,2018-09-12,Jacqueline,F,-34.93,138.63,,3b6372a5-9b14-4d98-bb58-92c215bca597,-37.81,144.96,VIC,Melbourne,debit,authorized,daab7b7e1e5c4503b87d96358d9b4bee,SALES-POS,20-30,2018,9,12,9,2,Wednesday,61 days,29874.641666666663
ACC-211792489,30,44.7,6045.9,1.0,CUS-497688347,2018-09-12,Jacqueline,F,-34.93,138.63,,15d635f7-3feb-4a08-99f8-2bc68dd5cda8,-35.56,138.62,SA,Victor Harbor,debit,authorized,d0ae31609d5449d8a35112557dbf503b,SALES-POS,20-30,2018,9,12,9,25,Wednesday,61 days,29874.641666666663
ACC-211792489,30,35.33,6010.57,1.0,CUS-497688347,2018-09-12,Jacqueline,F,-34.93,138.63,,bd5de8d2-dd79-41f8-af03-7e2f5a25dcfb,-34.82,138.59,SA,Dry Creek,debit,authorized,5b09f172eb234f8681d7b366a02cb611,SALES-POS,20-30,2018,9,12,9,40,Wednesday,61 days,29874.641666666663
ACC-211792489,30,47.0,5963.57,,CUS-497688347,2018-09-13,Jacqueline,F,-34.93,138.63,,,,,,,debit,posted,36d9c174bc024c7d9deca138eb86daea,PAYMENT,20-30,2018,9,13,6,0,Thursday,61 days,29874.641666666663
ACC-211792489,30,149.0,5814.57,,CUS-497688347,2018-09-14,Jacqueline,F,-34.93,138.63,,,,,,,debit,posted,1e033a6f68fa42cfa101190b648c6981,PAYMENT,20-30,2018,9,14,3,0,Friday,61 days,29874.641666666663
ACC-211792489,30,151.34,5663.23,0.0,CUS-497688347,2018-09-15,Jacqueline,F,-34.93,138.63,,9e344a83-00aa-4814-8ba5-5c7acc0b3482,-34.88,150.6,NSW,Nowra,debit,authorized,667aab669ff04c0695206002a0e1d5b0,SALES-POS,20-30,2018,9,15,15,53,Saturday,61 days,29874.641666666663
ACC-211792489,30,47.69,5615.54,1.0,CUS-497688347,2018-09-16,Jacqueline,F,-34.93,138.63,,334f9bdd-fb72-489b-8bf3-49487ef23bef,-35.04,150.67,NSW,Huskisson,debit,authorized,b750a335fd8e4a0d8877a9200866dd14,POS,20-30,2018,9,16,10,44,Sunday,61 days,29874.641666666663
ACC-211792489,30,23.96,5591.58,1.0,CUS-497688347,2018-09-16,Jacqueline,F,-34.93,138.63,,89ff4a05-ba92-4da5-9833-891dafbfafab,-34.74,150.53,NSW,Kangaroo Valley,debit,authorized,4ed0c107325648708adbcb229b9ee291,POS,20-30,2018,9,16,11,21,Sunday,61 days,29874.641666666663
ACC-211792489,30,59.04,5532.54,1.0,CUS-497688347,2018-09-16,Jacqueline,F,-34.93,138.63,,02cb9aab-54b3-489e-9189-e7750e0879aa,-34.88,150.61,NSW,Nowra,debit,authorized,1674ed4fa63441beb57383ee9e2323c6,SALES-POS,20-30,2018,9,16,16,29,Sunday,61 days,29874.641666666663
ACC-211792489,30,22.0,5510.54,,CUS-497688347,2018-09-16,Jacqueline,F,-34.93,138.63,,,,,,,debit,posted,0955e031b59943499e992f16c966276a,PAYMENT,20-30,2018,9,16,17,0,Sunday,61 days,29874.641666666663
ACC-211792489,30,143.57,5366.97,1.0,CUS-497688347,2018-09-16,Jacqueline,F,-34.93,138.63,,f7c2a095-4198-46b8-ad74-5eeba70e6766,-33.87,151.21,NSW,Sydney,debit,authorized,982877ca60974092b17b4c7977e06649,POS,20-30,2018,9,16,20,16,Sunday,61 days,29874.641666666663
ACC-211792489,30,41.91,5325.06,0.0,CUS-497688347,2018-09-18,Jacqueline,F,-34.93,138.63,,8f286c4f-06a4-451e-b856-5e06a5643171,-34.77,138.62,SA,Salisbury Downs,debit,authorized,222c1e01c01a4ba5ba9f0127aad90d80,POS,20-30,2018,9,18,11,20,Tuesday,61 days,29874.641666666663
ACC-211792489,30,90.88,5234.18,0.0,CUS-497688347,2018-09-18,Jacqueline,F,-34.93,138.63,,53e94c1f-1634-48fb-aef8-71f118c8dda7,-34.92,138.64,SA,Norwood,debit,authorized,20a9364d8810407ea74ecd5b2fe292dc,POS,20-30,2018,9,18,14,34,Tuesday,61 days,29874.641666666663
ACC-211792489,30,62.71,5171.47,1.0,CUS-497688347,2018-09-18,Jacqueline,F,-34.93,138.63,,b9a914a9-e469-44f9-af45-2ccd34e5adac,-34.72,135.86,SA,Port Lincoln,debit,authorized,3ec03acdfba6442aa9f23507f5a6e4ed,SALES-POS,20-30,2018,9,18,18,59,Tuesday,61 days,29874.641666666663
ACC-211792489,30,64.43,5107.04,1.0,CUS-497688347,2018-09-18,Jacqueline,F,-34.93,138.63,,00fde36e-134b-4a44-9eb2-4d51eab494f2,-34.87,138.58,SA,Kilburn North,debit,authorized,e3105e026ac64c83b7b817f013f9bc2c,POS,20-30,2018,9,18,19,57,Tuesday,61 days,29874.641666666663
ACC-211792489,30,61.26,5045.78,1.0,CUS-497688347,2018-09-18,Jacqueline,F,-34.93,138.63,,95feeef0-22e1-40ff-b7cb-ca6220234e20,-35.08,150.66,NSW,Vincentia,debit,authorized,9f110beddef54ff98b0ba5ae993aa337,SALES-POS,20-30,2018,9,18,20,45,Tuesday,61 days,29874.641666666663
ACC-211792489,30,168.0,4877.78,,CUS-497688347,2018-09-19,Jacqueline,F,-34.93,138.63,,,,,,,debit,posted,804453ed0a5b45bd91ea4a7d2b40c654,PAYMENT,20-30,2018,9,19,7,0,Wednesday,61 days,29874.641666666663
ACC-211792489,30,47.0,4830.78,,CUS-497688347,2018-09-20,Jacqueline,F,-34.93,138.63,,,,,,,debit,posted,0e9ddebfd18c466bb2de653f441b2326,PAYMENT,20-30,2018,9,20,6,0,Thursday,61 days,29874.641666666663
ACC-211792489,30,33.85,4796.93,1.0,CUS-497688347,2018-09-20,Jacqueline,F,-34.93,138.63,,190121ea-eb46-487d-8c31-c723c402f38f,-35.14,138.5,SA,Noarlunga Centre,debit,authorized,57542f587f2145679fb807528204b7a3,POS,20-30,2018,9,20,13,1,Thursday,61 days,29874.641666666663
ACC-211792489,30,142.35,4654.58,1.0,CUS-497688347,2018-09-23,Jacqueline,F,-34.93,138.63,,2c4cac87-8586-4eda-8b3d-fe7be164fa00,-34.86,150.6,NSW,North Nowra,debit,authorized,f25b9a56021143289b1066e9adb31a79,POS,20-30,2018,9,23,12,41,Sunday,61 days,29874.641666666663
ACC-211792489,30,50.03,4604.55,1.0,CUS-497688347,2018-09-23,Jacqueline,F,-34.93,138.63,,d5e0135b-d063-45f0-9696-81ece6091c26,-35.03,117.91,WA,Mount Clarence,debit,authorized,04a5b1e55e574095ad727d3fb9ad6f58,SALES-POS,20-30,2018,9,23,13,20,Sunday,61 days,29874.641666666663
ACC-211792489,30,22.0,4582.55,,CUS-497688347,2018-09-23,Jacqueline,F,-34.93,138.63,,,,,,,debit,posted,fe6e6b888b1a4f008e4e7a6a7a695421,PAYMENT,20-30,2018,9,23,17,0,Sunday,61 days,29874.641666666663
ACC-211792489,30,47.52,4535.03,1.0,CUS-497688347,2018-09-25,Jacqueline,F,-34.93,138.63,,a5d60ea9-6fbc-4dd2-b106-9c14dd48aca2,-34.87,138.55,SA,Kilkenny,debit,authorized,b6dba63fbd0c42d4a62f257993996b00,POS,20-30,2018,9,25,9,44,Tuesday,61 days,29874.641666666663
ACC-211792489,30,138.01,4397.02,1.0,CUS-497688347,2018-09-25,Jacqueline,F,-34.93,138.63,,3df82b4a-7300-4ebe-9660-0d810bb28410,-33.75,151.24,NSW,Frenchs Forest,debit,authorized,3b8627ebd5e547afa037d48b9e67a894,SALES-POS,20-30,2018,9,25,9,52,Tuesday,61 days,29874.641666666663
ACC-211792489,30,207.68,4189.34,1.0,CUS-497688347,2018-09-25,Jacqueline,F,-34.93,138.63,,89ac710d-8917-4b36-88a1-b373940bb767,-34.84,138.55,SA,Wingfield,debit,authorized,c764c28e94bb47dcae46825679cec3df,SALES-POS,20-30,2018,9,25,12,21,Tuesday,61 days,29874.641666666663
ACC-211792489,30,47.0,4142.34,,CUS-497688347,2018-09-27,Jacqueline,F,-34.93,138.63,,,,,,,debit,posted,27509f044a7c43a9b4a4b266ed562c96,PAYMENT,20-30,2018,9,27,6,0,Thursday,61 days,29874.641666666663
ACC-211792489,30,244.14,3898.2,1.0,CUS-497688347,2018-09-28,Jacqueline,F,-34.93,138.63,,eb8f1ada-3e8c-4017-908d-6b6282107c50,-33.87,151.21,NSW,Sydney,debit,authorized,83d525e810db431ea5825a4ca0eef92a,POS,20-30,2018,9,28,23,31,Friday,61 days,29874.641666666663
ACC-211792489,30,44.57,3853.63,1.0,CUS-497688347,2018-09-29,Jacqueline,F,-34.93,138.63,,9a658f0a-e753-4367-befe-950ff80f40af,-35.08,148.09,NSW,Gundagai,debit,authorized,5066da9e17414f3ca57685f7298f65a1,POS,20-30,2018,9,29,9,22,Saturday,61 days,29874.641666666663
ACC-211792489,30,65.62,3788.01,1.0,CUS-497688347,2018-09-29,Jacqueline,F,-34.93,138.63,,0359e1a0-5efd-4921-8c41-89f1f0783aa1,-33.86,151.2,NSW,Sydney,debit,authorized,8bc5d50556f74205ac0f9c5962d3a0dc,SALES-POS,20-30,2018,9,29,9,55,Saturday,61 days,29874.641666666663
ACC-211792489,30,22.0,3766.01,,CUS-497688347,2018-09-30,Jacqueline,F,-34.93,138.63,,,,,,,debit,posted,28e7ff1b6d3440848b0ac4a6823282a1,PAYMENT,20-30,2018,9,30,17,0,Sunday,61 days,29874.641666666663
ACC-211792489,30,47.0,3719.01,,CUS-497688347,2018-10-04,Jacqueline,F,-34.93,138.63,,,,,,,debit,posted,9bddd3c40f214e06960b03ad73f375df,PAYMENT,20-30,2018,10,4,6,0,Thursday,61 days,29874.641666666663
ACC-211792489,30,90.62,3628.39,1.0,CUS-497688347,2018-10-04,Jacqueline,F,-34.93,138.63,,03b7047b-72fa-41ba-9b20-e8c2c8312bf0,-35.35,149.08,ACT,Phillip,debit,authorized,7d83a568fef14a5a8574b17e9f3b020d,POS,20-30,2018,10,4,15,29,Thursday,61 days,29874.641666666663
ACC-211792489,30,143.85,3484.54,1.0,CUS-497688347,2018-10-07,Jacqueline,F,-34.93,138.63,,55a38a05-9140-42d3-a85d-21c1fc71f89b,-35.31,149.13,ACT,Forrest,debit,authorized,ad00bb5069a043ef855e0daf5ef65fef,POS,20-30,2018,10,7,11,56,Sunday,61 days,29874.641666666663
ACC-211792489,30,22.0,3462.54,,CUS-497688347,2018-10-07,Jacqueline,F,-34.93,138.63,,,,,,,debit,posted,a002394fa6e141a28344f2d29fb15fb4,PAYMENT,20-30,2018,10,7,17,0,Sunday,61 days,29874.641666666663
ACC-211792489,30,31.53,3431.01,1.0,CUS-497688347,2018-10-10,Jacqueline,F,-34.93,138.63,,bb18a07f-b0de-41d8-87ae-eb8c318b9b63,-35.27,138.56,SA,Willunga,debit,authorized,bb19219970ab453dab1c7e62f8f2c9d7,SALES-POS,20-30,2018,10,10,8,0,Wednesday,61 days,29874.641666666663
ACC-211792489,30,44.55,3386.46,1.0,CUS-497688347,2018-10-10,Jacqueline,F,-34.93,138.63,,0a66c544-54bd-4142-bf95-a92e5210a8ec,-35.11,147.37,NSW,Wagga Wagga,debit,authorized,9c9b55ceceb54c27a730766d0b6d1397,POS,20-30,2018,10,10,21,54,Wednesday,61 days,29874.641666666663
ACC-211792489,30,47.0,3339.46,,CUS-497688347,2018-10-11,Jacqueline,F,-34.93,138.63,,,,,,,debit,posted,4ed558d6d34e4f4d8d21358dee938bb8,PAYMENT,20-30,2018,10,11,6,0,Thursday,61 days,29874.641666666663
ACC-211792489,30,149.0,3190.46,,CUS-497688347,2018-10-14,Jacqueline,F,-34.93,138.63,,,,,,,debit,posted,0b71c400c157435c8d4fec363c282726,PAYMENT,20-30,2018,10,14,3,0,Sunday,61 days,29874.641666666663
ACC-211792489,30,22.0,3168.46,,CUS-497688347,2018-10-14,Jacqueline,F,-34.93,138.63,,,,,,,debit,posted,542f969385aa4c5fb30c18c03bda7c9b,PAYMENT,20-30,2018,10,14,17,0,Sunday,61 days,29874.641666666663
ACC-211792489,30,47.0,3121.46,,CUS-497688347,2018-10-18,Jacqueline,F,-34.93,138.63,,,,,,,debit,posted,c03a226e2cb346ff95150a19d72f1179,PAYMENT,20-30,2018,10,18,6,0,Thursday,61 days,29874.641666666663
ACC-211792489,30,168.0,2953.46,,CUS-497688347,2018-10-19,Jacqueline,F,-34.93,138.63,,,,,,,debit,posted,d4d6f65fd4154bcf82c05c547c61e0c0,PAYMENT,20-30,2018,10,19,7,0,Friday,61 days,29874.641666666663
ACC-211792489,30,73.61,2879.85,1.0,CUS-497688347,2018-10-19,Jacqueline,F,-34.93,138.63,,11d22c9c-8bb7-4001-b5c0-e2f015a37a35,-35.07,138.59,SA,Aberfoyle Park,debit,authorized,98eeddf4eafd446ea18d4eb346a122b5,POS,20-30,2018,10,19,8,51,Friday,61 days,29874.641666666663
ACC-211792489,30,120.34,2759.51,1.0,CUS-497688347,2018-10-21,Jacqueline,F,-34.93,138.63,,63bbd5c3-b880-4a7f-8414-c45bd5a9e18b,-35.34,149.24,NSW,Queanbeyan East,debit,authorized,598de3d1bdd74268b636761827887e0d,POS,20-30,2018,10,21,9,20,Sunday,61 days,29874.641666666663
ACC-211792489,30,22.0,2737.51,,CUS-497688347,2018-10-21,Jacqueline,F,-34.93,138.63,,,,,,,debit,posted,102577dcf4f348af98d04237b32f1fd0,PAYMENT,20-30,2018,10,21,17,0,Sunday,61 days,29874.641666666663
ACC-211792489,30,21.74,2715.77,1.0,CUS-497688347,2018-10-22,Jacqueline,F,-34.93,138.63,,59dab1d0-a572-4f34-a6c1-7556ecc8b28e,-34.86,138.55,SA,Athol Park,debit,authorized,f6635e52ca7243b4b8165b9745cd0b48,SALES-POS,20-30,2018,10,22,9,21,Monday,61 days,29874.641666666663
ACC-211792489,30,38.66,2677.11,1.0,CUS-497688347,2018-10-22,Jacqueline,F,-34.93,138.63,,a722d174-679d-43b2-beb3-926e781a8cd1,-34.88,150.6,NSW,Nowra,debit,authorized,3096a95559c94e2ab3748a723b8eeecb,SALES-POS,20-30,2018,10,22,12,20,Monday,61 days,29874.641666666663
ACC-211792489,30,190.42,2486.69,1.0,CUS-497688347,2018-10-23,Jacqueline,F,-34.93,138.63,,7ec296e9-6feb-46b0-b755-115ce31678c1,-33.8,151.18,NSW,Chatswood,debit,authorized,ce161bc68bcc44bf86cf3afe7cf00f66,POS,20-30,2018,10,23,9,46,Tuesday,61 days,29874.641666666663
ACC-211792489,30,47.0,7350.59,,CUS-497688347,2018-10-25,Jacqueline,F,-34.93,138.63,,,,,,,debit,posted,b47e85daceda43eb89aace211e744cba,PAYMENT,20-30,2018,10,25,6,0,Thursday,61 days,29874.641666666663
ACC-211792489,30,22.0,7328.59,,CUS-497688347,2018-10-28,Jacqueline,F,-34.93,138.63,,,,,,,debit,posted,44072042c7844c078414f46075ede657,PAYMENT,20-30,2018,10,28,17,0,Sunday,61 days,29874.641666666663
ACC-2231965366,35,33.0,1580.32,,CUS-2155701614,2018-08-02,Linda,F,-37.84,144.96,,,,,,,debit,posted,7fae30d872ba4c62b028c9b494a779fd,PAYMENT,30-40,2018,8,2,7,0,Thursday,7 days,127397.514
ACC-2231965366,35,15.7,1564.62,1.0,CUS-2155701614,2018-08-03,Linda,F,-37.84,144.96,,66a0231a-2397-4bf1-ba73-5b8ec0b069b4,-37.86,145.03,VIC,Malvern,debit,authorized,75b4507b4cdd4a638bbda1e270fc93d1,POS,30-40,2018,8,3,0,25,Friday,7 days,127397.514
ACC-2231965366,35,147.0,1417.62,,CUS-2155701614,2018-08-03,Linda,F,-37.84,144.96,,,,,,,debit,posted,a6a5a814c4a641c0900892dea39208c4,PAYMENT,30-40,2018,8,3,11,0,Friday,7 days,127397.514
ACC-2231965366,35,13.57,1404.05,1.0,CUS-2155701614,2018-08-04,Linda,F,-37.84,144.96,,5d1d344f-30dc-468c-afc5-3fe3c241a550,-37.81,144.96,VIC,Melbourne,debit,authorized,f8dcc5a6550e4c8fb001e1ca3943fc9d,POS,30-40,2018,8,4,13,22,Saturday,7 days,127397.514
ACC-2231965366,35,82.0,1322.05,,CUS-2155701614,2018-08-05,Linda,F,-37.84,144.96,,,,,,,debit,posted,7dd26985d4ca4490a69666700c185b10,PHONE BANK,30-40,2018,8,5,3,0,Sunday,7 days,127397.514
ACC-2231965366,35,17.0,1305.05,,CUS-2155701614,2018-08-07,Linda,F,-37.84,144.96,,,,,,,debit,posted,cd70b80ed5c343d08ff73c68f8aff8c6,INTER BANK,30-40,2018,8,7,3,0,Tuesday,7 days,127397.514
ACC-2231965366,35,36.0,1269.05,,CUS-2155701614,2018-08-07,Linda,F,-37.84,144.96,,,,,,,debit,posted,a39759c6388f4a138bee9fa64cbb09f5,PAYMENT,30-40,2018,8,7,8,0,Tuesday,7 days,127397.514
ACC-2231965366,35,45.0,1224.05,,CUS-2155701614,2018-08-07,Linda,F,-37.84,144.96,,,,,,,debit,posted,a93fa5a46e2c4930a9210dfead0f561d,PAYMENT,30-40,2018,8,7,11,0,Tuesday,7 days,127397.514
ACC-2231965366,35,33.0,3634.29,,CUS-2155701614,2018-08-09,Linda,F,-37.84,144.96,,,,,,,debit,posted,f6c86a328a5a43b89a4ab8a2c9c6983b,PAYMENT,30-40,2018,8,9,7,0,Thursday,7 days,127397.514
ACC-2231965366,35,166.0,3468.29,,CUS-2155701614,2018-08-11,Linda,F,-37.84,144.96,,,,,,,debit,posted,ec9e736ed27049eca0b8e3e965436283,PAYMENT,30-40,2018,8,11,7,0,Saturday,7 days,127397.514
ACC-2231965366,35,17.0,3451.29,,CUS-2155701614,2018-08-14,Linda,F,-37.84,144.96,,,,,,,debit,posted,1701e36c561d47bebe67837b34f07464,INTER BANK,30-40,2018,8,14,3,0,Tuesday,7 days,127397.514
ACC-2231965366,35,36.0,3415.29,,CUS-2155701614,2018-08-14,Linda,F,-37.84,144.96,,,,,,,debit,posted,b43aa722339546dba0f08fc9db8addea,PAYMENT,30-40,2018,8,14,8,0,Tuesday,7 days,127397.514
ACC-2231965366,35,45.0,3370.29,,CUS-2155701614,2018-08-14,Linda,F,-37.84,144.96,,,,,,,debit,posted,594bd2a10d004760b2386bfc0f7533d2,PAYMENT,30-40,2018,8,14,11,0,Tuesday,7 days,127397.514
ACC-2231965366,35,17.0,5763.53,,CUS-2155701614,2018-08-21,Linda,F,-37.84,144.96,,,,,,,debit,posted,2a71d90586094b28bc37d6a6f90d5e28,INTER BANK,30-40,2018,8,21,3,0,Tuesday,7 days,127397.514
ACC-2231965366,35,36.0,5727.53,,CUS-2155701614,2018-08-21,Linda,F,-37.84,144.96,,,,,,,debit,posted,487e90d7dc5f41c680e9b9e379bc330e,PAYMENT,30-40,2018,8,21,8,0,Tuesday,7 days,127397.514
ACC-2231965366,35,45.0,5682.53,,CUS-2155701614,2018-08-21,Linda,F,-37.84,144.96,,,,,,,debit,posted,782de44454f145e3907e0f82b0588961,PAYMENT,30-40,2018,8,21,11,0,Tuesday,7 days,127397.514
ACC-2231965366,35,33.0,8092.77,,CUS-2155701614,2018-08-23,Linda,F,-37.84,144.96,,,,,,,debit,posted,942c539b5ae64346a5a3bf3e0f8e6c66,PAYMENT,30-40,2018,8,23,7,0,Thursday,7 days,127397.514
ACC-2231965366,35,180.0,7912.77,,CUS-2155701614,2018-08-24,Linda,F,-37.84,144.96,,,,,,,debit,posted,9afcc188337a418799ae13c66665c041,PAYMENT,30-40,2018,8,24,15,0,Friday,7 days,127397.514
ACC-2231965366,35,17.0,7895.77,,CUS-2155701614,2018-08-28,Linda,F,-37.84,144.96,,,,,,,debit,posted,3f6414cc2e7c4530b19bab5e037b1459,INTER BANK,30-40,2018,8,28,3,0,Tuesday,7 days,127397.514
ACC-2231965366,35,36.0,7859.77,,CUS-2155701614,2018-08-28,Linda,F,-37.84,144.96,,,,,,,debit,posted,b712dcd8a31c4a8eb395b403bd2f8e79,PAYMENT,30-40,2018,8,28,8,0,Tuesday,7 days,127397.514
ACC-2231965366,35,45.0,7814.77,,CUS-2155701614,2018-08-28,Linda,F,-37.84,144.96,,,,,,,debit,posted,28ab386981ef478781db8fbaae15252c,PAYMENT,30-40,2018,8,28,11,0,Tuesday,7 days,127397.514
ACC-2231965366,35,33.0,10225.01,,CUS-2155701614,2018-08-30,Linda,F,-37.84,144.96,,,,,,,debit,posted,f7f703236c2f466792728be3a1c9b688,PAYMENT,30-40,2018,8,30,7,0,Thursday,7 days,127397.514
ACC-2231965366,35,11.06,10213.95,1.0,CUS-2155701614,2018-08-31,Linda,F,-37.84,144.96,,ad1404e0-42fe-4df6-ab2b-ed1b8fd73c1a,-37.82,144.95,VIC,Docklands,debit,authorized,8fd0b5addc654dce9db7fd1b093e9604,POS,30-40,2018,8,31,23,43,Friday,7 days,127397.514
ACC-2231965366,35,21.93,10192.02,0.0,CUS-2155701614,2018-09-01,Linda,F,-37.84,144.96,,8caef465-4a6c-46fd-a286-483a6a22fa57,-37.76,145.07,VIC,Heidelberg,debit,authorized,9f7d3a94c782469aabc0710c198d22d6,POS,30-40,2018,9,1,22,4,Saturday,7 days,127397.514
ACC-2231965366,35,23.16,10168.86,1.0,CUS-2155701614,2018-09-01,Linda,F,-37.84,144.96,,c6f8db8d-b03c-4e19-b2b1-2c366982e2a7,-37.88,147.97,VIC,Lakes Entrance,debit,authorized,d5e704fc58bd40e491de4440c81454ca,POS,30-40,2018,9,1,22,38,Saturday,7 days,127397.514
ACC-2231965366,35,147.0,10021.86,,CUS-2155701614,2018-09-03,Linda,F,-37.84,144.96,,,,,,,debit,posted,e2d61d5c690f43e8b9e21e4df26f1a73,PAYMENT,30-40,2018,9,3,11,0,Monday,7 days,127397.514
ACC-2231965366,35,17.0,10004.86,,CUS-2155701614,2018-09-04,Linda,F,-37.84,144.96,,,,,,,debit,posted,8d43b8464ded4626a4185736f56dc2c5,INTER BANK,30-40,2018,9,4,3,0,Tuesday,7 days,127397.514
ACC-2231965366,35,36.0,9968.86,,CUS-2155701614,2018-09-04,Linda,F,-37.84,144.96,,,,,,,debit,posted,14470dd55d4f4140b85999fabf3d792d,PAYMENT,30-40,2018,9,4,8,0,Tuesday,7 days,127397.514
ACC-2231965366,35,45.0,9923.86,,CUS-2155701614,2018-09-04,Linda,F,-37.84,144.96,,,,,,,debit,posted,13d18d82aa514726ad81179a95b3701a,PAYMENT,30-40,2018,9,4,11,0,Tuesday,7 days,127397.514
ACC-2231965366,35,82.0,12285.1,,CUS-2155701614,2018-09-05,Linda,F,-37.84,144.96,,,,,,,debit,posted,d6976f80cfce455fb28d9dec9e0722bf,PHONE BANK,30-40,2018,9,5,3,0,Wednesday,7 days,127397.514
ACC-2231965366,35,33.0,12252.1,,CUS-2155701614,2018-09-06,Linda,F,-37.84,144.96,,,,,,,debit,posted,43bc9585fab742fdb9a0f1565adcb392,PAYMENT,30-40,2018,9,6,7,0,Thursday,7 days,127397.514
ACC-2231965366,35,23.86,12228.24,1.0,CUS-2155701614,2018-09-06,Linda,F,-37.84,144.96,,9f13d90e-33e8-4bf4-b619-c12238e1eacf,-37.73,144.85,VIC,Keilor East,debit,authorized,380150df611a435c9303a08aa67bfccb,SALES-POS,30-40,2018,9,6,21,2,Thursday,7 days,127397.514
ACC-2231965366,35,33.12,12195.12,0.0,CUS-2155701614,2018-09-06,Linda,F,-37.84,144.96,,a7757fd8-1f60-4201-a7fd-b6c4cf90871c,-37.76,145.35,VIC,Lilydale,debit,authorized,7c3bb1fe04594557ba189c409949f2b9,POS,30-40,2018,9,6,23,49,Thursday,7 days,127397.514
ACC-2231965366,35,11.6,12183.52,1.0,CUS-2155701614,2018-09-07,Linda,F,-37.84,144.96,,d2f56f9c-4de9-4dea-8db7-50300e92d5e4,-37.82,144.95,VIC,Docklands,debit,authorized,dadff205bf49402bbf1c47dcd0218cd8,POS,30-40,2018,9,7,4,22,Friday,7 days,127397.514
ACC-2231965366,35,14.64,12168.88,0.0,CUS-2155701614,2018-09-08,Linda,F,-37.84,144.96,,e6707889-de24-4366-860d-c207f4f2a014,-37.76,144.83,VIC,Sunshine North,debit,authorized,3892a97123124a119d52d85d4c2ed815,SALES-POS,30-40,2018,9,8,1,37,Saturday,7 days,127397.514
ACC-2231965366,35,45.73,12123.15,1.0,CUS-2155701614,2018-09-08,Linda,F,-37.84,144.96,,ffaffe7f-3d95-4429-a3dd-96a8d6088863,-37.85,145,VIC,Prahran,debit,authorized,f3b07f6deabf46d89df5c46fb407808d,POS,30-40,2018,9,8,4,24,Saturday,7 days,127397.514
ACC-2231965366,35,37.74,12085.41,0.0,CUS-2155701614,2018-09-08,Linda,F,-37.84,144.96,,128a4561-435b-4489-832b-04b87d5c14ca,-37.86,145.29,VIC,Boronia,debit,authorized,1056d1b612784f4096604147e773d672,POS,30-40,2018,9,8,11,14,Saturday,7 days,127397.514
ACC-2231965366,35,17.0,12068.41,,CUS-2155701614,2018-09-11,Linda,F,-37.84,144.96,,,,,,,debit,posted,85a2dd9e08354f2dbd26d670bfa79793,INTER BANK,30-40,2018,9,11,3,0,Tuesday,7 days,127397.514
ACC-2231965366,35,166.0,11902.41,,CUS-2155701614,2018-09-11,Linda,F,-37.84,144.96,,,,,,,debit,posted,1326bb0c902f4afd86a12e4b1791dc60,PAYMENT,30-40,2018,9,11,7,0,Tuesday,7 days,127397.514
ACC-2231965366,35,36.0,11866.41,,CUS-2155701614,2018-09-11,Linda,F,-37.84,144.96,,,,,,,debit,posted,d406288d68dc4222b32624e94a550a89,PAYMENT,30-40,2018,9,11,8,0,Tuesday,7 days,127397.514
ACC-2231965366,35,110.25,11756.16,1.0,CUS-2155701614,2018-09-11,Linda,F,-37.84,144.96,,202453f5-0691-418b-9164-0ccab8209fe3,-27.31,152.99,QLD,Strathpine,debit,authorized,9e6093600e20432b982da72af8a52659,POS,30-40,2018,9,11,9,24,Tuesday,7 days,127397.514
ACC-2231965366,35,45.0,11711.16,,CUS-2155701614,2018-09-11,Linda,F,-37.84,144.96,,,,,,,debit,posted,ad0bd6167c144ce98b615ff74110c2b6,PAYMENT,30-40,2018,9,11,11,0,Tuesday,7 days,127397.514
ACC-2231965366,35,33.0,14121.4,,CUS-2155701614,2018-09-13,Linda,F,-37.84,144.96,,,,,,,debit,posted,aa985bb4e0ca494597541570f8220588,PAYMENT,30-40,2018,9,13,7,0,Thursday,7 days,127397.514
ACC-2231965366,35,18.62,14102.78,0.0,CUS-2155701614,2018-09-13,Linda,F,-37.84,144.96,,8ceab902-ce1f-42d4-971e-6a3ba3769422,-37.77,144.89,VIC,Maribyrnong,debit,authorized,e9bc8892dfdf4e6e867f38d81c695580,POS,30-40,2018,9,13,19,39,Thursday,7 days,127397.514
ACC-2231965366,35,40.13,14062.65,1.0,CUS-2155701614,2018-09-13,Linda,F,-37.84,144.96,,a4327c86-cf62-41ce-928a-881aaa11b2f4,-37.76,145.35,VIC,Lilydale,debit,authorized,df5b27e6c987483cab08de585685f267,SALES-POS,30-40,2018,9,13,21,54,Thursday,7 days,127397.514
ACC-2231965366,35,17.0,14045.65,,CUS-2155701614,2018-09-18,Linda,F,-37.84,144.96,,,,,,,debit,posted,4b05c7f9c8b349f49f8226f6839f0cc9,INTER BANK,30-40,2018,9,18,3,0,Tuesday,7 days,127397.514
ACC-2231965366,35,36.0,14009.65,,CUS-2155701614,2018-09-18,Linda,F,-37.84,144.96,,,,,,,debit,posted,cd0aef788e9349f0af1dd34dd37dc313,PAYMENT,30-40,2018,9,18,8,0,Tuesday,7 days,127397.514
ACC-2231965366,35,45.0,13964.65,,CUS-2155701614,2018-09-18,Linda,F,-37.84,144.96,,,,,,,debit,posted,80a50e8c657948fc9d831c595c97121a,PAYMENT,30-40,2018,9,18,11,0,Tuesday,7 days,127397.514
ACC-2231965366,35,9.85,16398.04,0.0,CUS-2155701614,2018-09-19,Linda,F,-37.84,144.96,,031cd041-d76e-40a8-a5ec-d2abfe1f0401,-37.82,144.95,VIC,Docklands,debit,authorized,06a99afdfde74889ad71b96e6c3976c9,POS,30-40,2018,9,19,15,19,Wednesday,7 days,127397.514
ACC-2231965366,35,20.95,16377.09,1.0,CUS-2155701614,2018-09-20,Linda,F,-37.84,144.96,,c116ba5b-0b90-4aa4-a71b-a1b1c6a8ed18,-37.74,145.03,VIC,Preston,debit,authorized,d1c340c9b4eb4cdc814f90676e76403f,POS,30-40,2018,9,20,1,10,Thursday,7 days,127397.514
ACC-2231965366,35,33.0,16344.09,,CUS-2155701614,2018-09-20,Linda,F,-37.84,144.96,,,,,,,debit,posted,f41b590440c34db9bf2b7c01bf912fb7,PAYMENT,30-40,2018,9,20,7,0,Thursday,7 days,127397.514
ACC-2231965366,35,180.0,16164.09,,CUS-2155701614,2018-09-24,Linda,F,-37.84,144.96,,,,,,,debit,posted,7dd20f93094c4ca6b53e40a5878cf523,PAYMENT,30-40,2018,9,24,15,0,Monday,7 days,127397.514
ACC-2231965366,35,17.0,16147.09,,CUS-2155701614,2018-09-25,Linda,F,-37.84,144.96,,,,,,,debit,posted,cdefdb0ca2db44528748d5dea4a34632,INTER BANK,30-40,2018,9,25,3,0,Tuesday,7 days,127397.514
ACC-2231965366,35,36.0,16111.09,,CUS-2155701614,2018-09-25,Linda,F,-37.84,144.96,,,,,,,debit,posted,0b9115b7debd4040a28c75d8b35ad268,PAYMENT,30-40,2018,9,25,8,0,Tuesday,7 days,127397.514
ACC-2231965366,35,1202.0,14909.09,,CUS-2155701614,2018-09-25,Linda,F,-37.84,144.96,,,,,,,debit,posted,717ce1bed3104a92a6c2c09bc8a00afe,PAYMENT,30-40,2018,9,25,10,0,Tuesday,7 days,127397.514
ACC-2231965366,35,45.0,14864.09,,CUS-2155701614,2018-09-25,Linda,F,-37.84,144.96,,,,,,,debit,posted,57ba37d28acd48dc983b2880152af653,PAYMENT,30-40,2018,9,25,11,0,Tuesday,7 days,127397.514
ACC-2231965366,35,33.0,17274.33,,CUS-2155701614,2018-09-27,Linda,F,-37.84,144.96,,,,,,,debit,posted,7f79190bfa6f4df9a9cd3f642e3c2c0e,PAYMENT,30-40,2018,9,27,7,0,Thursday,7 days,127397.514
ACC-2231965366,35,17.0,17257.33,,CUS-2155701614,2018-10-02,Linda,F,-37.84,144.96,,,,,,,debit,posted,85f07cf8515a4c9e9e68011b8f421540,INTER BANK,30-40,2018,10,2,3,0,Tuesday,7 days,127397.514
ACC-2231965366,35,36.0,17221.33,,CUS-2155701614,2018-10-02,Linda,F,-37.84,144.96,,,,,,,debit,posted,0ead25699bce4daeaec0e568d7c9eeea,PAYMENT,30-40,2018,10,2,8,0,Tuesday,7 days,127397.514
ACC-2231965366,35,45.0,17176.33,,CUS-2155701614,2018-10-02,Linda,F,-37.84,144.96,,,,,,,debit,posted,e360bca1540e4ef7b9857b9dfb6675f6,PAYMENT,30-40,2018,10,2,11,0,Tuesday,7 days,127397.514
ACC-2231965366,35,147.0,19472.57,,CUS-2155701614,2018-10-03,Linda,F,-37.84,144.96,,,,,,,debit,posted,ace9d8ef3841476a85b6a7653c9e8a00,PAYMENT,30-40,2018,10,3,11,0,Wednesday,7 days,127397.514
ACC-2231965366,35,33.0,19439.57,,CUS-2155701614,2018-10-04,Linda,F,-37.84,144.96,,,,,,,debit,posted,693f5859f1394b43a7efc71678b62804,PAYMENT,30-40,2018,10,4,7,0,Thursday,7 days,127397.514
ACC-2231965366,35,82.0,19357.57,,CUS-2155701614,2018-10-05,Linda,F,-37.84,144.96,,,,,,,debit,posted,0550c8737fbe4bedae218c721c2a9609,PHONE BANK,30-40,2018,10,5,3,0,Friday,7 days,127397.514
ACC-2231965366,35,17.0,19340.57,,CUS-2155701614,2018-10-09,Linda,F,-37.84,144.96,,,,,,,debit,posted,0ace783fcda747519e70b00316af222d,INTER BANK,30-40,2018,10,9,3,0,Tuesday,7 days,127397.514
ACC-2231965366,35,36.0,19304.57,,CUS-2155701614,2018-10-09,Linda,F,-37.84,144.96,,,,,,,debit,posted,392b3d97d16344ab9246efe9d83a465e,PAYMENT,30-40,2018,10,9,8,0,Tuesday,7 days,127397.514
ACC-2231965366,35,45.0,19259.57,,CUS-2155701614,2018-10-09,Linda,F,-37.84,144.96,,,,,,,debit,posted,e67c0aedbf7b46bea2cb49b8a702037f,PAYMENT,30-40,2018,10,9,11,0,Tuesday,7 days,127397.514
ACC-2231965366,35,33.0,21669.81,,CUS-2155701614,2018-10-11,Linda,F,-37.84,144.96,,,,,,,debit,posted,580866f138a44fafba74bd307b9e9699,PAYMENT,30-40,2018,10,11,7,0,Thursday,7 days,127397.514
ACC-2231965366,35,166.0,21503.81,,CUS-2155701614,2018-10-11,Linda,F,-37.84,144.96,,,,,,,debit,posted,0cdd72c6678c4bffb4ab5b25c60dd202,PAYMENT,30-40,2018,10,11,7,0,Thursday,7 days,127397.514
ACC-2231965366,35,901.0,20602.81,,CUS-2155701614,2018-10-14,Linda,F,-37.84,144.96,,,,,,,debit,posted,57fe7075bc0e46acaeb3a2f3ecb0dcc9,INTER BANK,30-40,2018,10,14,22,0,Sunday,7 days,127397.514
ACC-2231965366,35,17.0,20585.81,,CUS-2155701614,2018-10-16,Linda,F,-37.84,144.96,,,,,,,debit,posted,c73bb9600f81403081279877138da2be,INTER BANK,30-40,2018,10,16,3,0,Tuesday,7 days,127397.514
ACC-2231965366,35,36.0,20549.81,,CUS-2155701614,2018-10-16,Linda,F,-37.84,144.96,,,,,,,debit,posted,d2ec57ee9e6942fe9d3e8edcc5140282,PAYMENT,30-40,2018,10,16,8,0,Tuesday,7 days,127397.514
ACC-2231965366,35,45.0,20504.81,,CUS-2155701614,2018-10-16,Linda,F,-37.84,144.96,,,,,,,debit,posted,0d55a002d5ec446f8e256dbfd73391d4,PAYMENT,30-40,2018,10,16,11,0,Tuesday,7 days,127397.514
ACC-2231965366,35,33.0,22915.05,,CUS-2155701614,2018-10-18,Linda,F,-37.84,144.96,,,,,,,debit,posted,055fa9134e8548868c037f9141b33801,PAYMENT,30-40,2018,10,18,7,0,Thursday,7 days,127397.514
ACC-2231965366,35,42.6,22872.45,1.0,CUS-2155701614,2018-10-19,Linda,F,-37.84,144.96,,ca09e293-0cc7-4cfc-9ee9-0ea53dbdca69,-37.79,145.13,VIC,Doncaster,debit,authorized,b71426f9a97341e3b0b70e8c48cbb542,SALES-POS,30-40,2018,10,19,15,18,Friday,7 days,127397.514
ACC-2231965366,35,17.18,22855.27,0.0,CUS-2155701614,2018-10-21,Linda,F,-37.84,144.96,,a83cc4b9-cc95-4f83-b47a-d3a67eb87967,-37.84,145.17,VIC,Forest Hill,debit,authorized,1b0865ab85ad4ece95b97c024ea69979,SALES-POS,30-40,2018,10,21,8,27,Sunday,7 days,127397.514
ACC-2231965366,35,59.16,22796.11,1.0,CUS-2155701614,2018-10-21,Linda,F,-37.84,144.96,,2d3f9099-eb95-48d7-8e34-ef4c4f1e492b,-37.83,144.99,VIC,Cremorne,debit,authorized,46a7de58c7674fc7afe9882804416a16,POS,30-40,2018,10,21,10,19,Sunday,7 days,127397.514
ACC-2231965366,35,16.02,22780.09,1.0,CUS-2155701614,2018-10-21,Linda,F,-37.84,144.96,,3a899489-e3d9-4b09-8023-9d5b79126026,-37.81,144.98,VIC,Fitzroy,debit,authorized,c0c11d32a0b94ec6888f17faa769d7d2,POS,30-40,2018,10,21,21,9,Sunday,7 days,127397.514
ACC-2231965366,35,17.0,22763.09,,CUS-2155701614,2018-10-23,Linda,F,-37.84,144.96,,,,,,,debit,posted,16099e0e084849a0839cf49370150722,INTER BANK,30-40,2018,10,23,3,0,Tuesday,7 days,127397.514
ACC-2231965366,35,36.0,22727.09,,CUS-2155701614,2018-10-23,Linda,F,-37.84,144.96,,,,,,,debit,posted,4b08de331a404bb4b1a59b94f0df918d,PAYMENT,30-40,2018,10,23,8,0,Tuesday,7 days,127397.514
ACC-2231965366,35,45.0,22682.09,,CUS-2155701614,2018-10-23,Linda,F,-37.84,144.96,,,,,,,debit,posted,9fdf7f6dab3d4ef789bf133fa2d61d34,PAYMENT,30-40,2018,10,23,11,0,Tuesday,7 days,127397.514
ACC-2231965366,35,180.0,24945.33,,CUS-2155701614,2018-10-24,Linda,F,-37.84,144.96,,,,,,,debit,posted,dd0a58bae94b4bfd8e278a7dd5dd039c,PAYMENT,30-40,2018,10,24,15,0,Wednesday,7 days,127397.514
ACC-2231965366,35,32.31,24913.02,1.0,CUS-2155701614,2018-10-24,Linda,F,-37.84,144.96,,727fd7de-ac0a-4e5b-af2b-2d7e4be15c44,-37.89,145.08,VIC,Chadstone,debit,authorized,afb19d562c724a57bbfd768b837a3f0e,SALES-POS,30-40,2018,10,24,21,38,Wednesday,7 days,127397.514
ACC-2231965366,35,6.81,24906.21,1.0,CUS-2155701614,2018-10-25,Linda,F,-37.84,144.96,,552a2246-f940-4e3d-86e1-b12a892390f1,-37.74,142.03,VIC,Hamilton,debit,authorized,6c54adf4bfee4d55a2bcda76316ea3bf,POS,30-40,2018,10,25,4,45,Thursday,7 days,127397.514
ACC-2231965366,35,33.0,24873.21,,CUS-2155701614,2018-10-25,Linda,F,-37.84,144.96,,,,,,,debit,posted,d1ca9103eda5434d877c04f4f13c5512,PAYMENT,30-40,2018,10,25,7,0,Thursday,7 days,127397.514
ACC-2231965366,35,57.68,24815.53,1.0,CUS-2155701614,2018-10-25,Linda,F,-37.84,144.96,,1ade38f2-2fd0-491a-ba3c-a893f96335ce,-34.93,138.6,SA,Adelaide,debit,authorized,c08be1b88cd04bed8899aac2f35248b7,POS,30-40,2018,10,25,15,57,Thursday,7 days,127397.514
ACC-2231965366,35,17.0,24798.53,,CUS-2155701614,2018-10-30,Linda,F,-37.84,144.96,,,,,,,debit,posted,be2752f23a704d18b8b31fff8aab5fb5,INTER BANK,30-40,2018,10,30,3,0,Tuesday,7 days,127397.514
ACC-2231965366,35,36.0,24762.53,,CUS-2155701614,2018-10-30,Linda,F,-37.84,144.96,,,,,,,debit,posted,4c803ab466384d7fafd46548c79de5e4,PAYMENT,30-40,2018,10,30,8,0,Tuesday,7 days,127397.514
ACC-2231965366,35,45.0,24717.53,,CUS-2155701614,2018-10-30,Linda,F,-37.84,144.96,,,,,,,debit,posted,9eaceba97cfb4a57862109c4d5c85bcc,PAYMENT,30-40,2018,10,30,11,0,Tuesday,7 days,127397.514
ACC-2259139624,19,22.0,1146.46,,CUS-3174332735,2018-08-02,Cindy,F,-37.91,144.66,,,,,,,debit,posted,0fa1a5285c6b4704a4d5ba5c59c1b343,INTER BANK,<20,2018,8,2,7,0,Thursday,14 days,95863.079
ACC-2259139624,19,108.0,1038.46,,CUS-3174332735,2018-08-02,Cindy,F,-37.91,144.66,,,,,,,debit,posted,92ab96f2b3e64aa7909169a4f8f1e5c2,PAYMENT,<20,2018,8,2,22,0,Thursday,14 days,95863.079
ACC-2259139624,19,28.55,1009.91,1.0,CUS-3174332735,2018-08-03,Cindy,F,-37.91,144.66,,213229a4-b41d-4816-a1d8-b44c89289974,-37.83,145.06,VIC,Camberwell,debit,authorized,08a4742cd4424f5e8f0ff7f25f17a829,POS,<20,2018,8,3,2,4,Friday,14 days,95863.079
ACC-2259139624,19,166.57,843.34,0.0,CUS-3174332735,2018-08-03,Cindy,F,-37.91,144.66,,660f5b62-2cd1-44d1-93b3-5934909c059a,-38.14,145.12,VIC,Frankston,debit,authorized,6cb9013662e44ef4b1e1f77f33baee34,POS,<20,2018,8,3,11,20,Friday,14 days,95863.079
ACC-2259139624,19,112.0,731.34,,CUS-3174332735,2018-08-04,Cindy,F,-37.91,144.66,,,,,,,debit,posted,e4b90cfd7c3d4642af514d5388dd3e61,PAYMENT,<20,2018,8,4,17,0,Saturday,14 days,95863.079
ACC-2259139624,19,22.0,709.34,,CUS-3174332735,2018-08-09,Cindy,F,-37.91,144.66,,,,,,,debit,posted,5d1551f9160347c9a0d509e39d28bd44,INTER BANK,<20,2018,8,9,7,0,Thursday,14 days,95863.079
ACC-2259139624,19,37.68,4348.6,1.0,CUS-3174332735,2018-08-12,Cindy,F,-37.91,144.66,,ed5bf651-1c4f-4e04-a68b-9513e3c3dd8f,-37.88,147.99,VIC,Lakes Entrance,debit,authorized,ed9bde8dbc384b1d9caaacef3e6fffa7,SALES-POS,<20,2018,8,12,16,59,Sunday,14 days,95863.079
ACC-2259139624,19,41.84,4306.76,1.0,CUS-3174332735,2018-08-15,Cindy,F,-37.91,144.66,,0f835327-2bae-4b60-be44-7e9a1a1f2b0d,-37.93,145.03,VIC,Hampton East,debit,authorized,8c18427ef8cf46f18d71307fc79a2392,SALES-POS,<20,2018,8,15,9,5,Wednesday,14 days,95863.079
ACC-2259139624,19,165.0,4119.76,,CUS-3174332735,2018-08-18,Cindy,F,-37.91,144.66,,,,,,,debit,posted,620ef0d767be4c799a9d28cc0034b56e,PAYMENT,<20,2018,8,18,17,0,Saturday,14 days,95863.079
ACC-2259139624,19,38.64,4081.12,1.0,CUS-3174332735,2018-08-22,Cindy,F,-37.91,144.66,,6a36c97a-ba11-4a85-b45b-44999fffe057,-37.49,144.59,VIC,Gisborne,debit,authorized,f58357f0b4704be5b8a6e3763eca5c89,POS,<20,2018,8,22,15,43,Wednesday,14 days,95863.079
ACC-2259139624,19,22.0,4059.12,,CUS-3174332735,2018-08-23,Cindy,F,-37.91,144.66,,,,,,,debit,posted,0454855f491343c8bee84c4ca0e319eb,INTER BANK,<20,2018,8,23,7,0,Thursday,14 days,95863.079
ACC-2259139624,19,42.8,7693.26,1.0,CUS-3174332735,2018-08-24,Cindy,F,-37.91,144.66,,f81686da-9261-4a98-8196-1812682d10db,-37.74,144.96,VIC,Coburg,debit,authorized,0389ee6fc6324663bc41e9565aa69ecb,POS,<20,2018,8,24,20,17,Friday,14 days,95863.079
ACC-2259139624,19,20.59,7672.67,1.0,CUS-3174332735,2018-08-24,Cindy,F,-37.91,144.66,,3be46881-7d68-4d17-bac9-94cd80d24371,-37.85,144.71,VIC,Tarneit,debit,authorized,a075408ce1ea4c35a9ae4d70a91f0ccf,SALES-POS,<20,2018,8,24,21,53,Friday,14 days,95863.079
ACC-2259139624,19,89.53,7583.14,1.0,CUS-3174332735,2018-08-25,Cindy,F,-37.91,144.66,,beab21f3-b006-4e80-8034-808c45f1d957,-37.83,140.79,SA,Mount Gambier,debit,authorized,40df60e1f2434e11887d84ed20d5c76b,SALES-POS,<20,2018,8,25,21,4,Saturday,14 days,95863.079
ACC-2259139624,19,21.13,7562.01,1.0,CUS-3174332735,2018-08-25,Cindy,F,-37.91,144.66,,c29e9319-d67f-43b7-93fe-fa3796ac521f,-38.11,145.28,VIC,Cranbourne,debit,authorized,04c75906423a4dfa98df01995358b50e,POS,<20,2018,8,25,21,34,Saturday,14 days,95863.079
ACC-2259139624,19,25.86,7536.15,0.0,CUS-3174332735,2018-08-27,Cindy,F,-37.91,144.66,,dd8f3a2c-c24f-4820-9c1b-4659c92adde7,-38.03,145.27,VIC,Hampton Park,debit,authorized,3a50839e2ac143b68fb078d97b611d81,SALES-POS,<20,2018,8,27,8,45,Monday,14 days,95863.079
ACC-2259139624,19,18.38,7517.77,1.0,CUS-3174332735,2018-08-27,Cindy,F,-37.91,144.66,,3c460b16-7101-4147-acfa-2d689aa02f0f,-37.99,145.23,VIC,Dandenong,debit,authorized,76d48b09cf5a4a18b29f9b45ec8c26e9,POS,<20,2018,8,27,12,51,Monday,14 days,95863.079
ACC-2259139624,19,88.0,7429.77,,CUS-3174332735,2018-08-27,Cindy,F,-37.91,144.66,,,,,,,debit,posted,7872f986a35f46b8abc52c05612f6fac,PAYMENT,<20,2018,8,27,23,0,Monday,14 days,95863.079
ACC-2259139624,19,153.0,7276.77,,CUS-3174332735,2018-08-28,Cindy,F,-37.91,144.66,,,,,,,debit,posted,eda2202fae3245b59e328ff077b16a4e,PAYMENT,<20,2018,8,28,21,0,Tuesday,14 days,95863.079
ACC-2259139624,19,22.0,7226.85,,CUS-3174332735,2018-08-30,Cindy,F,-37.91,144.66,,,,,,,debit,posted,9732d99dd2974e80ac6e9b551b2afb9e,INTER BANK,<20,2018,8,30,7,0,Thursday,14 days,95863.079
ACC-2259139624,19,27.92,7248.85,0.0,CUS-3174332735,2018-08-30,Cindy,F,-37.91,144.66,,43f22ffb-0954-4770-ac05-d6761aec5ccc,-37.74,144.9,VIC,Niddrie,debit,authorized,9dbf8852ff7d4adca788e512ff64bc75,SALES-POS,<20,2018,8,30,7,39,Thursday,14 days,95863.079
ACC-2259139624,19,108.0,7118.85,,CUS-3174332735,2018-09-02,Cindy,F,-37.91,144.66,,,,,,,debit,posted,6956a694edb14fd49b80a414218939f0,PAYMENT,<20,2018,9,2,22,0,Sunday,14 days,95863.079
ACC-2259139624,19,112.0,7006.85,,CUS-3174332735,2018-09-04,Cindy,F,-37.91,144.66,,,,,,,debit,posted,f1f7c228364343b982d772eaff2a27e8,PAYMENT,<20,2018,9,4,17,0,Tuesday,14 days,95863.079
ACC-2259139624,19,18.89,6987.96,1.0,CUS-3174332735,2018-09-05,Cindy,F,-37.91,144.66,,c158e498-52a9-488e-8fa2-4d92242a6952,-38.26,144.55,VIC,Ocean Grove,debit,authorized,8af45cee3a7848b59e6cf937c26e9fcf,SALES-POS,<20,2018,9,5,11,44,Wednesday,14 days,95863.079
ACC-2259139624,19,22.0,6965.96,,CUS-3174332735,2018-09-06,Cindy,F,-37.91,144.66,,,,,,,debit,posted,0fec63fdfccc420f872580082adc9dec,INTER BANK,<20,2018,9,6,7,0,Thursday,14 days,95863.079
ACC-2259139624,19,19.08,10623.82,0.0,CUS-3174332735,2018-09-08,Cindy,F,-37.91,144.66,,c830946c-087a-4a30-afaa-21cd09c13534,-37.82,144.96,VIC,Melbourne,debit,authorized,1cde62313f6a49c093415a599cde7637,POS,<20,2018,9,8,1,57,Saturday,14 days,95863.079
ACC-2259139624,19,37.92,10585.9,1.0,CUS-3174332735,2018-09-08,Cindy,F,-37.91,144.66,,a32f73e9-a11c-489e-a00b-d65ff95a1bf5,-37.72,145.15,VIC,Eltham,debit,authorized,5536e6ea29844f9a8a26f9e5ac605538,SALES-POS,<20,2018,9,8,20,40,Saturday,14 days,95863.079
ACC-2259139624,19,22.0,10563.9,,CUS-3174332735,2018-09-13,Cindy,F,-37.91,144.66,,,,,,,debit,posted,5b4f14ccae5a443489e667f994d362a0,INTER BANK,<20,2018,9,13,7,0,Thursday,14 days,95863.079
ACC-2259139624,19,165.0,10398.9,,CUS-3174332735,2018-09-18,Cindy,F,-37.91,144.66,,,,,,,debit,posted,8b287d341ed24606b96756c9b71cf812,PAYMENT,<20,2018,9,18,17,0,Tuesday,14 days,95863.079
ACC-2259139624,19,22.0,10376.9,,CUS-3174332735,2018-09-20,Cindy,F,-37.91,144.66,,,,,,,debit,posted,3a2e3ac8c13a493facfa6687720b9a10,INTER BANK,<20,2018,9,20,7,0,Thursday,14 days,95863.079
ACC-2259139624,19,22.0,14031.84,,CUS-3174332735,2018-09-27,Cindy,F,-37.91,144.66,,,,,,,debit,posted,c4290ddbce724e82af1d62ebb6fdfed4,INTER BANK,<20,2018,9,27,7,0,Thursday,14 days,95863.079
ACC-2259139624,19,88.0,13943.84,,CUS-3174332735,2018-09-27,Cindy,F,-37.91,144.66,,,,,,,debit,posted,1c3654a2f1a94e079a6ba77ced21339f,PAYMENT,<20,2018,9,27,23,0,Thursday,14 days,95863.079
ACC-2259139624,19,153.0,13790.84,,CUS-3174332735,2018-09-28,Cindy,F,-37.91,144.66,,,,,,,debit,posted,2b36f0ac1237495f9804b3cf9e4ef818,PAYMENT,<20,2018,9,28,21,0,Friday,14 days,95863.079
ACC-2259139624,19,108.0,13682.84,,CUS-3174332735,2018-10-02,Cindy,F,-37.91,144.66,,,,,,,debit,posted,8c515f05c7b44af0ab6b94b0cb8e2b62,PAYMENT,<20,2018,10,2,22,0,Tuesday,14 days,95863.079
ACC-2259139624,19,22.0,13660.84,,CUS-3174332735,2018-10-04,Cindy,F,-37.91,144.66,,,,,,,debit,posted,78df757d0d774531b468a668948ec42b,INTER BANK,<20,2018,10,4,7,0,Thursday,14 days,95863.079
ACC-2259139624,19,112.0,17225.78,,CUS-3174332735,2018-10-04,Cindy,F,-37.91,144.66,,,,,,,debit,posted,e5201138bd4746548fd8ff57d4377099,PAYMENT,<20,2018,10,4,17,0,Thursday,14 days,95863.079
ACC-2259139624,19,22.0,17203.78,,CUS-3174332735,2018-10-11,Cindy,F,-37.91,144.66,,,,,,,debit,posted,b0bca50b3aa14c69b2143bf139a34172,INTER BANK,<20,2018,10,11,7,0,Thursday,14 days,95863.079
ACC-2259139624,19,22.0,17181.78,,CUS-3174332735,2018-10-18,Cindy,F,-37.91,144.66,,,,,,,debit,posted,09a354e3df9642f18f8087e686280761,INTER BANK,<20,2018,10,18,7,0,Thursday,14 days,95863.079
ACC-2259139624,19,165.0,20693.72,,CUS-3174332735,2018-10-18,Cindy,F,-37.91,144.66,,,,,,,debit,posted,39b61b1e62ab456bb30e240e7f77977b,PAYMENT,<20,2018,10,18,17,0,Thursday,14 days,95863.079
ACC-2259139624,19,22.0,20671.72,,CUS-3174332735,2018-10-25,Cindy,F,-37.91,144.66,,,,,,,debit,posted,1e48fbdf4c034ca9bddc0e77f38fdd36,INTER BANK,<20,2018,10,25,7,0,Thursday,14 days,95863.079
ACC-2259139624,19,88.0,20583.72,,CUS-3174332735,2018-10-27,Cindy,F,-37.91,144.66,,,,,,,debit,posted,9a8aa80af37a46fab1361b963ec47a89,PAYMENT,<20,2018,10,27,23,0,Saturday,14 days,95863.079
ACC-2259139624,19,153.0,20430.72,,CUS-3174332735,2018-10-28,Cindy,F,-37.91,144.66,,,,,,,debit,posted,26048dc6407446829dda676bb3f0b235,PAYMENT,<20,2018,10,28,21,0,Sunday,14 days,95863.079
ACC-2259139624,19,34.8,20395.92,0.0,CUS-3174332735,2018-10-29,Cindy,F,-37.91,144.66,,fdc01786-ee32-4a0b-8c42-c41f05df2753,-37.64,145.03,VIC,Epping,debit,authorized,38a466d82f3146a882ba29fd7a436147,POS,<20,2018,10,29,10,53,Monday,14 days,95863.079
ACC-2259139624,19,66.03,20329.89,0.0,CUS-3174332735,2018-10-29,Cindy,F,-37.91,144.66,,ffdfb1a2-66de-461d-b2f1-80629f008401,-37.85,145.17,VIC,Vermont South,debit,authorized,171939cf4e2943379d2145b87192c59d,POS,<20,2018,10,29,15,6,Monday,14 days,95863.079
ACC-2259139624,19,10.42,20319.47,0.0,CUS-3174332735,2018-10-29,Cindy,F,-37.91,144.66,,4e455bb2-5f25-4b3a-9f09-b78788e83373,-37.99,145.21,VIC,Dandenong,debit,authorized,6dbdd04bd4bf417299f8db9b1bf9556a,SALES-POS,<20,2018,10,29,17,18,Monday,14 days,95863.079
ACC-847145727,19,1692.56,50671.14,0.0,CUS-1609060617,2018-08-02,Michael,M,-31.92,115.90,,e62c0cf2-08f3-42c5-bad4-6de138fd9351,-31.95,115.84,WA,West Perth,debit,authorized,dc4ae2d4b0ec4643bf04445eee0d60d8,POS,<20,2018,8,2,7,20,Thursday,14 days,74427.15
ACC-847145727,19,13.49,50657.65,1.0,CUS-1609060617,2018-08-02,Michael,M,-31.92,115.90,,9a41612f-8ad3-4211-8546-4ef3c4063d7f,-31.95,115.86,WA,Perth,debit,authorized,110c5d35605f499a833ae94bbfc3742a,SALES-POS,<20,2018,8,2,9,33,Thursday,14 days,74427.15
ACC-847145727,19,19.8,50637.85,1.0,CUS-1609060617,2018-08-02,Michael,M,-31.92,115.90,,cb641e09-bc57-4192-b8db-515a25de31c0,-32.58,115.83,WA,Ravenswood,debit,authorized,0f0bb99523d549469fa428d91970675f,SALES-POS,<20,2018,8,2,15,43,Thursday,14 days,74427.15
ACC-847145727,19,46.86,50590.99,1.0,CUS-1609060617,2018-08-02,Michael,M,-31.92,115.90,,8f49e7a9-c5ca-4c7a-81dc-911ec5e52ba6,-37.71,145.15,VIC,Ringwood,debit,authorized,1100b09cbbb74996896c09d83579179b,SALES-POS,<20,2018,8,2,20,15,Thursday,14 days,74427.15
ACC-847145727,19,131.91,50459.08,1.0,CUS-1609060617,2018-08-02,Michael,M,-31.92,115.90,,7c0ed0d1-0976-4859-9793-49e2083165a5,-31.95,141.47,NSW,Broken Hill,debit,authorized,c29ee351fef5422a96ab37dc60d8c6e2,POS,<20,2018,8,2,23,12,Thursday,14 days,74427.15
ACC-847145727,19,123.0,50336.08,,CUS-1609060617,2018-08-05,Michael,M,-31.92,115.90,,,,,,,debit,posted,6647b2750c214302a0db1cc629c1a1a4,INTER BANK,<20,2018,8,5,6,0,Sunday,14 days,74427.15
ACC-847145727,19,109.0,50227.08,,CUS-1609060617,2018-08-05,Michael,M,-31.92,115.90,,,,,,,debit,posted,cbbb17d340f54e259faa76de72c825ce,PAYMENT,<20,2018,8,5,11,0,Sunday,14 days,74427.15
ACC-847145727,19,14.68,50212.4,1.0,CUS-1609060617,2018-08-05,Michael,M,-31.92,115.90,,578abd32-896d-4677-9738-69306f8d3caa,-37.82,145.08,VIC,Canterbury,debit,authorized,2fa1ff5bb18a4f98b9888038cc6ebf81,POS,<20,2018,8,5,21,2,Sunday,14 days,74427.15
ACC-847145727,19,14.28,50198.12,1.0,CUS-1609060617,2018-08-05,Michael,M,-31.92,115.90,,c0c401ad-0a56-4b6a-bc84-944b065c9045,-31.9,116.01,WA,Midland,debit,authorized,f836699407f744df83031731f19631a5,SALES-POS,<20,2018,8,5,21,22,Sunday,14 days,74427.15
ACC-847145727,19,19.25,50178.87,1.0,CUS-1609060617,2018-08-06,Michael,M,-31.92,115.90,,0779712a-6f25-4715-aaa5-84b8f69e6de0,-31.95,115.86,WA,Perth,debit,authorized,231d3adc5a2f4f66b566dcbf462efd37,SALES-POS,<20,2018,8,6,8,39,Monday,14 days,74427.15
ACC-847145727,19,37.0,50141.87,,CUS-1609060617,2018-08-06,Michael,M,-31.92,115.90,,,,,,,debit,posted,03f0f2084d4d4b8c83adff10927d218c,PAYMENT,<20,2018,8,6,11,0,Monday,14 days,74427.15
ACC-847145727,19,8.66,50133.21,1.0,CUS-1609060617,2018-08-09,Michael,M,-31.92,115.90,,2b3794b3-88cf-4593-869f-fbb806ae6426,-31.93,115.96,WA,Perth Airport,debit,authorized,3f191c038d9249f3a88a4593ea7fc133,POS,<20,2018,8,9,10,5,Thursday,14 days,74427.15
ACC-847145727,19,21.03,50112.18,1.0,CUS-1609060617,2018-08-09,Michael,M,-31.92,115.90,,b4bc21d4-283c-4cc8-b8fb-719157b10613,-32.13,115.96,WA,Southern River,debit,authorized,4d499b05f28c40de8007c163e7961785,SALES-POS,<20,2018,8,9,13,4,Thursday,14 days,74427.15
ACC-847145727,19,133.0,49979.18,,CUS-1609060617,2018-08-12,Michael,M,-31.92,115.90,,,,,,,debit,posted,b11507f8352f4b90a49af1441aaae2c6,PAYMENT,<20,2018,8,12,11,0,Sunday,14 days,74427.15
ACC-847145727,19,37.0,49942.18,,CUS-1609060617,2018-08-13,Michael,M,-31.92,115.90,,,,,,,debit,posted,e2040db95d934b2596b2da1053296863,PAYMENT,<20,2018,8,13,11,0,Monday,14 days,74427.15
ACC-847145727,19,13.21,52783.71,1.0,CUS-1609060617,2018-08-14,Michael,M,-31.92,115.90,,912c1695-41e4-408e-828b-1afe812d48fa,-31.9,116.17,WA,Perth,debit,authorized,a012b18af88948118f6f709a1e25a163,SALES-POS,<20,2018,8,14,15,5,Tuesday,14 days,74427.15
ACC-847145727,19,151.0,52632.71,,CUS-1609060617,2018-08-17,Michael,M,-31.92,115.90,,,,,,,debit,posted,6954104f31f446a39a580507a9e9faa2,PAYMENT,<20,2018,8,17,7,0,Friday,14 days,74427.15
ACC-847145727,19,39.68,52593.03,1.0,CUS-1609060617,2018-08-17,Michael,M,-31.92,115.90,,7ccaa951-2249-4cb4-8677-5e881a0d599d,-31.98,115.9,WA,East Victoria Park,debit,authorized,72ffaee0a0ba4b6aa4b2d6a7d699a9a9,SALES-POS,<20,2018,8,17,23,42,Friday,14 days,74427.15
ACC-847145727,19,23.43,52569.6,1.0,CUS-1609060617,2018-08-18,Michael,M,-31.92,115.90,,d121c0e2-07ac-4732-8f93-a5410f2df156,-31.77,116.03,WA,Upper Swan,debit,authorized,75e7748e67674a96aef46f021573bae2,SALES-POS,<20,2018,8,18,10,34,Saturday,14 days,74427.15
ACC-847145727,19,13.67,52555.93,0.0,CUS-1609060617,2018-08-19,Michael,M,-31.92,115.90,,f51760b0-c86b-4d38-960a-b13ba2b9f123,-31.69,115.72,WA,Clarkson,debit,authorized,da1f13eb4abe44fc9ccf2ea714ec0777,POS,<20,2018,8,19,20,43,Sunday,14 days,74427.15
ACC-847145727,19,40.16,52515.77,1.0,CUS-1609060617,2018-08-20,Michael,M,-31.92,115.90,,94257812-23ee-4e0d-a0b4-a45afdb46fb3,-31.89,116.77,WA,York,debit,authorized,3bfa0fb5463849048f1da13ac0a34eb5,SALES-POS,<20,2018,8,20,1,55,Monday,14 days,74427.15
ACC-847145727,19,33.94,52481.83,0.0,CUS-1609060617,2018-08-20,Michael,M,-31.92,115.90,,42a15a85-9b68-45de-87a9-2480d55c30e6,-31.74,115.77,WA,Joondalup,debit,authorized,d4678e0a6dbf4607b68e2f2d6e010c76,SALES-POS,<20,2018,8,20,9,57,Monday,14 days,74427.15
ACC-847145727,19,37.0,52444.83,,CUS-1609060617,2018-08-20,Michael,M,-31.92,115.90,,,,,,,debit,posted,4654e8048bf64d5eaa47b5e264d92198,PAYMENT,<20,2018,8,20,11,0,Monday,14 days,74427.15
ACC-847145727,19,17.21,52427.62,0.0,CUS-1609060617,2018-08-21,Michael,M,-31.92,115.90,,6e9da1d1-9003-4ab2-a830-16d0328bd2e4,-31.9,115.8,WA,Innaloo,debit,authorized,717022f7f43e457c9bffe2249f960e7d,SALES-POS,<20,2018,8,21,9,56,Tuesday,14 days,74427.15
ACC-847145727,19,37.79,52389.83,1.0,CUS-1609060617,2018-08-22,Michael,M,-31.92,115.90,,a92e16c3-14a3-4d19-b4e9-19ccd297e4f8,-31.95,141.45,NSW,Broken Hill,debit,authorized,99027204ba7d47b7bb243f6aed4f2f30,POS,<20,2018,8,22,15,17,Wednesday,14 days,74427.15
ACC-847145727,19,37.0,52352.83,,CUS-1609060617,2018-08-27,Michael,M,-31.92,115.90,,,,,,,debit,posted,a1ed59ae7e56457fa1b0bb3c4ce2632f,PAYMENT,<20,2018,8,27,11,0,Monday,14 days,74427.15
ACC-847145727,19,37.0,55170.57,,CUS-1609060617,2018-09-03,Michael,M,-31.92,115.90,,,,,,,debit,posted,37ccc936115d49089c4d8e1753ae8d22,PAYMENT,<20,2018,9,3,11,0,Monday,14 days,74427.15
ACC-847145727,19,123.0,55047.57,,CUS-1609060617,2018-09-05,Michael,M,-31.92,115.90,,,,,,,debit,posted,086c4c84a12b4b688a92f2211e67e212,INTER BANK,<20,2018,9,5,6,0,Wednesday,14 days,74427.15
ACC-847145727,19,109.0,54938.57,,CUS-1609060617,2018-09-05,Michael,M,-31.92,115.90,,,,,,,debit,posted,6e754ddfdb9f4075a237a69a7c8e7573,PAYMENT,<20,2018,9,5,11,0,Wednesday,14 days,74427.15
ACC-847145727,19,39.58,54898.99,1.0,CUS-1609060617,2018-09-07,Michael,M,-31.92,115.90,,acdca4d5-8eea-4608-951b-63a5589e092b,-31.99,115.77,WA,Cottesloe,debit,authorized,bef5fbaecc6d436aab0a39165b79a5e2,POS,<20,2018,9,7,15,5,Friday,14 days,74427.15
ACC-847145727,19,19.44,54879.55,1.0,CUS-1609060617,2018-09-07,Michael,M,-31.92,115.90,,2c58c6a8-7c64-41e2-82f1-d59329839094,-31.84,115.81,WA,Warwick,debit,authorized,22f6adc6936e4a00a32e9fdce6e53d42,POS,<20,2018,9,7,19,4,Friday,14 days,74427.15
ACC-847145727,19,10.83,54868.72,0.0,CUS-1609060617,2018-09-07,Michael,M,-31.92,115.90,,d9e7e5fb-2a7c-47b1-86a0-0bdbc4e59a66,-31.97,115.94,WA,Cloverdale,debit,authorized,3c4265df3fd34b82a0d4db5077a5f4e7,POS,<20,2018,9,7,23,44,Friday,14 days,74427.15
ACC-847145727,19,37.0,54831.72,,CUS-1609060617,2018-09-10,Michael,M,-31.92,115.90,,,,,,,debit,posted,620fee53415a45788588df8c56a607a3,PAYMENT,<20,2018,9,10,11,0,Monday,14 days,74427.15
ACC-847145727,19,42.91,57643.55,1.0,CUS-1609060617,2018-09-11,Michael,M,-31.92,115.90,,5472ce3d-8d13-4d83-b118-0e99a400ca3d,-31.89,116.77,WA,York,debit,authorized,5f92b4a1b1234f1b968a03f19495b9f3,POS,<20,2018,9,11,16,55,Tuesday,14 days,74427.15
ACC-847145727,19,18.76,57624.79,1.0,CUS-1609060617,2018-09-11,Michael,M,-31.92,115.90,,dbf44e06-ee8c-4b3a-9741-ac02f82cfe1c,-32.09,115.87,WA,Jandakot,debit,authorized,78bf8427168f48389015446b57694692,SALES-POS,<20,2018,9,11,17,53,Tuesday,14 days,74427.15
ACC-847145727,19,18.77,57606.02,1.0,CUS-1609060617,2018-09-12,Michael,M,-31.92,115.90,,2f276a34-0b5b-4b0c-b4f5-3cf05286dad9,-32.41,152.21,NSW,Bulahdelah,debit,authorized,a9d44a824a0f4088a83be6937a1bbd5e,POS,<20,2018,9,12,1,36,Wednesday,14 days,74427.15
ACC-847145727,19,133.0,57473.02,,CUS-1609060617,2018-09-12,Michael,M,-31.92,115.90,,,,,,,debit,posted,1e238089f5784ee783a7cc675a735312,PAYMENT,<20,2018,9,12,11,0,Wednesday,14 days,74427.15
ACC-847145727,19,13.87,57459.15,1.0,CUS-1609060617,2018-09-13,Michael,M,-31.92,115.90,,8d1075d3-05c6-4a8b-8e97-6171a08a5921,-31.89,116.77,WA,York,debit,authorized,e76d82b62535488a807db2c049abe446,SALES-POS,<20,2018,9,13,13,39,Thursday,14 days,74427.15
ACC-847145727,19,50.16,57408.99,1.0,CUS-1609060617,2018-09-14,Michael,M,-31.92,115.90,,1d0f5513-3654-4aaf-a3d8-762a0016fad8,-31.87,115.76,WA,Trigg,debit,authorized,4943b46650c04775a4420bfb68398534,SALES-POS,<20,2018,9,14,22,30,Friday,14 days,74427.15
ACC-847145727,19,453.89,56955.1,0.0,CUS-1609060617,2018-09-16,Michael,M,-31.92,115.90,,d00d2c9a-883a-4564-806f-54b6533d5472,-33.87,151.21,NSW,Sydney,debit,authorized,f47e71b77aad4060a884da4d27286135,SALES-POS,<20,2018,9,16,21,35,Sunday,14 days,74427.15
ACC-847145727,19,151.0,56804.1,,CUS-1609060617,2018-09-17,Michael,M,-31.92,115.90,,,,,,,debit,posted,a3798da224f6436a8ff0112f439e9e9f,PAYMENT,<20,2018,9,17,7,0,Monday,14 days,74427.15
ACC-847145727,19,37.0,56767.1,,CUS-1609060617,2018-09-17,Michael,M,-31.92,115.90,,,,,,,debit,posted,fb4fb80ed240487195cc488f1a0f70e6,PAYMENT,<20,2018,9,17,11,0,Monday,14 days,74427.15
ACC-847145727,19,37.0,56730.1,,CUS-1609060617,2018-09-24,Michael,M,-31.92,115.90,,,,,,,debit,posted,67834b496fd04ce488b416998e85a319,PAYMENT,<20,2018,9,24,11,0,Monday,14 days,74427.15
ACC-847145727,19,37.0,59547.84,,CUS-1609060617,2018-10-01,Michael,M,-31.92,115.90,,,,,,,debit,posted,b04448ac059c47a5bfda6109c0c7572e,PAYMENT,<20,2018,10,1,11,0,Monday,14 days,74427.15
ACC-847145727,19,9.78,59538.06,1.0,CUS-1609060617,2018-10-02,Michael,M,-31.92,115.90,,a042656e-c4b2-46a1-9c82-7adf0b3f564e,-31.95,115.86,WA,Perth,debit,authorized,107f05b6d69c46d2aa20fc0a250809a9,SALES-POS,<20,2018,10,2,11,46,Tuesday,14 days,74427.15
ACC-847145727,19,63.87,59474.19,1.0,CUS-1609060617,2018-10-02,Michael,M,-31.92,115.90,,5017be3f-42fa-429d-9da4-b4dd3274affb,-32.1,115.8,WA,Bibra Lake,debit,authorized,bbb4ade02979478da4776a07ea63dbd1,SALES-POS,<20,2018,10,2,14,19,Tuesday,14 days,74427.15
ACC-847145727,19,46.21,59427.98,1.0,CUS-1609060617,2018-10-02,Michael,M,-31.92,115.90,,5c3c4324-8954-4b5d-9e9b-5d9ee78f0902,-31.9,115.76,WA,Scarborough,debit,authorized,5fa709b1d4ba459ca315f1a516a4d73e,POS,<20,2018,10,2,14,54,Tuesday,14 days,74427.15
ACC-847145727,19,114.11,59313.87,1.0,CUS-1609060617,2018-10-02,Michael,M,-31.92,115.90,,fbb901d4-6d0d-4b7a-9b4e-82cd9ec119d5,-31.87,115.86,WA,Mirrabooka,debit,authorized,6e1e9c0c31ce42a3b32997fbc998e58b,POS,<20,2018,10,2,15,42,Tuesday,14 days,74427.15
ACC-847145727,19,79.89,59233.98,1.0,CUS-1609060617,2018-10-02,Michael,M,-31.92,115.90,,f1fce50d-8d6d-484a-aaa5-1f67f6bcb6a4,-31.77,115.78,WA,Edgewater,debit,authorized,183612b6255a42b780b8b83cdf02405a,POS,<20,2018,10,2,17,19,Tuesday,14 days,74427.15
ACC-847145727,19,7.85,59226.13,1.0,CUS-1609060617,2018-10-04,Michael,M,-31.92,115.90,,b32f49bc-dc89-4461-aad3-3aa25b0121a9,-31.8,115.83,WA,Wangara,debit,authorized,ab00237c779345a4aceda707cafae29a,POS,<20,2018,10,4,8,12,Thursday,14 days,74427.15
ACC-847145727,19,123.0,59103.13,,CUS-1609060617,2018-10-05,Michael,M,-31.92,115.90,,,,,,,debit,posted,6de182d9234d418f82c16774c5ae7179,INTER BANK,<20,2018,10,5,6,0,Friday,14 days,74427.15
ACC-847145727,19,109.0,58994.13,,CUS-1609060617,2018-10-05,Michael,M,-31.92,115.90,,,,,,,debit,posted,e97f3ce7537f4fa09dc240882e846596,PAYMENT,<20,2018,10,5,11,0,Friday,14 days,74427.15
ACC-847145727,19,53.29,58940.84,1.0,CUS-1609060617,2018-10-06,Michael,M,-31.92,115.90,,58cd3120-ac03-4968-9c6d-0f3523469769,-31.97,152.58,NSW,Old Bar,debit,authorized,61ac5c82855e4302a1195cc6c6d2ab4b,SALES-POS,<20,2018,10,6,21,52,Saturday,14 days,74427.15
ACC-847145727,19,82.08,58858.76,1.0,CUS-1609060617,2018-10-06,Michael,M,-31.92,115.90,,fc01efdd-0bf4-4b5d-aa1b-c48ce9bed120,-33.87,151.21,NSW,Sydney,debit,authorized,d65a0b627c8a4a8f9cd4e9a54bef969c,POS,<20,2018,10,6,23,9,Saturday,14 days,74427.15
ACC-847145727,19,43.89,58814.87,1.0,CUS-1609060617,2018-10-06,Michael,M,-31.92,115.90,,667ea255-c7b0-439a-bc9b-0e10b7bcaf33,-32.09,115.91,WA,Canning Vale,debit,authorized,6ce0187250af4ca9887dae1974e28d18,SALES-POS,<20,2018,10,6,23,35,Saturday,14 days,74427.15
ACC-847145727,19,37.0,58777.87,,CUS-1609060617,2018-10-08,Michael,M,-31.92,115.90,,,,,,,debit,posted,1c3a192e06364ffa93784828e1b11527,PAYMENT,<20,2018,10,8,11,0,Monday,14 days,74427.15
ACC-847145727,19,10.24,61622.37,1.0,CUS-1609060617,2018-10-09,Michael,M,-31.92,115.90,,2ae365f3-25c8-4c87-8d16-065834f2f69d,-31.94,115.83,WA,Subiaco,debit,authorized,0ee10d2e326143fb98dbca8cdfa42801,SALES-POS,<20,2018,10,9,9,19,Tuesday,14 days,74427.15
ACC-847145727,19,133.0,61489.37,,CUS-1609060617,2018-10-12,Michael,M,-31.92,115.90,,,,,,,debit,posted,8285d2c184004dc89e8c2c84770e28f5,PAYMENT,<20,2018,10,12,11,0,Friday,14 days,74427.15
ACC-847145727,19,37.0,61452.37,,CUS-1609060617,2018-10-15,Michael,M,-31.92,115.90,,,,,,,debit,posted,d8798aa2669a4a3cba0d8ca9f0b1c115,PAYMENT,<20,2018,10,15,11,0,Monday,14 days,74427.15
ACC-847145727,19,151.0,61301.37,,CUS-1609060617,2018-10-17,Michael,M,-31.92,115.90,,,,,,,debit,posted,fc415ef64e204a38aea2bf880b9b4c55,PAYMENT,<20,2018,10,17,7,0,Wednesday,14 days,74427.15
ACC-847145727,19,46.33,61255.04,1.0,CUS-1609060617,2018-10-18,Michael,M,-31.92,115.90,,b7336787-56af-415e-9e38-d018b78c8762,-31.9,115.94,WA,Bassendean,debit,authorized,1870ba69cb0a4e15866782aa25c92796,SALES-POS,<20,2018,10,18,0,29,Thursday,14 days,74427.15
ACC-847145727,19,18.17,61236.87,1.0,CUS-1609060617,2018-10-20,Michael,M,-31.92,115.90,,2adaa70e-3522-462a-a64e-b4502c41614b,-31.94,115.84,WA,Leederville,debit,authorized,eea9fddf6e134e57bd5c9531244507fa,SALES-POS,<20,2018,10,20,14,56,Saturday,14 days,74427.15
ACC-847145727,19,169.16,61067.71,1.0,CUS-1609060617,2018-10-20,Michael,M,-31.92,115.90,,4955db00-21af-4b83-8114-6ccddb0bf46a,-31.98,115.8,WA,Nedlands,debit,authorized,de4e964c994546dcb24a30ddf6649c71,POS,<20,2018,10,20,15,15,Saturday,14 days,74427.15
ACC-847145727,19,240.73,60826.98,1.0,CUS-1609060617,2018-10-21,Michael,M,-31.92,115.90,,976e9595-fdf4-4662-aaf2-476681a0291f,-33.87,151.2,NSW,Sydney,debit,authorized,a045e2c9b9a142708679a4392e2e11aa,SALES-POS,<20,2018,10,21,7,57,Sunday,14 days,74427.15
ACC-847145727,19,47.29,60779.69,1.0,CUS-1609060617,2018-10-21,Michael,M,-31.92,115.90,,79b26d70-74d5-4f1c-a5d0-91650431eeac,-31.96,141.46,NSW,Broken Hill,debit,authorized,23a0016abcdb446db38ea2a0ce62fbd9,POS,<20,2018,10,21,17,5,Sunday,14 days,74427.15
ACC-847145727,19,37.0,60742.69,,CUS-1609060617,2018-10-22,Michael,M,-31.92,115.90,,,,,,,debit,posted,376d79fd93fb4262a86a4d1e313665f7,PAYMENT,<20,2018,10,22,11,0,Monday,14 days,74427.15
ACC-847145727,19,53.28,63544.15,1.0,CUS-1609060617,2018-10-23,Michael,M,-31.92,115.90,,f5446956-20a9-4c2f-8df8-3d93ce458ccf,-32.13,133.67,SA,Ceduna,debit,authorized,de052020d806472d81ff333fd4302cf2,SALES-POS,<20,2018,10,23,9,4,Tuesday,14 days,74427.15
ACC-847145727,19,23.88,63520.27,1.0,CUS-1609060617,2018-10-23,Michael,M,-31.92,115.90,,870c9f0e-3c5b-45a1-b611-693c9020b9ed,-31.9,115.89,WA,Morley,debit,authorized,3896bc291ace4a8faf3745719976b6da,SALES-POS,<20,2018,10,23,9,17,Tuesday,14 days,74427.15
ACC-847145727,19,30.75,63489.52,1.0,CUS-1609060617,2018-10-23,Michael,M,-31.92,115.90,,3cd49f10-fdcc-47a6-922a-003eba2420c3,-32.04,115.82,WA,Booragoon,debit,authorized,98fad88d9b0147f1ad19a8fcbbfe67e2,SALES-POS,<20,2018,10,23,14,51,Tuesday,14 days,74427.15
ACC-847145727,19,24.53,63464.99,1.0,CUS-1609060617,2018-10-24,Michael,M,-31.92,115.90,,6096ea3e-85d4-496a-904d-0dd8a0722c85,-32.04,115.85,WA,Brentwood,debit,authorized,18ca4dc86a1c4c73be23074ee315c7a0,POS,<20,2018,10,24,7,3,Wednesday,14 days,74427.15
ACC-847145727,19,11.19,63453.8,1.0,CUS-1609060617,2018-10-24,Michael,M,-31.92,115.90,,58774670-0725-45f2-9b4d-0e30f1d3e8cb,-31.94,116.01,WA,Perth,debit,authorized,a7e75368580444ddb63f8514ff1b0ef7,SALES-POS,<20,2018,10,24,7,49,Wednesday,14 days,74427.15
ACC-847145727,19,84.94,63368.86,0.0,CUS-1609060617,2018-10-24,Michael,M,-31.92,115.90,,550c0b83-5997-4ac2-b699-2e68d81b6655,-31.8,115.75,WA,Hillarys,debit,authorized,0bb6a2d026aa40128a13b34a3402ca36,POS,<20,2018,10,24,15,57,Wednesday,14 days,74427.15
ACC-847145727,19,46.33,63322.53,1.0,CUS-1609060617,2018-10-25,Michael,M,-31.92,115.90,,353f2e6b-4949-490a-8062-adaa1c238790,-31.93,115.81,WA,Wembley,debit,authorized,202d095645aa481d8001c368231bae12,SALES-POS,<20,2018,10,25,6,42,Thursday,14 days,74427.15
ACC-847145727,19,43.92,63278.61,1.0,CUS-1609060617,2018-10-25,Michael,M,-31.92,115.90,,5605b47f-95a3-4928-826d-a1e3a78be850,-32.1,115.78,WA,Spearwood,debit,authorized,3451bfc8fc3c46b9ad263bf056a9b337,SALES-POS,<20,2018,10,25,10,31,Thursday,14 days,74427.15
ACC-847145727,19,37.0,63241.61,,CUS-1609060617,2018-10-29,Michael,M,-31.92,115.90,,,,,,,debit,posted,fe37d67720b744babbcbd8d06654f6f2,PAYMENT,<20,2018,10,29,11,0,Monday,14 days,74427.15
ACC-2828321672,53,6.48,463.96,1.0,CUS-1005756958,2018-08-02,Stephanie,F,-27.51,153.03,,0a1d930e-fed4-4d23-adee-6f46a9ac8bdb,-27.42,153.05,QLD,Clayfield,debit,authorized,498005fec6054a459538a3cb610526e2,POS,50-60,2018,8,2,8,8,Thursday,7 days,50603.079
ACC-2828321672,53,39.95,424.01,1.0,CUS-1005756958,2018-08-02,Stephanie,F,-27.51,153.03,,9bd98735-8b39-4eb1-9226-4624430f74a1,-27.59,151.98,QLD,Rangeville,debit,authorized,7423c4b384ed465a94cad6feeeb5b0bd,SALES-POS,50-60,2018,8,2,21,36,Thursday,7 days,50603.079
ACC-2828321672,53,22.96,401.05,1.0,CUS-1005756958,2018-08-03,Stephanie,F,-27.51,153.03,,392af96c-2a99-45eb-94e8-cddef88e1331,-33.89,151.24,NSW,Woollahra,debit,authorized,8daa0499269146708a05353c12574a69,POS,50-60,2018,8,3,8,27,Friday,7 days,50603.079
ACC-2828321672,53,9.11,391.94,0.0,CUS-1005756958,2018-08-03,Stephanie,F,-27.51,153.03,,cd62798b-8895-4037-99f7-50c70d39abe0,-26.4,153.09,QLD,Noosa Heads,debit,authorized,7a0dfdefa53b4e13ab294840a514dda3,POS,50-60,2018,8,3,9,15,Friday,7 days,50603.079
ACC-2828321672,53,14.65,377.29,1.0,CUS-1005756958,2018-08-03,Stephanie,F,-27.51,153.03,,9533e9e6-f9ea-49b8-b618-c11146028ba5,-27.61,152.79,QLD,Booval,debit,authorized,a92c12e2079f4bd1ac48dbad681395ce,SALES-POS,50-60,2018,8,3,21,51,Friday,7 days,50603.079
ACC-2828321672,53,148.0,229.29,,CUS-1005756958,2018-08-04,Stephanie,F,-27.51,153.03,,,,,,,debit,posted,74bec43b3fd04e34bc6a631ac01c8a7a,PAYMENT,50-60,2018,8,4,4,0,Saturday,7 days,50603.079
ACC-2828321672,53,21.77,207.52,1.0,CUS-1005756958,2018-08-04,Stephanie,F,-27.51,153.03,,1cfa9b18-b47c-4479-9a8b-ab714ac7409a,-26.4,153.06,QLD,Noosaville,debit,authorized,62bd472c624b4d7aba12a05c72cc22f6,SALES-POS,50-60,2018,8,4,5,29,Saturday,7 days,50603.079
ACC-2828321672,53,23.61,183.91,1.0,CUS-1005756958,2018-08-04,Stephanie,F,-27.51,153.03,,fb435e4d-6df1-422e-9324-73c442aaeeab,-26.64,153.07,QLD,Maroochydore,debit,authorized,7625cdeba1a2482fba726bff310328a8,POS,50-60,2018,8,4,21,35,Saturday,7 days,50603.079
ACC-2828321672,53,49.13,134.78,1.0,CUS-1005756958,2018-08-05,Stephanie,F,-27.51,153.03,,c3a9c01d-1171-4234-9fa8-1b3529504a56,-27.45,153.01,QLD,Red Hill,debit,authorized,2dd568512ff84c55a9b7e834c1128620,SALES-POS,50-60,2018,8,5,3,27,Sunday,7 days,50603.079
ACC-2828321672,53,17.89,116.89,1.0,CUS-1005756958,2018-08-05,Stephanie,F,-27.51,153.03,,08f74284-341e-463d-b282-7d8263e1d3b9,-27.56,153.08,QLD,Upper Mount Gravatt,debit,authorized,4fc8940fa62e42c0a4d0faaa5a9a0db4,POS,50-60,2018,8,5,10,8,Sunday,7 days,50603.079
ACC-2828321672,53,16.66,100.23,1.0,CUS-1005756958,2018-08-06,Stephanie,F,-27.51,153.03,,30eaeda0-a350-4df7-b327-0fae3381afd6,-27.23,153.09,QLD,Kippa Ring,debit,authorized,98cb904a78b94b348ad3210060b526f9,SALES-POS,50-60,2018,8,6,9,45,Monday,7 days,50603.079
ACC-2828321672,53,33.7,66.53,1.0,CUS-1005756958,2018-08-07,Stephanie,F,-27.51,153.03,,8bea91a6-d6b5-48ae-9550-7e04f054afad,-27.41,153.03,QLD,Kedron,debit,authorized,ddb1d7e4dccf47838cac4a26192d773c,SALES-POS,50-60,2018,8,7,1,33,Tuesday,7 days,50603.079
ACC-2828321672,53,13.96,52.57,1.0,CUS-1005756958,2018-08-07,Stephanie,F,-27.51,153.03,,0e983d91-5ce0-4c47-9463-8e9f9642b7b6,-30.11,153.18,NSW,Woolgoolga,debit,authorized,055d4ad23d784dfa9ff71b916d159847,SALES-POS,50-60,2018,8,7,10,17,Tuesday,7 days,50603.079
ACC-2828321672,53,11.17,41.4,1.0,CUS-1005756958,2018-08-07,Stephanie,F,-27.51,153.03,,f0f84efb-7f8f-4690-a526-800ecfaf2425,-27.67,152.78,QLD,Ripley,debit,authorized,82622984ad4f42749c8d4a996d8903f9,SALES-POS,50-60,2018,8,7,14,33,Tuesday,7 days,50603.079
ACC-2828321672,53,38.62,973.25,1.0,CUS-1005756958,2018-08-08,Stephanie,F,-27.51,153.03,,6ad817d9-62c1-4ae0-b58e-250def5ff24f,-27.51,152.95,QLD,Kenmore,debit,authorized,da756d85584d432da8deaba3ad1d39f0,POS,50-60,2018,8,8,11,30,Wednesday,7 days,50603.079
ACC-2828321672,53,112.69,860.56,1.0,CUS-1005756958,2018-08-10,Stephanie,F,-27.51,153.03,,ca9fa256-5d60-4cfa-929f-829c89239474,-27.67,153.18,QLD,Loganholme,debit,authorized,d9fa23e4f4d04211bf41ea72eaf83d87,SALES-POS,50-60,2018,8,10,14,30,Friday,7 days,50603.079
ACC-2828321672,53,11.83,848.73,1.0,CUS-1005756958,2018-08-10,Stephanie,F,-27.51,153.03,,37cd09c5-f238-4d32-8a60-03755b38b744,-27.53,153.1,QLD,Mansfield,debit,authorized,d73274a064ee449bbc11eba68fe29eb8,POS,50-60,2018,8,10,16,51,Friday,7 days,50603.079
ACC-2828321672,53,226.82,621.91,1.0,CUS-1005756958,2018-08-11,Stephanie,F,-27.51,153.03,,6d55982d-a0af-4dee-a6b9-bcedff161d6e,-27.27,152.98,QLD,Petrie,debit,authorized,e78a5e856a754849bc256656002e6f7d,SALES-POS,50-60,2018,8,11,11,1,Saturday,7 days,50603.079
ACC-2828321672,53,39.27,582.64,1.0,CUS-1005756958,2018-08-11,Stephanie,F,-27.51,153.03,,76fa93da-71d6-4e07-b627-6bd794a91b5c,-33.94,151.1,NSW,Kingsgrove,debit,authorized,bf13ae2e83924fad932471b8a39ca391,SALES-POS,50-60,2018,8,11,16,39,Saturday,7 days,50603.079
ACC-2828321672,53,22.5,560.14,1.0,CUS-1005756958,2018-08-12,Stephanie,F,-27.51,153.03,,4c04d1fa-e17c-47ee-8a1e-418fdab1d7a3,-27.47,151.95,QLD,Highfields,debit,authorized,e8486bde87f04c58adc3f750d3d65871,SALES-POS,50-60,2018,8,12,8,12,Sunday,7 days,50603.079
ACC-2828321672,53,26.41,533.73,1.0,CUS-1005756958,2018-08-12,Stephanie,F,-27.51,153.03,,d592c161-1bf7-4941-8bfc-30855ae32de9,-27.47,153.07,QLD,Morningside,debit,authorized,97e976c5ef874269b51ffe0fc2564df1,POS,50-60,2018,8,12,9,33,Sunday,7 days,50603.079
ACC-2828321672,53,13.08,520.65,1.0,CUS-1005756958,2018-08-13,Stephanie,F,-27.51,153.03,,d397880f-8fb7-4dea-ad87-acb67828c476,-27.48,153.02,QLD,South Brisbane,debit,authorized,4475ebbe05d64026893a12bf37bcff67,POS,50-60,2018,8,13,18,9,Monday,7 days,50603.079
ACC-2828321672,53,75.25,445.4,1.0,CUS-1005756958,2018-08-14,Stephanie,F,-27.51,153.03,,f3e1f057-7924-4195-aa29-a7706688c4e1,-27.46,153.03,QLD,Spring Hill,debit,authorized,c013ae34b2b84e2d8f75fe5c3bbe196c,SALES-POS,50-60,2018,8,14,11,45,Tuesday,7 days,50603.079
ACC-2828321672,53,17.17,428.23,0.0,CUS-1005756958,2018-08-14,Stephanie,F,-27.51,153.03,,f0e7431c-0605-4143-9ad2-c789c164b49d,-27.7,153.2,QLD,Eagleby,debit,authorized,b95b14cbb7c14d71b6fce7a3c2eda499,POS,50-60,2018,8,14,13,56,Tuesday,7 days,50603.079
ACC-2828321672,53,45.43,1229.61,1.0,CUS-1005756958,2018-08-17,Stephanie,F,-27.51,153.03,,1d5fcc47-f73b-4e3c-b111-56221a1b3384,-27.56,152.91,QLD,Riverhills,debit,authorized,a1fac8b5908f4125973f657d95c8ef84,POS,50-60,2018,8,17,9,10,Friday,7 days,50603.079
ACC-2828321672,53,27.96,1201.65,1.0,CUS-1005756958,2018-08-18,Stephanie,F,-27.51,153.03,,0589c075-346a-481e-a7cb-0ed96c406669,-29.69,152.93,NSW,Grafton,debit,authorized,43039d5dd467452f8741519ee4dcf90e,POS,50-60,2018,8,18,2,41,Saturday,7 days,50603.079
ACC-2828321672,53,68.96,1132.69,0.0,CUS-1005756958,2018-08-18,Stephanie,F,-27.51,153.03,,939bffd8-e25b-48c5-b847-c0533eb188a3,-33.87,151.21,NSW,Sydney,debit,authorized,80ae6bb7c5d54205b9bb4d2cda04c2a1,SALES-POS,50-60,2018,8,18,8,37,Saturday,7 days,50603.079
ACC-2828321672,53,10.65,1122.04,1.0,CUS-1005756958,2018-08-19,Stephanie,F,-27.51,153.03,,d29865e9-e5ea-4ff1-a8d8-eb9cdf4445c5,-27.71,153.19,QLD,Beenleigh,debit,authorized,eb61a71a595546e989d1a3306a45728d,POS,50-60,2018,8,19,0,46,Sunday,7 days,50603.079
ACC-2828321672,53,39.99,1082.05,1.0,CUS-1005756958,2018-08-19,Stephanie,F,-27.51,153.03,,0f0ff857-5b5d-448f-9d22-1bf31cbca5eb,-27.5,153.06,QLD,Coorparoo,debit,authorized,4be09f0ae31843e7a1c2cac53c7bee54,SALES-POS,50-60,2018,8,19,1,27,Sunday,7 days,50603.079
ACC-2828321672,53,11.12,1070.93,1.0,CUS-1005756958,2018-08-20,Stephanie,F,-27.51,153.03,,e9cac696-57f9-4784-8972-2e7f28740972,-27.41,153.06,QLD,Nundah,debit,authorized,20125da5f29744a8bf138b1e916a2742,POS,50-60,2018,8,20,0,11,Monday,7 days,50603.079
ACC-2828321672,53,31.93,1039.0,1.0,CUS-1005756958,2018-08-21,Stephanie,F,-27.51,153.03,,a1427ac2-3ca9-4a6b-9b28-2da614698dec,-27.72,153.2,QLD,Mount Warren Park,debit,authorized,09c102ffcc194d38bea3729f4a07a57b,SALES-POS,50-60,2018,8,21,8,32,Tuesday,7 days,50603.079
ACC-2828321672,53,156.0,883.0,,CUS-1005756958,2018-08-21,Stephanie,F,-27.51,153.03,,,,,,,debit,posted,b324999b2fb949718ef07d135fbeae35,PAYMENT,50-60,2018,8,21,15,0,Tuesday,7 days,50603.079
ACC-2828321672,53,30.65,1822.82,1.0,CUS-1005756958,2018-08-22,Stephanie,F,-27.51,153.03,,06e97ee1-fd6b-499e-92fe-9b1bfac33048,-27.06,153.16,QLD,Bellara,debit,authorized,f330aa93726646358856fd470a2b575f,POS,50-60,2018,8,22,9,6,Wednesday,7 days,50603.079
ACC-2828321672,53,11.76,1811.06,0.0,CUS-1005756958,2018-08-22,Stephanie,F,-27.51,153.03,,5fecdd4a-a0a0-46ec-876f-323b013fce47,-27.53,152.95,QLD,Jindalee,debit,authorized,2e3c8c573af0488891c65e7793546348,POS,50-60,2018,8,22,13,5,Wednesday,7 days,50603.079
ACC-2828321672,53,14.07,1796.99,0.0,CUS-1005756958,2018-08-22,Stephanie,F,-27.51,153.03,,af914cdf-e2bf-404d-924c-d2e4de0b9400,-27.67,152.92,QLD,Springfield Lakes,debit,authorized,43f6c79dbbec4ce19dba54b1c6f3ff76,POS,50-60,2018,8,22,14,30,Wednesday,7 days,50603.079
ACC-2828321672,53,136.96,1660.03,1.0,CUS-1005756958,2018-08-22,Stephanie,F,-27.51,153.03,,b32ff943-79b1-4cf2-ac7f-f7f93b9cf610,-27.47,153.03,QLD,Brisbane City,debit,authorized,24957416fadd468f90cd9c5e5627be7d,SALES-POS,50-60,2018,8,22,15,24,Wednesday,7 days,50603.079
ACC-2828321672,53,19.62,1640.41,0.0,CUS-1005756958,2018-08-23,Stephanie,F,-27.51,153.03,,03af788f-75a5-46be-a23e-68aeafaa3d87,-27.61,153.04,QLD,Algester,debit,authorized,91ad5281edd040be89921eb591d429c5,POS,50-60,2018,8,23,11,11,Thursday,7 days,50603.079
ACC-2828321672,53,202.74,1437.67,1.0,CUS-1005756958,2018-08-23,Stephanie,F,-27.51,153.03,,06bf749a-1db8-41fc-9f26-eb1683974516,-27.45,153.04,QLD,Fortitude Valley,debit,authorized,edc1201fa39f4796aa352f43f2fa60aa,POS,50-60,2018,8,23,22,9,Thursday,7 days,50603.079
ACC-2828321672,53,182.0,1255.67,,CUS-1005756958,2018-08-25,Stephanie,F,-27.51,153.03,,,,,,,debit,posted,faafab07e87f4639936f6faa418bd9ed,PHONE BANK,50-60,2018,8,25,4,0,Saturday,7 days,50603.079
ACC-2828321672,53,22.96,1232.71,1.0,CUS-1005756958,2018-08-25,Stephanie,F,-27.51,153.03,,eac8ac0c-17f2-482e-ae36-0d596d4a2a4a,-27.53,153.27,QLD,Cleveland,debit,authorized,c5e196aa01e9461faad155a0fcda05b6,POS,50-60,2018,8,25,9,44,Saturday,7 days,50603.079
ACC-2828321672,53,28.31,1204.4,1.0,CUS-1005756958,2018-08-25,Stephanie,F,-27.51,153.03,,bffb6c3a-5dfa-4422-bb30-49c0f9d38c62,-27.41,152.99,QLD,Everton Park,debit,authorized,76407bad260f472da76a4b4770a5676f,POS,50-60,2018,8,25,10,56,Saturday,7 days,50603.079
ACC-2828321672,53,19.96,1184.44,1.0,CUS-1005756958,2018-08-25,Stephanie,F,-27.51,153.03,,78dadc29-bcee-4c16-992b-7e77841b166e,-27.45,152.95,QLD,Brisbane,debit,authorized,3401a2088e3d494fa10a22c7947b0857,SALES-POS,50-60,2018,8,25,15,59,Saturday,7 days,50603.079
ACC-2828321672,53,14.67,1169.77,1.0,CUS-1005756958,2018-08-25,Stephanie,F,-27.51,153.03,,3642f4e7-d0a9-41bb-a93b-f10b83dc2bdf,-27.42,153.02,QLD,Lutwyche,debit,authorized,501740ffdff747e09776d776d80331be,POS,50-60,2018,8,25,20,27,Saturday,7 days,50603.079
ACC-2828321672,53,7.17,1162.6,1.0,CUS-1005756958,2018-08-25,Stephanie,F,-27.51,153.03,,c95626b3-f07e-4087-b471-28daf712da5f,-30.32,153.11,NSW,Coffs Harbour,debit,authorized,b1552ed602554b6e9f42bdd11a14743b,SALES-POS,50-60,2018,8,25,20,48,Saturday,7 days,50603.079
ACC-2828321672,53,33.93,1128.67,1.0,CUS-1005756958,2018-08-26,Stephanie,F,-27.51,153.03,,e5aa64b5-d1a4-4b77-b3cc-12fb61481e9c,-30.05,152.98,NSW,Glenreagh,debit,authorized,d333f490293c472e91bb9de8771d2bc0,SALES-POS,50-60,2018,8,26,6,44,Sunday,7 days,50603.079
ACC-2828321672,53,128.0,1971.14,,CUS-1005756958,2018-08-28,Stephanie,F,-27.51,153.03,,,,,,,debit,posted,5cad6107b097460d8f2bac10ddc8ae41,PAYMENT,50-60,2018,8,28,17,0,Tuesday,7 days,50603.079
ACC-2828321672,53,148.0,1823.14,,CUS-1005756958,2018-09-04,Stephanie,F,-27.51,153.03,,,,,,,debit,posted,79e4871a99764d52ae22d2f56841f3aa,PAYMENT,50-60,2018,9,4,4,0,Tuesday,7 days,50603.079
ACC-2828321672,53,17.39,2776.22,0.0,CUS-1005756958,2018-09-10,Stephanie,F,-27.51,153.03,,81580c88-c3bf-42fa-9121-ca550a0db9e9,-27.45,153.04,QLD,Newstead,debit,authorized,23d458b00cbf4f2c962f1dc729c008dc,POS,50-60,2018,9,10,10,31,Monday,7 days,50603.079
ACC-2828321672,53,29.17,2747.05,0.0,CUS-1005756958,2018-09-11,Stephanie,F,-27.51,153.03,,251499c5-16bf-4ea8-9424-314ffbefa772,-31.48,152.91,NSW,Port Macquarie South,debit,authorized,823f8fd36dda46baa2b3a9c8862d07bf,SALES-POS,50-60,2018,9,11,15,2,Tuesday,7 days,50603.079
ACC-2828321672,53,24.47,3693.05,1.0,CUS-1005756958,2018-09-11,Stephanie,F,-27.51,153.03,,e5728470-bf30-4467-86cf-33bf03578de1,-27.56,152.28,QLD,Gatton,debit,authorized,dae266158d114d2d98c02f91b21ba79f,POS,50-60,2018,9,11,18,19,Tuesday,7 days,50603.079
ACC-2828321672,53,47.12,3645.93,1.0,CUS-1005756958,2018-09-12,Stephanie,F,-27.51,153.03,,d9fc7e95-b5a1-4d35-bf83-2d1d9502a160,-27.38,153.03,QLD,Chermside,debit,authorized,90a84e5475e34154a9e1224adc655536,POS,50-60,2018,9,12,8,48,Wednesday,7 days,50603.079
ACC-2828321672,53,31.93,3614.0,0.0,CUS-1005756958,2018-09-12,Stephanie,F,-27.51,153.03,,f36be4b6-ba26-42bd-9412-4a05042cc7fa,-27.56,153.08,QLD,Upper Mount Gravatt,debit,authorized,55e3cbcc19e7497c8fc28cca7648ff95,POS,50-60,2018,9,12,11,1,Wednesday,7 days,50603.079
ACC-2828321672,53,17.26,3596.74,1.0,CUS-1005756958,2018-09-13,Stephanie,F,-27.51,153.03,,3174ce1c-7f3b-4852-99d1-33abf1bcfb90,-31.43,152.89,NSW,Port Macquarie,debit,authorized,1db6d9f999d64db8af3b04cfc61dbab3,SALES-POS,50-60,2018,9,13,9,55,Thursday,7 days,50603.079
ACC-2828321672,53,156.0,4411.21,,CUS-1005756958,2018-09-21,Stephanie,F,-27.51,153.03,,,,,,,debit,posted,c055b7b395e6435a80c7a76bbb7cf9d5,PAYMENT,50-60,2018,9,21,15,0,Friday,7 days,50603.079
ACC-2828321672,53,182.0,4229.21,,CUS-1005756958,2018-09-25,Stephanie,F,-27.51,153.03,,,,,,,debit,posted,3ca0da4a9a774981a2433428e8c6030a,PHONE BANK,50-60,2018,9,25,4,0,Tuesday,7 days,50603.079
ACC-2828321672,53,128.0,5071.68,,CUS-1005756958,2018-09-28,Stephanie,F,-27.51,153.03,,,,,,,debit,posted,78765e29708f4b3a8c4058198ee8698f,PAYMENT,50-60,2018,9,28,17,0,Friday,7 days,50603.079
ACC-2828321672,53,148.0,5894.15,,CUS-1005756958,2018-10-04,Stephanie,F,-27.51,153.03,,,,,,,debit,posted,bbf418c72eb345c8b3ef9326afec31af,PAYMENT,50-60,2018,10,4,4,0,Thursday,7 days,50603.079
ACC-2828321672,53,156.0,7679.09,,CUS-1005756958,2018-10-21,Stephanie,F,-27.51,153.03,,,,,,,debit,posted,2f8f9256249940c6977eb1ac8feb1ffa,PAYMENT,50-60,2018,10,21,15,0,Sunday,7 days,50603.079
ACC-2828321672,53,182.0,8467.56,,CUS-1005756958,2018-10-25,Stephanie,F,-27.51,153.03,,,,,,,debit,posted,c6f9f40883324bb8a0e30eb7d1ccbbbe,PHONE BANK,50-60,2018,10,25,4,0,Thursday,7 days,50603.079
ACC-2828321672,53,128.0,8339.56,,CUS-1005756958,2018-10-28,Stephanie,F,-27.51,153.03,,,,,,,debit,posted,1edb483f69d346bca90551ffd166ad61,PAYMENT,50-60,2018,10,28,17,0,Sunday,7 days,50603.079
ACC-3084464802,19,25.7,842.07,0.0,CUS-1928710999,2018-08-02,Susan,F,-37.76,145.15,,4b2fbc4b-533f-4084-8cd8-02132e2acea0,-37.62,145.03,VIC,Wollert,debit,authorized,90871d246cdb43729146ab6ccb78d9ae,POS,<20,2018,8,2,9,3,Thursday,14 days,64797.146
ACC-3084464802,19,18.2,823.87,1.0,CUS-1928710999,2018-08-02,Susan,F,-37.76,145.15,,ffb84541-d4df-49f9-87c0-7b0b7a7eb791,-37.58,144.73,VIC,Sunbury,debit,authorized,297858aca29c4fd293a738e83b7b4904,SALES-POS,<20,2018,8,2,14,45,Thursday,14 days,64797.146
ACC-3084464802,19,76.0,747.87,,CUS-1928710999,2018-08-04,Susan,F,-37.76,145.15,,,,,,,debit,posted,bd7fe4d587354612be66b483f2fade84,INTER BANK,<20,2018,8,4,6,0,Saturday,14 days,64797.146
ACC-3084464802,19,24.0,723.87,,CUS-1928710999,2018-08-06,Susan,F,-37.76,145.15,,,,,,,debit,posted,192aa35b29b34a919c2b777db653ec6b,INTER BANK,<20,2018,8,6,3,0,Monday,14 days,64797.146
ACC-3084464802,19,36.0,687.87,,CUS-1928710999,2018-08-06,Susan,F,-37.76,145.15,,,,,,,debit,posted,066672003ec840be8287024ef2b3ec2f,PAYMENT,<20,2018,8,6,17,0,Monday,14 days,64797.146
ACC-3084464802,19,24.0,3149.24,,CUS-1928710999,2018-08-13,Susan,F,-37.76,145.15,,,,,,,debit,posted,f03aedf0aa2a4186b67dbbb664afcbb2,INTER BANK,<20,2018,8,13,3,0,Monday,14 days,64797.146
ACC-3084464802,19,36.0,3113.24,,CUS-1928710999,2018-08-13,Susan,F,-37.76,145.15,,,,,,,debit,posted,abf0599af52140d390596cc9a7c2f209,PAYMENT,<20,2018,8,13,17,0,Monday,14 days,64797.146
ACC-3084464802,19,15.54,3097.7,1.0,CUS-1928710999,2018-08-14,Susan,F,-37.76,145.15,,9037452d-e11c-48c9-a708-4667be7ed5d5,-37.78,144.97,VIC,Brunswick East,debit,authorized,5579896ceb3b4df58d865d53acfbc727,SALES-POS,<20,2018,8,14,16,25,Tuesday,14 days,64797.146
ACC-3084464802,19,123.0,2974.7,,CUS-1928710999,2018-08-14,Susan,F,-37.76,145.15,,,,,,,debit,posted,7f41642112f14481b0d09517ebf824eb,PAYMENT,<20,2018,8,14,23,0,Tuesday,14 days,64797.146
ACC-3084464802,19,80.12,2894.58,1.0,CUS-1928710999,2018-08-15,Susan,F,-37.76,145.15,,eba5d2b2-cef3-42e4-94b0-419de48453a4,-37.96,145.05,VIC,Cheltenham,debit,authorized,e9bfd93e2d7d42ef8a5923d17e1c9cd1,POS,<20,2018,8,15,8,33,Wednesday,14 days,64797.146
ACC-3084464802,19,8.09,2886.49,1.0,CUS-1928710999,2018-08-15,Susan,F,-37.76,145.15,,683e2ebd-865e-490d-98d2-18e77c9615e1,-37.76,145.35,VIC,Lilydale,debit,authorized,127a3b4c007848b8972746682d134e8b,SALES-POS,<20,2018,8,15,9,17,Wednesday,14 days,64797.146
ACC-3084464802,19,29.58,2856.91,1.0,CUS-1928710999,2018-08-15,Susan,F,-37.76,145.15,,4c2bef46-6b43-4b1b-be8f-240c86b8035c,-37.88,145.26,VIC,Knoxfield,debit,authorized,f747b0a72c6245acbbf4d8d45dedc6fe,POS,<20,2018,8,15,15,45,Wednesday,14 days,64797.146
ACC-3084464802,19,37.02,2784.13,1.0,CUS-1928710999,2018-08-17,Susan,F,-37.76,145.15,,dd2f7c66-f3f9-4b71-bde3-3f86cbef3b12,-37.82,144.96,VIC,Melbourne,debit,authorized,6573f2d9500443749826fdbc9fb0b673,SALES-POS,<20,2018,8,17,21,18,Friday,14 days,64797.146
ACC-3084464802,19,24.0,2760.13,,CUS-1928710999,2018-08-20,Susan,F,-37.76,145.15,,,,,,,debit,posted,f1400cc2c29d4b6e99411c5e723b8261,INTER BANK,<20,2018,8,20,3,0,Monday,14 days,64797.146
ACC-3084464802,19,36.0,2724.13,,CUS-1928710999,2018-08-20,Susan,F,-37.76,145.15,,,,,,,debit,posted,804425aacdf54111869e8aa689d88b82,PAYMENT,<20,2018,8,20,17,0,Monday,14 days,64797.146
ACC-3084464802,19,16.45,5193.05,1.0,CUS-1928710999,2018-08-24,Susan,F,-37.76,145.15,,ace20424-f9d3-4cce-809d-a3a6b29da7fc,-37.88,144.7,VIC,Hoppers Crossing,debit,authorized,4ebd01a1f22f4656b10552114ead2078,SALES-POS,<20,2018,8,24,9,37,Friday,14 days,64797.146
ACC-3084464802,19,23.1,5169.95,1.0,CUS-1928710999,2018-08-25,Susan,F,-37.76,145.15,,afc10575-a978-432c-bf68-a80bc07ccca8,-33.87,151.21,NSW,Sydney,debit,authorized,89eea20a7ec5402f9beeb72d2957c12a,SALES-POS,<20,2018,8,25,10,13,Saturday,14 days,64797.146
ACC-3084464802,19,24.0,5145.95,,CUS-1928710999,2018-08-27,Susan,F,-37.76,145.15,,,,,,,debit,posted,a96cb233c6054721b59e7e39bc2534e0,INTER BANK,<20,2018,8,27,3,0,Monday,14 days,64797.146
ACC-3084464802,19,36.0,5109.95,,CUS-1928710999,2018-08-27,Susan,F,-37.76,145.15,,,,,,,debit,posted,9aaa8afd4efe4e3993c28bc2298afb33,PAYMENT,<20,2018,8,27,17,0,Monday,14 days,64797.146
ACC-3084464802,19,13.04,5096.91,1.0,CUS-1928710999,2018-08-28,Susan,F,-37.76,145.15,,80eaa491-4de7-494a-9f11-afb64ff1dbfa,-37.73,145.07,VIC,Macleod,debit,authorized,54e1c4b9ada34edcb29e279ba5cb3dd6,POS,<20,2018,8,28,9,40,Tuesday,14 days,64797.146
ACC-3084464802,19,9.78,5087.13,1.0,CUS-1928710999,2018-08-29,Susan,F,-37.76,145.15,,57246be2-5a4d-4fbc-ad7c-eb826d12e430,-37.69,144.57,VIC,Melton West,debit,authorized,4dcb64a2b7384921af5b2dd3e0de0fd3,SALES-POS,<20,2018,8,29,9,21,Wednesday,14 days,64797.146
ACC-3084464802,19,9.47,5077.66,1.0,CUS-1928710999,2018-08-29,Susan,F,-37.76,145.15,,34e74076-90f3-4ec8-8df4-af8a36b473bf,-37.81,144.96,VIC,Melbourne,debit,authorized,20b7f5c5e1ff4737af20cfa179d8300b,POS,<20,2018,8,29,16,40,Wednesday,14 days,64797.146
ACC-3084464802,19,18.49,5059.17,1.0,CUS-1928710999,2018-08-30,Susan,F,-37.76,145.15,,3ad1d3a7-f65c-48e9-a2ef-a54b7de31e29,-37.82,144.82,VIC,Laverton North,debit,authorized,c793c7a0a8ba4385bd46968cfeaebee0,SALES-POS,<20,2018,8,30,1,6,Thursday,14 days,64797.146
ACC-3084464802,19,27.08,5032.09,1.0,CUS-1928710999,2018-08-31,Susan,F,-37.76,145.15,,01aa962e-70a1-4e8a-8df2-590e790a00d9,-37.76,145.06,VIC,Heidelberg,debit,authorized,cfb6d9bcb4e148ea995e0d3a06fe5f53,POS,<20,2018,8,31,18,39,Friday,14 days,64797.146
ACC-3084464802,19,177.15,4854.94,1.0,CUS-1928710999,2018-08-31,Susan,F,-37.76,145.15,,3794505f-1ad4-4b8e-9dd1-866311c34481,-37.84,140.78,SA,Mount Gambier,debit,authorized,c4c3fff820ec42a18fa868ac216ad8bf,SALES-POS,<20,2018,8,31,21,29,Friday,14 days,64797.146
ACC-3084464802,19,14.23,4840.71,1.0,CUS-1928710999,2018-09-01,Susan,F,-37.76,145.15,,1e53dd68-faec-440e-81c4-f18cb3eecd76,-37.82,144.96,VIC,Melbourne,debit,authorized,d3081e2c371143a795d93bd3ca9c7372,SALES-POS,<20,2018,9,1,8,20,Saturday,14 days,64797.146
ACC-3084464802,19,32.86,4807.85,1.0,CUS-1928710999,2018-09-01,Susan,F,-37.76,145.15,,91596333-18b9-4045-91a0-6b91cfcc86a5,-37.82,145,VIC,Richmond,debit,authorized,db4612cb6a06443a9163af4c4029347f,SALES-POS,<20,2018,9,1,10,6,Saturday,14 days,64797.146
ACC-3084464802,19,33.03,4774.82,0.0,CUS-1928710999,2018-09-01,Susan,F,-37.76,145.15,,ab7309b7-ad87-4d24-bd87-111c70b56759,-37.84,144.97,VIC,Melbourne,debit,authorized,1865f79880b74c339f0cbaa7d0cf25a3,SALES-POS,<20,2018,9,1,14,15,Saturday,14 days,64797.146
ACC-3084464802,19,15.54,4759.28,1.0,CUS-1928710999,2018-09-02,Susan,F,-37.76,145.15,,6853e2a5-8300-47c8-83b5-3064da462516,-37.76,145.17,VIC,Doncaster East,debit,authorized,3b5bb47355474a77a3ecba7604501a3a,POS,<20,2018,9,2,11,21,Sunday,14 days,64797.146
ACC-3084464802,19,34.02,4725.26,1.0,CUS-1928710999,2018-09-02,Susan,F,-37.76,145.15,,5b6c51c7-5794-46d6-98cb-a6fbf53fb1a4,-37.82,144.96,VIC,Melbourne,debit,authorized,1365792cc9684f1b9056c237ad9b2181,POS,<20,2018,9,2,13,3,Sunday,14 days,64797.146
ACC-3084464802,19,109.51,4615.75,1.0,CUS-1928710999,2018-09-02,Susan,F,-37.76,145.15,,3647e656-341b-4fc7-b46e-d4b5fd2c93d4,-33.9,151.2,NSW,Alexandria,debit,authorized,f5a19992e21b4d10a183737c41417533,POS,<20,2018,9,2,16,51,Sunday,14 days,64797.146
ACC-3084464802,19,27.21,4588.54,1.0,CUS-1928710999,2018-09-02,Susan,F,-37.76,145.15,,042f2b17-e4bc-48a8-9537-ffef2838d3dd,-37.84,145.16,VIC,Forest Hill,debit,authorized,5d1f337fcfd14e7aa9e6e90a9106b1d2,SALES-POS,<20,2018,9,2,22,58,Sunday,14 days,64797.146
ACC-3084464802,19,24.0,4564.54,,CUS-1928710999,2018-09-03,Susan,F,-37.76,145.15,,,,,,,debit,posted,da48342d5138451b8c08c30339ccfaaa,INTER BANK,<20,2018,9,3,3,0,Monday,14 days,64797.146
ACC-3084464802,19,36.0,4528.54,,CUS-1928710999,2018-09-03,Susan,F,-37.76,145.15,,,,,,,debit,posted,7003547609e145838bebd0bbbf9f2eda,PAYMENT,<20,2018,9,3,17,0,Monday,14 days,64797.146
ACC-3084464802,19,76.0,4452.54,,CUS-1928710999,2018-09-04,Susan,F,-37.76,145.15,,,,,,,debit,posted,821b9b014d7146bc926ce1e4a11e85d9,INTER BANK,<20,2018,9,4,6,0,Tuesday,14 days,64797.146
ACC-3084464802,19,21.08,6916.83,1.0,CUS-1928710999,2018-09-09,Susan,F,-37.76,145.15,,eb106b8b-8a54-4c81-b110-5c006d2e0e05,-37.82,145.22,VIC,Ringwood,debit,authorized,c50a06f7f7ce41cf9a420ec9b872c53d,POS,<20,2018,9,9,15,36,Sunday,14 days,64797.146
ACC-3084464802,19,24.0,6892.83,,CUS-1928710999,2018-09-10,Susan,F,-37.76,145.15,,,,,,,debit,posted,7fab1709dbb743aca75ebe9073041271,INTER BANK,<20,2018,9,10,3,0,Monday,14 days,64797.146
ACC-3084464802,19,36.0,6856.83,,CUS-1928710999,2018-09-10,Susan,F,-37.76,145.15,,,,,,,debit,posted,86ef2c01088f49ac87adb9c7772bd59d,PAYMENT,<20,2018,9,10,17,0,Monday,14 days,64797.146
ACC-3084464802,19,21.4,6835.43,1.0,CUS-1928710999,2018-09-12,Susan,F,-37.76,145.15,,2d292a1b-d6fb-45ab-a605-287d1994b515,-37.81,144.96,VIC,Melbourne,debit,authorized,3ed0609c4c0f49dea52b3f7f8dd0019d,SALES-POS,<20,2018,9,12,11,36,Wednesday,14 days,64797.146
ACC-3084464802,19,22.43,6813.0,0.0,CUS-1928710999,2018-09-12,Susan,F,-37.76,145.15,,0117c644-de6b-42ac-ade4-a2eaedb5e78c,-37.87,144.99,VIC,Balaclava,debit,authorized,ea8e2cdcae394072bdc06749179a56fa,POS,<20,2018,9,12,13,47,Wednesday,14 days,64797.146
ACC-3084464802,19,26.44,6786.56,1.0,CUS-1928710999,2018-09-12,Susan,F,-37.76,145.15,,a063e596-233a-4c00-a910-8dfbf146ecca,-37.76,145.31,VIC,Chirnside Park,debit,authorized,72fc6de818f84dbbaf78873e93970b5c,SALES-POS,<20,2018,9,12,17,12,Wednesday,14 days,64797.146
ACC-3084464802,19,1066.0,5720.56,,CUS-1928710999,2018-09-12,Susan,F,-37.76,145.15,,,,,,,debit,posted,03344083122c4ccca306fd40cb280bd5,PAYMENT,<20,2018,9,12,19,0,Wednesday,14 days,64797.146
ACC-3084464802,19,8.38,5712.18,0.0,CUS-1928710999,2018-09-12,Susan,F,-37.76,145.15,,6eb62c10-2845-4d88-900a-4be92df6646d,-37.76,145.35,VIC,Lilydale,debit,authorized,c1fa5e8dd8a44b73bfeebb378552a1d4,SALES-POS,<20,2018,9,12,23,41,Wednesday,14 days,64797.146
ACC-3084464802,19,16.94,5695.24,0.0,CUS-1928710999,2018-09-13,Susan,F,-37.76,145.15,,ba875c12-e736-4688-bc3c-b577d5abf55c,-37.78,145.53,VIC,Woori Yallock,debit,authorized,ad035736e49341e98037e1f95a9b4dba,SALES-POS,<20,2018,9,13,0,7,Thursday,14 days,64797.146
ACC-3084464802,19,6.71,5688.53,0.0,CUS-1928710999,2018-09-13,Susan,F,-37.76,145.15,,0b5b8661-5fd3-480b-83ca-889afec8c716,-37.81,145.23,VIC,Ringwood,debit,authorized,ec383a4e7a1e466cafbf55b1ebe5f76a,POS,<20,2018,9,13,9,9,Thursday,14 days,64797.146
ACC-3084464802,19,43.16,5645.37,1.0,CUS-1928710999,2018-09-13,Susan,F,-37.76,145.15,,f3d2df7c-4c9a-4f88-931c-fa5ff1cca58c,-37.88,145,VIC,Ripponlea,debit,authorized,99f9005c2b674369a0bb22ee5b1bb6a2,SALES-POS,<20,2018,9,13,15,7,Thursday,14 days,64797.146
ACC-3084464802,19,123.0,5522.37,,CUS-1928710999,2018-09-14,Susan,F,-37.76,145.15,,,,,,,debit,posted,e883fa7c466c416aab1aec644b4bbd33,PAYMENT,<20,2018,9,14,23,0,Friday,14 days,64797.146
ACC-3084464802,19,35.84,5486.53,1.0,CUS-1928710999,2018-09-15,Susan,F,-37.76,145.15,,39ff1275-e6f1-4295-b197-a3f43f7ca2ce,-37.77,144.95,VIC,Brunswick West,debit,authorized,a3a38e31ca744dd9ac641a7acc7c5ab9,SALES-POS,<20,2018,9,15,16,55,Saturday,14 days,64797.146
ACC-3084464802,19,19.29,5467.24,1.0,CUS-1928710999,2018-09-16,Susan,F,-37.76,145.15,,2b6cd42f-f05c-4ea0-827b-264afe6dd800,-37.87,145.02,VIC,Caulfield North,debit,authorized,c9629eba8ef745d4a4032579e0bc34d9,POS,<20,2018,9,16,8,57,Sunday,14 days,64797.146
ACC-3084464802,19,24.0,5443.24,,CUS-1928710999,2018-09-17,Susan,F,-37.76,145.15,,,,,,,debit,posted,d0f0d9bf8c74432a848fd91517687611,INTER BANK,<20,2018,9,17,3,0,Monday,14 days,64797.146
ACC-3084464802,19,36.0,5407.24,,CUS-1928710999,2018-09-17,Susan,F,-37.76,145.15,,,,,,,debit,posted,995e97f3421e4fe5b462a476929ee025,PAYMENT,<20,2018,9,17,17,0,Monday,14 days,64797.146
ACC-3084464802,19,14.32,5392.92,1.0,CUS-1928710999,2018-09-17,Susan,F,-37.76,145.15,,7fbd6363-a171-4ce6-ad92-c59fd7991396,-33.86,151.06,NSW,Lidcombe,debit,authorized,0c47d821aff6488db9ff512898541ca6,POS,<20,2018,9,17,22,17,Monday,14 days,64797.146
ACC-3084464802,19,77.19,5315.73,1.0,CUS-1928710999,2018-09-19,Susan,F,-37.76,145.15,,46a57a24-c922-4ed2-96c6-e012b4e2c8d3,-33.88,151.21,NSW,SYDNEY,debit,authorized,9f1f48ea3cc549d48a11560988658627,POS,<20,2018,9,19,10,18,Wednesday,14 days,64797.146
ACC-3084464802,19,10.67,7790.43,1.0,CUS-1928710999,2018-09-19,Susan,F,-37.76,145.15,,08ecf547-7c8e-4a48-8b3b-4bc73ef65c02,-37.81,140.79,SA,Mount Gambier,debit,authorized,b7927e2e27e54c1ab7875af98b581a9f,SALES-POS,<20,2018,9,19,14,4,Wednesday,14 days,64797.146
ACC-3084464802,19,22.14,7768.29,1.0,CUS-1928710999,2018-09-20,Susan,F,-37.76,145.15,,62d827c0-2d51-4959-b917-997e8e70edd4,-37.71,145.15,VIC,Eltham,debit,authorized,397ab53ebc6749b7a35cf923d0f0c806,POS,<20,2018,9,20,11,45,Thursday,14 days,64797.146
ACC-3084464802,19,23.56,7744.73,0.0,CUS-1928710999,2018-09-20,Susan,F,-37.76,145.15,,a97685c3-4402-4767-8f87-5aba91a3d177,-37.99,145.17,VIC,Keysborough,debit,authorized,c0ab27f4424846d4b0f34d835bab4b3f,POS,<20,2018,9,20,13,40,Thursday,14 days,64797.146
ACC-3084464802,19,18.74,7725.99,0.0,CUS-1928710999,2018-09-20,Susan,F,-37.76,145.15,,2a114f24-eba6-4627-8eff-cb3621ad7099,-37.87,144.99,VIC,Balaclava,debit,authorized,55340531510b4a5c9bdb0df5f1761fc8,SALES-POS,<20,2018,9,20,15,6,Thursday,14 days,64797.146
ACC-3084464802,19,6.02,7719.97,1.0,CUS-1928710999,2018-09-20,Susan,F,-37.76,145.15,,6482805d-491b-4f43-89ac-123404c0faee,-37.76,145.03,VIC,Thornbury,debit,authorized,af792d325d15415cb162689168e98650,POS,<20,2018,9,20,23,10,Thursday,14 days,64797.146
ACC-3084464802,19,21.35,7698.62,1.0,CUS-1928710999,2018-09-23,Susan,F,-37.76,145.15,,4fb886c1-68b2-418d-9e18-818489c48831,-37.9,145.16,VIC,Glen Waverley,debit,authorized,db9758613ab74f5ca9ce00032d2211ad,POS,<20,2018,9,23,13,40,Sunday,14 days,64797.146
ACC-3084464802,19,24.79,7673.83,0.0,CUS-1928710999,2018-09-23,Susan,F,-37.76,145.15,,83da3ff7-17a2-404e-bfc4-65b32d957da5,-37.78,144.96,VIC,Brunswick,debit,authorized,d778bae10cbe4a1ba891f34e86f30cb0,SALES-POS,<20,2018,9,23,15,30,Sunday,14 days,64797.146
ACC-3084464802,19,56.81,7617.02,1.0,CUS-1928710999,2018-09-23,Susan,F,-37.76,145.15,,94416444-d32f-4593-b701-433cda8b583b,-37.81,144.97,VIC,Melbourne,debit,authorized,e12644e9ee2046eea846fa3bb69e9ecb,SALES-POS,<20,2018,9,23,20,37,Sunday,14 days,64797.146
ACC-3084464802,19,24.0,7593.02,,CUS-1928710999,2018-09-24,Susan,F,-37.76,145.15,,,,,,,debit,posted,d78f4e4acef94240a96b5ea20031b031,INTER BANK,<20,2018,9,24,3,0,Monday,14 days,64797.146
ACC-3084464802,19,41.67,7551.35,1.0,CUS-1928710999,2018-09-24,Susan,F,-37.76,145.15,,b0016a1a-83b4-410f-9d1b-f7417d7b4ae8,-37.81,144.96,VIC,Melbourne,debit,authorized,46ced647a8514e778cf0905ba9bcfe44,SALES-POS,<20,2018,9,24,9,18,Monday,14 days,64797.146
ACC-3084464802,19,36.0,7515.35,,CUS-1928710999,2018-09-24,Susan,F,-37.76,145.15,,,,,,,debit,posted,dafae8b5e0d04d999f541c0566230903,PAYMENT,<20,2018,9,24,17,0,Monday,14 days,64797.146
ACC-3084464802,19,18.73,7496.62,1.0,CUS-1928710999,2018-09-25,Susan,F,-37.76,145.15,,f7f1a4c4-9947-47f5-a461-2fed2ca3324c,-37.82,144.96,VIC,Melbourne,debit,authorized,5bc31be1ee5c4ed9b4e8646ea9068c38,SALES-POS,<20,2018,9,25,0,29,Tuesday,14 days,64797.146
ACC-3084464802,19,26.23,7470.39,1.0,CUS-1928710999,2018-09-25,Susan,F,-37.76,145.15,,6e4998a1-2407-4903-923b-51e2ea3b057b,-37.82,145.23,VIC,Ringwood,debit,authorized,8773a98daffa4b4cad918bdade96cf2d,POS,<20,2018,9,25,10,49,Tuesday,14 days,64797.146
ACC-3084464802,19,10.27,7460.12,1.0,CUS-1928710999,2018-09-26,Susan,F,-37.76,145.15,,65d1bee9-8f92-4f08-898c-26ad4ea8940e,-37.81,144.96,VIC,Melbourne,debit,authorized,14124b21718b4af7a996a30de3cba2a5,SALES-POS,<20,2018,9,26,21,23,Wednesday,14 days,64797.146
ACC-3084464802,19,21.32,7438.8,1.0,CUS-1928710999,2018-09-27,Susan,F,-37.76,145.15,,07801472-6840-4ca4-bbbe-0818899cc6c8,-37.8,144.91,VIC,Footscray,debit,authorized,75c9682b9f294dbf92602ee6ee65b591,POS,<20,2018,9,27,18,53,Thursday,14 days,64797.146
ACC-3084464802,19,15.68,7423.12,0.0,CUS-1928710999,2018-09-27,Susan,F,-37.76,145.15,,d61d7ca9-e029-4516-90a9-f3c5a37348f0,-37.76,145.36,VIC,Lilydale,debit,authorized,6822917c195b4c3a88801134b7a48f30,SALES-POS,<20,2018,9,27,22,18,Thursday,14 days,64797.146
ACC-3084464802,19,24.0,7399.12,,CUS-1928710999,2018-10-01,Susan,F,-37.76,145.15,,,,,,,debit,posted,3a565ede90d845d8936af6342e2bc331,INTER BANK,<20,2018,10,1,3,0,Monday,14 days,64797.146
ACC-3084464802,19,36.0,7363.12,,CUS-1928710999,2018-10-01,Susan,F,-37.76,145.15,,,,,,,debit,posted,c81f9f37aec04c32878ae748e7088b70,PAYMENT,<20,2018,10,1,17,0,Monday,14 days,64797.146
ACC-3084464802,19,76.0,9772.49,,CUS-1928710999,2018-10-04,Susan,F,-37.76,145.15,,,,,,,debit,posted,38a2b597a6384a9b859a47e4df151dd1,INTER BANK,<20,2018,10,4,6,0,Thursday,14 days,64797.146
ACC-3084464802,19,60.84,9711.65,1.0,CUS-1928710999,2018-10-07,Susan,F,-37.76,145.15,,c93d3a14-a29c-4fde-b1df-93b331a66ffc,-33.8,151.18,NSW,Chatswood,debit,authorized,b0b9eecf89484d5d899dfe1089744fd2,SALES-POS,<20,2018,10,7,11,2,Sunday,14 days,64797.146
ACC-3084464802,19,17.35,9694.3,0.0,CUS-1928710999,2018-10-07,Susan,F,-37.76,145.15,,272d32b1-9a29-4015-8a33-88bdd81da0d4,-37.82,145.12,VIC,Box Hill,debit,authorized,bad5915a49f741ec8389a2f82affa71d,POS,<20,2018,10,7,13,9,Sunday,14 days,64797.146
ACC-3084464802,19,79.65,9614.65,1.0,CUS-1928710999,2018-10-07,Susan,F,-37.76,145.15,,62765de5-9981-4223-b2d2-1587786e999e,-37.76,145.31,VIC,Chirnside Park,debit,authorized,265180a4b05c402c964820a1c53295f8,SALES-POS,<20,2018,10,7,14,43,Sunday,14 days,64797.146
ACC-3084464802,19,31.58,9583.07,1.0,CUS-1928710999,2018-10-07,Susan,F,-37.76,145.15,,99aeb1f4-0368-4238-820f-eb95e49b128c,-38.06,145.12,VIC,Chelsea,debit,authorized,124c4890546d4fd6bf44a16cd9ad662a,POS,<20,2018,10,7,19,15,Sunday,14 days,64797.146
ACC-3084464802,19,24.0,9559.07,,CUS-1928710999,2018-10-08,Susan,F,-37.76,145.15,,,,,,,debit,posted,2a31bf99378541af8b1d5bdbb823500f,INTER BANK,<20,2018,10,8,3,0,Monday,14 days,64797.146
ACC-3084464802,19,36.0,9502.38,,CUS-1928710999,2018-10-08,Susan,F,-37.76,145.15,,,,,,,debit,posted,c9990532ae834d96be8288ade026f85e,PAYMENT,<20,2018,10,8,17,0,Monday,14 days,64797.146
ACC-3084464802,19,20.69,9538.38,1.0,CUS-1928710999,2018-10-08,Susan,F,-37.76,145.15,,37fe8e9e-8581-4972-9348-26f890f02bee,-37.88,145,VIC,Ripponlea,debit,authorized,73177a35fcab457ebea827fb9c20cffc,POS,<20,2018,10,8,17,40,Monday,14 days,64797.146
ACC-3084464802,19,7.59,9494.79,1.0,CUS-1928710999,2018-10-10,Susan,F,-37.76,145.15,,e47ba9b4-955d-49f3-b977-dc2977348d17,-37.81,144.96,VIC,Melbourne,debit,authorized,3bb581288b824009a37db164f005e42f,POS,<20,2018,10,10,14,43,Wednesday,14 days,64797.146
ACC-3084464802,19,14.41,9480.38,1.0,CUS-1928710999,2018-10-10,Susan,F,-37.76,145.15,,0a947b4c-ec71-4a34-8f6b-c58b01104ee3,-37.76,145.31,VIC,Chirnside Park,debit,authorized,6b608310dcb84589b379524ba5efd963,SALES-POS,<20,2018,10,10,15,20,Wednesday,14 days,64797.146
ACC-3084464802,19,56.69,9423.69,0.0,CUS-1928710999,2018-10-11,Susan,F,-37.76,145.15,,f06dad7b-f633-4609-95cb-1e53642bbafb,-37.82,144.89,VIC,Yarraville,debit,authorized,e43b28ecfd0b4305aac05b2b01cbafb2,SALES-POS,<20,2018,10,11,18,32,Thursday,14 days,64797.146
ACC-3084464802,19,11.16,9412.53,1.0,CUS-1928710999,2018-10-14,Susan,F,-37.76,145.15,,8b717010-a410-4319-83a2-99491834adde,-37.8,144.98,VIC,Fitzroy,debit,authorized,c7b2d29643e04553a5a55f7cec647f12,POS,<20,2018,10,14,14,48,Sunday,14 days,64797.146
ACC-3084464802,19,25.72,9386.81,1.0,CUS-1928710999,2018-10-14,Susan,F,-37.76,145.15,,fcd3ad2d-4373-4fc4-a92e-1914da15cb35,-37.76,145,VIC,Thornbury,debit,authorized,9a871b15590e4b4388409cbba6e50065,POS,<20,2018,10,14,14,57,Sunday,14 days,64797.146
ACC-3084464802,19,26.3,9360.51,1.0,CUS-1928710999,2018-10-14,Susan,F,-37.76,145.15,,5ca0af7b-4e68-4c5e-85f4-ccf90bc9f359,-37.71,147.83,VIC,Bruthen,debit,authorized,a0c1327162d0421b960524b533b12812,POS,<20,2018,10,14,20,51,Sunday,14 days,64797.146
ACC-3084464802,19,16.32,9344.19,1.0,CUS-1928710999,2018-10-14,Susan,F,-37.76,145.15,,5c1478a8-5404-4e83-b0c3-062649022fc4,-37.85,144.99,VIC,Prahran,debit,authorized,02f679a58d8f4fc4ad181f5b5dccf3c5,POS,<20,2018,10,14,21,51,Sunday,14 days,64797.146
ACC-3084464802,19,123.0,9221.19,,CUS-1928710999,2018-10-14,Susan,F,-37.76,145.15,,,,,,,debit,posted,7e13d935ef0e4485a614041011263619,PAYMENT,<20,2018,10,14,23,0,Sunday,14 days,64797.146
ACC-3084464802,19,24.0,9197.19,,CUS-1928710999,2018-10-15,Susan,F,-37.76,145.15,,,,,,,debit,posted,adbca4735aee46c189dd0a8f711a513c,INTER BANK,<20,2018,10,15,3,0,Monday,14 days,64797.146
ACC-3084464802,19,24.22,9172.97,1.0,CUS-1928710999,2018-10-15,Susan,F,-37.76,145.15,,1a642b2b-4105-4b4f-8d30-3ec8171706a5,-37.8,144.88,VIC,West Footscray,debit,authorized,370bf6188b7142008451b804340b4f21,SALES-POS,<20,2018,10,15,16,9,Monday,14 days,64797.146
ACC-3084464802,19,36.0,9136.97,,CUS-1928710999,2018-10-15,Susan,F,-37.76,145.15,,,,,,,debit,posted,a8cc36af57fd4167a5b965178b8ec36b,PAYMENT,<20,2018,10,15,17,0,Monday,14 days,64797.146
ACC-3084464802,19,23.43,9113.54,1.0,CUS-1928710999,2018-10-15,Susan,F,-37.76,145.15,,877d2a2b-a280-48d2-a5cd-8f834c611fe2,-33.89,151.21,NSW,Surry Hills,debit,authorized,5ca1712dfb684feba6f2c8f1f664cf7f,SALES-POS,<20,2018,10,15,19,54,Monday,14 days,64797.146
ACC-3084464802,19,109.99,9003.55,1.0,CUS-1928710999,2018-10-15,Susan,F,-37.76,145.15,,03a6f7a2-91d9-45cf-9e28-5f5f51201c3a,-37.84,145.01,VIC,Toorak,debit,authorized,b6bfbbff5ed147fea69a7af7b35dd7d6,SALES-POS,<20,2018,10,15,21,42,Monday,14 days,64797.146
ACC-3084464802,19,18.6,8984.95,1.0,CUS-1928710999,2018-10-16,Susan,F,-37.76,145.15,,f05058d2-62a9-45b3-8e86-d44613f57337,-37.8,144.98,VIC,Fitzroy,debit,authorized,dc126fea61cb4f2dbf03e32923dd5d3f,SALES-POS,<20,2018,10,16,9,22,Tuesday,14 days,64797.146
ACC-3084464802,19,6.04,8978.91,1.0,CUS-1928710999,2018-10-16,Susan,F,-37.76,145.15,,c1f171fb-c1af-48c8-84dc-4dd05f6e3f1a,-37.81,144.96,VIC,Melbourne,debit,authorized,bf30bb078da349f7b36f211bc14f762f,POS,<20,2018,10,16,17,15,Tuesday,14 days,64797.146
ACC-3084464802,19,610.75,10853.53,1.0,CUS-1928710999,2018-10-17,Susan,F,-37.76,145.15,,7b4deb71-0e46-4da6-b2fa-7c718273f157,-37.83,140.78,SA,Mount Gambier,debit,authorized,5f950f0e513b4a96bf660f1171147b6a,POS,<20,2018,10,17,15,33,Wednesday,14 days,64797.146
ACC-3084464802,19,10.47,10843.06,1.0,CUS-1928710999,2018-10-18,Susan,F,-37.76,145.15,,7556256f-5f93-487d-be6d-e2f262447bf5,-37.87,144.74,VIC,Williams Landing,debit,authorized,2a0e946f511d4d30a6e5783d054ad304,POS,<20,2018,10,18,19,20,Thursday,14 days,64797.146
ACC-3084464802,19,17.43,10825.63,1.0,CUS-1928710999,2018-10-19,Susan,F,-37.76,145.15,,b12dc8da-322f-46a7-89ff-6e4f02973907,-37.74,144.91,VIC,Essendon,debit,authorized,6964def307f3496f94fec29fb7941ef7,POS,<20,2018,10,19,0,1,Friday,14 days,64797.146
ACC-3084464802,19,34.71,10790.92,1.0,CUS-1928710999,2018-10-19,Susan,F,-37.76,145.15,,de6f9dca-6637-4239-8fc9-f669e0846774,-37.77,144.89,VIC,Maribyrnong,debit,authorized,482ebd50d5f44e208320db67c5be422d,POS,<20,2018,10,19,4,47,Friday,14 days,64797.146
ACC-3084464802,19,122.72,10668.2,1.0,CUS-1928710999,2018-10-19,Susan,F,-37.76,145.15,,e67cbcbd-e44b-4cf0-b318-30827a7425af,-37.82,144.95,VIC,Docklands,debit,authorized,cb1d564e2abe48dca02d14d8749e1ace,SALES-POS,<20,2018,10,19,9,8,Friday,14 days,64797.146
ACC-3084464802,19,21.52,10646.68,0.0,CUS-1928710999,2018-10-19,Susan,F,-37.76,145.15,,781be408-bdd3-4724-b81c-5b44bd29964a,-37.81,144.97,VIC,Melbourne,debit,authorized,868ff4cce7e548e79bd17b0f5e5e40ab,POS,<20,2018,10,19,9,32,Friday,14 days,64797.146
ACC-3084464802,19,23.73,10622.95,1.0,CUS-1928710999,2018-10-20,Susan,F,-37.76,145.15,,c507f3be-d1a7-4194-8481-78dd24a845f0,-37.81,144.99,VIC,East Melbourne,debit,authorized,971561f75b9f4d2ba2f371ddf24df258,POS,<20,2018,10,20,15,34,Saturday,14 days,64797.146
ACC-3084464802,19,24.0,10598.95,,CUS-1928710999,2018-10-22,Susan,F,-37.76,145.15,,,,,,,debit,posted,1a39c2e619fb4f5384d2af4b079636d2,INTER BANK,<20,2018,10,22,3,0,Monday,14 days,64797.146
ACC-3084464802,19,36.0,10562.95,,CUS-1928710999,2018-10-22,Susan,F,-37.76,145.15,,,,,,,debit,posted,002834705cf24578a3d40a95e1408051,PAYMENT,<20,2018,10,22,17,0,Monday,14 days,64797.146
ACC-3084464802,19,18.17,10544.78,1.0,CUS-1928710999,2018-10-26,Susan,F,-37.76,145.15,,6e88a20f-2cde-46f6-b457-2b4727c9a3c5,-37.77,144.98,VIC,Brunswick East,debit,authorized,7c6c069a0fbc42f3bf191be9824fc236,POS,<20,2018,10,26,12,29,Friday,14 days,64797.146
ACC-3084464802,19,39.95,10504.83,1.0,CUS-1928710999,2018-10-26,Susan,F,-37.76,145.15,,10be468c-9d02-4d10-ba7f-10bd3ff986cd,-37.84,145.18,VIC,Forest Hill,debit,authorized,5edc5daa071842cbb7ab923eaf014c0a,POS,<20,2018,10,26,21,19,Friday,14 days,64797.146
ACC-3084464802,19,24.0,10480.83,,CUS-1928710999,2018-10-29,Susan,F,-37.76,145.15,,,,,,,debit,posted,9b069c56e36c4834b5e51eef085f61d4,INTER BANK,<20,2018,10,29,3,0,Monday,14 days,64797.146
ACC-3084464802,19,36.0,10444.83,,CUS-1928710999,2018-10-29,Susan,F,-37.76,145.15,,,,,,,debit,posted,4c275132125a4e58948a945f8aab5747,PAYMENT,<20,2018,10,29,17,0,Monday,14 days,64797.146
ACC-3084464802,19,19.07,12911.13,0.0,CUS-1928710999,2018-10-31,Susan,F,-37.76,145.15,,b167b54e-f5ba-4039-97ae-2c12176d5ef9,-37.81,144.75,VIC,Truganina,debit,authorized,4f51de6765c34123a3950670a6392bff,SALES-POS,<20,2018,10,31,13,15,Wednesday,14 days,64797.146
ACC-3084464802,19,13.06,12898.07,1.0,CUS-1928710999,2018-10-31,Susan,F,-37.76,145.15,,70439da9-3d83-40ac-b5bc-203fd21161f3,-37.81,145.24,VIC,Ringwood,debit,authorized,b72c9cc4a4ef4fe7952acf353eb50f4b,SALES-POS,<20,2018,10,31,14,33,Wednesday,14 days,64797.146
ACC-1788473090,21,20.26,344.8,0.0,CUS-134193016,2018-08-02,Rachael,F,-37.95,145.06,,6f46d443-1411-4315-bf87-9e7dd1a14f04,-37.79,145.13,VIC,Doncaster,debit,authorized,1660b57218f444508f46356d6d3f4661,SALES-POS,20-30,2018,8,2,9,37,Thursday,14 days,52760.229
ACC-1788473090,21,12.23,332.57,1.0,CUS-134193016,2018-08-02,Rachael,F,-37.95,145.06,,b148efb5-b7ac-46a6-9bd3-d42e8447a3a2,-37.78,145.13,VIC,Doncaster,debit,authorized,2970deb2afcc42e09ab55cb7c566f793,SALES-POS,20-30,2018,8,2,15,3,Thursday,14 days,52760.229
ACC-1788473090,21,5.63,326.94,1.0,CUS-134193016,2018-08-02,Rachael,F,-37.95,145.06,,41e75a91-399c-431a-bc46-b2300178c051,-37.82,145.19,VIC,Mitcham,debit,authorized,7d02cc08cecf4ddb8798413de3e35693,POS,20-30,2018,8,2,16,39,Thursday,14 days,52760.229
ACC-1788473090,21,11.32,315.62,1.0,CUS-134193016,2018-08-03,Rachael,F,-37.95,145.06,,514349e2-efc0-453c-8127-0306b185854f,-37.83,144.92,VIC,Port Melbourne,debit,authorized,7d9dd745886646739f4a93e965a3861a,SALES-POS,20-30,2018,8,3,10,54,Friday,14 days,52760.229
ACC-1788473090,21,66.0,249.62,,CUS-134193016,2018-08-03,Rachael,F,-37.95,145.06,,,,,,,debit,posted,670ea512ae814e6ca3fe416b192be269,INTER BANK,20-30,2018,8,3,11,0,Friday,14 days,52760.229
ACC-1788473090,21,7.25,2266.05,0.0,CUS-134193016,2018-08-03,Rachael,F,-37.95,145.06,,0110727d-8914-46b3-bcbb-ba7eef738dc6,-37.87,144.68,VIC,Werribee,debit,authorized,250a56c958d94195bef28d96fa4d96ca,SALES-POS,20-30,2018,8,3,14,32,Friday,14 days,52760.229
ACC-1788473090,21,33.0,2233.05,,CUS-134193016,2018-08-03,Rachael,F,-37.95,145.06,,,,,,,debit,posted,968507f8250b4172998aeec110b96860,INTER BANK,20-30,2018,8,3,18,0,Friday,14 days,52760.229
ACC-1788473090,21,28.08,2204.97,0.0,CUS-134193016,2018-08-05,Rachael,F,-37.95,145.06,,8be82f60-2f66-45de-85de-760ea2b9084d,-38.12,145.19,VIC,Carrum Downs,debit,authorized,fb168b2d3452457f86fa8e8b1420f0e4,SALES-POS,20-30,2018,8,5,21,9,Sunday,14 days,52760.229
ACC-1788473090,21,9.5,2195.47,1.0,CUS-134193016,2018-08-06,Rachael,F,-37.95,145.06,,2a979fe3-2afe-4ef3-9ec5-7bec899dd3d4,-37.81,147.63,VIC,Eastwood,debit,authorized,dc5b80bedc154afea7adf4ebfcb1e95d,SALES-POS,20-30,2018,8,6,9,23,Monday,14 days,52760.229
ACC-1788473090,21,38.65,2156.82,1.0,CUS-134193016,2018-08-06,Rachael,F,-37.95,145.06,,e073b046-7632-4b69-a46b-681be6baa67c,-33.77,151.26,NSW,Brookvale,debit,authorized,8bc589f654f44c7c92b4925223d68129,SALES-POS,20-30,2018,8,6,9,28,Monday,14 days,52760.229
ACC-1788473090,21,92.93,2063.89,0.0,CUS-134193016,2018-08-06,Rachael,F,-37.95,145.06,,ccdf7ece-401f-46e0-8600-3c00b3e6b9a6,-37.85,145.23,VIC,Wantirna,debit,authorized,d382608b1d1a4c80b6c42a401e73c7dd,POS,20-30,2018,8,6,21,21,Monday,14 days,52760.229
ACC-1788473090,21,20.0,2043.89,,CUS-134193016,2018-08-07,Rachael,F,-37.95,145.06,,,,,,,debit,posted,41657d3a27394b8db9fcdfb2d94e138a,INTER BANK,20-30,2018,8,7,4,0,Tuesday,14 days,52760.229
ACC-1788473090,21,66.0,1977.89,,CUS-134193016,2018-08-10,Rachael,F,-37.95,145.06,,,,,,,debit,posted,78a4f11404ec461ebff5eb06ca540ee1,INTER BANK,20-30,2018,8,10,11,0,Friday,14 days,52760.229
ACC-1788473090,21,33.0,1944.89,,CUS-134193016,2018-08-10,Rachael,F,-37.95,145.06,,,,,,,debit,posted,0559af182a9746b9b21d817b8401e2bc,INTER BANK,20-30,2018,8,10,18,0,Friday,14 days,52760.229
ACC-1788473090,21,15.05,1929.84,1.0,CUS-134193016,2018-08-11,Rachael,F,-37.95,145.06,,415420c9-e853-41de-8288-dcee1d4cc4ed,-37.81,144.98,VIC,East Melbourne,debit,authorized,bb7416f112a242e8bbc7111c4d6fc637,SALES-POS,20-30,2018,8,11,23,56,Saturday,14 days,52760.229
ACC-1788473090,21,20.0,1909.84,,CUS-134193016,2018-08-14,Rachael,F,-37.95,145.06,,,,,,,debit,posted,63540c3be7234f18bcc7ae51d5709c2f,INTER BANK,20-30,2018,8,14,4,0,Tuesday,14 days,52760.229
ACC-1788473090,21,24.87,1884.97,1.0,CUS-134193016,2018-08-14,Rachael,F,-37.95,145.06,,03dba15f-f8bd-4b33-8aec-31f3b8a8a7f8,-37.84,145.16,VIC,Forest Hill,debit,authorized,8cae9be956db44f5b64cc5b5f8a9a995,SALES-POS,20-30,2018,8,14,13,34,Tuesday,14 days,52760.229
ACC-1788473090,21,66.0,1806.69,,CUS-134193016,2018-08-17,Rachael,F,-37.95,145.06,,,,,,,debit,posted,ff187642d9ec45718e18851e1604786a,INTER BANK,20-30,2018,8,17,11,0,Friday,14 days,52760.229
ACC-1788473090,21,33.0,3797.37,,CUS-134193016,2018-08-17,Rachael,F,-37.95,145.06,,,,,,,debit,posted,4cd46287059249bf9345a08f210fbc59,INTER BANK,20-30,2018,8,17,18,0,Friday,14 days,52760.229
ACC-1788473090,21,25.9,3771.47,1.0,CUS-134193016,2018-08-18,Rachael,F,-37.95,145.06,,f66fce2b-75b5-494a-8e48-5f40253e5c0f,-37.66,144.92,VIC,Meadow Heights,debit,authorized,22012b4777ba4f3285a28aeaca844cef,POS,20-30,2018,8,18,6,45,Saturday,14 days,52760.229
ACC-1788473090,21,15.67,3755.8,1.0,CUS-134193016,2018-08-18,Rachael,F,-37.95,145.06,,294fb091-b541-432e-82b9-61547f7dfa63,-37.82,144.97,VIC,Melbourne,debit,authorized,791908101a024a878ed481bd9d0cd5e5,POS,20-30,2018,8,18,11,20,Saturday,14 days,52760.229
ACC-1788473090,21,17.34,3738.46,1.0,CUS-134193016,2018-08-18,Rachael,F,-37.95,145.06,,d7f1dad8-5163-4eb4-9a96-f83778298a0a,-37.83,144.96,VIC,South Melbourne,debit,authorized,d831d43530d54613a39a75750d0aa528,POS,20-30,2018,8,18,11,27,Saturday,14 days,52760.229
ACC-1788473090,21,18.01,3720.45,0.0,CUS-134193016,2018-08-18,Rachael,F,-37.95,145.06,,688fbc1d-a902-4b53-9eb6-e07b4a0e46b1,-38.11,147.07,VIC,Sale,debit,authorized,a325ce74815548cca284a0ffa2dd7298,SALES-POS,20-30,2018,8,18,13,53,Saturday,14 days,52760.229
ACC-1788473090,21,24.89,3695.56,1.0,CUS-134193016,2018-08-18,Rachael,F,-37.95,145.06,,63717f63-73be-48fe-a9e6-9aab3dc5ad55,-37.75,144.95,VIC,Brunswick West,debit,authorized,c36f1ec8c11f4dc5bdecd045ea7f5e67,SALES-POS,20-30,2018,8,18,14,5,Saturday,14 days,52760.229
ACC-1788473090,21,20.0,3675.56,,CUS-134193016,2018-08-21,Rachael,F,-37.95,145.06,,,,,,,debit,posted,1cae1d504db14253883590dab50a3f3f,INTER BANK,20-30,2018,8,21,4,0,Tuesday,14 days,52760.229
ACC-1788473090,21,193.0,3482.56,,CUS-134193016,2018-08-22,Rachael,F,-37.95,145.06,,,,,,,debit,posted,f115a51dfd1040d096bbd967f3601505,PAYMENT,20-30,2018,8,22,3,0,Wednesday,14 days,52760.229
ACC-1788473090,21,40.34,3442.22,1.0,CUS-134193016,2018-08-22,Rachael,F,-37.95,145.06,,60e022b6-d6c2-465c-936a-9c8bb35936bf,-37.79,145.07,VIC,Balwyn North,debit,authorized,1026d89ea1de4fd9bc2b8f136abb3a10,POS,20-30,2018,8,22,11,41,Wednesday,14 days,52760.229
ACC-1788473090,21,66.0,3376.22,,CUS-134193016,2018-08-24,Rachael,F,-37.95,145.06,,,,,,,debit,posted,9e6410f30baf4d83b600a97f2cff64d6,INTER BANK,20-30,2018,8,24,11,0,Friday,14 days,52760.229
ACC-1788473090,21,33.0,3343.22,,CUS-134193016,2018-08-24,Rachael,F,-37.95,145.06,,,,,,,debit,posted,4ea4eca3fc10486286a3b3fcfdc83055,INTER BANK,20-30,2018,8,24,18,0,Friday,14 days,52760.229
ACC-1788473090,21,20.0,3323.22,,CUS-134193016,2018-08-28,Rachael,F,-37.95,145.06,,,,,,,debit,posted,c0c4112b5a5d4eada489b62dd1cbb7b9,INTER BANK,20-30,2018,8,28,4,0,Tuesday,14 days,52760.229
ACC-1788473090,21,66.0,3257.22,,CUS-134193016,2018-08-31,Rachael,F,-37.95,145.06,,,,,,,debit,posted,33e87514af5b4aecbf38e2c16afdfe3b,INTER BANK,20-30,2018,8,31,11,0,Friday,14 days,52760.229
ACC-1788473090,21,33.0,5247.9,,CUS-134193016,2018-08-31,Rachael,F,-37.95,145.06,,,,,,,debit,posted,ed9321f44e244a369aace6c6a52fc665,INTER BANK,20-30,2018,8,31,18,0,Friday,14 days,52760.229
ACC-1788473090,21,20.0,5227.9,,CUS-134193016,2018-09-04,Rachael,F,-37.95,145.06,,,,,,,debit,posted,d781a3bdc2b34245908cd2842dfd05a5,INTER BANK,20-30,2018,9,4,4,0,Tuesday,14 days,52760.229
ACC-1788473090,21,66.0,5161.9,,CUS-134193016,2018-09-07,Rachael,F,-37.95,145.06,,,,,,,debit,posted,abad866a44064fabba456888ecd617a5,INTER BANK,20-30,2018,9,7,11,0,Friday,14 days,52760.229
ACC-1788473090,21,33.0,5128.9,,CUS-134193016,2018-09-07,Rachael,F,-37.95,145.06,,,,,,,debit,posted,537c5a100e4c4e53bb505916469316c3,INTER BANK,20-30,2018,9,7,18,0,Friday,14 days,52760.229
ACC-1788473090,21,20.0,5108.9,,CUS-134193016,2018-09-11,Rachael,F,-37.95,145.06,,,,,,,debit,posted,016444f6942e4b43b35e03d2e9182be1,INTER BANK,20-30,2018,9,11,4,0,Tuesday,14 days,52760.229
ACC-1788473090,21,66.0,5042.9,,CUS-134193016,2018-09-14,Rachael,F,-37.95,145.06,,,,,,,debit,posted,3a21e85f71f4443ba9836a6fe16d8f64,INTER BANK,20-30,2018,9,14,11,0,Friday,14 days,52760.229
ACC-1788473090,21,33.0,7033.58,,CUS-134193016,2018-09-14,Rachael,F,-37.95,145.06,,,,,,,debit,posted,8c4a886780a04d44af70ad90fcee2e49,INTER BANK,20-30,2018,9,14,18,0,Friday,14 days,52760.229
ACC-1788473090,21,22.24,7011.34,1.0,CUS-134193016,2018-09-16,Rachael,F,-37.95,145.06,,74a68dbe-3b29-4fdb-84c9-3cae03a2f99c,-38.02,145.3,VIC,Narre Warren,debit,authorized,5661d5d525e44eba9d24fb7a7cde0d23,SALES-POS,20-30,2018,9,16,22,40,Sunday,14 days,52760.229
ACC-1788473090,21,20.0,6991.34,,CUS-134193016,2018-09-18,Rachael,F,-37.95,145.06,,,,,,,debit,posted,d0ecb5538bab48a48608c45a412eb658,INTER BANK,20-30,2018,9,18,4,0,Tuesday,14 days,52760.229
ACC-1788473090,21,66.0,6925.34,,CUS-134193016,2018-09-21,Rachael,F,-37.95,145.06,,,,,,,debit,posted,f83bdc0478be428ca78db9374d2924b8,INTER BANK,20-30,2018,9,21,11,0,Friday,14 days,52760.229
ACC-1788473090,21,33.0,6892.34,,CUS-134193016,2018-09-21,Rachael,F,-37.95,145.06,,,,,,,debit,posted,6f38fd21b89f4502892df78dbe697f0e,INTER BANK,20-30,2018,9,21,18,0,Friday,14 days,52760.229
ACC-1788473090,21,193.0,6699.34,,CUS-134193016,2018-09-22,Rachael,F,-37.95,145.06,,,,,,,debit,posted,b0c8940d11e040a381074d317366285e,PAYMENT,20-30,2018,9,22,3,0,Saturday,14 days,52760.229
ACC-1788473090,21,20.0,6679.34,,CUS-134193016,2018-09-25,Rachael,F,-37.95,145.06,,,,,,,debit,posted,7154688fe2684e0db7452b1e10586590,INTER BANK,20-30,2018,9,25,4,0,Tuesday,14 days,52760.229
ACC-1788473090,21,43.29,6636.05,1.0,CUS-134193016,2018-09-26,Rachael,F,-37.95,145.06,,92dd879b-3ebb-43e0-a73c-21010b882a5f,-37.81,144.96,VIC,Melbourne,debit,authorized,f8508faa2e43453c8ee70b99eec3e7b4,SALES-POS,20-30,2018,9,26,9,3,Wednesday,14 days,52760.229
ACC-1788473090,21,16.17,6619.88,0.0,CUS-134193016,2018-09-26,Rachael,F,-37.95,145.06,,5ee54429-f90e-43d7-8089-71c4bcbd4905,-37.8,145.15,VIC,Blackburn North,debit,authorized,5ce4c44e13fa4f479084cfac7288a3cf,POS,20-30,2018,9,26,10,18,Wednesday,14 days,52760.229
ACC-1788473090,21,66.0,6553.88,,CUS-134193016,2018-09-28,Rachael,F,-37.95,145.06,,,,,,,debit,posted,6df9b8a1cd27466f88dc8d205fcfad29,INTER BANK,20-30,2018,9,28,11,0,Friday,14 days,52760.229
ACC-1788473090,21,33.0,8544.56,,CUS-134193016,2018-09-28,Rachael,F,-37.95,145.06,,,,,,,debit,posted,ddeac37c7a8d47bdb2fa0f75aea727b5,INTER BANK,20-30,2018,9,28,18,0,Friday,14 days,52760.229
ACC-1788473090,21,20.0,8524.56,,CUS-134193016,2018-10-02,Rachael,F,-37.95,145.06,,,,,,,debit,posted,4d23c572e50d4cbcbee1882c6fb22611,INTER BANK,20-30,2018,10,2,4,0,Tuesday,14 days,52760.229
ACC-1788473090,21,22.22,8502.34,1.0,CUS-134193016,2018-10-02,Rachael,F,-37.95,145.06,,acff7cc5-72ce-4b25-a434-8db80f28c7d4,-37.8,145.28,VIC,Croydon,debit,authorized,28ce3e4c57ab4c428169926ef7988e6a,POS,20-30,2018,10,2,14,8,Tuesday,14 days,52760.229
ACC-1788473090,21,28.83,8473.51,1.0,CUS-134193016,2018-10-02,Rachael,F,-37.95,145.06,,2df71d90-3c5f-425f-81e0-b73057ae0be2,-37.79,144.93,VIC,Flemington,debit,authorized,d50ee2e4089c4059a50e0e4cde711913,POS,20-30,2018,10,2,15,52,Tuesday,14 days,52760.229
ACC-1788473090,21,92.86,8380.65,0.0,CUS-134193016,2018-10-04,Rachael,F,-37.95,145.06,,122d170d-1e43-4960-b50d-9f0488127a9f,-37.9,145.24,VIC,Knoxfield,debit,authorized,1dc20c1bc04f48acafd2b39a071d39c2,POS,20-30,2018,10,4,18,50,Thursday,14 days,52760.229
ACC-1788473090,21,66.0,8304.61,,CUS-134193016,2018-10-05,Rachael,F,-37.95,145.06,,,,,,,debit,posted,2022968dbcb64652858b97ac29cb9892,INTER BANK,20-30,2018,10,5,11,0,Friday,14 days,52760.229
ACC-1788473090,21,10.04,8370.61,1.0,CUS-134193016,2018-10-05,Rachael,F,-37.95,145.06,,92a76cac-8074-46d1-b774-5f365d0d7aa0,-37.81,140.77,SA,Mount Gambier,debit,authorized,47a74e9f5d9849928ace390f63528e13,SALES-POS,20-30,2018,10,5,11,54,Friday,14 days,52760.229
ACC-1788473090,21,33.0,8271.61,,CUS-134193016,2018-10-05,Rachael,F,-37.95,145.06,,,,,,,debit,posted,bb6031fc576042a88f9154513a01746d,INTER BANK,20-30,2018,10,5,18,0,Friday,14 days,52760.229
ACC-1788473090,21,36.89,8234.72,1.0,CUS-134193016,2018-10-07,Rachael,F,-37.95,145.06,,d0e302c4-e0c6-40ff-8038-62ec4ecf97ae,-37.84,145.19,VIC,Vermont,debit,authorized,9c9d242ac6f64b87887d703c9432e130,SALES-POS,20-30,2018,10,7,14,18,Sunday,14 days,52760.229
ACC-1788473090,21,245.51,7989.21,1.0,CUS-134193016,2018-10-07,Rachael,F,-37.95,145.06,,909424d1-936e-4438-b877-b1ffad297e22,-37.77,145.04,VIC,Ivanhoe,debit,authorized,6faf45f10ef54254acd6302aaf261c4e,POS,20-30,2018,10,7,14,56,Sunday,14 days,52760.229
ACC-1788473090,21,20.0,7969.21,,CUS-134193016,2018-10-09,Rachael,F,-37.95,145.06,,,,,,,debit,posted,8ddac35d2d81443f827bd7dc7275ed2f,INTER BANK,20-30,2018,10,9,4,0,Tuesday,14 days,52760.229
ACC-1788473090,21,66.0,7903.21,,CUS-134193016,2018-10-12,Rachael,F,-37.95,145.06,,,,,,,debit,posted,f54509e4cbda4164ac015831761a20a8,INTER BANK,20-30,2018,10,12,11,0,Friday,14 days,52760.229
ACC-1788473090,21,33.0,9893.89,,CUS-134193016,2018-10-12,Rachael,F,-37.95,145.06,,,,,,,debit,posted,ffa8983324d141bda4b3e5c7184ba816,INTER BANK,20-30,2018,10,12,18,0,Friday,14 days,52760.229
ACC-1788473090,21,20.0,9873.89,,CUS-134193016,2018-10-16,Rachael,F,-37.95,145.06,,,,,,,debit,posted,edb150c7f1af456493d7f51ba9d50930,INTER BANK,20-30,2018,10,16,4,0,Tuesday,14 days,52760.229
ACC-1788473090,21,66.0,9807.89,,CUS-134193016,2018-10-19,Rachael,F,-37.95,145.06,,,,,,,debit,posted,d11989e4a38947468c0746de705fe21c,INTER BANK,20-30,2018,10,19,11,0,Friday,14 days,52760.229
ACC-1788473090,21,33.0,9774.89,,CUS-134193016,2018-10-19,Rachael,F,-37.95,145.06,,,,,,,debit,posted,c585a11ca23d4a5bbcae104a2554e545,INTER BANK,20-30,2018,10,19,18,0,Friday,14 days,52760.229
ACC-1788473090,21,13.08,9761.81,1.0,CUS-134193016,2018-10-20,Rachael,F,-37.95,145.06,,6ef2c3ff-dd5e-47a9-a2d4-be8ec90fab1f,-37.81,144.96,VIC,Melbourne,debit,authorized,78dca29b0d88489eb665d7d9859fa5c9,SALES-POS,20-30,2018,10,20,22,26,Saturday,14 days,52760.229
ACC-1788473090,21,193.0,9568.81,,CUS-134193016,2018-10-22,Rachael,F,-37.95,145.06,,,,,,,debit,posted,7fccff7ca5884789afa4c83d7110f985,PAYMENT,20-30,2018,10,22,3,0,Monday,14 days,52760.229
ACC-1788473090,21,20.0,9548.81,,CUS-134193016,2018-10-23,Rachael,F,-37.95,145.06,,,,,,,debit,posted,c695895061164cb28e69c7bd8f06a5f9,INTER BANK,20-30,2018,10,23,4,0,Tuesday,14 days,52760.229
ACC-1788473090,21,66.0,9482.81,,CUS-134193016,2018-10-26,Rachael,F,-37.95,145.06,,,,,,,debit,posted,1096b2bbdc774d0096cec6f238cefae9,INTER BANK,20-30,2018,10,26,11,0,Friday,14 days,52760.229
ACC-1788473090,21,33.0,11473.49,,CUS-134193016,2018-10-26,Rachael,F,-37.95,145.06,,,,,,,debit,posted,67ba4e7219004efca06f8925f253750a,INTER BANK,20-30,2018,10,26,18,0,Friday,14 days,52760.229
ACC-1788473090,21,20.0,11453.49,,CUS-134193016,2018-10-30,Rachael,F,-37.95,145.06,,,,,,,debit,posted,0c7584318087471fbf8ec03b370ce894,INTER BANK,20-30,2018,10,30,4,0,Tuesday,14 days,52760.229
ACC-559365433,64,31.5,159.66,1.0,CUS-1654129794,2018-08-02,Mary,F,-42.88,147.31,,092cf080-71f6-45f7-a423-23fb0fdc91d7,-36.74,147.17,VIC,Mount Beauty,debit,authorized,40e386bdc36a45e984537e154039f5af,SALES-POS,60-70,2018,8,2,10,29,Thursday,7 days,30034.286
ACC-559365433,64,30.0,705.66,,CUS-1654129794,2018-08-05,Mary,F,-42.88,147.31,,,,,,,debit,posted,f90b5668441b44f0b297c2aec7367b58,PAYMENT,60-70,2018,8,5,5,0,Sunday,7 days,30034.286
ACC-559365433,64,9.4,696.26,1.0,CUS-1654129794,2018-08-09,Mary,F,-42.88,147.31,,1a540ebf-3792-41c4-b91a-324b216dd58b,-41.48,147.13,TAS,Prospect Vale,debit,authorized,7978ba2a9c64407783370e97892198cb,SALES-POS,60-70,2018,8,9,12,46,Thursday,7 days,30034.286
ACC-559365433,64,15.36,680.9,1.0,CUS-1654129794,2018-08-09,Mary,F,-42.88,147.31,,53e177aa-a74e-457b-81ba-c98c3fbf2765,-42.88,147.39,TAS,Bellerive,debit,authorized,e7409fb711e145449f5f459b51f4307a,POS,60-70,2018,8,9,15,19,Thursday,7 days,30034.286
ACC-559365433,64,30.0,1226.9,,CUS-1654129794,2018-08-12,Mary,F,-42.88,147.31,,,,,,,debit,posted,d61892a39b8940b38190397d4f597634,PAYMENT,60-70,2018,8,12,5,0,Sunday,7 days,30034.286
ACC-559365433,64,160.0,1066.9,,CUS-1654129794,2018-08-13,Mary,F,-42.88,147.31,,,,,,,debit,posted,206f31957d484f4f999b0b0163be8ed4,INTER BANK,60-70,2018,8,13,6,0,Monday,7 days,30034.286
ACC-559365433,64,30.24,1036.66,1.0,CUS-1654129794,2018-08-15,Mary,F,-42.88,147.31,,99e95a31-ad49-4a0d-8470-36809376a834,-42.8,147.26,TAS,Claremont,debit,authorized,ad4432c4ff804763ae1bcf1b2635eaaf,POS,60-70,2018,8,15,10,5,Wednesday,7 days,30034.286
ACC-559365433,64,17.19,964.22,1.0,CUS-1654129794,2018-08-17,Mary,F,-42.88,147.31,,a3f93fa7-660c-4ae2-9388-e3061750582d,-35.15,147.47,NSW,Forest Hill,debit,authorized,b54280a715fe4d1992b86e6ee517f3cf,SALES-POS,60-70,2018,8,17,9,17,Friday,7 days,30034.286
ACC-559365433,64,18.8,1521.42,1.0,CUS-1654129794,2018-08-18,Mary,F,-42.88,147.31,,b5aed83c-ba2c-4d98-b539-feb0a14140a4,-41.47,147.14,TAS,Prospect,debit,authorized,8a67b8fcf20542ae911cecfb0e699785,POS,60-70,2018,8,18,20,8,Saturday,7 days,30034.286
ACC-559365433,64,34.6,1486.82,1.0,CUS-1654129794,2018-08-19,Mary,F,-42.88,147.31,,850f3446-4573-4cd1-8b3b-ba7faa8bd943,-42.87,147.32,TAS,North Hobart,debit,authorized,5f90fa93db0148549f7b7df7c1cff6ea,POS,60-70,2018,8,19,3,42,Sunday,7 days,30034.286
ACC-559365433,64,30.0,1456.82,,CUS-1654129794,2018-08-19,Mary,F,-42.88,147.31,,,,,,,debit,posted,2111334c598142ce8ef918c03b816452,PAYMENT,60-70,2018,8,19,5,0,Sunday,7 days,30034.286
ACC-559365433,64,25.48,1431.34,1.0,CUS-1654129794,2018-08-19,Mary,F,-42.88,147.31,,87df0ac3-dc0f-474b-8f3c-2a7075dc746b,-42.91,147.48,TAS,Lauderdale,debit,authorized,62728a5ae9fd4085b96b5bc4edf69906,SALES-POS,60-70,2018,8,19,9,44,Sunday,7 days,30034.286
ACC-559365433,64,30.92,1400.42,1.0,CUS-1654129794,2018-08-19,Mary,F,-42.88,147.31,,5c78a6f7-6d63-4b56-bd4a-8da9f39f9f2b,-16.51,145.46,QLD,Port Douglas,debit,authorized,9e7a51615aea42af80d760a204fe9005,SALES-POS,60-70,2018,8,19,16,29,Sunday,7 days,30034.286
ACC-559365433,64,20.67,1379.75,1.0,CUS-1654129794,2018-08-21,Mary,F,-42.88,147.31,,bd9e32fa-af12-427b-acb3-763b4a650b32,-37.75,145.14,VIC,Templestowe,debit,authorized,21e4de85a54f4946ae0d777c41905b29,POS,60-70,2018,8,21,15,20,Tuesday,7 days,30034.286
ACC-559365433,64,37.05,1342.7,1.0,CUS-1654129794,2018-08-21,Mary,F,-42.88,147.31,,2a4f1705-aab7-4a5a-b562-e2bbe62bd26b,-19.57,147.41,QLD,Ayr,debit,authorized,3e3cb07157924d4ca1826a7fb57f6737,POS,60-70,2018,8,21,22,11,Tuesday,7 days,30034.286
ACC-559365433,64,34.23,1308.47,0.0,CUS-1654129794,2018-08-22,Mary,F,-42.88,147.31,,723eedd7-f216-4771-b258-7d514990981f,-35.12,147.37,NSW,Wagga Wagga,debit,authorized,6ec2961b77a4441585555e8fa7fb911e,SALES-POS,60-70,2018,8,22,23,20,Wednesday,7 days,30034.286
ACC-559365433,64,21.97,1286.5,1.0,CUS-1654129794,2018-08-23,Mary,F,-42.88,147.31,,e6a12933-3c5e-4c2f-8844-ab53b1ab862f,-35.12,147.33,NSW,Ashmont,debit,authorized,9d81a455e6d14b978d730d78465c897e,SALES-POS,60-70,2018,8,23,11,29,Thursday,7 days,30034.286
ACC-559365433,64,21.84,1264.66,1.0,CUS-1654129794,2018-08-24,Mary,F,-42.88,147.31,,a7607d0c-8e67-4b92-bf46-c39b5b339d2a,-37.75,145.03,VIC,Preston,debit,authorized,6fbc79c390364a6fb6a3a206f22a0f1b,POS,60-70,2018,8,24,2,45,Friday,7 days,30034.286
ACC-559365433,64,30.0,1810.66,,CUS-1654129794,2018-08-26,Mary,F,-42.88,147.31,,,,,,,debit,posted,5148b10592bd4e33b3e6144fb8f95412,PAYMENT,60-70,2018,8,26,5,0,Sunday,7 days,30034.286
ACC-559365433,64,13.22,1797.44,1.0,CUS-1654129794,2018-08-31,Mary,F,-42.88,147.31,,2b81d172-bc5e-42fb-8569-098eaff5063d,-37.75,145.69,VIC,Warburton,debit,authorized,a3f344cd83e54fbbbfcfd76de0c1a62c,POS,60-70,2018,8,31,8,27,Friday,7 days,30034.286
ACC-559365433,64,30.0,2343.44,,CUS-1654129794,2018-09-02,Mary,F,-42.88,147.31,,,,,,,debit,posted,8b8c2ac9ff964e53b866400db701293f,PAYMENT,60-70,2018,9,2,5,0,Sunday,7 days,30034.286
ACC-559365433,64,29.5,2313.94,1.0,CUS-1654129794,2018-09-02,Mary,F,-42.88,147.31,,90df79a5-5cdc-4611-a332-b8cb7dd8c61a,-38.2,145.18,VIC,Somerville,debit,authorized,afbaef6fcfb4422b9e88a28a64084e00,SALES-POS,60-70,2018,9,2,17,37,Sunday,7 days,30034.286
ACC-559365433,64,19.01,2294.93,1.0,CUS-1654129794,2018-09-04,Mary,F,-42.88,147.31,,ac964516-7450-45ed-8175-21db21a364ee,-42.83,147.27,TAS,Glenorchy,debit,authorized,5f1d369d8488467ebdc1960a96811476,SALES-POS,60-70,2018,9,4,9,16,Tuesday,7 days,30034.286
ACC-559365433,64,37.27,2257.66,1.0,CUS-1654129794,2018-09-04,Mary,F,-42.88,147.31,,456146d8-ccaa-4b73-a3fc-9d7d04aabb8f,-19.58,147.4,QLD,Ayr,debit,authorized,b8aa186ba18c4498adb1cfb64a4cb399,SALES-POS,60-70,2018,9,4,19,16,Tuesday,7 days,30034.286
ACC-559365433,64,17.35,2240.31,1.0,CUS-1654129794,2018-09-06,Mary,F,-42.88,147.31,,f91415b8-9625-4cd2-9360-fb2524988740,-41.93,147.49,TAS,Campbelltown,debit,authorized,b5228405ae9a45dfa26545c0f681530b,SALES-POS,60-70,2018,9,6,15,52,Thursday,7 days,30034.286
ACC-559365433,64,412.53,1827.78,1.0,CUS-1654129794,2018-09-06,Mary,F,-42.88,147.31,,b45868cb-4890-4e2f-a8a1-0a8990f2cbab,-34.93,138.6,SA,Adelaide,debit,authorized,c805636d390d4d489d3b454e8d222e45,POS,60-70,2018,9,6,18,25,Thursday,7 days,30034.286
ACC-559365433,64,190.04,2213.74,1.0,CUS-1654129794,2018-09-08,Mary,F,-42.88,147.31,,74a69984-b77e-4702-b1e8-bb6124aff460,-35.12,147.35,NSW,Wagga Wagga,debit,authorized,d731a73e320e423b9e6e99a4fbed7d9a,POS,60-70,2018,9,8,11,44,Saturday,7 days,30034.286
ACC-559365433,64,35.98,2177.76,1.0,CUS-1654129794,2018-09-08,Mary,F,-42.88,147.31,,79dabde3-141d-4363-9b6d-043d695cba32,-37.91,145.01,VIC,Melbourne,debit,authorized,2e1d0945e3a34a6fb65d068ae4d5cdcb,SALES-POS,60-70,2018,9,8,15,31,Saturday,7 days,30034.286
ACC-559365433,64,28.68,2149.08,1.0,CUS-1654129794,2018-09-08,Mary,F,-42.88,147.31,,cc48220b-a44e-40f4-affd-1aa7363c2730,-42.3,147.37,TAS,Oatlands,debit,authorized,d71afb46cd1b4135af852bd5e0575ddb,SALES-POS,60-70,2018,9,8,22,6,Saturday,7 days,30034.286
ACC-559365433,64,5.82,2143.26,1.0,CUS-1654129794,2018-09-08,Mary,F,-42.88,147.31,,7645bd89-9675-4b0b-a598-7a72e59483d7,-35.15,147.46,NSW,Forest Hill,debit,authorized,70965602e69249f2add16a3315e87e58,SALES-POS,60-70,2018,9,8,22,19,Saturday,7 days,30034.286
ACC-559365433,64,30.0,2113.26,,CUS-1654129794,2018-09-09,Mary,F,-42.88,147.31,,,,,,,debit,posted,a168b47bdd6c48a48381c1fc10295101,PAYMENT,60-70,2018,9,9,5,0,Sunday,7 days,30034.286
ACC-559365433,64,160.0,1953.26,,CUS-1654129794,2018-09-13,Mary,F,-42.88,147.31,,,,,,,debit,posted,a3487a8de48e4077bd9bd5bede035417,INTER BANK,60-70,2018,9,13,6,0,Thursday,7 days,30034.286
ACC-559365433,64,25.05,1928.21,1.0,CUS-1654129794,2018-09-13,Mary,F,-42.88,147.31,,9e9c170b-c83e-4b0b-9b73-3a45556f233c,-37.78,144.98,VIC,Fitzroy North,debit,authorized,063b1db38704437da084c8a9f8b4d971,POS,60-70,2018,9,13,15,14,Thursday,7 days,30034.286
ACC-559365433,64,12.52,1915.69,0.0,CUS-1654129794,2018-09-13,Mary,F,-42.88,147.31,,84a5be12-07d2-4de0-a371-978a8544e6b0,-37.91,145.08,VIC,Oakleigh,debit,authorized,e6636c5615914cc7a2fff44a16936c29,POS,60-70,2018,9,13,18,35,Thursday,7 days,30034.286
ACC-559365433,64,30.0,2461.69,,CUS-1654129794,2018-09-16,Mary,F,-42.88,147.31,,,,,,,debit,posted,e84e09d37aa9426a8f17390e6497b8d4,PAYMENT,60-70,2018,9,16,5,0,Sunday,7 days,30034.286
ACC-559365433,64,30.0,3007.69,,CUS-1654129794,2018-09-23,Mary,F,-42.88,147.31,,,,,,,debit,posted,ef96626c0cb94edfade5ba7098f7de61,PAYMENT,60-70,2018,9,23,5,0,Sunday,7 days,30034.286
ACC-559365433,64,30.0,3553.69,,CUS-1654129794,2018-09-30,Mary,F,-42.88,147.31,,,,,,,debit,posted,20365a902c9c4dd8aeff41e35c6262b6,PAYMENT,60-70,2018,9,30,5,0,Sunday,7 days,30034.286
ACC-559365433,64,16.36,3537.33,1.0,CUS-1654129794,2018-10-02,Mary,F,-42.88,147.31,,f7f1a4c4-9947-47f5-a461-2fed2ca3324c,-37.82,144.96,VIC,Melbourne,debit,authorized,bb87b87928124026879883f348072d7f,POS,60-70,2018,10,2,22,30,Tuesday,7 days,30034.286
ACC-559365433,64,34.01,3503.32,1.0,CUS-1654129794,2018-10-03,Mary,F,-42.88,147.31,,8aa6a748-427f-4eaa-9e04-271af3dab846,-41.54,147.21,TAS,Western Junction,debit,authorized,9a8bfb4707734f5aa130befb6438754e,SALES-POS,60-70,2018,10,3,1,32,Wednesday,7 days,30034.286
ACC-559365433,64,29.41,3473.91,1.0,CUS-1654129794,2018-10-03,Mary,F,-42.88,147.31,,d50a563b-d4e4-457c-8534-d03272c4e80e,-37.91,144.99,VIC,Brighton,debit,authorized,985fb0e663c54b098bc9cce4df4d044c,SALES-POS,60-70,2018,10,3,20,50,Wednesday,7 days,30034.286
ACC-559365433,64,39.24,3434.67,1.0,CUS-1654129794,2018-10-03,Mary,F,-42.88,147.31,,27f93a60-ed2e-4b56-826d-8b1c9f1c1b8a,-33.88,151.02,NSW,Regents Park,debit,authorized,bfd1ef3e604e42f5b543560e2149bd3a,SALES-POS,60-70,2018,10,3,21,47,Wednesday,7 days,30034.286
ACC-559365433,64,13.0,3421.67,1.0,CUS-1654129794,2018-10-04,Mary,F,-42.88,147.31,,69253914-f9e0-4ec8-942b-ba6d0a0da111,-36.15,147.49,VIC,Koetong,debit,authorized,ce459f648ca446d491843880dda826c3,SALES-POS,60-70,2018,10,4,9,34,Thursday,7 days,30034.286
ACC-559365433,64,30.0,3967.67,,CUS-1654129794,2018-10-07,Mary,F,-42.88,147.31,,,,,,,debit,posted,f5e2b48a835d47c789a4b1d0e9698689,PAYMENT,60-70,2018,10,7,5,0,Sunday,7 days,30034.286
ACC-559365433,64,11.57,3956.1,0.0,CUS-1654129794,2018-10-07,Mary,F,-42.88,147.31,,da19f684-7a12-43ab-a840-a9737edb3784,-42.9,147.43,TAS,Rokeby,debit,authorized,c3d9ccd709a748d7b340bba786ba8863,POS,60-70,2018,10,7,9,31,Sunday,7 days,30034.286
ACC-559365433,64,15.16,3940.94,1.0,CUS-1654129794,2018-10-07,Mary,F,-42.88,147.31,,8ff166b5-9ccb-40cf-a1b0-e9928bf92127,-37.86,144.98,VIC,Saint Kilda West,debit,authorized,02729a53617d48728b512a4de88034ce,POS,60-70,2018,10,7,11,13,Sunday,7 days,30034.286
ACC-559365433,64,58.9,3882.04,1.0,CUS-1654129794,2018-10-11,Mary,F,-42.88,147.31,,8618d753-bada-4c3f-98b9-5c1bcf17b682,-42.82,147.3,TAS,Dowsing Point,debit,authorized,4ba8f0b4c11c425aaa75e78c00031729,SALES-POS,60-70,2018,10,11,8,53,Thursday,7 days,30034.286
ACC-559365433,64,15.94,3866.1,1.0,CUS-1654129794,2018-10-11,Mary,F,-42.88,147.31,,e1cfa151-fce0-4857-846f-47585b5d804f,-37.74,144.96,VIC,Coburg,debit,authorized,7fe07e61858445eba2a7d4ab67c167b8,POS,60-70,2018,10,11,9,41,Thursday,7 days,30034.286
ACC-559365433,64,41.22,3824.88,1.0,CUS-1654129794,2018-10-12,Mary,F,-42.88,147.31,,2a4f1705-aab7-4a5a-b562-e2bbe62bd26b,-19.57,147.41,QLD,Ayr,debit,authorized,8fb7a96574284c428808fd8bdf3ad944,SALES-POS,60-70,2018,10,12,8,39,Friday,7 days,30034.286
ACC-559365433,64,47.31,3777.57,1.0,CUS-1654129794,2018-10-12,Mary,F,-42.88,147.31,,61890fd6-7092-414f-9473-edc181e46843,-43.04,147.27,TAS,Margate,debit,authorized,bb1149ba466a411daf789cf05a81ad33,SALES-POS,60-70,2018,10,12,9,9,Friday,7 days,30034.286
ACC-559365433,64,36.89,3740.68,1.0,CUS-1654129794,2018-10-12,Mary,F,-42.88,147.31,,8caa374e-b525-4314-82e2-b8a4d8828490,-37.78,144.98,VIC,Carlton North,debit,authorized,2d389a851aca4bed8789375f941e4af3,SALES-POS,60-70,2018,10,12,12,22,Friday,7 days,30034.286
ACC-559365433,64,193.24,4123.44,1.0,CUS-1654129794,2018-10-12,Mary,F,-42.88,147.31,,74a69984-b77e-4702-b1e8-bb6124aff460,-35.12,147.35,NSW,Wagga Wagga,debit,authorized,c49729ae652e4228961888731c7f0191,SALES-POS,60-70,2018,10,12,14,26,Friday,7 days,30034.286
ACC-559365433,64,23.95,4099.49,1.0,CUS-1654129794,2018-10-12,Mary,F,-42.88,147.31,,d7b8f51e-1832-4609-8d34-3e2de4445823,-35.12,147.36,NSW,Wagga Wagga,debit,authorized,16536dc772a2428ea3081a1a717f74ef,POS,60-70,2018,10,12,15,14,Friday,7 days,30034.286
ACC-559365433,64,89.89,4009.6,1.0,CUS-1654129794,2018-10-12,Mary,F,-42.88,147.31,,42ade571-5972-4160-9ecb-e0162a305fee,-33.7,151.21,NSW,Belrose,debit,authorized,50503dfe120d4713b3866b5a79721a40,POS,60-70,2018,10,12,19,32,Friday,7 days,30034.286
ACC-559365433,64,160.0,3849.6,,CUS-1654129794,2018-10-13,Mary,F,-42.88,147.31,,,,,,,debit,posted,2287273605f140a7b01ba834b1bfd72d,INTER BANK,60-70,2018,10,13,6,0,Saturday,7 days,30034.286
ACC-559365433,64,30.0,3819.6,,CUS-1654129794,2018-10-14,Mary,F,-42.88,147.31,,,,,,,debit,posted,acaf620c9734465a86c93ec134f2b35c,PAYMENT,60-70,2018,10,14,5,0,Sunday,7 days,30034.286
ACC-559365433,64,11.42,3808.18,1.0,CUS-1654129794,2018-10-14,Mary,F,-42.88,147.31,,4ebc6c77-466d-4bc1-84cb-79098be0f2df,-28.12,153.47,QLD,Palm Beach,debit,authorized,d4ebc6e244c44a078b9b7d4cf577ef30,POS,60-70,2018,10,14,21,34,Sunday,7 days,30034.286
ACC-559365433,64,18.71,3789.47,1.0,CUS-1654129794,2018-10-15,Mary,F,-42.88,147.31,,9f6da3b6-d74b-413a-8b59-ed9d7ca76b9a,-37.87,144.98,VIC,Saint Kilda,debit,authorized,52dbef2529d8417db86f49b616bf0007,SALES-POS,60-70,2018,10,15,2,13,Monday,7 days,30034.286
ACC-559365433,64,13.78,3775.69,1.0,CUS-1654129794,2018-10-16,Mary,F,-42.88,147.31,,c169c804-b78b-4fd8-9883-a2c680b1a708,-41.54,147.21,TAS,Western Junction,debit,authorized,c2ba6cbda08246ca8dd3b6ef8e9574a0,POS,60-70,2018,10,16,9,4,Tuesday,7 days,30034.286
ACC-559365433,64,11.34,3764.35,1.0,CUS-1654129794,2018-10-17,Mary,F,-42.88,147.31,,c5f7193d-4597-494d-8359-42bd19d9866a,-37.99,145.08,VIC,Parkdale,debit,authorized,4a7270096128477b9c0f94d97e1a595a,SALES-POS,60-70,2018,10,17,6,42,Wednesday,7 days,30034.286
ACC-559365433,64,18.6,3745.75,1.0,CUS-1654129794,2018-10-18,Mary,F,-42.88,147.31,,8105415b-7bd2-4267-807a-1494276a3186,-38.01,145.26,VIC,Hallam,debit,authorized,a8d9cdf4a7f5443d95caec1de49cb055,SALES-POS,60-70,2018,10,18,9,37,Thursday,7 days,30034.286
ACC-559365433,64,23.94,3721.81,1.0,CUS-1654129794,2018-10-18,Mary,F,-42.88,147.31,,fb1f2c03-4ce0-49ce-8d39-3cda1fdf335a,-37.79,145.15,VIC,Doncaster East,debit,authorized,85beeb9ec69c4edaacfc487b66c5533a,SALES-POS,60-70,2018,10,18,11,41,Thursday,7 days,30034.286
ACC-559365433,64,55.83,3665.98,1.0,CUS-1654129794,2018-10-18,Mary,F,-42.88,147.31,,631c424b-3610-478b-bc31-b60b7b5248f0,-35.12,147.34,NSW,Wagga Wagga,debit,authorized,d2d147eed33e401eaa9a785df16ab613,POS,60-70,2018,10,18,22,57,Thursday,7 days,30034.286
ACC-559365433,64,54.31,4187.67,1.0,CUS-1654129794,2018-10-19,Mary,F,-42.88,147.31,,94466281-42f2-4aac-94a6-c07f3d6c996b,-35.12,147.37,NSW,Wagga Wagga,debit,authorized,b9d5cf9c2be3473098cce3aef3ee9891,POS,60-70,2018,10,19,18,34,Friday,7 days,30034.286
ACC-559365433,64,5.1,4182.57,1.0,CUS-1654129794,2018-10-20,Mary,F,-42.88,147.31,,7645bd89-9675-4b0b-a598-7a72e59483d7,-35.15,147.46,NSW,Forest Hill,debit,authorized,aeaaec9abf3d45b3bf73c6a7471da2a0,SALES-POS,60-70,2018,10,20,8,35,Saturday,7 days,30034.286
ACC-559365433,64,24.01,4158.56,1.0,CUS-1654129794,2018-10-20,Mary,F,-42.88,147.31,,ff0d46d6-c939-474e-8a08-6974387a4ed9,-37.78,144.83,VIC,Sunshine,debit,authorized,b9eba0b9c63b48dab2a77f78d2a4c0cc,SALES-POS,60-70,2018,10,20,15,43,Saturday,7 days,30034.286
ACC-559365433,64,10.85,4147.71,1.0,CUS-1654129794,2018-10-20,Mary,F,-42.88,147.31,,d3dc2938-b8a8-4338-8910-d867ed21df1a,-37.95,145.15,VIC,Springvale,debit,authorized,0ef94b9c9dea4014bc10e4ba95242933,POS,60-70,2018,10,20,23,57,Saturday,7 days,30034.286
ACC-559365433,64,30.0,4117.71,,CUS-1654129794,2018-10-21,Mary,F,-42.88,147.31,,,,,,,debit,posted,f760c7763bbe4f50a8728a1bca45fc88,PAYMENT,60-70,2018,10,21,5,0,Sunday,7 days,30034.286
ACC-559365433,64,22.39,4095.32,1.0,CUS-1654129794,2018-10-22,Mary,F,-42.88,147.31,,b22b39e0-0daa-4e47-94a3-bc5c16021bbe,-37.82,145.04,VIC,Hawthorn,debit,authorized,c6693a37bf8e4f7abb642727a9f48b95,SALES-POS,60-70,2018,10,22,20,54,Monday,7 days,30034.286
ACC-559365433,64,14.51,4656.81,1.0,CUS-1654129794,2018-10-26,Mary,F,-42.88,147.31,,a96dacb7-35b9-45f2-896f-ae4979f6989b,-35.14,147.35,NSW,Tolland,debit,authorized,6a464138c82247518c435bf72ced5215,POS,60-70,2018,10,26,20,12,Friday,7 days,30034.286
ACC-559365433,64,10.32,4646.49,0.0,CUS-1654129794,2018-10-27,Mary,F,-42.88,147.31,,b5144831-00d3-4675-a349-4d2b68518cf7,-35.12,147.37,NSW,Wagga Wagga,debit,authorized,5e74d1847606446bb4e86402d5819a6b,POS,60-70,2018,10,27,8,49,Saturday,7 days,30034.286
ACC-559365433,64,49.94,4596.55,1.0,CUS-1654129794,2018-10-27,Mary,F,-42.88,147.31,,4779df60-3c73-487b-a3c3-6fb5cc1b75fb,-19.55,147.35,QLD,Brandon,debit,authorized,3e3464b2bcfc40f1b86845a9b80d4b32,POS,60-70,2018,10,27,9,0,Saturday,7 days,30034.286
ACC-559365433,64,24.23,4572.32,0.0,CUS-1654129794,2018-10-27,Mary,F,-42.88,147.31,,d7b8f51e-1832-4609-8d34-3e2de4445823,-35.12,147.36,NSW,Wagga Wagga,debit,authorized,237cbaee4ffb40278aeebae2543a35be,SALES-POS,60-70,2018,10,27,13,51,Saturday,7 days,30034.286
ACC-559365433,64,30.0,4542.32,,CUS-1654129794,2018-10-28,Mary,F,-42.88,147.31,,,,,,,debit,posted,ba80e4cb510f48cf9eae38a4921c7e1b,PAYMENT,60-70,2018,10,28,5,0,Sunday,7 days,30034.286
ACC-559365433,64,10.59,4531.73,1.0,CUS-1654129794,2018-10-28,Mary,F,-42.88,147.31,,d92f1d35-5e2d-4cdd-a67e-25e424f79494,-37.93,145.16,VIC,Springvale,debit,authorized,dcc5f8f0b80542f89e68f5ad6e311013,SALES-POS,60-70,2018,10,28,9,46,Sunday,7 days,30034.286
ACC-559365433,64,7.24,4524.49,0.0,CUS-1654129794,2018-10-29,Mary,F,-42.88,147.31,,28306da3-da51-41c7-9a73-91ec2255a4b7,-37.82,144.96,VIC,Melbourne,debit,authorized,6584cb1aced5491aa5933c42d2cd4533,SALES-POS,60-70,2018,10,29,10,26,Monday,7 days,30034.286
ACC-1438600314,35,32.97,1903.7,1.0,CUS-2650223890,2018-08-02,Maria,F,-34.84,138.69,,8927cdaf-73bc-49c2-ad75-0ebfbe983053,-34.84,148.91,NSW,Yass,debit,authorized,4f3e081f21a44a4ea76255d3ba37a842,SALES-POS,30-40,2018,8,2,12,26,Thursday,7 days,44996.679
ACC-1438600314,35,45.0,1858.7,,CUS-2650223890,2018-08-03,Maria,F,-34.84,138.69,,,,,,,debit,posted,87f79342618d4a87afc901712f12a289,PAYMENT,30-40,2018,8,3,19,0,Friday,7 days,44996.679
ACC-1438600314,35,53.43,1805.27,0.0,CUS-2650223890,2018-08-06,Maria,F,-34.84,138.69,,a1265af0-d718-4285-99ce-6eb528f8527c,-35.05,147.49,NSW,Harefield,debit,authorized,fbbd8ee3c896470c81abc0301b23d075,POS,30-40,2018,8,6,3,49,Monday,7 days,44996.679
ACC-1438600314,35,35.0,1770.27,,CUS-2650223890,2018-08-06,Maria,F,-34.84,138.69,,,,,,,debit,posted,dad5da5d9bf44d6f9657d5d6bf8a33d7,PAYMENT,30-40,2018,8,6,6,0,Monday,7 days,44996.679
ACC-1438600314,35,16.83,1753.44,1.0,CUS-2650223890,2018-08-06,Maria,F,-34.84,138.69,,09ddf497-5927-4d75-ac6b-db4d30cb4c4c,-34.89,138.65,SA,Glynde,debit,authorized,3b44bbcd02614a2ea1fde5b2b7049d16,SALES-POS,30-40,2018,8,6,10,35,Monday,7 days,44996.679
ACC-1438600314,35,31.96,2584.43,0.0,CUS-2650223890,2018-08-10,Maria,F,-34.84,138.69,,7c51fea7-7fd7-4f1c-b64f-3e0377737868,-34.67,150.85,NSW,Kiama,debit,authorized,af3a40c17e544500a7cd536d72381fa2,SALES-POS,30-40,2018,8,10,9,36,Friday,7 days,44996.679
ACC-1438600314,35,30.44,2553.99,0.0,CUS-2650223890,2018-08-10,Maria,F,-34.84,138.69,,c8c5a63c-993b-4f10-9905-efc03c2be02c,-37.79,145.07,VIC,Balwyn North,debit,authorized,a8916a96c34b41059e01fb0abcf7956d,POS,30-40,2018,8,10,10,57,Friday,7 days,44996.679
ACC-1438600314,35,56.67,2497.32,1.0,CUS-2650223890,2018-08-10,Maria,F,-34.84,138.69,,86f838e5-2161-4e93-b259-43f5ff0db914,-34.89,150.61,NSW,Nowra,debit,authorized,abbe0fc73ff948ac98289adef6e79024,SALES-POS,30-40,2018,8,10,14,12,Friday,7 days,44996.679
ACC-1438600314,35,45.0,2452.32,,CUS-2650223890,2018-08-10,Maria,F,-34.84,138.69,,,,,,,debit,posted,53ef324756c641a0a9be7400d28cff5a,PAYMENT,30-40,2018,8,10,19,0,Friday,7 days,44996.679
ACC-1438600314,35,35.0,2417.32,,CUS-2650223890,2018-08-13,Maria,F,-34.84,138.69,,,,,,,debit,posted,09a96554af2d41fbb6b6398369cccec5,PAYMENT,30-40,2018,8,13,6,0,Monday,7 days,44996.679
ACC-1438600314,35,120.0,2297.32,,CUS-2650223890,2018-08-13,Maria,F,-34.84,138.69,,,,,,,debit,posted,7ec38fa711914f99b129cb7b5fc14499,PAYMENT,30-40,2018,8,13,7,0,Monday,7 days,44996.679
ACC-1438600314,35,175.0,2985.27,,CUS-2650223890,2018-08-14,Maria,F,-34.84,138.69,,,,,,,debit,posted,8d1ac70f4cb94257923bc3a735d5844b,PAYMENT,30-40,2018,8,14,4,0,Tuesday,7 days,44996.679
ACC-1438600314,35,45.0,2940.27,,CUS-2650223890,2018-08-17,Maria,F,-34.84,138.69,,,,,,,debit,posted,ac52e20ee1374aa0b51f9d82deaf87f1,PAYMENT,30-40,2018,8,17,19,0,Friday,7 days,44996.679
ACC-1438600314,35,83.0,2857.27,,CUS-2650223890,2018-08-17,Maria,F,-34.84,138.69,,,,,,,debit,posted,0df3acd752454c83bfd743669e5e4211,PAYMENT,30-40,2018,8,17,20,0,Friday,7 days,44996.679
ACC-1438600314,35,35.0,2822.27,,CUS-2650223890,2018-08-20,Maria,F,-34.84,138.69,,,,,,,debit,posted,65cbbec4b5d648c2a605b4451600446d,PAYMENT,30-40,2018,8,20,6,0,Monday,7 days,44996.679
ACC-1438600314,35,24.37,3660.85,0.0,CUS-2650223890,2018-08-21,Maria,F,-34.84,138.69,,7e4ce928-54c3-46aa-a1bf-1ee4f1fc8649,-35.24,149.07,ACT,Belconnen,debit,authorized,7afa9b9e2b9347f3896727f0f8105a91,SALES-POS,30-40,2018,8,21,7,44,Tuesday,7 days,44996.679
ACC-1438600314,35,15.47,3645.38,1.0,CUS-2650223890,2018-08-22,Maria,F,-34.84,138.69,,3287f682-8760-4b85-b0a7-a063edf15978,-35,138.52,SA,North Brighton,debit,authorized,0bcc717b70924068909bb322b00d2dfb,SALES-POS,30-40,2018,8,22,16,5,Wednesday,7 days,44996.679
ACC-1438600314,35,22.24,3623.14,1.0,CUS-2650223890,2018-08-23,Maria,F,-34.84,138.69,,335744ac-232a-4eed-b79d-7a7b422eb92c,-34.95,138.58,SA,Ashford,debit,authorized,0ea776b1e038493eb34c05b2bcda1f3e,SALES-POS,30-40,2018,8,23,9,28,Thursday,7 days,44996.679
ACC-1438600314,35,43.25,3579.89,0.0,CUS-2650223890,2018-08-24,Maria,F,-34.84,138.69,,cd6b9ee2-6660-41f0-807e-e403063257fd,-34.9,138.87,SA,Lobethal,debit,authorized,4bbe4c2e92184295839b9707977e6b74,SALES-POS,30-40,2018,8,24,15,0,Friday,7 days,44996.679
ACC-1438600314,35,64.66,3515.23,1.0,CUS-2650223890,2018-08-24,Maria,F,-34.84,138.69,,5ba0c0ed-5463-473e-b485-91ae795d2d2b,-34.91,150.58,NSW,South Nowra,debit,authorized,dd9a31c938464ba7855c161efbdec74c,SALES-POS,30-40,2018,8,24,18,19,Friday,7 days,44996.679
ACC-1438600314,35,45.0,3470.23,,CUS-2650223890,2018-08-24,Maria,F,-34.84,138.69,,,,,,,debit,posted,1b37a5f8fc4a46ea9222efac504b0f33,PAYMENT,30-40,2018,8,24,19,0,Friday,7 days,44996.679
ACC-1438600314,35,35.0,3435.23,,CUS-2650223890,2018-08-27,Maria,F,-34.84,138.69,,,,,,,debit,posted,bd97202f08bc402599e967ce6a7faa9c,PAYMENT,30-40,2018,8,27,6,0,Monday,7 days,44996.679
ACC-1438600314,35,45.0,4253.18,,CUS-2650223890,2018-08-31,Maria,F,-34.84,138.69,,,,,,,debit,posted,b0a79a8dd1264e8d8077a35839ec67ae,PAYMENT,30-40,2018,8,31,19,0,Friday,7 days,44996.679
ACC-1438600314,35,35.0,4218.18,,CUS-2650223890,2018-09-03,Maria,F,-34.84,138.69,,,,,,,debit,posted,90f8ee5ded6343e9a8e9d5755f3027c9,PAYMENT,30-40,2018,9,3,6,0,Monday,7 days,44996.679
ACC-1438600314,35,56.03,5025.1,1.0,CUS-2650223890,2018-09-04,Maria,F,-34.84,138.69,,350d6501-7393-4487-bc03-9206c9b6bec8,-34.95,138.64,SA,Glenunga,debit,authorized,4db7176b43b24a6ba45cd3f8f52e5a96,POS,30-40,2018,9,4,9,25,Tuesday,7 days,44996.679
ACC-1438600314,35,149.44,4875.66,0.0,CUS-2650223890,2018-09-04,Maria,F,-34.84,138.69,,7d255631-a82f-4d59-8647-4daaeed18d1d,-34.96,138.64,SA,Glen Osmond,debit,authorized,bce5e0146b10437da06b012103e9b345,POS,30-40,2018,9,4,11,13,Tuesday,7 days,44996.679
ACC-1438600314,35,1345.0,3530.66,,CUS-2650223890,2018-09-06,Maria,F,-34.84,138.69,,,,,,,debit,posted,e4f01a59de9f4852beea2ab394eead35,PAYMENT,30-40,2018,9,6,22,0,Thursday,7 days,44996.679
ACC-1438600314,35,45.0,3485.66,,CUS-2650223890,2018-09-07,Maria,F,-34.84,138.69,,,,,,,debit,posted,e550c1d609eb4bf2837bcce5bd4054d4,PAYMENT,30-40,2018,9,7,19,0,Friday,7 days,44996.679
ACC-1438600314,35,35.0,3450.66,,CUS-2650223890,2018-09-10,Maria,F,-34.84,138.69,,,,,,,debit,posted,94fa6fbf3f0d41ffbc4ce6c763d8791b,PAYMENT,30-40,2018,9,10,6,0,Monday,7 days,44996.679
ACC-1438600314,35,120.0,4193.61,,CUS-2650223890,2018-09-13,Maria,F,-34.84,138.69,,,,,,,debit,posted,0e316df7dfc74da6b2b9ddbe49036c44,PAYMENT,30-40,2018,9,13,7,0,Thursday,7 days,44996.679
ACC-1438600314,35,175.0,4018.61,,CUS-2650223890,2018-09-14,Maria,F,-34.84,138.69,,,,,,,debit,posted,f3306a35ffb64fe2a7c89c92894c7bad,PAYMENT,30-40,2018,9,14,4,0,Friday,7 days,44996.679
ACC-1438600314,35,45.0,3973.61,,CUS-2650223890,2018-09-14,Maria,F,-34.84,138.69,,,,,,,debit,posted,939b91185cbc44149e1cb0d8f7d5df7a,PAYMENT,30-40,2018,9,14,19,0,Friday,7 days,44996.679
ACC-1438600314,35,84.58,3889.03,1.0,CUS-2650223890,2018-09-15,Maria,F,-34.84,138.69,,d745e2a5-f129-47a4-b733-db2f94124359,-34.97,149.03,NSW,Murrumbateman,debit,authorized,daa00ff5e7c3429b811d57b4d5d928db,SALES-POS,30-40,2018,9,15,11,5,Saturday,7 days,44996.679
ACC-1438600314,35,19.4,3869.63,1.0,CUS-2650223890,2018-09-15,Maria,F,-34.84,138.69,,3f16e9e6-bf55-4d39-b4eb-3e459f51a019,-34.77,149.69,NSW,Goulburn,debit,authorized,3e57ef73772f43bba947e2b1c0638cfd,POS,30-40,2018,9,15,16,6,Saturday,7 days,44996.679
ACC-1438600314,35,23.87,3845.76,1.0,CUS-2650223890,2018-09-15,Maria,F,-34.84,138.69,,c1be9e40-0599-42c4-97e1-1eee927a4747,-34.61,150.23,NSW,Exeter,debit,authorized,12f959dd607d4922a485d78613fe00c1,POS,30-40,2018,9,15,16,22,Saturday,7 days,44996.679
ACC-1438600314,35,658.49,3187.27,1.0,CUS-2650223890,2018-09-15,Maria,F,-34.84,138.69,,cec6c173-d338-458d-8de3-0268e91dfcd6,-35.06,117.53,WA,Lowlands,debit,authorized,ad4edd91b3ab4675b61b98ef9a68ab51,POS,30-40,2018,9,15,17,41,Saturday,7 days,44996.679
ACC-1438600314,35,99.54,3087.73,1.0,CUS-2650223890,2018-09-15,Maria,F,-34.84,138.69,,7c9a4525-f0a0-4d06-bd3a-9518bcf2d406,-34.95,138.58,SA,Ashford,debit,authorized,c14c810d4fc74027b5df2cf9e155e1e1,POS,30-40,2018,9,15,17,50,Saturday,7 days,44996.679
ACC-1438600314,35,76.3,3011.43,1.0,CUS-2650223890,2018-09-15,Maria,F,-34.84,138.69,,3761c02e-96d1-49d0-8553-b5454268edca,-34.96,138.54,SA,North Plympton,debit,authorized,4deeffd1f07d4fbe851728f10d56ec79,POS,30-40,2018,9,15,19,10,Saturday,7 days,44996.679
ACC-1438600314,35,23.64,2987.79,1.0,CUS-2650223890,2018-09-15,Maria,F,-34.84,138.69,,dde85bee-5ccf-4571-b426-77837c1b9408,-34.81,148.88,NSW,Yass,debit,authorized,8a2e9a8765124572805c2f0c01c872ed,SALES-POS,30-40,2018,9,15,19,20,Saturday,7 days,44996.679
ACC-1438600314,35,110.18,2877.61,0.0,CUS-2650223890,2018-09-16,Maria,F,-34.84,138.69,,3627a189-f7ee-4fcc-b2d2-8adeab637990,-34.94,138.64,SA,Glenside,debit,authorized,849729dcd1d44a2ca2534f4e7e28021f,SALES-POS,30-40,2018,9,16,9,52,Sunday,7 days,44996.679
ACC-1438600314,35,40.93,2836.68,1.0,CUS-2650223890,2018-09-16,Maria,F,-34.84,138.69,,bba9dc1b-883b-4f60-a316-3a34ac6ffc1c,-34.99,150.72,NSW,Callala Bay,debit,authorized,7059ddba884c4b4c8e2da45265865c02,SALES-POS,30-40,2018,9,16,10,50,Sunday,7 days,44996.679
ACC-1438600314,35,35.0,2801.68,,CUS-2650223890,2018-09-17,Maria,F,-34.84,138.69,,,,,,,debit,posted,ffeccd3e43bb4806b641678efebe9fd0,PAYMENT,30-40,2018,9,17,6,0,Monday,7 days,44996.679
ACC-1438600314,35,83.0,3581.63,,CUS-2650223890,2018-09-17,Maria,F,-34.84,138.69,,,,,,,debit,posted,510fd13a01124453a19bb1cd268466c1,PAYMENT,30-40,2018,9,17,20,0,Monday,7 days,44996.679
ACC-1438600314,35,23.34,3558.29,1.0,CUS-2650223890,2018-09-17,Maria,F,-34.84,138.69,,96afff67-b020-4df1-aa73-b73645ed6b0a,-35.31,149.19,ACT,MAJURA,debit,authorized,bdfc365ce9f04f0da593901a1781b9b7,SALES-POS,30-40,2018,9,17,21,57,Monday,7 days,44996.679
ACC-1438600314,35,53.1,3505.19,1.0,CUS-2650223890,2018-09-18,Maria,F,-34.84,138.69,,1d1a5361-c41c-45fa-aba5-645f3b147e28,-34.93,150.76,NSW,Culburra Beach,debit,authorized,fcce0ead56594b9daa919ac454dd1496,SALES-POS,30-40,2018,9,18,8,11,Tuesday,7 days,44996.679
ACC-1438600314,35,39.59,3465.6,1.0,CUS-2650223890,2018-09-18,Maria,F,-34.84,138.69,,bf5c617d-0edd-4fc0-b636-b1abc5af32e9,-35.1,150.69,NSW,Hyams Beach,debit,authorized,4e61a5c219fc46a3bdd0a17cb9505c11,POS,30-40,2018,9,18,9,15,Tuesday,7 days,44996.679
ACC-1438600314,35,791.29,2674.31,1.0,CUS-2650223890,2018-09-18,Maria,F,-34.84,138.69,,f91add47-f896-4fbd-b60f-4e59aa1a1bbb,-34.98,138.57,SA,Melrose Park,debit,authorized,e0af4b6da01b479fb75f7ea21ed069f8,SALES-POS,30-40,2018,9,18,10,2,Tuesday,7 days,44996.679
ACC-1438600314,35,45.0,2582.66,,CUS-2650223890,2018-09-21,Maria,F,-34.84,138.69,,,,,,,debit,posted,e9ceb91a1fb74539bc0c5e7db520c0b4,PAYMENT,30-40,2018,9,21,19,0,Friday,7 days,44996.679
ACC-1438600314,35,46.65,2627.66,1.0,CUS-2650223890,2018-09-21,Maria,F,-34.84,138.69,,7fd1b176-d418-4ba9-959f-320e20a3ae05,-37.95,145.04,VIC,Highett,debit,authorized,402419b57b934f789527bebf5d837303,SALES-POS,30-40,2018,9,21,19,14,Friday,7 days,44996.679
ACC-1438600314,35,101.04,2481.62,1.0,CUS-2650223890,2018-09-21,Maria,F,-34.84,138.69,,2c4cac87-8586-4eda-8b3d-fe7be164fa00,-34.86,150.6,NSW,North Nowra,debit,authorized,d772d01d13a349b7962af3c56d5fe8ea,SALES-POS,30-40,2018,9,21,20,36,Friday,7 days,44996.679
ACC-1438600314,35,36.78,2444.84,1.0,CUS-2650223890,2018-09-22,Maria,F,-34.84,138.69,,547ea2f7-a774-4edb-b284-e7730ad7dec9,-34.69,138.69,SA,Smithfield,debit,authorized,203f4816ab6b41cb990db54cfa2d1c04,SALES-POS,30-40,2018,9,22,16,39,Saturday,7 days,44996.679
ACC-1438600314,35,35.0,2409.84,,CUS-2650223890,2018-09-24,Maria,F,-34.84,138.69,,,,,,,debit,posted,f9c85c44efd54325a9978860214cd7a4,PAYMENT,30-40,2018,9,24,6,0,Monday,7 days,44996.679
ACC-1438600314,35,45.0,3227.79,,CUS-2650223890,2018-09-28,Maria,F,-34.84,138.69,,,,,,,debit,posted,42d8d6eb50a3422a89b00eff1f8c5f92,PAYMENT,30-40,2018,9,28,19,0,Friday,7 days,44996.679
ACC-1438600314,35,35.0,3192.79,,CUS-2650223890,2018-10-01,Maria,F,-34.84,138.69,,,,,,,debit,posted,8811312934164b69afb6c6d1e02b8dff,PAYMENT,30-40,2018,10,1,6,0,Monday,7 days,44996.679
ACC-1438600314,35,45.0,4010.74,,CUS-2650223890,2018-10-05,Maria,F,-34.84,138.69,,,,,,,debit,posted,8571bf07e58a469787e5c168cef23bd0,PAYMENT,30-40,2018,10,5,19,0,Friday,7 days,44996.679
ACC-1438600314,35,35.0,3975.74,,CUS-2650223890,2018-10-08,Maria,F,-34.84,138.69,,,,,,,debit,posted,fba9ef9b85174497965ed2e074d81e06,PAYMENT,30-40,2018,10,8,6,0,Monday,7 days,44996.679
ACC-1438600314,35,45.0,4793.69,,CUS-2650223890,2018-10-12,Maria,F,-34.84,138.69,,,,,,,debit,posted,d2508e55879b40729d4d1a4bb2094807,PAYMENT,30-40,2018,10,12,19,0,Friday,7 days,44996.679
ACC-1438600314,35,120.0,4673.69,,CUS-2650223890,2018-10-13,Maria,F,-34.84,138.69,,,,,,,debit,posted,b09f824fef3041628bbb9aa78ab8dccc,PAYMENT,30-40,2018,10,13,7,0,Saturday,7 days,44996.679
ACC-1438600314,35,175.0,4498.69,,CUS-2650223890,2018-10-14,Maria,F,-34.84,138.69,,,,,,,debit,posted,4b700d3e637a45709dd65f967620ef1b,PAYMENT,30-40,2018,10,14,4,0,Sunday,7 days,44996.679
ACC-1438600314,35,35.0,4463.69,,CUS-2650223890,2018-10-15,Maria,F,-34.84,138.69,,,,,,,debit,posted,3b44533b8b5a4d218947e6ada514540e,PAYMENT,30-40,2018,10,15,6,0,Monday,7 days,44996.679
ACC-1438600314,35,17.66,4446.03,1.0,CUS-2650223890,2018-10-15,Maria,F,-34.84,138.69,,f9718448-276c-404d-afd5-3a1fa947e605,-34.73,138.63,SA,Edinburgh,debit,authorized,a62d19988e77404c925accee27339b8d,SALES-POS,30-40,2018,10,15,8,21,Monday,7 days,44996.679
ACC-1438600314,35,83.0,5225.98,,CUS-2650223890,2018-10-17,Maria,F,-34.84,138.69,,,,,,,debit,posted,ef71d48e1f2242e89621b338db04fa3f,PAYMENT,30-40,2018,10,17,20,0,Wednesday,7 days,44996.679
ACC-1438600314,35,45.0,5180.98,,CUS-2650223890,2018-10-19,Maria,F,-34.84,138.69,,,,,,,debit,posted,4f65b57308c2404e8a39b261593482af,PAYMENT,30-40,2018,10,19,19,0,Friday,7 days,44996.679
ACC-1438600314,35,26.45,5154.53,1.0,CUS-2650223890,2018-10-19,Maria,F,-34.84,138.69,,9b8f5049-fe7e-484d-931d-c01f43615087,-35.24,149.07,ACT,Belconnen,debit,authorized,b0ff0a96e9344fe496bd75d9ddb73eca,SALES-POS,30-40,2018,10,19,21,34,Friday,7 days,44996.679
ACC-1438600314,35,35.0,5119.53,,CUS-2650223890,2018-10-22,Maria,F,-34.84,138.69,,,,,,,debit,posted,e144a76e57d3445dbfa8b5d8794efb94,PAYMENT,30-40,2018,10,22,6,0,Monday,7 days,44996.679
ACC-1438600314,35,27.08,5955.4,1.0,CUS-2650223890,2018-10-24,Maria,F,-34.84,138.69,,3c90e5e5-31ae-4e20-b78d-6b0cd3537178,-34.83,138.69,SA,Modbury,debit,authorized,00bde5de15184e7ca669f7efc1143f9a,SALES-POS,30-40,2018,10,24,11,22,Wednesday,7 days,44996.679
ACC-1438600314,35,45.0,5910.4,,CUS-2650223890,2018-10-26,Maria,F,-34.84,138.69,,,,,,,debit,posted,37ffa60ed86e4b34a6b227af611f9f02,PAYMENT,30-40,2018,10,26,19,0,Friday,7 days,44996.679
ACC-1438600314,35,35.0,5875.4,,CUS-2650223890,2018-10-29,Maria,F,-34.84,138.69,,,,,,,debit,posted,abe40a84923f431e8f0d8bb8df222cdc,PAYMENT,30-40,2018,10,29,6,0,Monday,7 days,44996.679
ACC-4274272854,20,15.0,2666.12,,CUS-2484453271,2018-08-02,Timothy,M,-37.86,145.23,,,,,,,debit,posted,9b0fa78459a04576940b30246fa9b65d,PAYMENT,<20,2018,8,2,13,0,Thursday,14 days,42778.782
ACC-4274272854,20,7.24,2658.88,1.0,CUS-2484453271,2018-08-02,Timothy,M,-37.86,145.23,,4247b971-f70e-437a-bda8-954adefab19e,-37.8,144.98,VIC,Collingwood,debit,authorized,979ec4292de44de79d50f9d23bb6309e,SALES-POS,<20,2018,8,2,17,45,Thursday,14 days,42778.782
ACC-4274272854,20,61.14,2597.74,1.0,CUS-2484453271,2018-08-03,Timothy,M,-37.86,145.23,,42ade571-5972-4160-9ecb-e0162a305fee,-33.7,151.21,NSW,Belrose,debit,authorized,6d0837e6986c4e2693c437c3fb269535,POS,<20,2018,8,3,11,12,Friday,14 days,42778.782
ACC-4274272854,20,37.92,2559.82,1.0,CUS-2484453271,2018-08-03,Timothy,M,-37.86,145.23,,38b59ae9-b336-4e24-9f56-cc0b0d56b732,-36.39,145.41,VIC,Shepparton,debit,authorized,318efd65578f4990960b266f430f17ab,POS,<20,2018,8,3,18,56,Friday,14 days,42778.782
ACC-4274272854,20,12.89,2546.93,1.0,CUS-2484453271,2018-08-03,Timothy,M,-37.86,145.23,,bc0743aa-38d8-4d19-9488-0be15bae94e9,-37.77,144.96,VIC,Brunswick,debit,authorized,ae9b7e6c2e284143a2f4b7cc4f0132d5,POS,<20,2018,8,3,21,26,Friday,14 days,42778.782
ACC-4274272854,20,25.43,2521.5,1.0,CUS-2484453271,2018-08-05,Timothy,M,-37.86,145.23,,d00f8335-63b0-44a2-8584-158ee558ec6f,-34.09,151.15,NSW,Bundeena,debit,authorized,ca8e3ef7bfca4068834f48dd28687f9e,POS,<20,2018,8,5,1,51,Sunday,14 days,42778.782
ACC-4274272854,20,34.0,2487.5,,CUS-2484453271,2018-08-07,Timothy,M,-37.86,145.23,,,,,,,debit,posted,a47dc07b42f140f9b0ce6e45c74ebb07,PAYMENT,<20,2018,8,7,7,0,Tuesday,14 days,42778.782
ACC-4274272854,20,18.56,2468.94,1.0,CUS-2484453271,2018-08-08,Timothy,M,-37.86,145.23,,6102e64f-516d-4b51-bc28-87dbfe089f5c,-37.83,144.97,VIC,Southbank,debit,authorized,ab45a6368c4b42f59b340bd68280cca9,SALES-POS,<20,2018,8,8,8,19,Wednesday,14 days,42778.782
ACC-4274272854,20,15.14,2453.8,1.0,CUS-2484453271,2018-08-08,Timothy,M,-37.86,145.23,,d1ec3755-236f-4953-9d15-9907643da39d,-37.83,147.63,VIC,Bairnsdale,debit,authorized,e9094df43bac428cb38f4504779e0d22,SALES-POS,<20,2018,8,8,8,29,Wednesday,14 days,42778.782
ACC-4274272854,20,6.62,2447.18,1.0,CUS-2484453271,2018-08-08,Timothy,M,-37.86,145.23,,c71c012b-861c-49f6-9fde-3c6c56a054f9,-37.74,145.03,VIC,Preston,debit,authorized,b622b64a5ade46bbaf8102262c5e99d7,POS,<20,2018,8,8,11,22,Wednesday,14 days,42778.782
ACC-4274272854,20,20.25,2426.93,1.0,CUS-2484453271,2018-08-08,Timothy,M,-37.86,145.23,,0294e5b5-4b58-4bb2-9e37-a343fe0730ca,-38.06,144.38,VIC,Corio,debit,authorized,4a065abfba984d439335a37d5d254869,POS,<20,2018,8,8,11,37,Wednesday,14 days,42778.782
ACC-4274272854,20,15.0,2411.93,,CUS-2484453271,2018-08-09,Timothy,M,-37.86,145.23,,,,,,,debit,posted,6944836fb83444fc9cfed8ec655d1242,PAYMENT,<20,2018,8,9,13,0,Thursday,14 days,42778.782
ACC-4274272854,20,18.14,2393.79,1.0,CUS-2484453271,2018-08-09,Timothy,M,-37.86,145.23,,f38a29b7-7468-4617-810b-9de0342575d6,-37.82,144.96,VIC,Melbourne,debit,authorized,ac8bc1c875da4c3cab2aa7bdb88a7f79,SALES-POS,<20,2018,8,9,20,34,Thursday,14 days,42778.782
ACC-4274272854,20,10.29,2383.5,1.0,CUS-2484453271,2018-08-10,Timothy,M,-37.86,145.23,,1e53dd68-faec-440e-81c4-f18cb3eecd76,-37.82,144.96,VIC,Melbourne,debit,authorized,0bd3d40bad1c46bf92a08bddec13d469,SALES-POS,<20,2018,8,10,5,25,Friday,14 days,42778.782
ACC-4274272854,20,11.82,2371.68,1.0,CUS-2484453271,2018-08-12,Timothy,M,-37.86,145.23,,003c0f9e-f622-4899-8c82-1fc01ca0b69f,-37.8,144.98,VIC,Fitzroy,debit,authorized,b26184ad18774624968bebe4bd4b5555,SALES-POS,<20,2018,8,12,10,22,Sunday,14 days,42778.782
ACC-4274272854,20,9.57,2362.11,1.0,CUS-2484453271,2018-08-12,Timothy,M,-37.86,145.23,,5fd8cf03-ac07-496c-b4b6-3e20b9f1162e,-37.81,145.05,VIC,Kew,debit,authorized,95fee5c08fa0480aa8089f39e022523c,POS,<20,2018,8,12,10,38,Sunday,14 days,42778.782
ACC-4274272854,20,15.84,2346.27,1.0,CUS-2484453271,2018-08-12,Timothy,M,-37.86,145.23,,d066992c-cfaf-4c4a-8d76-42844a72e355,-37.87,144.78,VIC,Altona Meadows,debit,authorized,8980f9651b2d43b896fe54a3f56a9b5b,POS,<20,2018,8,12,22,35,Sunday,14 days,42778.782
ACC-4274272854,20,16.33,2329.94,0.0,CUS-2484453271,2018-08-12,Timothy,M,-37.86,145.23,,f1b609f1-d90b-41fe-97b1-8977c6c06d70,-37.87,144.59,VIC,Wyndham Vale,debit,authorized,c4bed06b7a6a462f88fc54321308bfc9,SALES-POS,<20,2018,8,12,23,25,Sunday,14 days,42778.782
ACC-4274272854,20,15.69,2314.25,1.0,CUS-2484453271,2018-08-13,Timothy,M,-37.86,145.23,,df53ac87-5ae2-4100-b92d-1e4684e83c49,-37.82,145.04,VIC,Hawthorn,debit,authorized,25d7065bafb9403582a707bfb0ce493d,POS,<20,2018,8,13,11,59,Monday,14 days,42778.782
ACC-4274272854,20,34.0,3921.08,,CUS-2484453271,2018-08-14,Timothy,M,-37.86,145.23,,,,,,,debit,posted,7f283de5489248ee8f68b524b5b39c7b,PAYMENT,<20,2018,8,14,7,0,Tuesday,14 days,42778.782
ACC-4274272854,20,71.0,3835.08,,CUS-2484453271,2018-08-18,Timothy,M,-37.86,145.23,,,,,,,debit,posted,3b88adab001e46f4a3ffbd81414acf3a,PAYMENT,<20,2018,8,18,7,0,Saturday,14 days,42778.782
ACC-4274272854,20,34.0,3801.08,,CUS-2484453271,2018-08-21,Timothy,M,-37.86,145.23,,,,,,,debit,posted,36f7daf5c35d49798e6b2dfb504d97c0,PAYMENT,<20,2018,8,21,7,0,Tuesday,14 days,42778.782
ACC-4274272854,20,116.0,3685.08,,CUS-2484453271,2018-08-22,Timothy,M,-37.86,145.23,,,,,,,debit,posted,e526c15d2f864df19b4c87cd1cd8164c,PAYMENT,<20,2018,8,22,19,0,Wednesday,14 days,42778.782
ACC-4274272854,20,15.0,3670.08,,CUS-2484453271,2018-08-23,Timothy,M,-37.86,145.23,,,,,,,debit,posted,9bb2d6f13018485094161a7db5fcfcea,PAYMENT,<20,2018,8,23,13,0,Thursday,14 days,42778.782
ACC-4274272854,20,34.0,5276.91,,CUS-2484453271,2018-08-28,Timothy,M,-37.86,145.23,,,,,,,debit,posted,5a97227863174db58f1fe8af317639eb,PAYMENT,<20,2018,8,28,7,0,Tuesday,14 days,42778.782
ACC-4274272854,20,15.0,5261.91,,CUS-2484453271,2018-08-30,Timothy,M,-37.86,145.23,,,,,,,debit,posted,9cf6bac786c04e84b26e3f922fbbc508,PAYMENT,<20,2018,8,30,13,0,Thursday,14 days,42778.782
ACC-4274272854,20,34.0,5227.91,,CUS-2484453271,2018-09-04,Timothy,M,-37.86,145.23,,,,,,,debit,posted,f985eb89457c428e89b8d052c7758a0c,PAYMENT,<20,2018,9,4,7,0,Tuesday,14 days,42778.782
ACC-4274272854,20,15.0,5212.91,,CUS-2484453271,2018-09-06,Timothy,M,-37.86,145.23,,,,,,,debit,posted,d5b33133004442b9a0ca0abd0c04a522,PAYMENT,<20,2018,9,6,13,0,Thursday,14 days,42778.782
ACC-4274272854,20,34.0,6819.74,,CUS-2484453271,2018-09-11,Timothy,M,-37.86,145.23,,,,,,,debit,posted,17165be2cb0345678b762e70fe3e509f,PAYMENT,<20,2018,9,11,7,0,Tuesday,14 days,42778.782
ACC-4274272854,20,969.62,5850.12,1.0,CUS-2484453271,2018-09-12,Timothy,M,-37.86,145.23,,67b77e0d-60d2-4aa8-8505-e92d77630788,-37.85,144.79,VIC,Altona,debit,authorized,f49ef10f5df743b5b3692ef3b8c21b6b,POS,<20,2018,9,12,15,34,Wednesday,14 days,42778.782
ACC-4274272854,20,25.02,5825.1,0.0,CUS-2484453271,2018-09-13,Timothy,M,-37.86,145.23,,0542f88c-0252-437a-9161-da3c0aff2875,-37.78,144.86,VIC,Braybrook,debit,authorized,3ccbe2836f4d4d2db5c812cf760d9665,POS,<20,2018,9,13,1,36,Thursday,14 days,42778.782
ACC-4274272854,20,17.7,5807.4,1.0,CUS-2484453271,2018-09-13,Timothy,M,-37.86,145.23,,32dee8bf-1e33-4568-94b5-f51d531175a4,-38.06,145.41,VIC,Officer,debit,authorized,b1b7db8040e94343be70dcda91c058e2,POS,<20,2018,9,13,4,38,Thursday,14 days,42778.782
ACC-4274272854,20,8.66,5798.74,1.0,CUS-2484453271,2018-09-13,Timothy,M,-37.86,145.23,,acb057e5-a59f-492e-b83b-61b75fa1fa12,-42.15,145.33,TAS,Strahan,debit,authorized,a216c6965edf459f9fbdcdd775b66a12,POS,<20,2018,9,13,8,13,Thursday,14 days,42778.782
ACC-4274272854,20,10.27,5788.47,1.0,CUS-2484453271,2018-09-13,Timothy,M,-37.86,145.23,,1832158b-7c45-4e17-9239-b7d7fef46969,-38.02,145.31,VIC,Narre Warren,debit,authorized,dff97f3022f942d7ab9faa2be3769989,SALES-POS,<20,2018,9,13,8,29,Thursday,14 days,42778.782
ACC-4274272854,20,15.0,5773.47,,CUS-2484453271,2018-09-13,Timothy,M,-37.86,145.23,,,,,,,debit,posted,c8b43329fe4b41159c7032ec01fa9f12,PAYMENT,<20,2018,9,13,13,0,Thursday,14 days,42778.782
ACC-4274272854,20,34.0,5739.47,,CUS-2484453271,2018-09-18,Timothy,M,-37.86,145.23,,,,,,,debit,posted,642718bf9e0440e0a3995809e9aea494,PAYMENT,<20,2018,9,18,7,0,Tuesday,14 days,42778.782
ACC-4274272854,20,71.0,5668.47,,CUS-2484453271,2018-09-18,Timothy,M,-37.86,145.23,,,,,,,debit,posted,160c5050cb4949bbb188f88ffa14aede,PAYMENT,<20,2018,9,18,7,0,Tuesday,14 days,42778.782
ACC-4274272854,20,15.0,5653.47,,CUS-2484453271,2018-09-20,Timothy,M,-37.86,145.23,,,,,,,debit,posted,7d1af9e01da54b29af01729328b28c94,PAYMENT,<20,2018,9,20,13,0,Thursday,14 days,42778.782
ACC-4274272854,20,116.0,5537.47,,CUS-2484453271,2018-09-22,Timothy,M,-37.86,145.23,,,,,,,debit,posted,70dec51ea56e4ca9b364d01f4632df18,PAYMENT,<20,2018,9,22,19,0,Saturday,14 days,42778.782
ACC-4274272854,20,34.0,7144.3,,CUS-2484453271,2018-09-25,Timothy,M,-37.86,145.23,,,,,,,debit,posted,ae93d1d6be554bbbb3516719e4e60ed1,PAYMENT,<20,2018,9,25,7,0,Tuesday,14 days,42778.782
ACC-4274272854,20,19.68,7124.62,1.0,CUS-2484453271,2018-09-26,Timothy,M,-37.86,145.23,,cbce5e24-75c0-4eb2-8681-462a18200447,-37.73,144.81,VIC,Keilor Downs,debit,authorized,ec9ff581f1e94fe1a1f640e244d1e088,POS,<20,2018,9,26,15,57,Wednesday,14 days,42778.782
ACC-4274272854,20,15.0,7109.62,,CUS-2484453271,2018-09-27,Timothy,M,-37.86,145.23,,,,,,,debit,posted,7b1925d0fb7d457fab29c308d3eed511,PAYMENT,<20,2018,9,27,13,0,Thursday,14 days,42778.782
ACC-4274272854,20,34.0,7075.62,,CUS-2484453271,2018-10-02,Timothy,M,-37.86,145.23,,,,,,,debit,posted,1cfcabc6860044cbb168c49886ce353b,PAYMENT,<20,2018,10,2,7,0,Tuesday,14 days,42778.782
ACC-4274272854,20,15.0,7060.62,,CUS-2484453271,2018-10-04,Timothy,M,-37.86,145.23,,,,,,,debit,posted,46dea03fa3de4f0f874fcbb2ebfb4e6b,PAYMENT,<20,2018,10,4,13,0,Thursday,14 days,42778.782
ACC-4274272854,20,63.25,6997.37,1.0,CUS-2484453271,2018-10-07,Timothy,M,-37.86,145.23,,a6a83743-35c0-4c9f-ac48-79c27c11ccc4,-37.82,145.11,VIC,Mont Albert,debit,authorized,7a2dd5bab13344f1bd7b54e0d42a4fa8,POS,<20,2018,10,7,22,59,Sunday,14 days,42778.782
ACC-4274272854,20,34.0,8604.2,,CUS-2484453271,2018-10-09,Timothy,M,-37.86,145.23,,,,,,,debit,posted,329dac9097d4489493b0dfb097dacea1,PAYMENT,<20,2018,10,9,7,0,Tuesday,14 days,42778.782
ACC-4274272854,20,17.17,8587.03,1.0,CUS-2484453271,2018-10-10,Timothy,M,-37.86,145.23,,fe235033-df5c-4703-ac2e-474efd1acb4d,-33.88,151.21,NSW,Haymarket,debit,authorized,f3cb80e87d4e4dcd848e331f319b828e,POS,<20,2018,10,10,11,26,Wednesday,14 days,42778.782
ACC-4274272854,20,12.2,8574.83,1.0,CUS-2484453271,2018-10-11,Timothy,M,-37.86,145.23,,4b10a1e0-19aa-4845-8716-6146d0be3a29,-37.7,144.96,VIC,Fawkner,debit,authorized,54945eb9fe004f42a341147bab51a8a4,POS,<20,2018,10,11,11,34,Thursday,14 days,42778.782
ACC-4274272854,20,15.0,8559.83,,CUS-2484453271,2018-10-11,Timothy,M,-37.86,145.23,,,,,,,debit,posted,0f60643035ce438f872e7d30acb6ac17,PAYMENT,<20,2018,10,11,13,0,Thursday,14 days,42778.782
ACC-4274272854,20,16.59,8543.24,1.0,CUS-2484453271,2018-10-11,Timothy,M,-37.86,145.23,,aa6ae610-6f14-481e-9318-edaa7b6f8990,-37.67,144.75,VIC,Calder Park,debit,authorized,f136d92b571e4c66a63250b981f33242,SALES-POS,<20,2018,10,11,14,3,Thursday,14 days,42778.782
ACC-4274272854,20,34.0,8509.24,,CUS-2484453271,2018-10-16,Timothy,M,-37.86,145.23,,,,,,,debit,posted,a081705695504976803d7ba24558395b,PAYMENT,<20,2018,10,16,7,0,Tuesday,14 days,42778.782
ACC-4274272854,20,71.0,8438.24,,CUS-2484453271,2018-10-18,Timothy,M,-37.86,145.23,,,,,,,debit,posted,b4e307dc68ca41df8c7957ade9a01559,PAYMENT,<20,2018,10,18,7,0,Thursday,14 days,42778.782
ACC-4274272854,20,15.0,8423.24,,CUS-2484453271,2018-10-18,Timothy,M,-37.86,145.23,,,,,,,debit,posted,e279f6ea9c8340ff9bccaac9337faf29,PAYMENT,<20,2018,10,18,13,0,Thursday,14 days,42778.782
ACC-4274272854,20,116.0,9948.07,,CUS-2484453271,2018-10-22,Timothy,M,-37.86,145.23,,,,,,,debit,posted,dddf2a8b8b88458482a0c96d72bbf688,PAYMENT,<20,2018,10,22,19,0,Monday,14 days,42778.782
ACC-4274272854,20,34.0,9914.07,,CUS-2484453271,2018-10-23,Timothy,M,-37.86,145.23,,,,,,,debit,posted,3698e9d041f84e0e9144c96b6b057d6d,PAYMENT,<20,2018,10,23,7,0,Tuesday,14 days,42778.782
ACC-4274272854,20,9.22,9904.85,1.0,CUS-2484453271,2018-10-24,Timothy,M,-37.86,145.23,,ff10333e-4d6e-4e46-8195-80d940ce7c75,-37.82,144.97,VIC,Melbourne,debit,authorized,01211dfc6e1f4217b6bed0c90269ab91,SALES-POS,<20,2018,10,24,17,56,Wednesday,14 days,42778.782
ACC-4274272854,20,25.77,9879.08,1.0,CUS-2484453271,2018-10-24,Timothy,M,-37.86,145.23,,635f047e-65f0-4c24-8596-9ef6c1df36fb,-37.85,145.06,VIC,Camberwell,debit,authorized,de63a22ce837487c86bfa52df802fb84,SALES-POS,<20,2018,10,24,18,50,Wednesday,14 days,42778.782
ACC-4274272854,20,15.0,9864.08,,CUS-2484453271,2018-10-25,Timothy,M,-37.86,145.23,,,,,,,debit,posted,5b9e570b0a5446e487f649766fcb8d33,PAYMENT,<20,2018,10,25,13,0,Thursday,14 days,42778.782
ACC-4274272854,20,26.88,9837.2,1.0,CUS-2484453271,2018-10-26,Timothy,M,-37.86,145.23,,bdfe0723-af65-4d90-9c84-0a7298c4e5ca,-37.73,144.89,VIC,Essendon Fields,debit,authorized,1da12aa736224d549e04db8d684cbedf,SALES-POS,<20,2018,10,26,8,10,Friday,14 days,42778.782
ACC-4274272854,20,4.54,9832.66,0.0,CUS-2484453271,2018-10-27,Timothy,M,-37.86,145.23,,c1d10c78-0bd1-4990-9896-94c760858cd4,-37.83,145.02,VIC,Burnley,debit,authorized,7d917a0bd2324b29b96728911dc89b2d,SALES-POS,<20,2018,10,27,19,7,Saturday,14 days,42778.782
ACC-4274272854,20,8.6,9824.06,1.0,CUS-2484453271,2018-10-27,Timothy,M,-37.86,145.23,,05ff194d-8afa-4b49-8be5-d98170b227ea,-37.82,144.96,VIC,Melbourne,debit,authorized,7ed66e5b602e49c198a54698509f3036,POS,<20,2018,10,27,20,55,Saturday,14 days,42778.782
ACC-4274272854,20,17.91,9806.15,1.0,CUS-2484453271,2018-10-27,Timothy,M,-37.86,145.23,,ece73050-e083-475b-89c0-1bd84f191760,-37.82,144.96,VIC,Southbank,debit,authorized,0a2bb3a6f1fd434d92f435186689bceb,SALES-POS,<20,2018,10,27,21,5,Saturday,14 days,42778.782
ACC-4274272854,20,22.25,9783.9,0.0,CUS-2484453271,2018-10-27,Timothy,M,-37.86,145.23,,4cc213cb-2959-47b0-83a4-924d99e26216,-37.89,145.09,VIC,Oakleigh,debit,authorized,7a5d6a306bd548f486738472b74d9208,POS,<20,2018,10,27,21,19,Saturday,14 days,42778.782
ACC-4274272854,20,11.55,9772.35,0.0,CUS-2484453271,2018-10-27,Timothy,M,-37.86,145.23,,bdcf9ea0-9997-4409-b44f-a05b96fb41d8,-37.85,144.98,VIC,Melbourne,debit,authorized,583783ba112d49f0b8449c17528d0d44,SALES-POS,<20,2018,10,27,21,28,Saturday,14 days,42778.782
ACC-4274272854,20,12.87,9759.48,1.0,CUS-2484453271,2018-10-27,Timothy,M,-37.86,145.23,,dee023bb-ae6e-4379-ab55-6b5e6b224176,-37.8,144.95,VIC,North Melbourne,debit,authorized,70246cf04984461681c8b63392ecf47d,SALES-POS,<20,2018,10,27,21,38,Saturday,14 days,42778.782
ACC-4274272854,20,34.0,9725.48,,CUS-2484453271,2018-10-30,Timothy,M,-37.86,145.23,,,,,,,debit,posted,8ff563e39bd84969ae98921e67b3b679,PAYMENT,<20,2018,10,30,7,0,Tuesday,14 days,42778.782
ACC-3326339947,22,28.51,3130.0,0.0,CUS-326006476,2018-08-02,Eric,M,-33.80,151.18,,7bf8ed30-2236-46df-b601-2e10fadaf2c9,-33.9,151.15,NSW,Lewisham,debit,authorized,a50aa5346ffa415b8036b49944a6b660,POS,20-30,2018,8,2,13,54,Thursday,7 days,51275.2
ACC-3326339947,22,263.44,2866.56,1.0,CUS-326006476,2018-08-02,Eric,M,-33.80,151.18,,feda5c3b-b971-4d0f-bd4e-00910b13a027,-33.82,150.99,NSW,Parramatta,debit,authorized,b649dd03b4b64f4b83de005e89d35ab3,POS,20-30,2018,8,2,16,7,Thursday,7 days,51275.2
ACC-3326339947,22,16.68,2849.88,0.0,CUS-326006476,2018-08-03,Eric,M,-33.80,151.18,,a0246887-000f-4e85-b0cc-64f05c3296fe,-33.89,151.16,NSW,Leichhardt,debit,authorized,f8065d3aa34348a09fb62e50c34b3bf7,POS,20-30,2018,8,3,17,56,Friday,7 days,51275.2
ACC-3326339947,22,158.0,2691.88,,CUS-326006476,2018-08-07,Eric,M,-33.80,151.18,,,,,,,debit,posted,df076f64071446d6923dc3e0d9d354bf,PHONE BANK,20-30,2018,8,7,21,0,Tuesday,7 days,51275.2
ACC-3326339947,22,20.65,3654.59,1.0,CUS-326006476,2018-08-08,Eric,M,-33.80,151.18,,0417bb47-cff9-41f8-b34e-94f40fc9a260,-33.81,151.11,NSW,Ryde,debit,authorized,57b1d73d5f274bf8b25a4f458af2dd13,SALES-POS,20-30,2018,8,8,14,5,Wednesday,7 days,51275.2
ACC-3326339947,22,17.65,3636.94,1.0,CUS-326006476,2018-08-08,Eric,M,-33.80,151.18,,c4fa85da-754a-405a-9f48-42cc063f6677,-33.79,150.67,NSW,Glenmore Park,debit,authorized,3833000df6c542b7b1d3c05ce28c6c5f,POS,20-30,2018,8,8,15,19,Wednesday,7 days,51275.2
ACC-3326339947,22,73.0,3563.94,,CUS-326006476,2018-08-08,Eric,M,-33.80,151.18,,,,,,,debit,posted,5ba37490b6b8491b8f4043b5f6e8476b,PAYMENT,20-30,2018,8,8,20,0,Wednesday,7 days,51275.2
ACC-3326339947,22,29.64,3534.3,1.0,CUS-326006476,2018-08-12,Eric,M,-33.80,151.18,,a89d30ae-50f2-4ea9-b0a0-90ebd5bdc2bb,-33.81,150.8,NSW,Erskine Park,debit,authorized,7b3b8d51f2de427b9b04a034a4006fc6,POS,20-30,2018,8,12,2,37,Sunday,7 days,51275.2
ACC-3326339947,22,26.02,3508.28,1.0,CUS-326006476,2018-08-14,Eric,M,-33.80,151.18,,1721f0a6-7e7c-4eb0-98a8-63317be6be65,-33.78,151.05,NSW,Carlingford,debit,authorized,711cb834816e480c8d32b0d749fa11fa,POS,20-30,2018,8,14,1,38,Tuesday,7 days,51275.2
ACC-3326339947,22,15.92,3492.36,1.0,CUS-326006476,2018-08-14,Eric,M,-33.80,151.18,,91982bed-cf7f-4a5e-a483-04a4770a54fb,-33.91,151.2,NSW,Beaconsfield,debit,authorized,44bab76757374cb3a52b9872f6c08884,POS,20-30,2018,8,14,9,30,Tuesday,7 days,51275.2
ACC-3326339947,22,17.94,4398.81,1.0,CUS-326006476,2018-08-17,Eric,M,-33.80,151.18,,d960a5aa-a4e2-48a6-bb42-0c30df5ab69f,-33.79,151.26,NSW,Balgowlah,debit,authorized,35ae7d59a0a244ea95b8f57e15754085,SALES-POS,20-30,2018,8,17,1,38,Friday,7 days,51275.2
ACC-3326339947,22,16.96,4381.85,1.0,CUS-326006476,2018-08-17,Eric,M,-33.80,151.18,,b462d997-f440-4b25-8da9-a02bdc53d4f1,-33.79,151.19,NSW,Chatswood,debit,authorized,b4a8efd50b1c44e2b59fb53f2aaa12f8,POS,20-30,2018,8,17,1,56,Friday,7 days,51275.2
ACC-3326339947,22,35.38,4346.47,1.0,CUS-326006476,2018-08-17,Eric,M,-33.80,151.18,,53b7b6f1-1698-4028-a38c-e0eb2cb8ef1c,-33.78,150.91,NSW,Blacktown,debit,authorized,a0cf882e52c043919a46786ed9a3cda5,SALES-POS,20-30,2018,8,17,8,38,Friday,7 days,51275.2
ACC-3326339947,22,89.0,4257.47,,CUS-326006476,2018-08-19,Eric,M,-33.80,151.18,,,,,,,debit,posted,a2626fead7eb4b65b479510f2c702e6e,PAYMENT,20-30,2018,8,19,22,0,Sunday,7 days,51275.2
ACC-3326339947,22,22.66,7184.89,1.0,CUS-326006476,2018-09-06,Eric,M,-33.80,151.18,,9d553cc1-2b64-4bef-a7b5-15552679c26d,-33.9,151.14,NSW,Dulwich Hill,debit,authorized,e9ac3b32ff3f42dd9199610cd4e13e8b,POS,20-30,2018,9,6,14,22,Thursday,7 days,51275.2
ACC-3326339947,22,17.15,7167.74,1.0,CUS-326006476,2018-09-07,Eric,M,-33.80,151.18,,1087cfc6-df78-4677-bb29-87d20fbcb885,-33.93,151.21,NSW,Eastlakes,debit,authorized,deef0336f90441de93efff5edf1488c1,SALES-POS,20-30,2018,9,7,4,39,Friday,7 days,51275.2
ACC-3326339947,22,80.19,7087.55,1.0,CUS-326006476,2018-09-07,Eric,M,-33.80,151.18,,0d40d160-af20-47eb-a715-c90935884964,-33.96,151.15,NSW,Brighton-Le-Sands,debit,authorized,b8750b46ca32423ebb1cd00bb79499d5,SALES-POS,20-30,2018,9,7,9,44,Friday,7 days,51275.2
ACC-3326339947,22,158.0,6929.55,,CUS-326006476,2018-09-07,Eric,M,-33.80,151.18,,,,,,,debit,posted,bf2053cdaa7645a5b3052c4bcafc6271,PHONE BANK,20-30,2018,9,7,21,0,Friday,7 days,51275.2
ACC-3326339947,22,73.0,6856.55,,CUS-326006476,2018-09-08,Eric,M,-33.80,151.18,,,,,,,debit,posted,f43626d8b26f4f1e8d48828c126aa15f,PAYMENT,20-30,2018,9,8,20,0,Saturday,7 days,51275.2
ACC-3326339947,22,16.26,7823.65,1.0,CUS-326006476,2018-09-17,Eric,M,-33.80,151.18,,83e75b26-d3ae-49f0-9031-27782d0f5be1,-33.93,151.18,NSW,Mascot,debit,authorized,39b57de1751d4d6f8054ee34cc8186c8,POS,20-30,2018,9,17,11,43,Monday,7 days,51275.2
ACC-3326339947,22,31.87,7791.78,1.0,CUS-326006476,2018-09-18,Eric,M,-33.80,151.18,,822070b9-6b55-4157-8b84-7fa07ead3d35,-33.9,150.88,NSW,Bonnyrigg,debit,authorized,524bc11e59c64a8fa50ebb64dcf68f03,SALES-POS,20-30,2018,9,18,11,26,Tuesday,7 days,51275.2
ACC-3326339947,22,89.0,8686.14,,CUS-326006476,2018-09-19,Eric,M,-33.80,151.18,,,,,,,debit,posted,2c0a937502704b27b3cbd5173e781a0b,PAYMENT,20-30,2018,9,19,22,0,Wednesday,7 days,51275.2
ACC-3326339947,22,32.75,8653.39,0.0,CUS-326006476,2018-09-20,Eric,M,-33.80,151.18,,eede62c3-8e5e-4b3e-9d5e-75f3a4b32fb9,-33.81,150.96,NSW,Wentworthville,debit,authorized,e8bff70772104647abb8af2a528ca09d,POS,20-30,2018,9,20,16,45,Thursday,7 days,51275.2
ACC-3326339947,22,17.53,8635.86,0.0,CUS-326006476,2018-09-21,Eric,M,-33.80,151.18,,7981975a-ab6a-463f-9003-55579315e8f8,-33.79,150.87,NSW,Arndell Park,debit,authorized,3ae3c57c7c7e418d8651f39939c0ff26,POS,20-30,2018,9,21,9,21,Friday,7 days,51275.2
ACC-3326339947,22,39.54,8596.32,0.0,CUS-326006476,2018-09-21,Eric,M,-33.80,151.18,,c7d169a9-fe96-4983-8d1e-9c0c6805a31e,-33.88,151.22,NSW,Darlinghurst,debit,authorized,2a6aef04974849e6a168bbf148df86dd,POS,20-30,2018,9,21,15,49,Friday,7 days,51275.2
ACC-3326339947,22,31.14,8565.18,1.0,CUS-326006476,2018-09-21,Eric,M,-33.80,151.18,,46000757-9873-4003-a8f1-f7a15cdc5b25,-33.93,150.86,NSW,Hinchinbrook,debit,authorized,13b0dd9acdfe42cc84706986c17cf373,SALES-POS,20-30,2018,9,21,16,47,Friday,7 days,51275.2
ACC-3326339947,22,14.51,8550.67,1.0,CUS-326006476,2018-09-21,Eric,M,-33.80,151.18,,043c52d1-33ca-4214-8f34-3f549afaebce,-33.91,151.25,NSW,Randwick,debit,authorized,47d24a6ec0924427818f85edb38618dd,SALES-POS,20-30,2018,9,21,22,25,Friday,7 days,51275.2
ACC-3326339947,22,107.38,8443.29,1.0,CUS-326006476,2018-09-21,Eric,M,-33.80,151.18,,bccc2aea-8c61-401e-9d1b-7c89f557c036,-33.81,151,NSW,Parramatta,debit,authorized,2816a9d654ff4829b865d1c7ba7d2065,SALES-POS,20-30,2018,9,21,23,22,Friday,7 days,51275.2
ACC-3326339947,22,38.24,8405.05,1.0,CUS-326006476,2018-09-22,Eric,M,-33.80,151.18,,c2b7e3fe-d17c-4415-b0ff-2625531bc331,-33.86,150.9,NSW,Prairiewood,debit,authorized,64c4b0f3f59144af8f1612896c21b795,POS,20-30,2018,9,22,0,11,Saturday,7 days,51275.2
ACC-3326339947,22,22.92,8382.13,1.0,CUS-326006476,2018-09-22,Eric,M,-33.80,151.18,,d341eff8-8e3c-463a-acae-4e80f5e208c2,-33.78,150.89,NSW,Blacktown,debit,authorized,72735d4a5f7f41f39a43c73605a181c4,POS,20-30,2018,9,22,1,51,Saturday,7 days,51275.2
ACC-3326339947,22,158.0,10190.85,,CUS-326006476,2018-10-07,Eric,M,-33.80,151.18,,,,,,,debit,posted,24b63207ccc047599dae8f71fcd6758f,PHONE BANK,20-30,2018,10,7,21,0,Sunday,7 days,51275.2
ACC-3326339947,22,73.0,10117.85,,CUS-326006476,2018-10-08,Eric,M,-33.80,151.18,,,,,,,debit,posted,25bfb9e6fcff496fb9ba3e36fcee40ee,PAYMENT,20-30,2018,10,8,20,0,Monday,7 days,51275.2
ACC-3326339947,22,89.0,11995.57,,CUS-326006476,2018-10-19,Eric,M,-33.80,151.18,,,,,,,debit,posted,89bb81e7d71c4dc9a65b8e11ff538141,PAYMENT,20-30,2018,10,19,22,0,Friday,7 days,51275.2
ACC-2681137560,31,20.07,14.26,1.0,CUS-2083971310,2018-08-02,Nathaniel,M,-33.99,151.11,,1de4fdda-bc50-4deb-9d7f-22948091f3c7,-33.81,151.11,NSW,Ryde,debit,authorized,2cad4f55467a41c3b18100b109c7d0b7,SALES-POS,30-40,2018,8,2,14,15,Thursday,14 days,75255.7
ACC-2681137560,31,7.22,7.04,1.0,CUS-2083971310,2018-08-03,Nathaniel,M,-33.99,151.11,,d3881e7b-aacc-46a3-be15-ff3bb66b8072,-33.77,151.13,NSW,West Pymble,debit,authorized,167340d515f84de99af731dba3be3406,SALES-POS,30-40,2018,8,3,15,4,Friday,14 days,75255.7
ACC-2681137560,31,6.02,1.02,1.0,CUS-2083971310,2018-08-11,Nathaniel,M,-33.99,151.11,,1965f16b-c400-4611-8367-28a7203711cd,-33.83,151.09,NSW,Rhodes,debit,authorized,87f022d08ad448e0ad1668e6bd1241c4,POS,30-40,2018,8,11,11,56,Saturday,14 days,75255.7
ACC-2681137560,31,8.75,2878.79,1.0,CUS-2083971310,2018-08-14,Nathaniel,M,-33.99,151.11,,1d7df048-b03b-4455-b00b-f6cc926cc0b1,-33.89,151.27,NSW,Bondi Beach,debit,authorized,b6d02b6775f2474c837ccd1d8474bf6e,SALES-POS,30-40,2018,8,14,16,2,Tuesday,14 days,75255.7
ACC-2681137560,31,74.0,2804.79,,CUS-2083971310,2018-08-17,Nathaniel,M,-33.99,151.11,,,,,,,debit,posted,250a2f35219249159a7efd5f5eaf576d,PAYMENT,30-40,2018,8,17,2,0,Friday,14 days,75255.7
ACC-2681137560,31,29.0,2775.79,,CUS-2083971310,2018-08-17,Nathaniel,M,-33.99,151.11,,,,,,,debit,posted,97766aac5adb44ee86eaab06131aaed8,PAYMENT,30-40,2018,8,17,21,0,Friday,14 days,75255.7
ACC-2681137560,31,26.0,2749.79,,CUS-2083971310,2018-08-18,Nathaniel,M,-33.99,151.11,,,,,,,debit,posted,5e4a5cf0ddd34382bd262e14cee3c8ba,PAYMENT,30-40,2018,8,18,5,0,Saturday,14 days,75255.7
ACC-2681137560,31,17.0,2732.79,,CUS-2083971310,2018-08-18,Nathaniel,M,-33.99,151.11,,,,,,,debit,posted,f9b4e4bd090440d38aecd513bdca9d6b,PAYMENT,30-40,2018,8,18,11,0,Saturday,14 days,75255.7
ACC-2681137560,31,45.0,2687.79,,CUS-2083971310,2018-08-19,Nathaniel,M,-33.99,151.11,,,,,,,debit,posted,9e3ab5f492784e448e99e5d3c184d462,PAYMENT,30-40,2018,8,19,18,0,Sunday,14 days,75255.7
ACC-2681137560,31,13.78,2674.01,1.0,CUS-2083971310,2018-08-21,Nathaniel,M,-33.99,151.11,,ab8a6dca-6eae-465c-b158-fa5965291a6d,-33.89,151.23,NSW,Paddington,debit,authorized,e8d1950ab8f948cfb75a187a0397948b,SALES-POS,30-40,2018,8,21,15,3,Tuesday,14 days,75255.7
ACC-2681137560,31,9.45,2664.56,1.0,CUS-2083971310,2018-08-23,Nathaniel,M,-33.99,151.11,,a676b903-4684-4757-8f5a-faa8ec453947,-33.79,151.27,NSW,Balgowlah,debit,authorized,1aeb4ed865ed4520a275fcc01ff008e7,SALES-POS,30-40,2018,8,23,14,32,Thursday,14 days,75255.7
ACC-2681137560,31,4.05,2660.51,0.0,CUS-2083971310,2018-08-24,Nathaniel,M,-33.99,151.11,,a76033fe-f356-400e-ab62-dc174815cee4,-33.89,151.26,NSW,Bondi,debit,authorized,abe2b3603b3841968096da31a7275498,SALES-POS,30-40,2018,8,24,8,51,Friday,14 days,75255.7
ACC-2681137560,31,29.0,2631.51,,CUS-2083971310,2018-08-24,Nathaniel,M,-33.99,151.11,,,,,,,debit,posted,ec1e083b93714eb0acef39a49525eed0,PAYMENT,30-40,2018,8,24,21,0,Friday,14 days,75255.7
ACC-2681137560,31,26.0,2605.51,,CUS-2083971310,2018-08-25,Nathaniel,M,-33.99,151.11,,,,,,,debit,posted,beff44ae56184cb3a3bbf24ba0fade01,PAYMENT,30-40,2018,8,25,5,0,Saturday,14 days,75255.7
ACC-2681137560,31,20.69,2584.82,1.0,CUS-2083971310,2018-08-25,Nathaniel,M,-33.99,151.11,,786e2dcb-aa00-4a01-a8d7-7cff67fd69e1,-33.89,151.25,NSW,Bondi Junction,debit,authorized,156aa5c521d649099523070b2a40e2e9,POS,30-40,2018,8,25,9,17,Saturday,14 days,75255.7
ACC-2681137560,31,17.0,2567.82,,CUS-2083971310,2018-08-25,Nathaniel,M,-33.99,151.11,,,,,,,debit,posted,6456fac0bfb4412f9e9179a2ee09d854,PAYMENT,30-40,2018,8,25,11,0,Saturday,14 days,75255.7
ACC-2681137560,31,45.0,2522.82,,CUS-2083971310,2018-08-26,Nathaniel,M,-33.99,151.11,,,,,,,debit,posted,a70a352205244a24a134e2b9dbc71a84,PAYMENT,30-40,2018,8,26,18,0,Sunday,14 days,75255.7
ACC-2681137560,31,141.98,5267.36,1.0,CUS-2083971310,2018-08-28,Nathaniel,M,-33.99,151.11,,36fa6b5e-0d62-49f6-a02d-66cefe7f0301,-33.86,151.08,NSW,Homebush,debit,authorized,7fe4011a6d584800acef20c3996a799a,POS,30-40,2018,8,28,14,39,Tuesday,14 days,75255.7
ACC-2681137560,31,29.0,5238.36,,CUS-2083971310,2018-08-31,Nathaniel,M,-33.99,151.11,,,,,,,debit,posted,b8f91fc2aa3e4d22b41454bb639df116,PAYMENT,30-40,2018,8,31,21,0,Friday,14 days,75255.7
ACC-2681137560,31,18.19,5220.17,0.0,CUS-2083971310,2018-08-31,Nathaniel,M,-33.99,151.11,,de38f401-f2aa-48e2-a2fd-c739dd6006b7,-33.85,150.94,NSW,Smithfield,debit,authorized,af3d0cfe225444d2bcf168b6f6e6b6b2,POS,30-40,2018,8,31,22,40,Friday,14 days,75255.7
ACC-2681137560,31,15.66,5204.51,1.0,CUS-2083971310,2018-09-01,Nathaniel,M,-33.99,151.11,,ffb4538f-cf69-434f-8c0a-5c9e7a8d359b,-33.81,151.11,NSW,Ryde,debit,authorized,59377e7f435944729ed6fed10868337f,POS,30-40,2018,9,1,1,27,Saturday,14 days,75255.7
ACC-2681137560,31,26.0,5178.51,,CUS-2083971310,2018-09-01,Nathaniel,M,-33.99,151.11,,,,,,,debit,posted,6c86cc2702c94d1bb70870a80b28c30b,PAYMENT,30-40,2018,9,1,5,0,Saturday,14 days,75255.7
ACC-2681137560,31,17.0,5161.51,,CUS-2083971310,2018-09-01,Nathaniel,M,-33.99,151.11,,,,,,,debit,posted,b98c6abcb3d74c35b78e78a7b66c71ec,PAYMENT,30-40,2018,9,1,11,0,Saturday,14 days,75255.7
ACC-2681137560,31,8.83,5152.68,1.0,CUS-2083971310,2018-09-01,Nathaniel,M,-33.99,151.11,,cf4fea2f-dd7b-4b20-bc43-40e99f576e59,-33.79,151.19,NSW,Roseville,debit,authorized,4d50a7fdd08f404e9affa77da1e0d45f,POS,30-40,2018,9,1,15,0,Saturday,14 days,75255.7
ACC-2681137560,31,30.3,5122.38,1.0,CUS-2083971310,2018-09-02,Nathaniel,M,-33.99,151.11,,438fdb3a-9c2c-45ac-9583-f138420f0d18,-33.96,137.72,SA,Kadina,debit,authorized,3e8c903ce2f2405cad9cf72deaa06b1d,POS,30-40,2018,9,2,7,54,Sunday,14 days,75255.7
ACC-2681137560,31,33.73,5088.65,1.0,CUS-2083971310,2018-09-02,Nathaniel,M,-33.99,151.11,,d816309c-7cd6-4975-8ef4-e8b3d7ea33e8,-33.79,151.08,NSW,Eastwood,debit,authorized,8258d38c142c4e39bab4abb7121e83dd,SALES-POS,30-40,2018,9,2,9,32,Sunday,14 days,75255.7
ACC-2681137560,31,5.36,5083.29,1.0,CUS-2083971310,2018-09-02,Nathaniel,M,-33.99,151.11,,25d3cec1-491f-4041-aa54-10560b598c1d,-33.85,151.09,NSW,Concord West,debit,authorized,f05af1349fe9427f820ef25a1be8eb3f,POS,30-40,2018,9,2,15,37,Sunday,14 days,75255.7
ACC-2681137560,31,45.0,5038.29,,CUS-2083971310,2018-09-02,Nathaniel,M,-33.99,151.11,,,,,,,debit,posted,b2a07801b63c433d9607fe4642b8b599,PAYMENT,30-40,2018,9,2,18,0,Sunday,14 days,75255.7
ACC-2681137560,31,3.96,5034.33,1.0,CUS-2083971310,2018-09-03,Nathaniel,M,-33.99,151.11,,c3d9b906-8111-4c76-acf8-7b23fe2a34bf,-33.77,151.1,NSW,Marsfield,debit,authorized,88d27819a13e4f47963626c0fd695798,SALES-POS,30-40,2018,9,3,9,59,Monday,14 days,75255.7
ACC-2681137560,31,187.0,4847.33,,CUS-2083971310,2018-09-03,Nathaniel,M,-33.99,151.11,,,,,,,debit,posted,f621a5a49a1b496b92a8cc50e2a2187e,PAYMENT,30-40,2018,9,3,21,0,Monday,14 days,75255.7
ACC-2681137560,31,14.81,4832.52,1.0,CUS-2083971310,2018-09-04,Nathaniel,M,-33.99,151.11,,13ff2a38-4834-4779-9a11-18bd91063e7e,-33.78,151.12,NSW,Macquarie Park,debit,authorized,d62e0ce7901a49a9a225e2a8f6361d9e,POS,30-40,2018,9,4,12,51,Tuesday,14 days,75255.7
ACC-2681137560,31,13.26,4819.26,1.0,CUS-2083971310,2018-09-06,Nathaniel,M,-33.99,151.11,,0b79c6f5-61db-4bcf-afeb-c0116215f7af,-29.77,151.11,NSW,Inverell,debit,authorized,6b50bd7cafcd486ca9cbb14051ec52c1,POS,30-40,2018,9,6,20,10,Thursday,14 days,75255.7
ACC-2681137560,31,29.0,4790.26,,CUS-2083971310,2018-09-07,Nathaniel,M,-33.99,151.11,,,,,,,debit,posted,4b7953e2ea664154aa43277fa90bc636,PAYMENT,30-40,2018,9,7,21,0,Friday,14 days,75255.7
ACC-2681137560,31,67.46,4722.8,1.0,CUS-2083971310,2018-09-07,Nathaniel,M,-33.99,151.11,,591eb556-c5b4-4697-80ad-3c7fe42d49c2,-33.66,115.27,WA,Broadwater,debit,authorized,16db40fce9f34cb19280eb7bf53df0a8,SALES-POS,30-40,2018,9,7,23,59,Friday,14 days,75255.7
ACC-2681137560,31,26.0,4696.8,,CUS-2083971310,2018-09-08,Nathaniel,M,-33.99,151.11,,,,,,,debit,posted,8068d57579f44cb1821a61475b301d22,PAYMENT,30-40,2018,9,8,5,0,Saturday,14 days,75255.7
ACC-2681137560,31,10.36,4686.44,0.0,CUS-2083971310,2018-09-08,Nathaniel,M,-33.99,151.11,,93cd9b38-d890-45f1-9ccd-b9a90181bdcd,-33.89,151.25,NSW,Bondi Junction,debit,authorized,7e7aab1bf60b4a4c8c501c7bf33b9fec,POS,30-40,2018,9,8,10,58,Saturday,14 days,75255.7
ACC-2681137560,31,17.0,4669.44,,CUS-2083971310,2018-09-08,Nathaniel,M,-33.99,151.11,,,,,,,debit,posted,66c1e436fd5149ff9ce3261f65a912c7,PAYMENT,30-40,2018,9,8,11,0,Saturday,14 days,75255.7
ACC-2681137560,31,15.84,4653.6,1.0,CUS-2083971310,2018-09-08,Nathaniel,M,-33.99,151.11,,7815cc1e-e52d-4533-8a18-1340c50c2409,-33.88,151.19,NSW,Glebe,debit,authorized,d9ecc8ae3ea94ae592fc34bb48f86f43,POS,30-40,2018,9,8,21,57,Saturday,14 days,75255.7
ACC-2681137560,31,45.0,4608.6,,CUS-2083971310,2018-09-09,Nathaniel,M,-33.99,151.11,,,,,,,debit,posted,8071f91194fa4bb08c0e22b51197f4d1,PAYMENT,30-40,2018,9,9,18,0,Sunday,14 days,75255.7
ACC-2681137560,31,138.0,7357.12,,CUS-2083971310,2018-09-11,Nathaniel,M,-33.99,151.11,,,,,,,debit,posted,b8bb1ecfb02f4b6790a55ebaadf1f9aa,PAYMENT,30-40,2018,9,11,15,0,Tuesday,14 days,75255.7
ACC-2681137560,31,29.0,7240.82,,CUS-2083971310,2018-09-14,Nathaniel,M,-33.99,151.11,,,,,,,debit,posted,f4476392b11e422cad5ed00a75c470c5,PAYMENT,30-40,2018,9,14,21,0,Friday,14 days,75255.7
ACC-2681137560,31,87.3,7269.82,0.0,CUS-2083971310,2018-09-14,Nathaniel,M,-33.99,151.11,,d1f1060e-ce6f-4ab3-a91e-e0570af14010,-33.87,151.21,NSW,Sydney,debit,authorized,8d8b2889a6844993bd689e15a88d8596,POS,30-40,2018,9,14,21,40,Friday,14 days,75255.7
ACC-2681137560,31,26.0,7214.82,,CUS-2083971310,2018-09-15,Nathaniel,M,-33.99,151.11,,,,,,,debit,posted,3aa4697af7c7401a9ce2818b57a35628,PAYMENT,30-40,2018,9,15,5,0,Saturday,14 days,75255.7
ACC-2681137560,31,9.62,7205.2,1.0,CUS-2083971310,2018-09-15,Nathaniel,M,-33.99,151.11,,8f2c36dd-9a99-4230-b00f-99bbb42b68ef,-33.96,137.71,SA,Kadina,debit,authorized,602d2d9235ea42dbacb2d71354bb1739,POS,30-40,2018,9,15,8,40,Saturday,14 days,75255.7
ACC-2681137560,31,17.0,7188.2,,CUS-2083971310,2018-09-15,Nathaniel,M,-33.99,151.11,,,,,,,debit,posted,2aaceeab9a5440a8a69ed182b6f5849b,PAYMENT,30-40,2018,9,15,11,0,Saturday,14 days,75255.7
ACC-2681137560,31,45.0,7143.2,,CUS-2083971310,2018-09-16,Nathaniel,M,-33.99,151.11,,,,,,,debit,posted,a006298315734f62af7ce282c1419b31,PAYMENT,30-40,2018,9,16,18,0,Sunday,14 days,75255.7
ACC-2681137560,31,74.0,7069.2,,CUS-2083971310,2018-09-17,Nathaniel,M,-33.99,151.11,,,,,,,debit,posted,f44b9cadaada4338bd608f1005acf6ec,PAYMENT,30-40,2018,9,17,2,0,Monday,14 days,75255.7
ACC-2681137560,31,6.24,7062.96,1.0,CUS-2083971310,2018-09-18,Nathaniel,M,-33.99,151.11,,1e9792a8-f3bd-4ba0-836d-8429121e01da,-33.84,151.21,NSW,North Sydney,debit,authorized,1035002425ea4af4affb5eebe245f339,POS,30-40,2018,9,18,11,45,Tuesday,14 days,75255.7
ACC-2681137560,31,21.75,7041.21,1.0,CUS-2083971310,2018-09-19,Nathaniel,M,-33.99,151.11,,0d334319-a990-47d5-9d01-ff172cf8448e,-33.87,150.96,NSW,Fairfield,debit,authorized,3c5842f6ebac4ac29a422ac1ad69a134,SALES-POS,30-40,2018,9,19,4,49,Wednesday,14 days,75255.7
ACC-2681137560,31,48.82,6992.39,0.0,CUS-2083971310,2018-09-20,Nathaniel,M,-33.99,151.11,,bc24f831-0bed-4afd-bd89-3d9c0292b78f,-33.79,151.26,NSW,Balgowlah,debit,authorized,cf846e8e91fb43fe8f19fad6cfc4d0f5,POS,30-40,2018,9,20,8,49,Thursday,14 days,75255.7
ACC-2681137560,31,67.49,6924.9,0.0,CUS-2083971310,2018-09-20,Nathaniel,M,-33.99,151.11,,12199c94-c98a-454d-86c7-330b9d109260,-27.45,153.04,QLD,Newstead,debit,authorized,4f4bc96ba0744dfdb5fb5c46691af101,SALES-POS,30-40,2018,9,20,9,32,Thursday,14 days,75255.7
ACC-2681137560,31,16.38,6908.52,1.0,CUS-2083971310,2018-09-20,Nathaniel,M,-33.99,151.11,,7a2f5cbb-efb5-44d0-9f4b-49c7c2b14c38,-33.73,151.01,NSW,Castle Hill,debit,authorized,7feaf9e86a214256bd167e2d47141d61,POS,30-40,2018,9,20,9,42,Thursday,14 days,75255.7
ACC-2681137560,31,14.7,6893.82,1.0,CUS-2083971310,2018-09-20,Nathaniel,M,-33.99,151.11,,793f2016-33cd-48ae-8c31-0b032f115623,-33.73,151,NSW,Castle Hill,debit,authorized,8f1375c82e144f839141d57a9dfae2d8,SALES-POS,30-40,2018,9,20,11,2,Thursday,14 days,75255.7
ACC-2681137560,31,67.35,6826.47,1.0,CUS-2083971310,2018-09-21,Nathaniel,M,-33.99,151.11,,26ee250f-6a04-4400-95c0-173695c87fb5,-29.77,151.11,NSW,Inverell,debit,authorized,4b5e9cca3b01446e84a3233135440868,POS,30-40,2018,9,21,1,51,Friday,14 days,75255.7
ACC-2681137560,31,59.58,6766.89,1.0,CUS-2083971310,2018-09-21,Nathaniel,M,-33.99,151.11,,96f23b7a-2abb-4bdb-a0bb-62314d50ca73,-23.44,144.27,QLD,Longreach,debit,authorized,0844e04cb3a740d38fbfe11d6a0beb9b,POS,30-40,2018,9,21,10,56,Friday,14 days,75255.7
ACC-2681137560,31,35.2,6731.69,1.0,CUS-2083971310,2018-09-21,Nathaniel,M,-33.99,151.11,,c6717cc7-5c1e-4779-b147-d59ecd7f3827,-33.82,151,NSW,Parramatta,debit,authorized,ea90db4302f747a69c4930ccf2556c17,SALES-POS,30-40,2018,9,21,15,20,Friday,14 days,75255.7
ACC-2681137560,31,29.0,6702.69,,CUS-2083971310,2018-09-21,Nathaniel,M,-33.99,151.11,,,,,,,debit,posted,871c684d905748a39012024189b87c75,PAYMENT,30-40,2018,9,21,21,0,Friday,14 days,75255.7
ACC-2681137560,31,26.0,6676.69,,CUS-2083971310,2018-09-22,Nathaniel,M,-33.99,151.11,,,,,,,debit,posted,808fa41c07d7479ab92963ee6dff8641,PAYMENT,30-40,2018,9,22,5,0,Saturday,14 days,75255.7
ACC-2681137560,31,17.0,6659.69,,CUS-2083971310,2018-09-22,Nathaniel,M,-33.99,151.11,,,,,,,debit,posted,1accff9e206b4504ab462726aabcb4d9,PAYMENT,30-40,2018,9,22,11,0,Saturday,14 days,75255.7
ACC-2681137560,31,45.0,6614.69,,CUS-2083971310,2018-09-23,Nathaniel,M,-33.99,151.11,,,,,,,debit,posted,b86ce31e06284bc4b021b68ac34a0909,PAYMENT,30-40,2018,9,23,18,0,Sunday,14 days,75255.7
ACC-2681137560,31,32.23,6582.46,0.0,CUS-2083971310,2018-09-24,Nathaniel,M,-33.99,151.11,,f5fa6091-a464-4f01-b563-4a3cba0ae50c,-33.69,117.56,WA,Katanning,debit,authorized,73eba4f0962246698f021dcf6338a61b,POS,30-40,2018,9,24,10,7,Monday,14 days,75255.7
ACC-2681137560,31,12.15,9456.83,1.0,CUS-2083971310,2018-09-25,Nathaniel,M,-33.99,151.11,,e597c518-a64e-4091-a7a2-0bf8bc8e7159,-33.96,116.14,WA,Bridgetown,debit,authorized,289dee9edab746779e7d41060ff98a10,SALES-POS,30-40,2018,9,25,13,5,Tuesday,14 days,75255.7
ACC-2681137560,31,13.44,9443.39,1.0,CUS-2083971310,2018-09-26,Nathaniel,M,-33.99,151.11,,1c6f0ba8-083d-460c-8072-1adb4a013f99,-33.99,151.13,NSW,Sans Souci,debit,authorized,ed399dbaedb14d2e967687fcf41d14a2,POS,30-40,2018,9,26,13,7,Wednesday,14 days,75255.7
ACC-2681137560,31,9.03,9434.36,0.0,CUS-2083971310,2018-09-26,Nathaniel,M,-33.99,151.11,,68c05695-d552-4a40-b4a8-cc9f8d88b18f,-33.97,139,SA,Robertson,debit,authorized,22abc3736278462ca81e843728de3710,SALES-POS,30-40,2018,9,26,16,48,Wednesday,14 days,75255.7
ACC-2681137560,31,29.0,9405.36,,CUS-2083971310,2018-09-28,Nathaniel,M,-33.99,151.11,,,,,,,debit,posted,60fc3121bb3d4b9d9e4d5142975c6324,PAYMENT,30-40,2018,9,28,21,0,Friday,14 days,75255.7
ACC-2681137560,31,26.0,9379.36,,CUS-2083971310,2018-09-29,Nathaniel,M,-33.99,151.11,,,,,,,debit,posted,ad80530440d9462f9265f246acd52824,PAYMENT,30-40,2018,9,29,5,0,Saturday,14 days,75255.7
ACC-2681137560,31,117.16,9262.2,1.0,CUS-2083971310,2018-09-29,Nathaniel,M,-33.99,151.11,,3075b265-3b29-4d54-a38e-c379113f73bf,-33.79,115.97,WA,Balingup,debit,authorized,8ca3fb2509e34a22b4f7dce42beba9f9,SALES-POS,30-40,2018,9,29,8,54,Saturday,14 days,75255.7
ACC-2681137560,31,17.0,9245.2,,CUS-2083971310,2018-09-29,Nathaniel,M,-33.99,151.11,,,,,,,debit,posted,f3a0703409ae44a186a58d7cff033350,PAYMENT,30-40,2018,9,29,11,0,Saturday,14 days,75255.7
ACC-2681137560,31,45.0,9200.2,,CUS-2083971310,2018-09-30,Nathaniel,M,-33.99,151.11,,,,,,,debit,posted,ebce26c0db564b6a8bd2c5a0ff240457,PAYMENT,30-40,2018,9,30,18,0,Sunday,14 days,75255.7
ACC-2681137560,31,5.63,9194.57,1.0,CUS-2083971310,2018-10-01,Nathaniel,M,-33.99,151.11,,19667bd5-50c6-4a1d-8b11-054bcd023220,-33.89,151.22,NSW,Surry Hills,debit,authorized,367c473c1b304c1e9db8f3126dbb8b0d,POS,30-40,2018,10,1,19,15,Monday,14 days,75255.7
ACC-2681137560,31,13.38,9181.19,1.0,CUS-2083971310,2018-10-03,Nathaniel,M,-33.99,151.11,,7f5ee0ac-e185-4657-ad7b-fd117e54b7ec,-33.71,151.1,NSW,Waitara,debit,authorized,ebe54aad4e0948e1bb09f28c1dbf329a,POS,30-40,2018,10,3,9,16,Wednesday,14 days,75255.7
ACC-2681137560,31,28.04,9153.15,1.0,CUS-2083971310,2018-10-03,Nathaniel,M,-33.99,151.11,,64529278-23c6-4ce2-aa0b-f8e3cf0af77f,-33.92,151.19,NSW,Alexandria,debit,authorized,b4d6d6d39238438ab7b407fa84df42bc,POS,30-40,2018,10,3,11,24,Wednesday,14 days,75255.7
ACC-2681137560,31,18.34,9134.81,1.0,CUS-2083971310,2018-10-03,Nathaniel,M,-33.99,151.11,,48f6c028-724d-430a-abdd-1357a94b6457,-33.84,151.08,NSW,Rhodes,debit,authorized,ff551f83e27f461ebd6ce24130e458b5,SALES-POS,30-40,2018,10,3,12,35,Wednesday,14 days,75255.7
ACC-2681137560,31,187.0,8947.81,,CUS-2083971310,2018-10-03,Nathaniel,M,-33.99,151.11,,,,,,,debit,posted,9fa8630a370a419383d230ea99ca5ad4,PAYMENT,30-40,2018,10,3,21,0,Wednesday,14 days,75255.7
ACC-2681137560,31,11.05,8936.76,0.0,CUS-2083971310,2018-10-04,Nathaniel,M,-33.99,151.11,,4910d30d-0e61-497d-b829-3deac4033aa7,-33.79,151.19,NSW,Chatswood,debit,authorized,28d5f74838574077a95800afa3feeef1,SALES-POS,30-40,2018,10,4,9,5,Thursday,14 days,75255.7
ACC-2681137560,31,29.0,8907.76,,CUS-2083971310,2018-10-05,Nathaniel,M,-33.99,151.11,,,,,,,debit,posted,c88aa8b603aa482abd77a332bb6a50c2,PAYMENT,30-40,2018,10,5,21,0,Friday,14 days,75255.7
ACC-2681137560,31,21.31,8886.45,1.0,CUS-2083971310,2018-10-06,Nathaniel,M,-33.99,151.11,,e7bf1c3f-19c1-4bf8-87c3-53e4bb09742d,-33.73,151.29,NSW,Collaroy Plateau,debit,authorized,73dee3418a73423fb6cde00a4ed4d755,POS,30-40,2018,10,6,3,6,Saturday,14 days,75255.7
ACC-2681137560,31,26.0,8860.45,,CUS-2083971310,2018-10-06,Nathaniel,M,-33.99,151.11,,,,,,,debit,posted,92a03233bbb74ef6b6adda751920e7eb,PAYMENT,30-40,2018,10,6,5,0,Saturday,14 days,75255.7
ACC-2681137560,31,17.0,8843.45,,CUS-2083971310,2018-10-06,Nathaniel,M,-33.99,151.11,,,,,,,debit,posted,62d75fa793c74577bc8a46ef35f49236,PAYMENT,30-40,2018,10,6,11,0,Saturday,14 days,75255.7
ACC-2681137560,31,45.0,8798.45,,CUS-2083971310,2018-10-07,Nathaniel,M,-33.99,151.11,,,,,,,debit,posted,ad6af5bf34af4088a9bb3d4ed1b29f23,PAYMENT,30-40,2018,10,7,18,0,Sunday,14 days,75255.7
ACC-2681137560,31,221.14,11463.83,1.0,CUS-2083971310,2018-10-09,Nathaniel,M,-33.99,151.11,,51f6a542-c40d-4474-9ef3-f9fb37327f3a,-33.83,151.2,NSW,Crows Nest,debit,authorized,2c3243798816434e85ee241aaf57b31d,POS,30-40,2018,10,9,12,14,Tuesday,14 days,75255.7
ACC-2681137560,31,11.03,11452.8,1.0,CUS-2083971310,2018-10-09,Nathaniel,M,-33.99,151.11,,78f073e0-be8f-490e-bce4-62b2dfbff291,-33.96,137.72,SA,Kadina,debit,authorized,a842130e90564de6a0e389edec4e100f,POS,30-40,2018,10,9,14,17,Tuesday,14 days,75255.7
ACC-2681137560,31,138.0,11314.8,,CUS-2083971310,2018-10-11,Nathaniel,M,-33.99,151.11,,,,,,,debit,posted,e90a8b81b1f54d10b0856b1136eeaff4,PAYMENT,30-40,2018,10,11,15,0,Thursday,14 days,75255.7
ACC-2681137560,31,29.0,11251.39,,CUS-2083971310,2018-10-12,Nathaniel,M,-33.99,151.11,,,,,,,debit,posted,13311aca1a2e40f3a3110c86e87f3f8a,PAYMENT,30-40,2018,10,12,21,0,Friday,14 days,75255.7
ACC-2681137560,31,34.41,11280.39,1.0,CUS-2083971310,2018-10-12,Nathaniel,M,-33.99,151.11,,165ae310-aa9e-43b6-b875-f996db6586bd,-27.47,153.03,QLD,Brisbane City,debit,authorized,54f77d872d1a4c7bac131cd20587c90a,SALES-POS,30-40,2018,10,12,21,57,Friday,14 days,75255.7
ACC-2681137560,31,19.67,11231.72,0.0,CUS-2083971310,2018-10-13,Nathaniel,M,-33.99,151.11,,f67d0426-a4c2-4605-9746-97aeaf78ce49,-33.94,150.99,NSW,Milperra,debit,authorized,bf66124eea074f02ae521e93abafcfee,SALES-POS,30-40,2018,10,13,2,36,Saturday,14 days,75255.7
ACC-2681137560,31,26.0,11205.72,,CUS-2083971310,2018-10-13,Nathaniel,M,-33.99,151.11,,,,,,,debit,posted,e93c45e515fd412a8e21435d7e656133,PAYMENT,30-40,2018,10,13,5,0,Saturday,14 days,75255.7
ACC-2681137560,31,17.0,11188.72,,CUS-2083971310,2018-10-13,Nathaniel,M,-33.99,151.11,,,,,,,debit,posted,3887665996d745e5a70445b885341f85,PAYMENT,30-40,2018,10,13,11,0,Saturday,14 days,75255.7
ACC-2681137560,31,8.97,11179.75,0.0,CUS-2083971310,2018-10-13,Nathaniel,M,-33.99,151.11,,b8a35e86-bc08-47e5-9038-3aef46739c4e,-33.86,150.9,NSW,Wetherill Park,debit,authorized,461ea072a8a3493facdea6cc00700d46,POS,30-40,2018,10,13,12,5,Saturday,14 days,75255.7
ACC-2681137560,31,21.44,11158.31,1.0,CUS-2083971310,2018-10-13,Nathaniel,M,-33.99,151.11,,8bfd095a-2403-4c09-8ce5-31b670b46931,-33.98,115.76,WA,Nannup,debit,authorized,351ed8ea697543799bb3385a9662f4ce,SALES-POS,30-40,2018,10,13,17,24,Saturday,14 days,75255.7
ACC-2681137560,31,9.41,11148.9,1.0,CUS-2083971310,2018-10-14,Nathaniel,M,-33.99,151.11,,611783f0-977f-45d3-a38e-2d8640ff3491,-33.96,137.69,SA,New Town,debit,authorized,4f22ed30ea3b4ebb80c6c4275fe14aae,SALES-POS,30-40,2018,10,14,8,10,Sunday,14 days,75255.7
ACC-2681137560,31,45.0,11103.9,,CUS-2083971310,2018-10-14,Nathaniel,M,-33.99,151.11,,,,,,,debit,posted,67d869d682de487a9f4b05f61df25916,PAYMENT,30-40,2018,10,14,18,0,Sunday,14 days,75255.7
ACC-2681137560,31,74.0,11029.9,,CUS-2083971310,2018-10-17,Nathaniel,M,-33.99,151.11,,,,,,,debit,posted,354ca63f0e004b7fad178b998a1ce7ef,PAYMENT,30-40,2018,10,17,2,0,Wednesday,14 days,75255.7
ACC-2681137560,31,29.0,11000.9,,CUS-2083971310,2018-10-19,Nathaniel,M,-33.99,151.11,,,,,,,debit,posted,f100730e87a34b7291d1a0fd387cd9d0,PAYMENT,30-40,2018,10,19,21,0,Friday,14 days,75255.7
ACC-2681137560,31,26.0,10974.9,,CUS-2083971310,2018-10-20,Nathaniel,M,-33.99,151.11,,,,,,,debit,posted,d1bb4cbf3ef34ead8af97b4a6ca4759d,PAYMENT,30-40,2018,10,20,5,0,Saturday,14 days,75255.7
ACC-2681137560,31,17.0,10957.9,,CUS-2083971310,2018-10-20,Nathaniel,M,-33.99,151.11,,,,,,,debit,posted,8c2db3f1274b4d8686ee62fab2fdedc0,PAYMENT,30-40,2018,10,20,11,0,Saturday,14 days,75255.7
ACC-2681137560,31,22.16,10935.74,0.0,CUS-2083971310,2018-10-21,Nathaniel,M,-33.99,151.11,,2c5f2074-e8cc-4e01-ac39-30fd936dd547,-33.8,151.18,NSW,Chatswood,debit,authorized,379e5c3d326f4d16bd5b52c8b12dad19,SALES-POS,30-40,2018,10,21,14,8,Sunday,14 days,75255.7
ACC-2681137560,31,8.15,10927.59,0.0,CUS-2083971310,2018-10-21,Nathaniel,M,-33.99,151.11,,3d4eeb49-5fb4-445a-8365-ea8e82595b86,-33.86,150.9,NSW,Sydney,debit,authorized,91e80e030917476a84dce326be857162,POS,30-40,2018,10,21,17,55,Sunday,14 days,75255.7
ACC-2681137560,31,45.0,10865.23,,CUS-2083971310,2018-10-21,Nathaniel,M,-33.99,151.11,,,,,,,debit,posted,961b3a3a24b84756ad2760ee7c310d91,PAYMENT,30-40,2018,10,21,18,0,Sunday,14 days,75255.7
ACC-2681137560,31,17.36,10910.23,1.0,CUS-2083971310,2018-10-21,Nathaniel,M,-33.99,151.11,,51c8920e-230e-436f-b2bf-f838c4d6ff65,-33.91,151.2,NSW,Beaconsfield,debit,authorized,b2011b35c71e4bcc8617176402bfaf38,SALES-POS,30-40,2018,10,21,18,58,Sunday,14 days,75255.7
ACC-2681137560,31,9.98,10855.25,1.0,CUS-2083971310,2018-10-21,Nathaniel,M,-33.99,151.11,,dfe86507-89bd-4ebc-883e-977a09338586,-33.83,151.22,NSW,Neutral Bay,debit,authorized,a2b12f8911f54bb1baacf73823baaa82,SALES-POS,30-40,2018,10,21,20,47,Sunday,14 days,75255.7
ACC-2681137560,31,23.86,10831.39,1.0,CUS-2083971310,2018-10-21,Nathaniel,M,-33.99,151.11,,460fb2e0-6ee2-481b-b6ab-33aa4dfe0126,-33.91,151.15,NSW,Marrickville,debit,authorized,b3acf0e6f9364e15985dd2fbdf595f8e,POS,30-40,2018,10,21,21,46,Sunday,14 days,75255.7
ACC-2681137560,31,11.25,10820.14,1.0,CUS-2083971310,2018-10-22,Nathaniel,M,-33.99,151.11,,611783f0-977f-45d3-a38e-2d8640ff3491,-33.96,137.69,SA,New Town,debit,authorized,61df0300ed3a4111a4bf3c1f0ca6e0bf,POS,30-40,2018,10,22,9,43,Monday,14 days,75255.7
ACC-2681137560,31,19.35,13687.31,1.0,CUS-2083971310,2018-10-22,Nathaniel,M,-33.99,151.11,,a20827bf-4aa3-4845-99ef-14a0f887f5c6,-35.22,149.14,ACT,Mitchell,debit,authorized,9543a66561474ab2b19b80f246dfd525,POS,30-40,2018,10,22,15,45,Monday,14 days,75255.7
ACC-2681137560,31,39.52,13647.79,1.0,CUS-2083971310,2018-10-25,Nathaniel,M,-33.99,151.11,,a46906c1-9d2d-498d-8f9a-ba9b448b583d,-33.87,151.21,NSW,Sydney,debit,authorized,086abaafb7e0432eadd4778a66698a2c,POS,30-40,2018,10,25,9,31,Thursday,14 days,75255.7
ACC-2681137560,31,66.75,13581.04,0.0,CUS-2083971310,2018-10-25,Nathaniel,M,-33.99,151.11,,e18bf45f-a268-426f-b817-8d0340dff41d,-33.92,151.26,NSW,Coogee,debit,authorized,53b67bbab3da4df9939f705e71b1843e,SALES-POS,30-40,2018,10,25,11,11,Thursday,14 days,75255.7
ACC-2681137560,31,29.0,13552.04,,CUS-2083971310,2018-10-26,Nathaniel,M,-33.99,151.11,,,,,,,debit,posted,e3367c602b9d4113ab6760814e6deaf6,PAYMENT,30-40,2018,10,26,21,0,Friday,14 days,75255.7
ACC-2681137560,31,26.0,13526.04,,CUS-2083971310,2018-10-27,Nathaniel,M,-33.99,151.11,,,,,,,debit,posted,ba5e47f1a895438f83fcca8ca7c8eb4c,PAYMENT,30-40,2018,10,27,5,0,Saturday,14 days,75255.7
ACC-2681137560,31,17.0,13509.04,,CUS-2083971310,2018-10-27,Nathaniel,M,-33.99,151.11,,,,,,,debit,posted,2e9db8613fd64059bae2325787619e77,PAYMENT,30-40,2018,10,27,11,0,Saturday,14 days,75255.7
ACC-2681137560,31,13.63,13495.41,1.0,CUS-2083971310,2018-10-27,Nathaniel,M,-33.99,151.11,,3b990820-b69e-4bd1-993b-d09158f22778,-33.92,150.92,NSW,Liverpool,debit,authorized,f7ec5e37c25342c18e1a54bfb99253c3,SALES-POS,30-40,2018,10,27,12,2,Saturday,14 days,75255.7
ACC-2681137560,31,45.0,13450.41,,CUS-2083971310,2018-10-28,Nathaniel,M,-33.99,151.11,,,,,,,debit,posted,f8f9f7b3b1384f8da2bc703e8d7cf6be,PAYMENT,30-40,2018,10,28,18,0,Sunday,14 days,75255.7
ACC-2681137560,31,8.26,13442.15,1.0,CUS-2083971310,2018-10-31,Nathaniel,M,-33.99,151.11,,bd55b2be-eda5-45e8-8a91-053eafbd5480,-33.96,116.14,WA,Bridgetown,debit,authorized,70af92fcc1e64cb5905271b810825c7d,POS,30-40,2018,10,31,17,54,Wednesday,14 days,75255.7
ACC-2920611728,69,20.78,1948.27,0.0,CUS-1388323263,2018-08-02,Tyler,M,-37.76,144.96,,0cd4b13e-0508-4cd6-8b65-20955b51e629,-37.83,144.98,VIC,Melbourne,debit,authorized,7d379856791e46ecae0b98325a80d633,POS,60-70,2018,8,2,14,21,Thursday,7 days,54391.257
ACC-2920611728,69,17.0,1931.27,,CUS-1388323263,2018-08-04,Tyler,M,-37.76,144.96,,,,,,,debit,posted,4e44b90cf8b5479aa28e30fa5d66ada7,PAYMENT,60-70,2018,8,4,16,0,Saturday,7 days,54391.257
ACC-2920611728,69,70.0,1861.27,,CUS-1388323263,2018-08-06,Tyler,M,-37.76,144.96,,,,,,,debit,posted,0aa0a5d74c7e413fab05c03519f6b6a9,PAYMENT,60-70,2018,8,6,4,0,Monday,7 days,54391.257
ACC-2920611728,69,64.0,1797.27,,CUS-1388323263,2018-08-06,Tyler,M,-37.76,144.96,,,,,,,debit,posted,6f2c1fc8056d45c2be4ad8831ddf0931,PAYMENT,60-70,2018,8,6,20,0,Monday,7 days,54391.257
ACC-2920611728,69,21.54,2818.85,1.0,CUS-1388323263,2018-08-10,Tyler,M,-37.76,144.96,,de14dbcc-7d8b-4e71-9a26-4bd4d2da13c5,-37.85,144.69,VIC,Tarneit,debit,authorized,b507557a00f946c4bc34c7a5f520311b,POS,60-70,2018,8,10,15,39,Friday,7 days,54391.257
ACC-2920611728,69,12.77,2806.08,1.0,CUS-1388323263,2018-08-10,Tyler,M,-37.76,144.96,,775afd42-678a-418a-af51-70557fab5fb7,-37.81,144.95,VIC,Docklands,debit,authorized,5f4d82e5ed1b413da717912f40b1c213,SALES-POS,60-70,2018,8,10,20,7,Friday,7 days,54391.257
ACC-2920611728,69,33.18,2772.9,1.0,CUS-1388323263,2018-08-11,Tyler,M,-37.76,144.96,,c3eb7d47-28a1-42c1-9a27-d1f01e9c696f,-37.78,144.91,VIC,Ascot Vale,debit,authorized,68a81012f3ed496487dffa7050bad95b,POS,60-70,2018,8,11,7,34,Saturday,7 days,54391.257
ACC-2920611728,69,12.48,2760.42,1.0,CUS-1388323263,2018-08-11,Tyler,M,-37.76,144.96,,8bb9e62d-0186-4d3c-9c17-ef186314a6b6,-37.85,145.23,VIC,Wantirna,debit,authorized,27994d87c89e482dada956ba16ca4b72,SALES-POS,60-70,2018,8,11,11,9,Saturday,7 days,54391.257
ACC-2920611728,69,17.0,2743.42,,CUS-1388323263,2018-08-11,Tyler,M,-37.76,144.96,,,,,,,debit,posted,e7a7fd230fff411c84f8684d3f64af38,PAYMENT,60-70,2018,8,11,16,0,Saturday,7 days,54391.257
ACC-2920611728,69,64.0,2679.42,,CUS-1388323263,2018-08-13,Tyler,M,-37.76,144.96,,,,,,,debit,posted,b3315b5655e340088115b3965b200c70,PAYMENT,60-70,2018,8,13,20,0,Monday,7 days,54391.257
ACC-2920611728,69,18.81,2660.61,1.0,CUS-1388323263,2018-08-13,Tyler,M,-37.76,144.96,,e1c47887-675b-48a7-9a4f-5f9fc51e6f0c,-37.91,144.99,VIC,Brighton,debit,authorized,f608808ac8034fdf836f696a0dac394e,SALES-POS,60-70,2018,8,13,23,59,Monday,7 days,54391.257
ACC-2920611728,69,11.93,2648.68,1.0,CUS-1388323263,2018-08-14,Tyler,M,-37.76,144.96,,424e95f4-f020-4f98-9cdc-b80178f01e1d,-37.77,145.11,VIC,Templestowe Lower,debit,authorized,7370fbfeac9e4b3d8eb063f6fc6eec53,POS,60-70,2018,8,14,11,10,Tuesday,7 days,54391.257
ACC-2920611728,69,16.56,2632.12,0.0,CUS-1388323263,2018-08-14,Tyler,M,-37.76,144.96,,d39ef731-28df-4327-af7a-8ef42b3d80ed,-37.83,144.97,VIC,South Melbourne,debit,authorized,0970fa7eeb2841e2a9f0e1b15396a606,POS,60-70,2018,8,14,12,50,Tuesday,7 days,54391.257
ACC-2920611728,69,19.3,2612.82,0.0,CUS-1388323263,2018-08-14,Tyler,M,-37.76,144.96,,d3fd832b-36b0-461f-aeca-2b154a4b18ad,-37.76,145,VIC,Northcote,debit,authorized,a9a15ad8bf1947c99691347389462835,POS,60-70,2018,8,14,16,48,Tuesday,7 days,54391.257
ACC-2920611728,69,23.36,3530.18,0.0,CUS-1388323263,2018-08-17,Tyler,M,-37.76,144.96,,04a5df97-f0a8-4003-a9ea-50191babbdb0,-37.81,144.98,VIC,Collingwood,debit,authorized,11cc75b7efce4ac5bc0955d38fe3afeb,SALES-POS,60-70,2018,8,17,16,26,Friday,7 days,54391.257
ACC-2920611728,69,55.92,3474.26,0.0,CUS-1388323263,2018-08-18,Tyler,M,-37.76,144.96,,a3eb712f-444e-4eeb-9da0-99474eed4e1b,-37.83,144.96,VIC,South Melbourne,debit,authorized,c167dcf7ffc54a4683e33df9d28b5d53,SALES-POS,60-70,2018,8,18,11,13,Saturday,7 days,54391.257
ACC-2920611728,69,17.0,3457.26,,CUS-1388323263,2018-08-18,Tyler,M,-37.76,144.96,,,,,,,debit,posted,e3feb8ee9e0046c7b3868a50c7b31cda,PAYMENT,60-70,2018,8,18,16,0,Saturday,7 days,54391.257
ACC-2920611728,69,22.06,3435.2,1.0,CUS-1388323263,2018-08-20,Tyler,M,-37.76,144.96,,075ce28f-2841-4c84-b04a-6864bd46624c,-37.9,145.16,VIC,Wheelers Hill,debit,authorized,2048c1cbb88b4976be80cd5159a2e357,POS,60-70,2018,8,20,16,28,Monday,7 days,54391.257
ACC-2920611728,69,64.0,3371.2,,CUS-1388323263,2018-08-20,Tyler,M,-37.76,144.96,,,,,,,debit,posted,75b706e991084cfa8a614ab5ada72b63,PAYMENT,60-70,2018,8,20,20,0,Monday,7 days,54391.257
ACC-2920611728,69,194.0,4220.32,,CUS-1388323263,2018-08-23,Tyler,M,-37.76,144.96,,,,,,,debit,posted,bcc388204e81458b97b7290a03644523,PAYMENT,60-70,2018,8,23,8,0,Thursday,7 days,54391.257
ACC-2920611728,69,17.0,4203.32,,CUS-1388323263,2018-08-25,Tyler,M,-37.76,144.96,,,,,,,debit,posted,7472eb02e78648129f284d1697f5285b,PAYMENT,60-70,2018,8,25,16,0,Saturday,7 days,54391.257
ACC-2920611728,69,10.41,4192.91,1.0,CUS-1388323263,2018-08-26,Tyler,M,-37.76,144.96,,72cde54c-aa30-42de-bc67-54369a9cf904,-37.74,140.78,SA,Mount Gambier Airport,debit,authorized,f7d51ff273d64710ae9ec9359a77f4d3,SALES-POS,60-70,2018,8,26,18,6,Sunday,7 days,54391.257
ACC-2920611728,69,64.0,4128.91,,CUS-1388323263,2018-08-27,Tyler,M,-37.76,144.96,,,,,,,debit,posted,3c8c860abb55408b94696d88550fd838,PAYMENT,60-70,2018,8,27,20,0,Monday,7 days,54391.257
ACC-2920611728,69,167.0,3961.91,,CUS-1388323263,2018-08-28,Tyler,M,-37.76,144.96,,,,,,,debit,posted,e11510c3d1e54fe1a8371d03e84de946,PAYMENT,60-70,2018,8,28,12,0,Tuesday,7 days,54391.257
ACC-2920611728,69,39.41,4965.62,1.0,CUS-1388323263,2018-08-30,Tyler,M,-37.76,144.96,,4bf1e62b-6e47-41a0-bee4-70651d0e5c62,-37.82,144.96,VIC,Melbourne,debit,authorized,5fd33869c9f3426db96f6a92ca44bf79,SALES-POS,60-70,2018,8,30,14,46,Thursday,7 days,54391.257
ACC-2920611728,69,29.45,4936.17,1.0,CUS-1388323263,2018-08-31,Tyler,M,-37.76,144.96,,d5b6fb02-8f78-467d-9bb1-2f2bafd8d422,-37.8,144.96,VIC,The University of Melbourne,debit,authorized,b0a90a969d004921a72889314a26d3f6,POS,60-70,2018,8,31,6,15,Friday,7 days,54391.257
ACC-2920611728,69,22.83,4913.34,1.0,CUS-1388323263,2018-09-01,Tyler,M,-37.76,144.96,,7b69c603-686d-46c9-9d1c-e27a693e638b,-37.54,144.94,VIC,Donnybrook,debit,authorized,7b880973ac8c4b42952341271b939bdf,SALES-POS,60-70,2018,9,1,13,11,Saturday,7 days,54391.257
ACC-2920611728,69,17.0,4896.34,,CUS-1388323263,2018-09-01,Tyler,M,-37.76,144.96,,,,,,,debit,posted,d2c47f9b4daf4304a48630624cf871eb,PAYMENT,60-70,2018,9,1,16,0,Saturday,7 days,54391.257
ACC-2920611728,69,164.37,4731.97,1.0,CUS-1388323263,2018-09-02,Tyler,M,-37.76,144.96,,e67cbcbd-e44b-4cf0-b318-30827a7425af,-37.82,144.95,VIC,Docklands,debit,authorized,c1818e08188545aab828b30e0df841c3,SALES-POS,60-70,2018,9,2,15,55,Sunday,7 days,54391.257
ACC-2920611728,69,57.79,4674.18,1.0,CUS-1388323263,2018-09-02,Tyler,M,-37.76,144.96,,df5575c7-916e-47df-91bb-b6bd0e7bd890,-37.77,145.37,VIC,Lilydale,debit,authorized,2057159346c84e5fa37c59006e0c2a12,SALES-POS,60-70,2018,9,2,20,7,Sunday,7 days,54391.257
ACC-2920611728,69,64.0,4610.18,,CUS-1388323263,2018-09-03,Tyler,M,-37.76,144.96,,,,,,,debit,posted,7fc2a0eb074b43cfbdec08c696f12f7f,PAYMENT,60-70,2018,9,3,20,0,Monday,7 days,54391.257
ACC-2920611728,69,17.02,4593.16,1.0,CUS-1388323263,2018-09-04,Tyler,M,-37.76,144.96,,238774cb-e57c-4054-815a-be7606a52038,-37.83,140.78,SA,Mount Gambier,debit,authorized,dafbf4da19654703bd916609bb3cb10b,POS,60-70,2018,9,4,9,8,Tuesday,7 days,54391.257
ACC-2920611728,69,18.34,4574.82,1.0,CUS-1388323263,2018-09-04,Tyler,M,-37.76,144.96,,05c06f19-8264-44b9-841d-de617eae0dbc,-37.76,145.07,VIC,Heidelberg,debit,authorized,9f02fff00c934e23b885d95dbb9b8ee4,SALES-POS,60-70,2018,9,4,9,55,Tuesday,7 days,54391.257
ACC-2920611728,69,19.99,4554.83,0.0,CUS-1388323263,2018-09-04,Tyler,M,-37.76,144.96,,f5b5665a-1714-4377-8dec-17216ffb3dcc,-37.83,145.15,VIC,Blackburn,debit,authorized,46dc139276574a0e817e03b6c2c363d3,SALES-POS,60-70,2018,9,4,11,56,Tuesday,7 days,54391.257
ACC-2920611728,69,24.91,4529.92,1.0,CUS-1388323263,2018-09-04,Tyler,M,-37.76,144.96,,c794e437-402d-4f03-ba26-c4d705c498ca,-37.91,145.19,VIC,Wheelers Hill,debit,authorized,cab06ec0064046309a6f7c367e147333,SALES-POS,60-70,2018,9,4,13,56,Tuesday,7 days,54391.257
ACC-2920611728,69,43.47,4486.45,1.0,CUS-1388323263,2018-09-04,Tyler,M,-37.76,144.96,,826e9398-cdcf-46fe-98e7-248b23e3f67c,-37.89,145.26,VIC,Scoresby,debit,authorized,853dba29ce5e4be390fde79b0fbe7c78,POS,60-70,2018,9,4,14,29,Tuesday,7 days,54391.257
ACC-2920611728,69,70.0,5459.57,,CUS-1388323263,2018-09-06,Tyler,M,-37.76,144.96,,,,,,,debit,posted,a3647eefa3b8460482dea928255db3a4,PAYMENT,60-70,2018,9,6,4,0,Thursday,7 days,54391.257
ACC-2920611728,69,30.29,5429.28,0.0,CUS-1388323263,2018-09-07,Tyler,M,-37.76,144.96,,d5887d53-1850-4274-8348-c5751e7148ac,-37.85,140.79,SA,Mt Gambier,debit,authorized,d601c8a759264e53a9e7f59b5637f00a,SALES-POS,60-70,2018,9,7,20,27,Friday,7 days,54391.257
ACC-2920611728,69,46.96,5382.32,1.0,CUS-1388323263,2018-09-08,Tyler,M,-37.76,144.96,,a7757fd8-1f60-4201-a7fd-b6c4cf90871c,-37.76,145.35,VIC,Lilydale,debit,authorized,011ad9f8627e4ecf8559b357a6447431,POS,60-70,2018,9,8,10,48,Saturday,7 days,54391.257
ACC-2920611728,69,17.0,5365.32,,CUS-1388323263,2018-09-08,Tyler,M,-37.76,144.96,,,,,,,debit,posted,0536f491f2234645a3fd03f0928ce6df,PAYMENT,60-70,2018,9,8,16,0,Saturday,7 days,54391.257
ACC-2920611728,69,12.71,5352.61,1.0,CUS-1388323263,2018-09-09,Tyler,M,-37.76,144.96,,32aa73dc-b7c2-4161-b14d-6271b96ce792,-37.81,145.23,VIC,Ringwood,debit,authorized,46bb0528c13848658285f8c8ae51cf79,SALES-POS,60-70,2018,9,9,13,53,Sunday,7 days,54391.257
ACC-2920611728,69,24.15,5328.46,1.0,CUS-1388323263,2018-09-09,Tyler,M,-37.76,144.96,,e4fd1b04-9985-4d3e-ac70-2cfcd93b5ad5,-37.87,145.24,VIC,Wantirna South,debit,authorized,5f13b2bd6f87434ca37d7afcef1f57a9,POS,60-70,2018,9,9,22,25,Sunday,7 days,54391.257
ACC-2920611728,69,64.0,5264.46,,CUS-1388323263,2018-09-10,Tyler,M,-37.76,144.96,,,,,,,debit,posted,a5ccb75aae7a4b56be80cab4be29db08,PAYMENT,60-70,2018,9,10,20,0,Monday,7 days,54391.257
ACC-2920611728,69,9.57,5254.89,1.0,CUS-1388323263,2018-09-11,Tyler,M,-37.76,144.96,,2752307d-a872-4644-844f-f19ef9fc1628,-37.9,145.03,VIC,Caulfield South,debit,authorized,d2750317ed794b2c8ae16cc2e4cd8b37,POS,60-70,2018,9,11,7,7,Tuesday,7 days,54391.257
ACC-2920611728,69,39.12,5215.77,1.0,CUS-1388323263,2018-09-12,Tyler,M,-37.76,144.96,,9cf12ed7-1600-403d-bb24-7f61d51609ef,-37.88,144.7,VIC,Hoppers Crossing,debit,authorized,9c4b758fc15c4aaca329872b206da045,SALES-POS,60-70,2018,9,12,1,12,Wednesday,7 days,54391.257
ACC-2920611728,69,43.01,5172.76,1.0,CUS-1388323263,2018-09-12,Tyler,M,-37.76,144.96,,8469c266-0837-436d-8de4-667aa319b6e3,-37.99,145.08,VIC,Parkdale,debit,authorized,45011495f5d1492a86cfe3b9e380f3e8,POS,60-70,2018,9,12,15,55,Wednesday,7 days,54391.257
ACC-2920611728,69,17.0,6198.88,,CUS-1388323263,2018-09-15,Tyler,M,-37.76,144.96,,,,,,,debit,posted,ed198a7e80c240c0819d213c033cdee2,PAYMENT,60-70,2018,9,15,16,0,Saturday,7 days,54391.257
ACC-2920611728,69,64.0,6134.88,,CUS-1388323263,2018-09-17,Tyler,M,-37.76,144.96,,,,,,,debit,posted,b3d7c49c28af472d95bf711a6a5d0e49,PAYMENT,60-70,2018,9,17,20,0,Monday,7 days,54391.257
ACC-2920611728,69,111.63,7066.37,0.0,CUS-1388323263,2018-09-21,Tyler,M,-37.76,144.96,,d2017cb5-ce4f-4e77-b5f3-4c1f5c0cb3a5,-37.81,144.87,VIC,Yarraville,debit,authorized,54e1cdbed44242a997efada393091116,SALES-POS,60-70,2018,9,21,23,36,Friday,7 days,54391.257
ACC-2920611728,69,17.0,7049.37,,CUS-1388323263,2018-09-22,Tyler,M,-37.76,144.96,,,,,,,debit,posted,4c4732fc8c5a475abf75c5bfc2e122b6,PAYMENT,60-70,2018,9,22,16,0,Saturday,7 days,54391.257
ACC-2920611728,69,194.0,6855.37,,CUS-1388323263,2018-09-23,Tyler,M,-37.76,144.96,,,,,,,debit,posted,826e43fcc02540b1a402a36f711b5578,PAYMENT,60-70,2018,9,23,8,0,Sunday,7 days,54391.257
ACC-2920611728,69,64.0,6791.37,,CUS-1388323263,2018-09-24,Tyler,M,-37.76,144.96,,,,,,,debit,posted,4989771d8cf647e58ff8042fdd4dbe50,PAYMENT,60-70,2018,9,24,20,0,Monday,7 days,54391.257
ACC-2920611728,69,19.95,6771.42,1.0,CUS-1388323263,2018-09-25,Tyler,M,-37.76,144.96,,0cd1831f-e23a-44d6-bc32-0cf6ab4d5da1,-37.77,144.89,VIC,Maribyrnong,debit,authorized,87ea5b2665a442ada2d8d807c3f02515,POS,60-70,2018,9,25,14,22,Tuesday,7 days,54391.257
ACC-2920611728,69,28.74,6742.68,0.0,CUS-1388323263,2018-09-25,Tyler,M,-37.76,144.96,,3958f1b8-0c3e-4fb9-9a41-c3dcd6da32e0,-37.81,145.29,VIC,Croydon South,debit,authorized,abff5a67d3c445429db2752a1bcb471b,SALES-POS,60-70,2018,9,25,16,21,Tuesday,7 days,54391.257
ACC-2920611728,69,31.6,6711.08,1.0,CUS-1388323263,2018-09-26,Tyler,M,-37.76,144.96,,11e9b7bb-8bc6-4dd3-8030-eae08285fc20,-37.69,145.11,VIC,Greensborough,debit,authorized,f8955c4a7fda4015a6f5c55e7f4c69e2,SALES-POS,60-70,2018,9,26,9,7,Wednesday,7 days,54391.257
ACC-2920611728,69,60.46,7693.74,0.0,CUS-1388323263,2018-09-27,Tyler,M,-37.76,144.96,,b5b916b3-94c5-427e-b88f-7f60c55c35dc,-37.82,144.96,VIC,Melbourne,debit,authorized,15dc46e7d79940cab5c496227d06ca80,SALES-POS,60-70,2018,9,27,8,6,Thursday,7 days,54391.257
ACC-2920611728,69,37.66,7656.08,0.0,CUS-1388323263,2018-09-27,Tyler,M,-37.76,144.96,,7bf90658-0064-4e02-90be-e3133d3494b9,-37.87,145.03,VIC,Malvern,debit,authorized,4b5ae7ee8ec146e8b6fd903d1af7eb4e,POS,60-70,2018,9,27,10,56,Thursday,7 days,54391.257
ACC-2920611728,69,13.35,7642.73,1.0,CUS-1388323263,2018-09-27,Tyler,M,-37.76,144.96,,c87249d7-f123-4bfc-8928-9519b32d2bdb,-37.9,145.12,VIC,Clayton,debit,authorized,2405da0e5aa242fbb94a226f2cab4f22,POS,60-70,2018,9,27,20,15,Thursday,7 days,54391.257
ACC-2920611728,69,167.0,7475.73,,CUS-1388323263,2018-09-28,Tyler,M,-37.76,144.96,,,,,,,debit,posted,c5ce0d46932c415aa8d67b22049aec18,PAYMENT,60-70,2018,9,28,12,0,Friday,7 days,54391.257
ACC-2920611728,69,12.56,7463.17,1.0,CUS-1388323263,2018-09-28,Tyler,M,-37.76,144.96,,e57a7561-6194-41fc-bdff-fa1f40bf0df0,-37.82,145.31,VIC,Kilsyth South,debit,authorized,f96787610af64713875c189c2cf0ca57,SALES-POS,60-70,2018,9,28,20,13,Friday,7 days,54391.257
ACC-2920611728,69,15.07,7448.1,1.0,CUS-1388323263,2018-09-29,Tyler,M,-37.76,144.96,,81fe1636-2edb-4a2f-ae93-3d375027047b,-37.76,145.31,VIC,Chirnside Park,debit,authorized,69bd0382f4d345d0b8c52fc2cdc7bd7c,SALES-POS,60-70,2018,9,29,10,14,Saturday,7 days,54391.257
ACC-2920611728,69,17.0,7431.1,,CUS-1388323263,2018-09-29,Tyler,M,-37.76,144.96,,,,,,,debit,posted,7257dbf75952426398252db9b662f570,PAYMENT,60-70,2018,9,29,16,0,Saturday,7 days,54391.257
ACC-2920611728,69,17.54,7413.56,1.0,CUS-1388323263,2018-09-29,Tyler,M,-37.76,144.96,,a7933aae-e35e-4e5d-9cbc-214a1835d0c6,-37.78,145.27,VIC,Croydon,debit,authorized,4bb18eb7d27c4d8f9faf939908f3c145,SALES-POS,60-70,2018,9,29,23,32,Saturday,7 days,54391.257
ACC-2920611728,69,64.0,7349.56,,CUS-1388323263,2018-10-01,Tyler,M,-37.76,144.96,,,,,,,debit,posted,512d7e4800f044f7b81b1bf456304fad,PAYMENT,60-70,2018,10,1,20,0,Monday,7 days,54391.257
ACC-2920611728,69,70.0,8322.68,,CUS-1388323263,2018-10-06,Tyler,M,-37.76,144.96,,,,,,,debit,posted,60b205552e1c4c7e918926e1671a7912,PAYMENT,60-70,2018,10,6,4,0,Saturday,7 days,54391.257
ACC-2920611728,69,17.0,8305.68,,CUS-1388323263,2018-10-06,Tyler,M,-37.76,144.96,,,,,,,debit,posted,ca7a6173eccf453f8e10d73525036397,PAYMENT,60-70,2018,10,6,16,0,Saturday,7 days,54391.257
ACC-2920611728,69,45.54,8260.14,1.0,CUS-1388323263,2018-10-07,Tyler,M,-37.76,144.96,,8ec59b50-d959-4dfe-af86-b05c501de93c,-37.91,144.99,VIC,Brighton,debit,authorized,b793e101a12146bcab3d4a5f86df8261,SALES-POS,60-70,2018,10,7,1,34,Sunday,7 days,54391.257
ACC-2920611728,69,64.0,8196.14,,CUS-1388323263,2018-10-08,Tyler,M,-37.76,144.96,,,,,,,debit,posted,5ef04aabfb5a404f8836e27b25e3791b,PAYMENT,60-70,2018,10,8,20,0,Monday,7 days,54391.257
ACC-2920611728,69,17.0,9222.26,,CUS-1388323263,2018-10-13,Tyler,M,-37.76,144.96,,,,,,,debit,posted,f6c61597a7e94b73ba0788edff0253da,PAYMENT,60-70,2018,10,13,16,0,Saturday,7 days,54391.257
ACC-2920611728,69,54.41,9167.85,1.0,CUS-1388323263,2018-10-15,Tyler,M,-37.76,144.96,,10be468c-9d02-4d10-ba7f-10bd3ff986cd,-37.84,145.18,VIC,Forest Hill,debit,authorized,6b6f2a557c434560a4bd34a4a2ec8076,SALES-POS,60-70,2018,10,15,11,36,Monday,7 days,54391.257
ACC-2920611728,69,64.0,9103.85,,CUS-1388323263,2018-10-15,Tyler,M,-37.76,144.96,,,,,,,debit,posted,dffb2d5b23154677ad674818b801eafd,PAYMENT,60-70,2018,10,15,20,0,Monday,7 days,54391.257
ACC-2920611728,69,39.9,9063.95,1.0,CUS-1388323263,2018-10-16,Tyler,M,-37.76,144.96,,958785e9-7a35-4e6d-8e5d-51f1e12c1174,-37.8,145.1,VIC,Balwyn,debit,authorized,485b702838f74fc28cf0938f9a42b4cf,POS,60-70,2018,10,16,8,1,Tuesday,7 days,54391.257
ACC-2920611728,69,25.66,9038.29,1.0,CUS-1388323263,2018-10-16,Tyler,M,-37.76,144.96,,450383c0-a70a-4ef2-8381-3fa1d3e86523,-37.81,147.63,VIC,Eastwood,debit,authorized,76bb1ff68d2c40689a6c87ac70a76441,POS,60-70,2018,10,16,23,21,Tuesday,7 days,54391.257
ACC-2920611728,69,16.26,9022.03,1.0,CUS-1388323263,2018-10-17,Tyler,M,-37.76,144.96,,fe94fe3b-dcbb-462a-b9a8-68cd2fef3018,-37.78,144.86,VIC,Braybrook,debit,authorized,e605e29152484edbbbde35af46bea8fb,SALES-POS,60-70,2018,10,17,13,18,Wednesday,7 days,54391.257
ACC-2920611728,69,37.91,10027.24,1.0,CUS-1388323263,2018-10-18,Tyler,M,-37.76,144.96,,714b7c90-5b6f-456b-9cb6-66237bee922b,-37.81,145.08,VIC,Balwyn,debit,authorized,2b5a88daca63490b9ada344e60976ab1,SALES-POS,60-70,2018,10,18,15,24,Thursday,7 days,54391.257
ACC-2920611728,69,32.3,9994.94,1.0,CUS-1388323263,2018-10-19,Tyler,M,-37.76,144.96,,a61580ea-86e1-469c-84f6-b1e3bf8f81c5,-37.78,145.27,VIC,Croydon,debit,authorized,47996b9cbabb48b5a6a1b946a31cec39,POS,60-70,2018,10,19,19,59,Friday,7 days,54391.257
ACC-2920611728,69,27.84,9967.1,1.0,CUS-1388323263,2018-10-20,Tyler,M,-37.76,144.96,,e10fbfdd-dc68-4b63-a714-8288ab50db0c,-37.87,144.98,VIC,Saint Kilda,debit,authorized,79041a8ea9f64530bd28751a14c1646f,SALES-POS,60-70,2018,10,20,8,12,Saturday,7 days,54391.257
ACC-2920611728,69,56.93,9910.17,1.0,CUS-1388323263,2018-10-20,Tyler,M,-37.76,144.96,,df6ddb5a-f5c5-4cff-9150-82829fcaf32a,-37.88,145.03,VIC,Caulfield North,debit,authorized,c5256d76ed5341de9c6f97599e282d2f,POS,60-70,2018,10,20,10,40,Saturday,7 days,54391.257
ACC-2920611728,69,17.0,9893.17,,CUS-1388323263,2018-10-20,Tyler,M,-37.76,144.96,,,,,,,debit,posted,7710726a9b7b48b4965b1b28c039350e,PAYMENT,60-70,2018,10,20,16,0,Saturday,7 days,54391.257
ACC-2920611728,69,16.77,9876.4,1.0,CUS-1388323263,2018-10-20,Tyler,M,-37.76,144.96,,dbe14c6d-105f-41ae-a6a8-f37a74377091,-37.85,144.87,VIC,Williamstown North,debit,authorized,583da878e6ae4defbe4d9bd6e328eedb,SALES-POS,60-70,2018,10,20,18,44,Saturday,7 days,54391.257
ACC-2920611728,69,19.14,9857.26,1.0,CUS-1388323263,2018-10-21,Tyler,M,-37.76,144.96,,a8460564-f18e-4c13-a2de-893f64597ecc,-37.88,144.61,VIC,Wyndham Vale,debit,authorized,73edb8ee294b4edfac1e0c8b80da4248,SALES-POS,60-70,2018,10,21,1,33,Sunday,7 days,54391.257
ACC-2920611728,69,64.0,9793.26,,CUS-1388323263,2018-10-22,Tyler,M,-37.76,144.96,,,,,,,debit,posted,0ecfaff40cc24b028afd752e62952514,PAYMENT,60-70,2018,10,22,20,0,Monday,7 days,54391.257
ACC-2920611728,69,194.0,9599.26,,CUS-1388323263,2018-10-23,Tyler,M,-37.76,144.96,,,,,,,debit,posted,65c2fb22309b4254a416a97e43e66967,PAYMENT,60-70,2018,10,23,8,0,Tuesday,7 days,54391.257
ACC-2920611728,69,17.0,10625.38,,CUS-1388323263,2018-10-27,Tyler,M,-37.76,144.96,,,,,,,debit,posted,95904c651dd14dd1866c7ae7b1f70614,PAYMENT,60-70,2018,10,27,16,0,Saturday,7 days,54391.257
ACC-2920611728,69,167.0,10458.38,,CUS-1388323263,2018-10-28,Tyler,M,-37.76,144.96,,,,,,,debit,posted,88e3658b271f422e94faf540f84d55fa,PAYMENT,60-70,2018,10,28,12,0,Sunday,7 days,54391.257
ACC-2920611728,69,64.0,10394.38,,CUS-1388323263,2018-10-29,Tyler,M,-37.76,144.96,,,,,,,debit,posted,ab22022bdc484b48814d1e2ec360f484,PAYMENT,60-70,2018,10,29,20,0,Monday,7 days,54391.257
ACC-2920611728,69,56.06,10338.32,1.0,CUS-1388323263,2018-10-30,Tyler,M,-37.76,144.96,,fb65ded2-f680-474b-a46b-86cb75bc2125,-37.78,145.12,VIC,Doncaster,debit,authorized,5eb8e60b883542a8b584e10e33b64cc0,SALES-POS,60-70,2018,10,30,1,11,Tuesday,7 days,54391.257
ACC-2920611728,69,30.77,11350.67,1.0,CUS-1388323263,2018-10-31,Tyler,M,-37.76,144.96,,af49051a-591d-4b08-bd3c-27730b70ed37,-37.91,145.09,VIC,Oakleigh,debit,authorized,74aa9cd7e4af4c6d9cd7dbd28e9aedc9,SALES-POS,60-70,2018,10,31,23,47,Wednesday,7 days,54391.257
ACC-2674800293,50,10.13,24268.73,1.0,CUS-2977593493,2018-08-02,Elizabeth,F,-37.69,144.96,,08301df2-1d46-4c51-a1ac-f2a4eefe43ef,-37.91,145.05,VIC,Mckinnon,debit,authorized,66b8e33e15894a44a9f87fb387cb19fb,SALES-POS,40-50,2018,8,2,15,16,Thursday,14 days,37464.121
ACC-2674800293,50,15.84,24252.89,1.0,CUS-2977593493,2018-08-03,Elizabeth,F,-37.69,144.96,,a7257417-3cd7-40ef-af50-ba8acd441601,-37.72,144.99,VIC,Reservoir,debit,authorized,13b5d87ae645480f9f2da5f9f38b5272,SALES-POS,40-50,2018,8,3,10,39,Friday,14 days,37464.121
ACC-2674800293,50,171.0,25518.87,,CUS-2977593493,2018-08-09,Elizabeth,F,-37.69,144.96,,,,,,,debit,posted,1e9ebe4d57f34703a740273ecaacf15d,PAYMENT,40-50,2018,8,9,14,0,Thursday,14 days,37464.121
ACC-2674800293,50,32.41,25486.46,0.0,CUS-2977593493,2018-08-11,Elizabeth,F,-37.69,144.96,,8c0cf5d2-7b3b-4592-8b1c-8cf6f82a4901,-37.77,144.92,VIC,Moonee Ponds,debit,authorized,0d8046c1b9364479bbc67015f425973f,POS,40-50,2018,8,11,14,13,Saturday,14 days,37464.121
ACC-2674800293,50,25.93,25460.53,1.0,CUS-2977593493,2018-08-11,Elizabeth,F,-37.69,144.96,,f35dd9ce-355d-4b5d-90cb-f008170ee42d,-37.59,144.91,VIC,Craigieburn,debit,authorized,150a6cfd3adf44819f55309120e01528,SALES-POS,40-50,2018,8,11,21,24,Saturday,14 days,37464.121
ACC-2674800293,50,36.97,25423.56,1.0,CUS-2977593493,2018-08-11,Elizabeth,F,-37.69,144.96,,da0c98f6-0eae-424b-94b3-ef8969d2146d,-37.78,144.83,VIC,Sunshine,debit,authorized,c16d2697c2ac4e17aba05b077bab9046,SALES-POS,40-50,2018,8,11,21,52,Saturday,14 days,37464.121
ACC-2674800293,50,24.68,25398.88,1.0,CUS-2977593493,2018-08-11,Elizabeth,F,-37.69,144.96,,5e5443db-feaa-4e0d-a77d-63b4bd34ad73,-38.41,144.85,VIC,Fingal,debit,authorized,7309e45c60694e4cbc81e5ee30a85c27,POS,40-50,2018,8,11,22,47,Saturday,14 days,37464.121
ACC-2674800293,50,176.0,25222.88,,CUS-2977593493,2018-08-12,Elizabeth,F,-37.69,144.96,,,,,,,debit,posted,887c28e34b8140e78a90044b0f924ab9,PAYMENT,40-50,2018,8,12,8,0,Sunday,14 days,37464.121
ACC-2674800293,50,20.74,25202.14,1.0,CUS-2977593493,2018-08-12,Elizabeth,F,-37.69,144.96,,1f3e0229-44e6-4f73-9705-d2d52261a8a4,-37.79,145.16,VIC,Doncaster East,debit,authorized,9681851bdf1c4773a59d7e992e7abc8d,POS,40-50,2018,8,12,9,48,Sunday,14 days,37464.121
ACC-2674800293,50,14.63,28061.47,1.0,CUS-2977593493,2018-09-02,Elizabeth,F,-37.69,144.96,,0a142703-a518-46ac-b854-a98a334f9b27,-37.88,147.99,VIC,Lakes Entrance,debit,authorized,1a6640a6946443ceaee661764ff4210a,SALES-POS,40-50,2018,9,2,10,15,Sunday,14 days,37464.121
ACC-2674800293,50,46.35,28015.12,0.0,CUS-2977593493,2018-09-06,Elizabeth,F,-37.69,144.96,,f8773f21-0470-4ba3-8fdc-6398e164709e,-38.02,145.12,VIC,Aspendale Gardens,debit,authorized,5c26727e307647819d27deee16e04033,SALES-POS,40-50,2018,9,6,15,59,Thursday,14 days,37464.121
ACC-2674800293,50,660.99,27354.13,1.0,CUS-2977593493,2018-09-08,Elizabeth,F,-37.69,144.96,,4f379cad-d380-4426-b39d-32132f77fe27,-33.87,151.21,NSW,Sydney,debit,authorized,4eeab795237f42c999082584d482865c,POS,40-50,2018,9,8,16,55,Saturday,14 days,37464.121
ACC-2674800293,50,171.0,27183.13,,CUS-2977593493,2018-09-09,Elizabeth,F,-37.69,144.96,,,,,,,debit,posted,1b666837d63e482aafc203d60f767e7d,PAYMENT,40-50,2018,9,9,14,0,Sunday,14 days,37464.121
ACC-2674800293,50,176.0,27007.13,,CUS-2977593493,2018-09-12,Elizabeth,F,-37.69,144.96,,,,,,,debit,posted,c5a1d3de93a44e2ebc3a53aba752b300,PAYMENT,40-50,2018,9,12,8,0,Wednesday,14 days,37464.121
ACC-2674800293,50,57.87,28386.24,0.0,CUS-2977593493,2018-09-16,Elizabeth,F,-37.69,144.96,,278f9e02-7fff-413f-b0de-7d56ffaf941f,-37.87,145.24,VIC,Wantirna South,debit,authorized,2e499ff1d74946cb9a693dd1ff06857c,POS,40-50,2018,9,16,14,1,Sunday,14 days,37464.121
ACC-2674800293,50,44.95,28341.29,1.0,CUS-2977593493,2018-09-17,Elizabeth,F,-37.69,144.96,,c4c6020c-b9ab-4868-b6c4-7a6bed751010,-37.78,145.46,VIC,Seville,debit,authorized,3ce9dec3a7e943b8a9cddca96556fe57,SALES-POS,40-50,2018,9,17,21,31,Monday,14 days,37464.121
ACC-2674800293,50,32.89,28308.4,1.0,CUS-2977593493,2018-09-20,Elizabeth,F,-37.69,144.96,,412d7d98-c415-4a19-9423-3bd4fa92af09,-37.8,144.79,VIC,Sunshine West,debit,authorized,17a6214e4ea241a3b17f7f9f618349d1,SALES-POS,40-50,2018,9,20,14,9,Thursday,14 days,37464.121
ACC-2674800293,50,39.27,28269.13,1.0,CUS-2977593493,2018-09-20,Elizabeth,F,-37.69,144.96,,0e0e608d-6695-44b1-8e29-4e73db757a2b,-37.85,145.08,VIC,Glen Iris,debit,authorized,82e84d502f0747c197d707ff6cea78b9,SALES-POS,40-50,2018,9,20,14,58,Thursday,14 days,37464.121
ACC-2674800293,50,19.51,28249.62,1.0,CUS-2977593493,2018-09-20,Elizabeth,F,-37.69,144.96,,625ee8cf-38a2-4115-97bd-9b8c7c5a53d0,-37.88,145.13,VIC,Mount Waverley,debit,authorized,69436790194d4e5dbbd4e3f78bea0634,SALES-POS,40-50,2018,9,20,18,31,Thursday,14 days,37464.121
ACC-2674800293,50,23.93,28225.69,1.0,CUS-2977593493,2018-09-20,Elizabeth,F,-37.69,144.96,,4a67d7a9-5b74-4439-bb74-8565c22bf7d1,-37.82,144.95,VIC,Docklands,debit,authorized,8328d117f01f4f6393e3f05c7657cf8f,SALES-POS,40-50,2018,9,20,19,51,Thursday,14 days,37464.121
ACC-2674800293,50,19.44,28206.25,1.0,CUS-2977593493,2018-09-25,Elizabeth,F,-37.69,144.96,,1a48ffe9-8e3c-4ff1-969e-fff37762269a,-37.83,147.63,VIC,Bairnsdale,debit,authorized,c34f3cc4c1eb4e3e97f4b66d158320d2,POS,40-50,2018,9,25,14,37,Tuesday,14 days,37464.121
ACC-2674800293,50,909.61,27296.64,1.0,CUS-2977593493,2018-09-25,Elizabeth,F,-37.69,144.96,,7b4deb71-0e46-4da6-b2fa-7c718273f157,-37.83,140.78,SA,Mount Gambier,debit,authorized,969c2afa8a864c7b87ea9970a1fe3bbb,POS,40-50,2018,9,25,15,49,Tuesday,14 days,37464.121
ACC-2674800293,50,28.41,28705.21,1.0,CUS-2977593493,2018-09-28,Elizabeth,F,-37.69,144.96,,5339d6a8-a898-4314-9bf4-4e028757448f,-37.93,145.17,VIC,Mulgrave,debit,authorized,63915d33ee3c4b59aad70cc2f9f270f8,SALES-POS,40-50,2018,9,28,22,15,Friday,14 days,37464.121
ACC-2674800293,50,171.0,28534.21,,CUS-2977593493,2018-10-09,Elizabeth,F,-37.69,144.96,,,,,,,debit,posted,ea14e0f716f64bd188daaed4540689d6,PAYMENT,40-50,2018,10,9,14,0,Tuesday,14 days,37464.121
ACC-2674800293,50,176.0,28358.21,,CUS-2977593493,2018-10-12,Elizabeth,F,-37.69,144.96,,,,,,,debit,posted,a5e5e690f5a3447992be64c901ed58af,PAYMENT,40-50,2018,10,12,8,0,Friday,14 days,37464.121
ACC-2674800293,50,31.45,29763.74,0.0,CUS-2977593493,2018-10-12,Elizabeth,F,-37.69,144.96,,176e7769-03e0-4dc5-bec2-b62fd2b2a3d3,-37.79,145.13,VIC,Doncaster,debit,authorized,341c79aaab00496da8e3b01072cd88e1,POS,40-50,2018,10,12,16,40,Friday,14 days,37464.121
ACC-2674800293,50,15.67,29748.07,1.0,CUS-2977593493,2018-10-12,Elizabeth,F,-37.69,144.96,,8b382536-a7ee-4260-933b-8a32348b7eab,-37.91,145.19,VIC,Wheelers Hill,debit,authorized,a6a74bd707244cf4ab2e351067865ee4,SALES-POS,40-50,2018,10,12,18,37,Friday,14 days,37464.121
ACC-2674800293,50,50.15,29697.92,1.0,CUS-2977593493,2018-10-13,Elizabeth,F,-37.69,144.96,,ed7e8df5-6d0b-42d7-8d51-d13b14d191a7,-37.84,144.99,VIC,South Yarra,debit,authorized,53c17ca876c0484e89878f04774f907e,POS,40-50,2018,10,13,19,49,Saturday,14 days,37464.121
ACC-2674800293,50,14.14,29683.78,0.0,CUS-2977593493,2018-10-13,Elizabeth,F,-37.69,144.96,,5e7e7bf9-49f9-4a68-bde4-edf09a454dc9,-37.82,144.97,VIC,Melbourne,debit,authorized,3be5b85a241848839c2435d8f8b7732f,POS,40-50,2018,10,13,22,23,Saturday,14 days,37464.121
ACC-2674800293,50,36.07,29647.71,1.0,CUS-2977593493,2018-10-14,Elizabeth,F,-37.69,144.96,,e232c1e0-14e3-4a49-9b80-b7d6b0ce7a42,-37.79,144.98,VIC,Fitzroy,debit,authorized,7f33160bfe7640439984c75c78c070aa,SALES-POS,40-50,2018,10,14,10,40,Sunday,14 days,37464.121
ACC-2674800293,50,21.11,29626.6,0.0,CUS-2977593493,2018-10-19,Elizabeth,F,-37.69,144.96,,d17237f0-23ad-4030-a39c-fa9ac4cab55f,-37.84,145.27,VIC,Bayswater,debit,authorized,8824a93fbbee4225a3c00b63572689e6,POS,40-50,2018,10,19,16,44,Friday,14 days,37464.121
ACC-2674800293,50,57.32,29569.28,1.0,CUS-2977593493,2018-10-20,Elizabeth,F,-37.69,144.96,,4a22bf35-14a5-412a-bfa7-2f335c2890b8,-37.86,145.03,VIC,Malvern,debit,authorized,68189b32603c47c9abd73be135285faf,POS,40-50,2018,10,20,8,46,Saturday,14 days,37464.121
ACC-2674800293,50,38.82,29530.46,1.0,CUS-2977593493,2018-10-20,Elizabeth,F,-37.69,144.96,,7577e8e3-de34-4032-b7ba-f83774cc62e9,-37.89,145.08,VIC,Chadstone,debit,authorized,918baec376ab4002b23a40a528454f68,POS,40-50,2018,10,20,11,41,Saturday,14 days,37464.121
ACC-2674800293,50,50.14,29480.32,1.0,CUS-2977593493,2018-10-20,Elizabeth,F,-37.69,144.96,,e288a819-9b84-424f-b17c-e4e4869472b4,-37.83,140.78,SA,Mount Gambier,debit,authorized,22dfd6c7a57649868f34a780dc8560e4,POS,40-50,2018,10,20,19,35,Saturday,14 days,37464.121
ACC-2674800293,50,24.85,29455.47,0.0,CUS-2977593493,2018-10-23,Elizabeth,F,-37.69,144.96,,798f87f6-f0d5-4165-b84b-d2801c47ccd2,-37.65,145.01,VIC,Epping,debit,authorized,f5abbf3a1e2d42f6a0ad08a780c4d9a6,POS,40-50,2018,10,23,9,33,Tuesday,14 days,37464.121
ACC-2674800293,50,10.05,29445.42,1.0,CUS-2977593493,2018-10-24,Elizabeth,F,-37.69,144.96,,e51b7681-9e22-43d1-911b-62ea1a0ef165,-37.82,144.96,VIC,Melbourne,debit,authorized,3284b0896bc54d92aeadbd09337f45d7,SALES-POS,40-50,2018,10,24,1,2,Wednesday,14 days,37464.121
ACC-2674800293,50,8.53,29436.89,0.0,CUS-2977593493,2018-10-26,Elizabeth,F,-37.69,144.96,,8c17f994-bf4e-4045-ad13-7cbf4173eea4,-28.77,114.61,WA,Geraldton,debit,authorized,f2f866dde7144a1fa64c24329bc929fb,POS,40-50,2018,10,26,10,4,Friday,14 days,37464.121
ACC-3941181087,25,41.66,1014.72,1.0,CUS-3989008654,2018-08-02,Paul,M,-31.94,115.79,,c6bf12ba-12c7-413d-8219-d68eceece31e,-31.96,116.05,WA,Gooseberry Hill,debit,authorized,4f6aa62906854c9ba1f2aef97424ba37,SALES-POS,20-30,2018,8,2,15,29,Thursday,14 days,70076.089
ACC-3941181087,25,28.0,986.72,,CUS-3989008654,2018-08-03,Paul,M,-31.94,115.79,,,,,,,debit,posted,70391bad384248ff86be528407d2f402,PAYMENT,20-30,2018,8,3,6,0,Friday,14 days,70076.089
ACC-3941181087,25,10.33,976.39,1.0,CUS-3989008654,2018-08-03,Paul,M,-31.94,115.79,,8a64cce8-b119-4f5d-992c-6acb90503af9,-31.8,115.79,WA,Kingsley,debit,authorized,e94d12fdf7db4ce59857891f3be0f8ec,SALES-POS,20-30,2018,8,3,16,44,Friday,14 days,70076.089
ACC-3941181087,25,85.0,891.39,,CUS-3989008654,2018-08-04,Paul,M,-31.94,115.79,,,,,,,debit,posted,e4fbe13b38af4f29930d302e0a3ae328,PAYMENT,20-30,2018,8,4,5,0,Saturday,14 days,70076.089
ACC-3941181087,25,46.0,845.39,,CUS-3989008654,2018-08-07,Paul,M,-31.94,115.79,,,,,,,debit,posted,7102804de8b34d53b7f13b57d60733b9,PAYMENT,20-30,2018,8,7,16,0,Tuesday,14 days,70076.089
ACC-3941181087,25,27.18,818.21,1.0,CUS-3989008654,2018-08-08,Paul,M,-31.94,115.79,,877d2a2b-a280-48d2-a5cd-8f834c611fe2,-33.89,151.21,NSW,Surry Hills,debit,authorized,e7c1807d55d04377a17cd245d0590fa3,POS,20-30,2018,8,8,15,25,Wednesday,14 days,70076.089
ACC-3941181087,25,28.0,3478.06,,CUS-3989008654,2018-08-10,Paul,M,-31.94,115.79,,,,,,,debit,posted,f48d2636b7054b2598821ba3c503c0ea,PAYMENT,20-30,2018,8,10,6,0,Friday,14 days,70076.089
ACC-3941181087,25,14.56,3463.5,1.0,CUS-3989008654,2018-08-10,Paul,M,-31.94,115.79,,c0da52af-7294-4b01-95e2-45eaa184972d,-32.41,115.76,WA,Secret Harbour,debit,authorized,ae0188a17e7c4b7793f1810073dfd977,SALES-POS,20-30,2018,8,10,15,18,Friday,14 days,70076.089
ACC-3941181087,25,35.32,3428.18,1.0,CUS-3989008654,2018-08-10,Paul,M,-31.94,115.79,,a25d7bfa-76a9-475d-9251-c73b1f14b4bc,-33.88,151.2,NSW,Ultimo,debit,authorized,d99f01e17e0441cfb07473054fcb38dd,POS,20-30,2018,8,10,19,18,Friday,14 days,70076.089
ACC-3941181087,25,46.0,3382.18,,CUS-3989008654,2018-08-14,Paul,M,-31.94,115.79,,,,,,,debit,posted,111d9b894d164e3e98d830222d02aa30,PAYMENT,20-30,2018,8,14,16,0,Tuesday,14 days,70076.089
ACC-3941181087,25,172.0,3210.18,,CUS-3989008654,2018-08-15,Paul,M,-31.94,115.79,,,,,,,debit,posted,6a6250d6c08d461e8e7849a4c8e64c03,PAYMENT,20-30,2018,8,15,6,0,Wednesday,14 days,70076.089
ACC-3941181087,25,28.0,3182.18,,CUS-3989008654,2018-08-17,Paul,M,-31.94,115.79,,,,,,,debit,posted,64148e44016e490d9f5d83cf4cabfb37,PAYMENT,20-30,2018,8,17,6,0,Friday,14 days,70076.089
ACC-3941181087,25,192.0,2990.18,,CUS-3989008654,2018-08-19,Paul,M,-31.94,115.79,,,,,,,debit,posted,5cc972fef6d14309a9d0d4f2b61db9e6,INTER BANK,20-30,2018,8,19,7,0,Sunday,14 days,70076.089
ACC-3941181087,25,89.0,2901.18,,CUS-3989008654,2018-08-21,Paul,M,-31.94,115.79,,,,,,,debit,posted,2d81b1aef1304e5a87e58f4adcf3d7f6,PAYMENT,20-30,2018,8,21,10,0,Tuesday,14 days,70076.089
ACC-3941181087,25,46.0,2855.18,,CUS-3989008654,2018-08-21,Paul,M,-31.94,115.79,,,,,,,debit,posted,d7c451ece48e45cea5eb5d553aaf56e9,PAYMENT,20-30,2018,8,21,16,0,Tuesday,14 days,70076.089
ACC-3941181087,25,28.0,5515.03,,CUS-3989008654,2018-08-24,Paul,M,-31.94,115.79,,,,,,,debit,posted,1295717d2df048bf90298658937b7f49,PAYMENT,20-30,2018,8,24,6,0,Friday,14 days,70076.089
ACC-3941181087,25,46.0,5469.03,,CUS-3989008654,2018-08-28,Paul,M,-31.94,115.79,,,,,,,debit,posted,32bf938eaa264087813aed7c0b9081c4,PAYMENT,20-30,2018,8,28,16,0,Tuesday,14 days,70076.089
ACC-3941181087,25,28.0,5441.03,,CUS-3989008654,2018-08-31,Paul,M,-31.94,115.79,,,,,,,debit,posted,a702a78623e842f7814017a1a9302de8,PAYMENT,20-30,2018,8,31,6,0,Friday,14 days,70076.089
ACC-3941181087,25,85.0,5356.03,,CUS-3989008654,2018-09-04,Paul,M,-31.94,115.79,,,,,,,debit,posted,367d04dd2e67457d8b25a1579f48eca9,PAYMENT,20-30,2018,9,4,5,0,Tuesday,14 days,70076.089
ACC-3941181087,25,46.0,5310.03,,CUS-3989008654,2018-09-04,Paul,M,-31.94,115.79,,,,,,,debit,posted,c55c7b28a6ee4914a008e77a8c8fb1dd,PAYMENT,20-30,2018,9,4,16,0,Tuesday,14 days,70076.089
ACC-3941181087,25,28.0,7969.88,,CUS-3989008654,2018-09-07,Paul,M,-31.94,115.79,,,,,,,debit,posted,2e541b94f69a4c99897fbd98fe76deee,PAYMENT,20-30,2018,9,7,6,0,Friday,14 days,70076.089
ACC-3941181087,25,46.0,7923.88,,CUS-3989008654,2018-09-11,Paul,M,-31.94,115.79,,,,,,,debit,posted,48eaa2de66a44a54b5892ba8267c27ec,PAYMENT,20-30,2018,9,11,16,0,Tuesday,14 days,70076.089
ACC-3941181087,25,28.0,7895.88,,CUS-3989008654,2018-09-14,Paul,M,-31.94,115.79,,,,,,,debit,posted,1166d34bf7ad4437a6b86b8d6b9a0e27,PAYMENT,20-30,2018,9,14,6,0,Friday,14 days,70076.089
ACC-3941181087,25,172.0,7723.88,,CUS-3989008654,2018-09-15,Paul,M,-31.94,115.79,,,,,,,debit,posted,dcd7a0ff5f554bffbca34a5b7b9e5692,PAYMENT,20-30,2018,9,15,6,0,Saturday,14 days,70076.089
ACC-3941181087,25,46.0,7677.88,,CUS-3989008654,2018-09-18,Paul,M,-31.94,115.79,,,,,,,debit,posted,28443b60f38643c4a1ff2deedcd6c3a2,PAYMENT,20-30,2018,9,18,16,0,Tuesday,14 days,70076.089
ACC-3941181087,25,192.0,7485.88,,CUS-3989008654,2018-09-19,Paul,M,-31.94,115.79,,,,,,,debit,posted,037a033b16fe4b7295f0573c0c0f7cb6,INTER BANK,20-30,2018,9,19,7,0,Wednesday,14 days,70076.089
ACC-3941181087,25,28.0,10145.73,,CUS-3989008654,2018-09-21,Paul,M,-31.94,115.79,,,,,,,debit,posted,ed820bd701254ef794ebdf11004f540f,PAYMENT,20-30,2018,9,21,6,0,Friday,14 days,70076.089
ACC-3941181087,25,89.0,10056.73,,CUS-3989008654,2018-09-21,Paul,M,-31.94,115.79,,,,,,,debit,posted,618892fd930547aea5b444f9e1288a1f,PAYMENT,20-30,2018,9,21,10,0,Friday,14 days,70076.089
ACC-3941181087,25,46.0,10010.73,,CUS-3989008654,2018-09-25,Paul,M,-31.94,115.79,,,,,,,debit,posted,3cd57c8263854d6eb682619d5468f122,PAYMENT,20-30,2018,9,25,16,0,Tuesday,14 days,70076.089
ACC-3941181087,25,28.0,9982.73,,CUS-3989008654,2018-09-28,Paul,M,-31.94,115.79,,,,,,,debit,posted,e3322ca869dc4c58a9544bbce919364b,PAYMENT,20-30,2018,9,28,6,0,Friday,14 days,70076.089
ACC-3941181087,25,46.0,9936.73,,CUS-3989008654,2018-10-02,Paul,M,-31.94,115.79,,,,,,,debit,posted,3e55ef30c1ae40a99fa5efc98006be5a,PAYMENT,20-30,2018,10,2,16,0,Tuesday,14 days,70076.089
ACC-3941181087,25,85.0,9851.73,,CUS-3989008654,2018-10-04,Paul,M,-31.94,115.79,,,,,,,debit,posted,2507c902038d46dda188c6c2d56cb41b,PAYMENT,20-30,2018,10,4,5,0,Thursday,14 days,70076.089
ACC-3941181087,25,28.0,12511.58,,CUS-3989008654,2018-10-05,Paul,M,-31.94,115.79,,,,,,,debit,posted,5ec6ee6777c94e8396115d6fd07997c6,PAYMENT,20-30,2018,10,5,6,0,Friday,14 days,70076.089
ACC-3941181087,25,46.0,12465.58,,CUS-3989008654,2018-10-09,Paul,M,-31.94,115.79,,,,,,,debit,posted,6b59945f8bfd4a0f9045287a41856a57,PAYMENT,20-30,2018,10,9,16,0,Tuesday,14 days,70076.089
ACC-3941181087,25,28.0,12437.58,,CUS-3989008654,2018-10-12,Paul,M,-31.94,115.79,,,,,,,debit,posted,081cee8d2304451e8ec4f06c1a65ccb1,PAYMENT,20-30,2018,10,12,6,0,Friday,14 days,70076.089
ACC-3941181087,25,172.0,12265.58,,CUS-3989008654,2018-10-15,Paul,M,-31.94,115.79,,,,,,,debit,posted,8d858ac160f14b93a489b819396367ef,PAYMENT,20-30,2018,10,15,6,0,Monday,14 days,70076.089
ACC-3941181087,25,46.0,12219.58,,CUS-3989008654,2018-10-16,Paul,M,-31.94,115.79,,,,,,,debit,posted,588eadbbc71c42d6bb578065e01539fa,PAYMENT,20-30,2018,10,16,16,0,Tuesday,14 days,70076.089
ACC-3941181087,25,28.0,14879.43,,CUS-3989008654,2018-10-19,Paul,M,-31.94,115.79,,,,,,,debit,posted,b0f501ffb60e4a1099304ba16c43d42d,PAYMENT,20-30,2018,10,19,6,0,Friday,14 days,70076.089
ACC-3941181087,25,192.0,14687.43,,CUS-3989008654,2018-10-19,Paul,M,-31.94,115.79,,,,,,,debit,posted,e128e42d71aa49708efbc4539ec875ef,INTER BANK,20-30,2018,10,19,7,0,Friday,14 days,70076.089
ACC-3941181087,25,89.0,14598.43,,CUS-3989008654,2018-10-21,Paul,M,-31.94,115.79,,,,,,,debit,posted,7c0dec77be64434da2a7d0c449148b78,PAYMENT,20-30,2018,10,21,10,0,Sunday,14 days,70076.089
ACC-3941181087,25,19.02,14579.41,1.0,CUS-3989008654,2018-10-21,Paul,M,-31.94,115.79,,1b585c58-bada-4784-8bb2-5ca0ee2543c1,-32.47,115.76,WA,Lakelands,debit,authorized,3fcc7f085361475dbbd14e857280d219,POS,20-30,2018,10,21,19,41,Sunday,14 days,70076.089
ACC-3941181087,25,53.33,14526.08,1.0,CUS-3989008654,2018-10-21,Paul,M,-31.94,115.79,,c6f1642d-7309-4970-a380-da4656c569ed,-31.77,115.78,WA,Edgewater,debit,authorized,78edab8aef774e37b2bae31b64c160b5,SALES-POS,20-30,2018,10,21,20,14,Sunday,14 days,70076.089
ACC-3941181087,25,18.0,14508.08,1.0,CUS-3989008654,2018-10-21,Paul,M,-31.94,115.79,,5f7e261c-4366-49a3-baf6-0257e0017c8a,-31.83,116.02,WA,Herne Hill,debit,authorized,a483839daaa14f2eaa17fda059b9058f,POS,20-30,2018,10,21,20,27,Sunday,14 days,70076.089
ACC-3941181087,25,46.0,14462.08,,CUS-3989008654,2018-10-23,Paul,M,-31.94,115.79,,,,,,,debit,posted,f27426a9fa0542b7b478a6c9528a8e99,PAYMENT,20-30,2018,10,23,16,0,Tuesday,14 days,70076.089
ACC-3941181087,25,35.77,14426.31,1.0,CUS-3989008654,2018-10-24,Paul,M,-31.94,115.79,,ebfc6c9f-9558-4df8-9184-7ee02271ee8d,-31.95,115.86,WA,Perth,debit,authorized,955ec0f29a96483ea262d8632499b8b7,SALES-POS,20-30,2018,10,24,11,51,Wednesday,14 days,70076.089
ACC-3941181087,25,16.22,14410.09,0.0,CUS-3989008654,2018-10-24,Paul,M,-31.94,115.79,,294193ff-d76e-445f-b240-dea59df2caf8,-31.94,141.47,NSW,Broken Hill,debit,authorized,140cfa4e960442a6b8712168805bdd4a,SALES-POS,20-30,2018,10,24,15,25,Wednesday,14 days,70076.089
ACC-3941181087,25,38.18,14371.91,1.0,CUS-3989008654,2018-10-25,Paul,M,-31.94,115.79,,1dc3155c-3786-4bb5-9109-2a21867accc8,-32.41,115.76,WA,Secret Harbour,debit,authorized,ef700d0ba66d43ab908fd0619c7e1dc7,SALES-POS,20-30,2018,10,25,17,56,Thursday,14 days,70076.089
ACC-3941181087,25,24.01,14347.9,0.0,CUS-3989008654,2018-10-25,Paul,M,-31.94,115.79,,629a092b-8b4a-4182-bace-d7c632aa921a,-32.41,115.76,WA,Secret Harbour,debit,authorized,85a3b876d0504cdf937aab525ada2530,SALES-POS,20-30,2018,10,25,20,48,Thursday,14 days,70076.089
ACC-3941181087,25,28.0,14319.9,,CUS-3989008654,2018-10-26,Paul,M,-31.94,115.79,,,,,,,debit,posted,dbc06b576ba44311966dfd68d4550247,PAYMENT,20-30,2018,10,26,6,0,Friday,14 days,70076.089
ACC-3941181087,25,30.82,14289.08,1.0,CUS-3989008654,2018-10-26,Paul,M,-31.94,115.79,,5bd7c95d-4d40-4945-96f4-97437dd6f2ab,-31.88,115.78,WA,Karrinyup,debit,authorized,6e5ff9f0602443fa9f2ada9885e3b859,POS,20-30,2018,10,26,17,5,Friday,14 days,70076.089
ACC-3941181087,25,25.55,14263.53,1.0,CUS-3989008654,2018-10-28,Paul,M,-31.94,115.79,,5a6d6308-dd3e-4e8a-972d-720a18cb746d,-31.65,117.24,WA,Cunderdin,debit,authorized,ed7e775abd544fa28fcb427b04eb782a,SALES-POS,20-30,2018,10,28,10,15,Sunday,14 days,70076.089
ACC-3941181087,25,20.84,14242.69,1.0,CUS-3989008654,2018-10-28,Paul,M,-31.94,115.79,,bedfaec0-2483-449c-9d0f-b8492469a4a2,-31.91,152.46,NSW,Taree,debit,authorized,f3557aeea1f24ae2ba93a1d06f5d96b6,SALES-POS,20-30,2018,10,28,14,7,Sunday,14 days,70076.089
ACC-3941181087,25,16.74,14225.95,0.0,CUS-3989008654,2018-10-28,Paul,M,-31.94,115.79,,d2e6a683-926b-4f86-ab6e-2729e59fb86d,-31.9,115.8,WA,Innaloo,debit,authorized,e8cd3e4de62b44778710cd25539d3ae7,SALES-POS,20-30,2018,10,28,14,26,Sunday,14 days,70076.089
ACC-3941181087,25,14.81,14211.14,0.0,CUS-3989008654,2018-10-28,Paul,M,-31.94,115.79,,1e3d98fc-9edc-4224-83ab-37d8faef9154,-31.84,115.78,WA,Perth,debit,authorized,15104f24ccf44fbf8d8b0a18acba1c4d,POS,20-30,2018,10,28,15,24,Sunday,14 days,70076.089
ACC-3941181087,25,15.53,14195.61,1.0,CUS-3989008654,2018-10-28,Paul,M,-31.94,115.79,,1ef8ab2a-497a-4f88-8bc0-7b4f0908f791,-31.96,115.92,WA,Rivervale,debit,authorized,caf861bf11f04b6683ec211d35c85e47,POS,20-30,2018,10,28,17,9,Sunday,14 days,70076.089
ACC-3941181087,25,46.0,14149.61,,CUS-3989008654,2018-10-30,Paul,M,-31.94,115.79,,,,,,,debit,posted,8d03895293ee41aeb08a3b3d88725226,PAYMENT,20-30,2018,10,30,16,0,Tuesday,14 days,70076.089
ACC-1344825761,46,97.95,13583.79,1.0,CUS-1499065773,2018-08-02,Sarah,F,-33.91,151.09,,4d0051b3-91be-4db7-b397-ac82ea844118,-33.84,151.21,NSW,North Sydney,debit,authorized,4bb9e807b2aa41ca92221a1c8646a6c9,SALES-POS,40-50,2018,8,2,18,11,Thursday,14 days,64408.161
ACC-1344825761,46,22.0,13561.79,,CUS-1499065773,2018-08-03,Sarah,F,-33.91,151.09,,,,,,,debit,posted,e6ced3e8195b441d87992f3f764d4502,PAYMENT,40-50,2018,8,3,14,0,Friday,14 days,64408.161
ACC-1344825761,46,5.62,13556.17,0.0,CUS-1499065773,2018-08-04,Sarah,F,-33.91,151.09,,7a6204b2-c42b-42a2-a432-2110027fb828,-33.83,138.61,SA,Clare,debit,authorized,845b55224c5a4c6483923500ad8c308d,POS,40-50,2018,8,4,2,52,Saturday,14 days,64408.161
ACC-1344825761,46,32.21,13523.96,1.0,CUS-1499065773,2018-08-04,Sarah,F,-33.91,151.09,,0fadddf3-a178-4d76-8d7a-f4352b2434a2,-33.91,151.26,NSW,Clovelly,debit,authorized,0a8d7e79cfe14650989ea21009d0c51b,SALES-POS,40-50,2018,8,4,9,57,Saturday,14 days,64408.161
ACC-1344825761,46,38.77,13485.19,1.0,CUS-1499065773,2018-08-04,Sarah,F,-33.91,151.09,,d6326066-ca2b-4669-bd55-d38a8e42a52b,-33.91,151.21,NSW,Zetland,debit,authorized,182504341e27447b89770d03312a71e1,SALES-POS,40-50,2018,8,4,14,49,Saturday,14 days,64408.161
ACC-1344825761,46,28.0,13457.19,,CUS-1499065773,2018-08-04,Sarah,F,-33.91,151.09,,,,,,,debit,posted,3306adf084544e1e8f2b5549ad55a765,PAYMENT,40-50,2018,8,4,21,0,Saturday,14 days,64408.161
ACC-1344825761,46,45.0,13412.19,,CUS-1499065773,2018-08-07,Sarah,F,-33.91,151.09,,,,,,,debit,posted,c7c80c20e6b84129805513bac7288ebd,PAYMENT,40-50,2018,8,7,18,0,Tuesday,14 days,64408.161
ACC-1344825761,46,35.91,13376.28,1.0,CUS-1499065773,2018-08-09,Sarah,F,-33.91,151.09,,49b7bafa-407e-4ea1-a896-000929736eb8,-33.79,151.14,NSW,North Ryde,debit,authorized,d504021d7e3f4327af429a63b602882b,POS,40-50,2018,8,9,4,1,Thursday,14 days,64408.161
ACC-1344825761,46,22.0,13354.28,,CUS-1499065773,2018-08-10,Sarah,F,-33.91,151.09,,,,,,,debit,posted,4a56ff61e417423aa12c175b3554c4c0,PAYMENT,40-50,2018,8,10,14,0,Friday,14 days,64408.161
ACC-1344825761,46,28.0,15796.73,,CUS-1499065773,2018-08-11,Sarah,F,-33.91,151.09,,,,,,,debit,posted,836b908bdb8c4296b601ab117c343861,PAYMENT,40-50,2018,8,11,21,0,Saturday,14 days,64408.161
ACC-1344825761,46,45.0,15751.73,,CUS-1499065773,2018-08-14,Sarah,F,-33.91,151.09,,,,,,,debit,posted,f2cb762a3c1a42a09e711c602639732e,PAYMENT,40-50,2018,8,14,18,0,Tuesday,14 days,64408.161
ACC-1344825761,46,22.0,15729.73,,CUS-1499065773,2018-08-17,Sarah,F,-33.91,151.09,,,,,,,debit,posted,4d250222351c4fdb90f7a3085f881276,PAYMENT,40-50,2018,8,17,14,0,Friday,14 days,64408.161
ACC-1344825761,46,28.0,15701.73,,CUS-1499065773,2018-08-18,Sarah,F,-33.91,151.09,,,,,,,debit,posted,b66d6671ed6b4a27823c897f88c1b840,PAYMENT,40-50,2018,8,18,21,0,Saturday,14 days,64408.161
ACC-1344825761,46,155.0,15546.73,,CUS-1499065773,2018-08-19,Sarah,F,-33.91,151.09,,,,,,,debit,posted,b1d13744c5f14729a57a766b6ae46ff1,PAYMENT,40-50,2018,8,19,5,0,Sunday,14 days,64408.161
ACC-1344825761,46,45.0,15501.73,,CUS-1499065773,2018-08-21,Sarah,F,-33.91,151.09,,,,,,,debit,posted,d3cd5e898ab2406dbb716f196ae1c556,PAYMENT,40-50,2018,8,21,18,0,Tuesday,14 days,64408.161
ACC-1344825761,46,22.0,15479.73,,CUS-1499065773,2018-08-24,Sarah,F,-33.91,151.09,,,,,,,debit,posted,c9f961653e1a485992ce1fa53c392d66,PAYMENT,40-50,2018,8,24,14,0,Friday,14 days,64408.161
ACC-1344825761,46,28.0,17922.18,,CUS-1499065773,2018-08-25,Sarah,F,-33.91,151.09,,,,,,,debit,posted,0af818c1dc6b40a58916733f83409e61,PAYMENT,40-50,2018,8,25,21,0,Saturday,14 days,64408.161
ACC-1344825761,46,182.0,17740.18,,CUS-1499065773,2018-08-26,Sarah,F,-33.91,151.09,,,,,,,debit,posted,74a5ae74e7544ea98244578ca9a674a7,INTER BANK,40-50,2018,8,26,6,0,Sunday,14 days,64408.161
ACC-1344825761,46,45.0,17695.18,,CUS-1499065773,2018-08-28,Sarah,F,-33.91,151.09,,,,,,,debit,posted,f0fcc229f21f4309a87fc9361f7bd08f,PAYMENT,40-50,2018,8,28,18,0,Tuesday,14 days,64408.161
ACC-1344825761,46,22.0,17673.18,,CUS-1499065773,2018-08-31,Sarah,F,-33.91,151.09,,,,,,,debit,posted,32d806e17752466eb1e82a3d3ae3d952,PAYMENT,40-50,2018,8,31,14,0,Friday,14 days,64408.161
ACC-1344825761,46,28.0,17645.18,,CUS-1499065773,2018-09-01,Sarah,F,-33.91,151.09,,,,,,,debit,posted,01b220ed27a64416b208f3f5e8667b4f,PAYMENT,40-50,2018,9,1,21,0,Saturday,14 days,64408.161
ACC-1344825761,46,45.0,17600.18,,CUS-1499065773,2018-09-04,Sarah,F,-33.91,151.09,,,,,,,debit,posted,7fc89d493de24946a021ffc3875c08d4,PAYMENT,40-50,2018,9,4,18,0,Tuesday,14 days,64408.161
ACC-1344825761,46,40.38,17559.8,1.0,CUS-1499065773,2018-09-06,Sarah,F,-33.91,151.09,,f4a02aa3-90f6-4b95-97b6-63b76fcd3a00,-33.91,151.25,NSW,Randwick,debit,authorized,0c96f1d0126645c0939da536a4219f47,POS,40-50,2018,9,6,19,55,Thursday,14 days,64408.161
ACC-1344825761,46,22.0,17537.8,,CUS-1499065773,2018-09-07,Sarah,F,-33.91,151.09,,,,,,,debit,posted,267cdf020b614dfa8e6415007b840e62,PAYMENT,40-50,2018,9,7,14,0,Friday,14 days,64408.161
ACC-1344825761,46,26.45,19981.8,0.0,CUS-1499065773,2018-09-07,Sarah,F,-33.91,151.09,,1b4d71f3-884e-4a30-9c9a-8d1ad0d80e44,-33.9,151.2,NSW,Waterloo,debit,authorized,1dafbe3ba6b54595ae3be0831a5e9ab2,POS,40-50,2018,9,7,21,20,Friday,14 days,64408.161
ACC-1344825761,46,214.51,19767.29,1.0,CUS-1499065773,2018-09-08,Sarah,F,-33.91,151.09,,55ff1fc2-4da0-42ae-ae7d-193ac4cf8db2,-33.9,151.2,NSW,Waterloo,debit,authorized,8ff887f39f434b1d883a71589ffc9b07,SALES-POS,40-50,2018,9,8,20,27,Saturday,14 days,64408.161
ACC-1344825761,46,28.0,19739.29,,CUS-1499065773,2018-09-08,Sarah,F,-33.91,151.09,,,,,,,debit,posted,5c368bda8e574513b55d07f372f501c2,PAYMENT,40-50,2018,9,8,21,0,Saturday,14 days,64408.161
ACC-1344825761,46,20.19,19719.1,1.0,CUS-1499065773,2018-09-09,Sarah,F,-33.91,151.09,,1b21ead5-0f2a-4c83-8e2e-90341646872c,-33.89,151.2,NSW,Eveleigh,debit,authorized,0e6758050c384255894a6764bb4b003b,POS,40-50,2018,9,9,11,57,Sunday,14 days,64408.161
ACC-1344825761,46,54.32,19664.78,1.0,CUS-1499065773,2018-09-09,Sarah,F,-33.91,151.09,,af2ba482-b082-4e6c-83de-487978aa8b0a,-33.74,150.92,NSW,Kings Langley,debit,authorized,a994506e2f10419899fd4ae260186c5e,POS,40-50,2018,9,9,21,23,Sunday,14 days,64408.161
ACC-1344825761,46,62.13,19602.65,0.0,CUS-1499065773,2018-09-09,Sarah,F,-33.91,151.09,,9a73b52e-41bf-4fa4-80a8-89c19c55ea87,-33.95,151.25,NSW,Maroubra,debit,authorized,4b327b8df2194e23ae87ca88be3d98b3,POS,40-50,2018,9,9,23,41,Sunday,14 days,64408.161
ACC-1344825761,46,45.0,19557.65,,CUS-1499065773,2018-09-11,Sarah,F,-33.91,151.09,,,,,,,debit,posted,231e8d17556449b48a11391209b00a71,PAYMENT,40-50,2018,9,11,18,0,Tuesday,14 days,64408.161
ACC-1344825761,46,22.0,19535.65,,CUS-1499065773,2018-09-14,Sarah,F,-33.91,151.09,,,,,,,debit,posted,ed550cde5685491289bc99062277cebc,PAYMENT,40-50,2018,9,14,14,0,Friday,14 days,64408.161
ACC-1344825761,46,27.56,19508.09,1.0,CUS-1499065773,2018-09-15,Sarah,F,-33.91,151.09,,963f436b-358e-4976-8871-7c48bbf0b435,-34.01,151.1,NSW,Sylvania,debit,authorized,bff83edbd2314fc6a4c19bf74a86e0a1,SALES-POS,40-50,2018,9,15,14,15,Saturday,14 days,64408.161
ACC-1344825761,46,59.45,19448.64,1.0,CUS-1499065773,2018-09-15,Sarah,F,-33.91,151.09,,1df732ad-2900-40d7-99fe-edb926815acb,-33.9,151.2,NSW,Waterloo,debit,authorized,83a0d574714c44c58c17cd9621ace64e,SALES-POS,40-50,2018,9,15,14,31,Saturday,14 days,64408.161
ACC-1344825761,46,54.74,19393.9,1.0,CUS-1499065773,2018-09-15,Sarah,F,-33.91,151.09,,5a3c3a04-69ec-4c07-beb1-64e96cd3bceb,-33.66,115.36,WA,Busselton,debit,authorized,a10323eb0c3f4a529ff3e523c91c6d75,POS,40-50,2018,9,15,17,15,Saturday,14 days,64408.161
ACC-1344825761,46,28.0,19365.9,,CUS-1499065773,2018-09-15,Sarah,F,-33.91,151.09,,,,,,,debit,posted,0a7113bc1bd548a5b59d651a7ef2ef1f,PAYMENT,40-50,2018,9,15,21,0,Saturday,14 days,64408.161
ACC-1344825761,46,150.82,19215.08,1.0,CUS-1499065773,2018-09-17,Sarah,F,-33.91,151.09,,b35c0649-12ba-428b-a82d-09ad6bb11bdb,-31.78,115.97,WA,Ellenbrook,debit,authorized,af98c0bb00634906bec8410d3c86c2b6,SALES-POS,40-50,2018,9,17,15,1,Monday,14 days,64408.161
ACC-1344825761,46,45.0,19170.08,,CUS-1499065773,2018-09-18,Sarah,F,-33.91,151.09,,,,,,,debit,posted,b7ed917a184e48958245615a792d8f3d,PAYMENT,40-50,2018,9,18,18,0,Tuesday,14 days,64408.161
ACC-1344825761,46,155.0,19015.08,,CUS-1499065773,2018-09-19,Sarah,F,-33.91,151.09,,,,,,,debit,posted,d151a61b44a4421bbb005c00d3bad0f7,PAYMENT,40-50,2018,9,19,5,0,Wednesday,14 days,64408.161
ACC-1344825761,46,22.0,18993.08,,CUS-1499065773,2018-09-21,Sarah,F,-33.91,151.09,,,,,,,debit,posted,d2a6e5038afa4874a3e262a219763f64,PAYMENT,40-50,2018,9,21,14,0,Friday,14 days,64408.161
ACC-1344825761,46,99.69,21363.84,1.0,CUS-1499065773,2018-09-21,Sarah,F,-33.91,151.09,,4d0051b3-91be-4db7-b397-ac82ea844118,-33.84,151.21,NSW,North Sydney,debit,authorized,6406440d2c394280a5375188b6de4066,SALES-POS,40-50,2018,9,21,22,57,Friday,14 days,64408.161
ACC-1344825761,46,28.0,21335.84,,CUS-1499065773,2018-09-22,Sarah,F,-33.91,151.09,,,,,,,debit,posted,19b1ad764c434f95a59cedc354a09482,PAYMENT,40-50,2018,9,22,21,0,Saturday,14 days,64408.161
ACC-1344825761,46,56.07,21279.77,1.0,CUS-1499065773,2018-09-23,Sarah,F,-33.91,151.09,,49ecb44f-3833-4b9e-9ad5-5c4f7cc8f4d6,-33.76,151.22,NSW,Sydney,debit,authorized,283907f0562a45dca6ab9434abce92ee,POS,40-50,2018,9,23,9,46,Sunday,14 days,64408.161
ACC-1344825761,46,13.08,21266.69,0.0,CUS-1499065773,2018-09-23,Sarah,F,-33.91,151.09,,559bce8b-2c87-47c4-8a8e-b0cb3c5af835,-33.96,151.13,NSW,Kogarah,debit,authorized,25f5a7c322a24883b664ebd9cd1dc42d,SALES-POS,40-50,2018,9,23,21,59,Sunday,14 days,64408.161
ACC-1344825761,46,54.4,21212.29,0.0,CUS-1499065773,2018-09-25,Sarah,F,-33.91,151.09,,2e668114-59de-47f9-89c5-fdf26c695c43,-33.92,151.25,NSW,Coogee,debit,authorized,75369fcce42944039330668c05e5215c,POS,40-50,2018,9,25,11,33,Tuesday,14 days,64408.161
ACC-1344825761,46,51.54,21160.75,1.0,CUS-1499065773,2018-09-25,Sarah,F,-33.91,151.09,,c0d04007-b8c4-4727-a367-88fcdf8ca7d1,-33.75,151.14,NSW,Pymble,debit,authorized,0c3d9b71ee2b4f898303314f33616cfb,SALES-POS,40-50,2018,9,25,17,42,Tuesday,14 days,64408.161
ACC-1344825761,46,45.0,21115.75,,CUS-1499065773,2018-09-25,Sarah,F,-33.91,151.09,,,,,,,debit,posted,784d0ca94c0b4b0b8c70807f56467d10,PAYMENT,40-50,2018,9,25,18,0,Tuesday,14 days,64408.161
ACC-1344825761,46,182.0,20933.75,,CUS-1499065773,2018-09-26,Sarah,F,-33.91,151.09,,,,,,,debit,posted,876efc477eb04168ade1e7fc22e9cc0a,INTER BANK,40-50,2018,9,26,6,0,Wednesday,14 days,64408.161
ACC-1344825761,46,22.0,20911.75,,CUS-1499065773,2018-09-28,Sarah,F,-33.91,151.09,,,,,,,debit,posted,1ea1c386a76e43e3afd36643738e98b5,PAYMENT,40-50,2018,9,28,14,0,Friday,14 days,64408.161
ACC-1344825761,46,34.65,20877.1,0.0,CUS-1499065773,2018-09-29,Sarah,F,-33.91,151.09,,f9519f2a-0562-475f-8cbe-5a5064835d8e,-33.9,151.18,NSW,Erskineville,debit,authorized,1835584d9fb64ffca4e0989439cbe180,POS,40-50,2018,9,29,6,57,Saturday,14 days,64408.161
ACC-1344825761,46,491.14,20385.96,1.0,CUS-1499065773,2018-09-29,Sarah,F,-33.91,151.09,,a82a474e-3e2e-4dd3-87fd-9b24da692e0e,-33.89,151.1,NSW,Enfield,debit,authorized,5b7d7717caf04645af49671adb880d3c,POS,40-50,2018,9,29,16,56,Saturday,14 days,64408.161
ACC-1344825761,46,28.0,20357.96,,CUS-1499065773,2018-09-29,Sarah,F,-33.91,151.09,,,,,,,debit,posted,de73636a9d7e4c6285e288b971eb6bec,PAYMENT,40-50,2018,9,29,21,0,Saturday,14 days,64408.161
ACC-1344825761,46,45.0,20312.96,,CUS-1499065773,2018-10-02,Sarah,F,-33.91,151.09,,,,,,,debit,posted,045cefa65b8b4467be8efb20c6706606,PAYMENT,40-50,2018,10,2,18,0,Tuesday,14 days,64408.161
ACC-1344825761,46,22.0,20290.96,,CUS-1499065773,2018-10-05,Sarah,F,-33.91,151.09,,,,,,,debit,posted,6ad86e6104794ca2978dd061a35dfd10,PAYMENT,40-50,2018,10,5,14,0,Friday,14 days,64408.161
ACC-1344825761,46,28.0,22733.41,,CUS-1499065773,2018-10-06,Sarah,F,-33.91,151.09,,,,,,,debit,posted,428530d59d8b4b86aed0855d2e8dff09,PAYMENT,40-50,2018,10,6,21,0,Saturday,14 days,64408.161
ACC-1344825761,46,45.0,22688.41,,CUS-1499065773,2018-10-09,Sarah,F,-33.91,151.09,,,,,,,debit,posted,231477c92f7e4d0a98ca1cc24ce43ae1,PAYMENT,40-50,2018,10,9,18,0,Tuesday,14 days,64408.161
ACC-1344825761,46,22.0,22666.41,,CUS-1499065773,2018-10-12,Sarah,F,-33.91,151.09,,,,,,,debit,posted,ba5455dee5b74aef8f41944d6eace1aa,PAYMENT,40-50,2018,10,12,14,0,Friday,14 days,64408.161
ACC-1344825761,46,28.0,22638.41,,CUS-1499065773,2018-10-13,Sarah,F,-33.91,151.09,,,,,,,debit,posted,e9f8d2970ad544f798607fa174662623,PAYMENT,40-50,2018,10,13,21,0,Saturday,14 days,64408.161
ACC-1344825761,46,45.0,22593.41,,CUS-1499065773,2018-10-16,Sarah,F,-33.91,151.09,,,,,,,debit,posted,87ee96c5c8d54f90801fb2dfe3104d84,PAYMENT,40-50,2018,10,16,18,0,Tuesday,14 days,64408.161
ACC-1344825761,46,155.0,22438.41,,CUS-1499065773,2018-10-19,Sarah,F,-33.91,151.09,,,,,,,debit,posted,fbdf3381305844c484a9594a669594a9,PAYMENT,40-50,2018,10,19,5,0,Friday,14 days,64408.161
ACC-1344825761,46,28.89,22409.52,1.0,CUS-1499065773,2018-10-19,Sarah,F,-33.91,151.09,,0d338c2f-cf2d-4f14-ae19-e9f79c5f90aa,-33.8,151.28,NSW,Manly,debit,authorized,f91b5b9d2f134e479d187391f0c76b0e,SALES-POS,40-50,2018,10,19,13,48,Friday,14 days,64408.161
ACC-1344825761,46,22.0,22387.52,,CUS-1499065773,2018-10-19,Sarah,F,-33.91,151.09,,,,,,,debit,posted,1ee3f61cbfd74ceebe182cabcd3c52a4,PAYMENT,40-50,2018,10,19,14,0,Friday,14 days,64408.161
ACC-1344825761,46,39.32,24818.65,1.0,CUS-1499065773,2018-10-19,Sarah,F,-33.91,151.09,,d63d1e1a-8e49-4db3-ad8b-470a86e13f23,-33.81,151,NSW,Parramatta,debit,authorized,0401970285e64ceca576ccc468d52790,POS,40-50,2018,10,19,19,29,Friday,14 days,64408.161
ACC-1344825761,46,43.96,24774.69,1.0,CUS-1499065773,2018-10-19,Sarah,F,-33.91,151.09,,e7bf1c3f-19c1-4bf8-87c3-53e4bb09742d,-33.73,151.29,NSW,Collaroy Plateau,debit,authorized,a7a575743ba54e588e64abb3f31e2712,POS,40-50,2018,10,19,23,18,Friday,14 days,64408.161
ACC-1344825761,46,74.36,24700.33,1.0,CUS-1499065773,2018-10-20,Sarah,F,-33.91,151.09,,4ab1cd65-2ec6-4fc6-a4dd-f1db091a06fe,-33.99,150.89,NSW,Macquarie Fields,debit,authorized,b767f633e153416ca1e12e2449c584ae,SALES-POS,40-50,2018,10,20,17,39,Saturday,14 days,64408.161
ACC-1344825761,46,28.0,24672.33,,CUS-1499065773,2018-10-20,Sarah,F,-33.91,151.09,,,,,,,debit,posted,0c5a330ea7934c06b799bf453e72ac9b,PAYMENT,40-50,2018,10,20,21,0,Saturday,14 days,64408.161
ACC-1344825761,46,76.03,24596.3,1.0,CUS-1499065773,2018-10-21,Sarah,F,-33.91,151.09,,d2372bc1-5983-4d93-8759-489362ab5377,-33.96,137.72,SA,Kadina,debit,authorized,3024e10212e348d3bfa7b7487e151b2f,SALES-POS,40-50,2018,10,21,18,35,Sunday,14 days,64408.161
ACC-1344825761,46,45.0,24551.3,,CUS-1499065773,2018-10-23,Sarah,F,-33.91,151.09,,,,,,,debit,posted,764584ef2cda4d34a1a7d09717915b4b,PAYMENT,40-50,2018,10,23,18,0,Tuesday,14 days,64408.161
ACC-1344825761,46,39.89,24511.41,1.0,CUS-1499065773,2018-10-25,Sarah,F,-33.91,151.09,,cc697036-cf95-4d7e-857c-48031c0d5f86,-33.88,151.2,NSW,Chippendale,debit,authorized,108d2ed489f548bfbc5e8e2e49d74521,POS,40-50,2018,10,25,19,36,Thursday,14 days,64408.161
ACC-1344825761,46,182.0,24329.41,,CUS-1499065773,2018-10-26,Sarah,F,-33.91,151.09,,,,,,,debit,posted,ca9eb86ba4ab4d7eaa90ecf4732dba67,INTER BANK,40-50,2018,10,26,6,0,Friday,14 days,64408.161
ACC-1344825761,46,22.0,24307.41,,CUS-1499065773,2018-10-26,Sarah,F,-33.91,151.09,,,,,,,debit,posted,e0291be4177445eaab414752d4a5e0d7,PAYMENT,40-50,2018,10,26,14,0,Friday,14 days,64408.161
ACC-1344825761,46,24.62,24282.79,1.0,CUS-1499065773,2018-10-26,Sarah,F,-33.91,151.09,,7b5f2dab-bded-4190-8f86-e1ec8408e8a9,-33.87,151.21,NSW,Sydney,debit,authorized,56e9807e2c034fefb242364ec8361281,POS,40-50,2018,10,26,15,50,Friday,14 days,64408.161
ACC-1344825761,46,46.56,24236.23,1.0,CUS-1499065773,2018-10-26,Sarah,F,-33.91,151.09,,e0f6a222-0585-4b68-80e6-300a88ff8ad5,-33.93,151.09,NSW,Roselands,debit,authorized,c421fa30dbb04dc294dad8d82a6c448c,POS,40-50,2018,10,26,21,44,Friday,14 days,64408.161
ACC-1344825761,46,57.1,24179.13,1.0,CUS-1499065773,2018-10-27,Sarah,F,-33.91,151.09,,dda21f62-8924-49ad-a804-2e3390414d15,-37.84,144.97,VIC,Melbourne,debit,authorized,18d950150c864007979c43a03014a80a,POS,40-50,2018,10,27,17,16,Saturday,14 days,64408.161
ACC-1344825761,46,28.0,24151.13,,CUS-1499065773,2018-10-27,Sarah,F,-33.91,151.09,,,,,,,debit,posted,7585f03e15294877bc0a80ed60dbe47e,PAYMENT,40-50,2018,10,27,21,0,Saturday,14 days,64408.161
ACC-1344825761,46,81.24,24069.89,1.0,CUS-1499065773,2018-10-28,Sarah,F,-33.91,151.09,,636bca35-1b64-4459-b4e8-9fc51992ac1a,-33.94,151.24,NSW,Maroubra,debit,authorized,58896fe4ec624ddeb356f4b36dcd62af,SALES-POS,40-50,2018,10,28,8,34,Sunday,14 days,64408.161
ACC-1344825761,46,25.13,24044.76,1.0,CUS-1499065773,2018-10-28,Sarah,F,-33.91,151.09,,b9b7ce17-4ead-4530-92d2-f886ecdeaf1b,-33.78,151.05,NSW,Carlingford,debit,authorized,26d5f18bcbb044ae947da4ee55ce6edc,SALES-POS,40-50,2018,10,28,11,47,Sunday,14 days,64408.161
ACC-1344825761,46,18.8,24025.96,0.0,CUS-1499065773,2018-10-29,Sarah,F,-33.91,151.09,,81ddb518-e969-41fa-84bb-4637c7090440,-33.74,151.28,NSW,Cromer,debit,authorized,d49761e433a04e2f99a219d3e5fb1475,POS,40-50,2018,10,29,9,14,Monday,14 days,64408.161
ACC-1344825761,46,45.0,23980.96,,CUS-1499065773,2018-10-30,Sarah,F,-33.91,151.09,,,,,,,debit,posted,53eba7f7a5c648c899d6b80ac37e1432,PAYMENT,40-50,2018,10,30,18,0,Tuesday,14 days,64408.161
ACC-1344825761,46,263.64,23717.32,1.0,CUS-1499065773,2018-10-31,Sarah,F,-33.91,151.09,,ddce202f-e1d4-4008-b949-c0bbd793eb2f,-33.88,151.21,NSW,Surry Hills,debit,authorized,dc000af1a59b4892b23478446e9435e0,POS,40-50,2018,10,31,13,34,Wednesday,14 days,64408.161
ACC-4059612845,38,190.5,50192.66,1.0,CUS-495599312,2018-08-02,Jonathan,M,-12.49,130.98,,441fb5fc-693f-4898-a0e9-ac8ea1bbfbd4,-12.39,130.78,NT,Darwin City,debit,authorized,732cbb6dba834d31a52e44eb604d87e1,POS,30-40,2018,8,2,19,24,Thursday,14 days,69020.979
ACC-4059612845,38,77.0,50115.66,,CUS-495599312,2018-08-10,Jonathan,M,-12.49,130.98,,,,,,,debit,posted,a4465a560910402182a9e557586ad564,PAYMENT,30-40,2018,8,10,2,0,Friday,14 days,69020.979
ACC-4059612845,38,195.0,49920.66,,CUS-495599312,2018-08-15,Jonathan,M,-12.49,130.98,,,,,,,debit,posted,49dd43ec7c564bbab9187c2e6dd46136,INTER BANK,30-40,2018,8,15,6,0,Wednesday,14 days,69020.979
ACC-4059612845,38,178.0,52337.69,,CUS-495599312,2018-08-17,Jonathan,M,-12.49,130.98,,,,,,,debit,posted,d70482067b38434c849bfb25bfad4921,PAYMENT,30-40,2018,8,17,13,0,Friday,14 days,69020.979
ACC-4059612845,38,125.0,52212.69,,CUS-495599312,2018-08-26,Jonathan,M,-12.49,130.98,,,,,,,debit,posted,fd1e417d16fe4f229527cfd1fc0dc860,PAYMENT,30-40,2018,8,26,5,0,Sunday,14 days,69020.979
ACC-4059612845,38,198.0,52014.69,,CUS-495599312,2018-08-27,Jonathan,M,-12.49,130.98,,,,,,,debit,posted,abf0e03d25624f818b2bad0035ef3e77,PAYMENT,30-40,2018,8,27,13,0,Monday,14 days,69020.979
ACC-4059612845,38,77.0,54585.07,,CUS-495599312,2018-09-10,Jonathan,M,-12.49,130.98,,,,,,,debit,posted,7884e4770cd9498989b7e50b2448f391,PAYMENT,30-40,2018,9,10,2,0,Monday,14 days,69020.979
ACC-4059612845,38,195.0,57037.45,,CUS-495599312,2018-09-15,Jonathan,M,-12.49,130.98,,,,,,,debit,posted,a4c862c2f1254a029e2276ae30b1b574,INTER BANK,30-40,2018,9,15,6,0,Saturday,14 days,69020.979
ACC-4059612845,38,178.0,56859.45,,CUS-495599312,2018-09-17,Jonathan,M,-12.49,130.98,,,,,,,debit,posted,9d1130bdb0204da09266471ff8ce6c93,PAYMENT,30-40,2018,9,17,13,0,Monday,14 days,69020.979
ACC-4059612845,38,8.44,56851.01,1.0,CUS-495599312,2018-09-20,Jonathan,M,-12.49,130.98,,cc58adc3-19aa-4400-b3d1-58945c7b7a7a,-38.02,145.3,VIC,Narre Warren,debit,authorized,b2436a2b7393467492a9912076ec939f,SALES-POS,30-40,2018,9,20,4,8,Thursday,14 days,69020.979
ACC-4059612845,38,125.0,56726.01,,CUS-495599312,2018-09-26,Jonathan,M,-12.49,130.98,,,,,,,debit,posted,b86e2986e4164b53965b274f9e07a09f,PAYMENT,30-40,2018,9,26,5,0,Wednesday,14 days,69020.979
ACC-4059612845,38,198.0,59175.39,,CUS-495599312,2018-09-27,Jonathan,M,-12.49,130.98,,,,,,,debit,posted,be3b6ecbe74c463e9509d843559e82c4,PAYMENT,30-40,2018,9,27,13,0,Thursday,14 days,69020.979
ACC-4059612845,38,55.47,59119.92,1.0,CUS-495599312,2018-10-08,Jonathan,M,-12.49,130.98,,abe51cc4-14e1-4655-b0ea-8dd27efdc316,-37.8,144.99,VIC,Collingwood,debit,authorized,bf5a8753c9424163ae90d70408d90f6c,POS,30-40,2018,10,8,12,45,Monday,14 days,69020.979
ACC-4059612845,38,80.99,59038.93,0.0,CUS-495599312,2018-10-09,Jonathan,M,-12.49,130.98,,ea70ee79-20a2-4171-93eb-55a3908253d4,-28.1,153.42,QLD,Burleigh Heads,debit,authorized,1c318526d52b4d858f588e2e9c82df08,SALES-POS,30-40,2018,10,9,15,40,Tuesday,14 days,69020.979
ACC-4059612845,38,77.0,58961.93,,CUS-495599312,2018-10-10,Jonathan,M,-12.49,130.98,,,,,,,debit,posted,0e59c039ddf045188de07b534d82f880,PAYMENT,30-40,2018,10,10,2,0,Wednesday,14 days,69020.979
ACC-4059612845,38,33.84,61575.47,0.0,CUS-495599312,2018-10-10,Jonathan,M,-12.49,130.98,,c9744c93-e984-40f0-82b4-aa09b945fe50,-34.43,150.89,NSW,Wollongong,debit,authorized,f450d62de9f74788a7fb78bc8db01e60,SALES-POS,30-40,2018,10,10,21,29,Wednesday,14 days,69020.979
ACC-4059612845,38,71.42,61504.05,1.0,CUS-495599312,2018-10-13,Jonathan,M,-12.49,130.98,,a0fbbd7f-a6e2-480c-982b-d9597568d42a,-12.57,131.1,NT,Humpty Doo,debit,authorized,667337ee6fd34f92a277368433329db0,SALES-POS,30-40,2018,10,13,21,32,Saturday,14 days,69020.979
ACC-4059612845,38,195.0,61309.05,,CUS-495599312,2018-10-15,Jonathan,M,-12.49,130.98,,,,,,,debit,posted,5e08ee27cee54550b1f926a9e61a8c7a,INTER BANK,30-40,2018,10,15,6,0,Monday,14 days,69020.979
ACC-4059612845,38,178.0,61131.05,,CUS-495599312,2018-10-17,Jonathan,M,-12.49,130.98,,,,,,,debit,posted,7293034fadcc4b948f50756933dab1b9,PAYMENT,30-40,2018,10,17,13,0,Wednesday,14 days,69020.979
ACC-4059612845,38,121.88,61009.17,0.0,CUS-495599312,2018-10-20,Jonathan,M,-12.49,130.98,,b4ef8c0b-d288-4542-8be9-c310d56e2dff,-12.5,131.04,NT,Howard Springs,debit,authorized,20053ca4eaa64f74b8836cf2fab8ae7a,POS,30-40,2018,10,20,14,7,Saturday,14 days,69020.979
ACC-4059612845,38,125.0,63531.55,,CUS-495599312,2018-10-26,Jonathan,M,-12.49,130.98,,,,,,,debit,posted,386d69cf1743410f823069eaadeed433,PAYMENT,30-40,2018,10,26,5,0,Friday,14 days,69020.979
ACC-4059612845,38,198.0,63333.55,,CUS-495599312,2018-10-27,Jonathan,M,-12.49,130.98,,,,,,,debit,posted,094c6a2d382d425bb984263b6e0c743f,PAYMENT,30-40,2018,10,27,13,0,Saturday,14 days,69020.979
ACC-4059612845,38,41.8,63291.75,1.0,CUS-495599312,2018-10-30,Jonathan,M,-12.49,130.98,,39d8e31d-aa6c-443e-b9de-9f0031c33578,-33.86,151.19,NSW,Pyrmont,debit,authorized,800411eca77446559030da77589d2623,POS,30-40,2018,10,30,19,58,Tuesday,14 days,69020.979
ACC-4059612845,38,47.62,63244.13,0.0,CUS-495599312,2018-10-31,Jonathan,M,-12.49,130.98,,c7d169a9-fe96-4983-8d1e-9c0c6805a31e,-33.88,151.22,NSW,Darlinghurst,debit,authorized,b5c06dceece947188c81835f8f1729ec,SALES-POS,30-40,2018,10,31,1,44,Wednesday,14 days,69020.979
ACC-1890605467,38,40.31,5748.22,0.0,CUS-1478398256,2018-08-02,Alexander,M,-37.66,143.88,,f4c25daa-db9b-4373-9d40-645cd4654f40,-33.89,151.2,NSW,Chippendale,debit,authorized,e3577b7f81394d4caacae34672d1129c,POS,30-40,2018,8,2,19,50,Thursday,14 days,95147.939
ACC-1890605467,38,133.0,5587.25,,CUS-1478398256,2018-08-04,Alexander,M,-37.66,143.88,,,,,,,debit,posted,a8735aaa4075479cbe25a420cbf295d5,INTER BANK,30-40,2018,8,4,15,0,Saturday,14 days,95147.939
ACC-1890605467,38,27.97,5720.25,1.0,CUS-1478398256,2018-08-04,Alexander,M,-37.66,143.88,,404dcd84-8176-476a-bd48-afe561bc1ce8,-37.67,144.85,VIC,Melbourne Airport,debit,authorized,21d1a11390084c94beeaa8a6520da115,SALES-POS,30-40,2018,8,4,15,41,Saturday,14 days,95147.939
ACC-1890605467,38,42.0,5545.25,,CUS-1478398256,2018-08-07,Alexander,M,-37.66,143.88,,,,,,,debit,posted,c5dcdfac54da441a97e627f3536b613c,INTER BANK,30-40,2018,8,7,5,0,Tuesday,14 days,95147.939
ACC-1890605467,38,183.0,5362.25,,CUS-1478398256,2018-08-08,Alexander,M,-37.66,143.88,,,,,,,debit,posted,d49a78d32eee4dfc8d561bd86f2853e7,PAYMENT,30-40,2018,8,8,8,0,Wednesday,14 days,95147.939
ACC-1890605467,38,33.52,8978.24,1.0,CUS-1478398256,2018-08-10,Alexander,M,-37.66,143.88,,182844f5-6fd2-4aae-8a6b-fbbc105ee8e9,-37.78,145.11,VIC,Doncaster,debit,authorized,15a78e5c8b2f4826b9ce6ed958f7bdf2,POS,30-40,2018,8,10,21,53,Friday,14 days,95147.939
ACC-1890605467,38,29.04,8949.2,0.0,CUS-1478398256,2018-08-11,Alexander,M,-37.66,143.88,,ced47f80-ffad-40a3-8470-2d305b336d48,-37.56,143.86,VIC,Ballarat Central,debit,authorized,3d58e680cb23481bb9b26598decf5cf9,POS,30-40,2018,8,11,18,54,Saturday,14 days,95147.939
ACC-1890605467,38,40.03,8909.17,1.0,CUS-1478398256,2018-08-11,Alexander,M,-37.66,143.88,,c333767c-e932-46f7-a4ed-2b2c5edd1dae,-38.54,143.97,VIC,Lorne,debit,authorized,88897e5f737549079aa7245ff3aabb77,SALES-POS,30-40,2018,8,11,20,55,Saturday,14 days,95147.939
ACC-1890605467,38,21.88,8887.29,0.0,CUS-1478398256,2018-08-13,Alexander,M,-37.66,143.88,,abe979df-9b1d-42a2-a04a-180eed06d77d,-37.56,143.85,VIC,Ballarat Central,debit,authorized,40f0411653ba4ba4a2bf3bf4e769dc3e,POS,30-40,2018,8,13,15,2,Monday,14 days,95147.939
ACC-1890605467,38,42.0,8845.29,,CUS-1478398256,2018-08-14,Alexander,M,-37.66,143.88,,,,,,,debit,posted,e0ffbdc398e643b5b2e60dd07d4fce98,INTER BANK,30-40,2018,8,14,5,0,Tuesday,14 days,95147.939
ACC-1890605467,38,554.0,8291.29,,CUS-1478398256,2018-08-14,Alexander,M,-37.66,143.88,,,,,,,debit,posted,a205a1dd70b14c528739352561e8b5e8,PAYMENT,30-40,2018,8,14,10,0,Tuesday,14 days,95147.939
ACC-1890605467,38,8.45,8282.84,1.0,CUS-1478398256,2018-08-17,Alexander,M,-37.66,143.88,,4d613acf-1427-4196-9015-db1aeecd287a,-37.6,144.94,VIC,Craigieburn,debit,authorized,330af2dd99c842a184e80c2d83c9d249,POS,30-40,2018,8,17,14,51,Friday,14 days,95147.939
ACC-1890605467,38,11.48,8271.36,1.0,CUS-1478398256,2018-08-17,Alexander,M,-37.66,143.88,,95064b95-235e-43e6-9964-aae0157ba5a4,-37.72,145.14,VIC,Eltham,debit,authorized,35d281ca0ce7450ca5ab6d66066dfaf3,SALES-POS,30-40,2018,8,17,19,2,Friday,14 days,95147.939
ACC-1890605467,38,42.0,8229.36,,CUS-1478398256,2018-08-21,Alexander,M,-37.66,143.88,,,,,,,debit,posted,fec7ee051af84cef9dc8ab88184df2b0,INTER BANK,30-40,2018,8,21,5,0,Tuesday,14 days,95147.939
ACC-1890605467,38,18.62,8210.74,1.0,CUS-1478398256,2018-08-22,Alexander,M,-37.66,143.88,,625ce358-1e06-419b-a6cf-b7a8a56ca554,-37.77,145.12,VIC,Doncaster,debit,authorized,36baeb12e1b046f094a78f6ea18b94d4,POS,30-40,2018,8,22,13,25,Wednesday,14 days,95147.939
ACC-1890605467,38,50.85,11809.4,0.0,CUS-1478398256,2018-08-25,Alexander,M,-37.66,143.88,,18474c62-9208-4f15-a437-c6ec03768b70,-37.67,144.93,VIC,Dallas,debit,authorized,fdf1b1dbe54b4731a20cbacc7c8f75aa,SALES-POS,30-40,2018,8,25,22,48,Saturday,14 days,95147.939
ACC-1890605467,38,134.0,11675.4,,CUS-1478398256,2018-08-26,Alexander,M,-37.66,143.88,,,,,,,debit,posted,4567097065e64336b2b5964fcec27da8,INTER BANK,30-40,2018,8,26,8,0,Sunday,14 days,95147.939
ACC-1890605467,38,40.37,11635.03,1.0,CUS-1478398256,2018-08-26,Alexander,M,-37.66,143.88,,fcc5f982-d673-4dbd-a893-f01800e9c7de,-27.47,153.02,QLD,Brisbane City,debit,authorized,5e054bd14f4f4a37bfe95333a75e9972,SALES-POS,30-40,2018,8,26,21,37,Sunday,14 days,95147.939
ACC-1890605467,38,42.0,11593.03,,CUS-1478398256,2018-08-28,Alexander,M,-37.66,143.88,,,,,,,debit,posted,ca0419b6ef3b4c2a9313704289fa35f0,INTER BANK,30-40,2018,8,28,5,0,Tuesday,14 days,95147.939
ACC-1890605467,38,32.8,11560.23,0.0,CUS-1478398256,2018-08-28,Alexander,M,-37.66,143.88,,76931b68-8dd8-47c4-98b6-690f1908713a,-37.64,144.93,VIC,Roxburgh Park,debit,authorized,36892ca7446841ab9ff1e9474d05c54b,SALES-POS,30-40,2018,8,28,14,24,Tuesday,14 days,95147.939
ACC-1890605467,38,22.86,11537.37,0.0,CUS-1478398256,2018-08-31,Alexander,M,-37.66,143.88,,9abc6dfb-5e63-40fb-8852-4eaebe967c80,-37.78,144.98,VIC,Fitzroy North,debit,authorized,64da74c314044fa5a9773e9e704c0097,POS,30-40,2018,8,31,1,23,Friday,14 days,95147.939
ACC-1890605467,38,61.3,11476.07,0.0,CUS-1478398256,2018-08-31,Alexander,M,-37.66,143.88,,b6c1fb32-bd29-48fa-a650-1d2604ce8f26,-37.7,144.8,VIC,Taylors Lakes,debit,authorized,dbc0ac87b826497e9926d9969e69ad21,SALES-POS,30-40,2018,8,31,11,59,Friday,14 days,95147.939
ACC-1890605467,38,43.12,11432.95,1.0,CUS-1478398256,2018-09-01,Alexander,M,-37.66,143.88,,231f5f5b-628b-4365-a00f-22bc51095a5a,-37.7,145.06,VIC,Bundoora,debit,authorized,e69b5e77f2a64700bd626edc316c0eb5,POS,30-40,2018,9,1,14,8,Saturday,14 days,95147.939
ACC-1890605467,38,27.59,11405.36,1.0,CUS-1478398256,2018-09-01,Alexander,M,-37.66,143.88,,15116f50-f83d-4e87-ae55-bfbefc312a7f,-37.64,144.93,VIC,Roxburgh Park,debit,authorized,3d5f73706e444a07a0426d65361dd334,POS,30-40,2018,9,1,15,19,Saturday,14 days,95147.939
ACC-1890605467,38,846.0,10559.36,,CUS-1478398256,2018-09-01,Alexander,M,-37.66,143.88,,,,,,,debit,posted,df0bb9d85390456387bedf12c81a83a8,PAYMENT,30-40,2018,9,1,22,0,Saturday,14 days,95147.939
ACC-1890605467,38,24.19,10535.17,1.0,CUS-1478398256,2018-09-03,Alexander,M,-37.66,143.88,,9f87eb59-be5e-4687-8d25-5745329ad419,-37.68,145.07,VIC,Bundoora,debit,authorized,4f769e2d26f14b72a3e25a9fb8702b5a,SALES-POS,30-40,2018,9,3,9,36,Monday,14 days,95147.939
ACC-1890605467,38,42.0,10493.17,,CUS-1478398256,2018-09-04,Alexander,M,-37.66,143.88,,,,,,,debit,posted,5616cc004a314ac4a3a30e5bfc3c0f32,INTER BANK,30-40,2018,9,4,5,0,Tuesday,14 days,95147.939
ACC-1890605467,38,54.44,10438.73,0.0,CUS-1478398256,2018-09-04,Alexander,M,-37.66,143.88,,39141d29-67c2-4d81-8cba-4a9cbabc0d47,-37.68,145.07,VIC,Bundoora,debit,authorized,b3734b0e4efa4622be70374b5a41e295,POS,30-40,2018,9,4,9,21,Tuesday,14 days,95147.939
ACC-1890605467,38,34.64,10404.09,1.0,CUS-1478398256,2018-09-04,Alexander,M,-37.66,143.88,,198c2a0c-3eb7-4e5c-9c0e-5e9b4ff99a90,-37.6,140.31,SA,Millicent,debit,authorized,20a86ef9feb8423d9b1a6e876662d5bc,POS,30-40,2018,9,4,10,34,Tuesday,14 days,95147.939
ACC-1890605467,38,133.0,10271.09,,CUS-1478398256,2018-09-04,Alexander,M,-37.66,143.88,,,,,,,debit,posted,9f3b6f4ecf2f44d8a84ada97a9765887,INTER BANK,30-40,2018,9,4,15,0,Tuesday,14 days,95147.939
ACC-1890605467,38,202.77,10068.32,1.0,CUS-1478398256,2018-09-05,Alexander,M,-37.66,143.88,,3de16e20-02c7-47cb-9ad8-98ce5b04d22a,-33.87,151.21,NSW,Sydney,debit,authorized,555db2e6b8de4f97b7710337511c0da9,SALES-POS,30-40,2018,9,5,10,10,Wednesday,14 days,95147.939
ACC-1890605467,38,15.89,10052.43,1.0,CUS-1478398256,2018-09-05,Alexander,M,-37.66,143.88,,6ac6de73-8418-46ef-8bff-6987c5c81642,-37.67,145.06,VIC,Mill Park,debit,authorized,9037543da650499ca3a645819a4d105a,SALES-POS,30-40,2018,9,5,18,9,Wednesday,14 days,95147.939
ACC-1890605467,38,51.85,10000.58,1.0,CUS-1478398256,2018-09-06,Alexander,M,-37.66,143.88,,e8d3e859-db04-4b1b-9e7c-0ae39f23ca67,-37.78,145.16,VIC,Doncaster East,debit,authorized,dcb3a6fff48248028c41d4d0dd92c547,POS,30-40,2018,9,6,11,24,Thursday,14 days,95147.939
ACC-1890605467,38,34.75,9965.83,1.0,CUS-1478398256,2018-09-07,Alexander,M,-37.66,143.88,,7aeba739-92ad-47b2-8f3d-48bb75f34060,-37.77,145,VIC,Northcote,debit,authorized,3712c6701d93412bacff0a5b707adf1a,SALES-POS,30-40,2018,9,7,0,32,Friday,14 days,95147.939
ACC-1890605467,38,183.0,13432.34,,CUS-1478398256,2018-09-08,Alexander,M,-37.66,143.88,,,,,,,debit,posted,e2ccc88d8c394da283175dca18ae86f6,PAYMENT,30-40,2018,9,8,8,0,Saturday,14 days,95147.939
ACC-1890605467,38,30.17,13402.17,1.0,CUS-1478398256,2018-09-08,Alexander,M,-37.66,143.88,,3aa3094b-1211-4e9c-a427-411d49e23db8,-37.77,144.96,VIC,Brunswick,debit,authorized,7819c02363f84639930f5e8f6bc81ef3,SALES-POS,30-40,2018,9,8,15,20,Saturday,14 days,95147.939
ACC-1890605467,38,41.81,13360.36,1.0,CUS-1478398256,2018-09-09,Alexander,M,-37.66,143.88,,3b4cef6e-7b92-41cb-92cb-2602d25486b6,-37.82,145.03,VIC,Hawthorn,debit,authorized,02f57c4292bb419d848308b61ec68514,SALES-POS,30-40,2018,9,9,14,8,Sunday,14 days,95147.939
ACC-1890605467,38,42.0,13318.36,,CUS-1478398256,2018-09-11,Alexander,M,-37.66,143.88,,,,,,,debit,posted,9a34fe2e36fd46c5a8d81c8dce21739e,INTER BANK,30-40,2018,9,11,5,0,Tuesday,14 days,95147.939
ACC-1890605467,38,40.94,13277.42,1.0,CUS-1478398256,2018-09-11,Alexander,M,-37.66,143.88,,7c6c5c99-7e7f-4e73-b7ca-543d10aa4901,-37.57,144.92,VIC,Craigieburn,debit,authorized,759b615ecbab4233b7667eab0b3edf95,POS,30-40,2018,9,11,20,18,Tuesday,14 days,95147.939
ACC-1890605467,38,34.59,13242.83,1.0,CUS-1478398256,2018-09-13,Alexander,M,-37.66,143.88,,76931b68-8dd8-47c4-98b6-690f1908713a,-37.64,144.93,VIC,Roxburgh Park,debit,authorized,b1e8263f3f474f1da1081dd320ae034c,POS,30-40,2018,9,13,11,27,Thursday,14 days,95147.939
ACC-1890605467,38,26.95,13215.88,0.0,CUS-1478398256,2018-09-13,Alexander,M,-37.66,143.88,,3e35990d-c83e-415e-9830-79a9ed47239d,-37.77,144.87,VIC,Avondale Heights,debit,authorized,523d4c337f274ea9a809627927f078ba,POS,30-40,2018,9,13,19,59,Thursday,14 days,95147.939
ACC-1890605467,38,18.04,13197.84,1.0,CUS-1478398256,2018-09-14,Alexander,M,-37.66,143.88,,e5ecdb21-12f4-480e-b79c-b9340caf0eae,-37.58,144.73,VIC,Sunbury,debit,authorized,0d85fec7d67a473fbb7a54e7f30fd419,POS,30-40,2018,9,14,19,1,Friday,14 days,95147.939
ACC-1890605467,38,57.01,13140.83,1.0,CUS-1478398256,2018-09-15,Alexander,M,-37.66,143.88,,52ea5772-5c58-477a-8529-066adc898666,-37.74,145,VIC,Preston,debit,authorized,b59614c2b7c64f088263beea899ed3a6,SALES-POS,30-40,2018,9,15,11,46,Saturday,14 days,95147.939
ACC-1890605467,38,16.88,13123.95,1.0,CUS-1478398256,2018-09-15,Alexander,M,-37.66,143.88,,d887d414-368c-4332-a219-a9a33c87628a,-37.62,145.03,VIC,Wollert,debit,authorized,70b79c5b72054ce99a33f86f837993a9,POS,30-40,2018,9,15,22,34,Saturday,14 days,95147.939
ACC-1890605467,38,7.24,13116.71,1.0,CUS-1478398256,2018-09-16,Alexander,M,-37.66,143.88,,93958fca-80f1-46c6-bd3e-4058354d75e0,-37.56,143.86,VIC,Ballarat Central,debit,authorized,ae6021519242472d91b73de46e503a15,SALES-POS,30-40,2018,9,16,0,31,Sunday,14 days,95147.939
ACC-1890605467,38,18.48,13098.23,0.0,CUS-1478398256,2018-09-17,Alexander,M,-37.66,143.88,,b4a1b887-eb10-4ffd-b849-7c67d37a8d59,-37.58,144.73,VIC,Sunbury,debit,authorized,a170fdea74d74c2a80ed70c8b2519420,SALES-POS,30-40,2018,9,17,16,1,Monday,14 days,95147.939
ACC-1890605467,38,42.0,13056.23,,CUS-1478398256,2018-09-18,Alexander,M,-37.66,143.88,,,,,,,debit,posted,2907f89f8db24612b4fb23fcf77bd808,INTER BANK,30-40,2018,9,18,5,0,Tuesday,14 days,95147.939
ACC-1890605467,38,82.86,12973.37,1.0,CUS-1478398256,2018-09-18,Alexander,M,-37.66,143.88,,60a729cc-dad1-42a2-b944-da711498bba7,-37.82,144.95,VIC,Docklands,debit,authorized,d0fb489f629345219a21acb2f1b2beac,POS,30-40,2018,9,18,17,42,Tuesday,14 days,95147.939
ACC-1890605467,38,13.83,12959.54,1.0,CUS-1478398256,2018-09-19,Alexander,M,-37.66,143.88,,18625e36-e8c7-4ca4-a0fc-9a4bb4f28bff,-37.67,145.16,VIC,Diamond Creek,debit,authorized,594ab8b98001472ca426b4bcc14c6616,SALES-POS,30-40,2018,9,19,14,53,Wednesday,14 days,95147.939
ACC-1890605467,38,28.75,16580.3,1.0,CUS-1478398256,2018-09-22,Alexander,M,-37.66,143.88,,1fb39dd7-1ada-40a2-9948-bc19b0581dff,-37.64,144.93,VIC,Roxburgh Park,debit,authorized,5678237a0a1e494b860524814be28f25,SALES-POS,30-40,2018,9,22,15,12,Saturday,14 days,95147.939
ACC-1890605467,38,26.63,16553.67,1.0,CUS-1478398256,2018-09-22,Alexander,M,-37.66,143.88,,aedb62e5-0117-4875-a26d-afcecbd411d6,-37.67,144.95,VIC,Campbellfield,debit,authorized,13843d332d47464d8b9344388b37fde0,POS,30-40,2018,9,22,21,35,Saturday,14 days,95147.939
ACC-1890605467,38,42.0,16511.67,,CUS-1478398256,2018-09-25,Alexander,M,-37.66,143.88,,,,,,,debit,posted,d8341e10aee24b5798dde92efa214ea0,INTER BANK,30-40,2018,9,25,5,0,Tuesday,14 days,95147.939
ACC-1890605467,38,93.52,16418.15,1.0,CUS-1478398256,2018-09-25,Alexander,M,-37.66,143.88,,835ea2d9-9be0-4f76-8ab8-2596bd457e53,-37.76,144.94,VIC,Brunswick West,debit,authorized,861904a027484ba99d719fc9c815f65b,SALES-POS,30-40,2018,9,25,9,56,Tuesday,14 days,95147.939
ACC-1890605467,38,134.0,16284.15,,CUS-1478398256,2018-09-26,Alexander,M,-37.66,143.88,,,,,,,debit,posted,b7aa1f1c30594a29bb3915786d138ece,INTER BANK,30-40,2018,9,26,8,0,Wednesday,14 days,95147.939
ACC-1890605467,38,13.34,16270.81,1.0,CUS-1478398256,2018-09-28,Alexander,M,-37.66,143.88,,96699df4-8fe5-4120-a5df-30d5c87826be,-37.58,144.73,VIC,Sunbury,debit,authorized,b779203dd6be4b83bc6472f30abb34d7,POS,30-40,2018,9,28,15,20,Friday,14 days,95147.939
ACC-1890605467,38,20.95,16249.86,1.0,CUS-1478398256,2018-09-30,Alexander,M,-37.66,143.88,,0654e137-7cbe-4371-858a-b407b612ee52,-37.62,145.03,VIC,Wollert,debit,authorized,788f393d1bbd45bd874da6f429a80bed,POS,30-40,2018,9,30,6,59,Sunday,14 days,95147.939
ACC-1890605467,38,12.22,16237.64,1.0,CUS-1478398256,2018-09-30,Alexander,M,-37.66,143.88,,f9f244e9-3f3b-4a7a-ba03-e9c5fae5bac1,-37.68,145.14,VIC,Saint Helena,debit,authorized,a20c55b9b5ae46ad94bdaaf559ea1438,POS,30-40,2018,9,30,21,11,Sunday,14 days,95147.939
ACC-1890605467,38,54.33,16183.31,1.0,CUS-1478398256,2018-10-01,Alexander,M,-37.66,143.88,,a026ca96-21a2-4e81-83c9-e3e9f3644bc0,-37.72,145.04,VIC,Bundoora,debit,authorized,d5dbd8cf4a36434c959b9bcfdbbb261f,SALES-POS,30-40,2018,10,1,8,35,Monday,14 days,95147.939
ACC-1890605467,38,42.0,16141.31,,CUS-1478398256,2018-10-02,Alexander,M,-37.66,143.88,,,,,,,debit,posted,7d5de3c4d1cb4fbfad544f12befa9f57,INTER BANK,30-40,2018,10,2,5,0,Tuesday,14 days,95147.939
ACC-1890605467,38,27.62,16113.69,1.0,CUS-1478398256,2018-10-03,Alexander,M,-37.66,143.88,,73ce1be7-1481-4a01-9bb1-fab3a2db0f85,-37.8,144.89,VIC,Seddon,debit,authorized,b0f66965db904d728fce3a0a1e97f444,POS,30-40,2018,10,3,14,23,Wednesday,14 days,95147.939
ACC-1890605467,38,39.12,16074.57,1.0,CUS-1478398256,2018-10-03,Alexander,M,-37.66,143.88,,356921ce-3042-4e97-9900-727a161f2a72,-37.58,144.73,VIC,Sunbury,debit,authorized,2235f724e1904cdcaf2e961c29823f62,POS,30-40,2018,10,3,15,53,Wednesday,14 days,95147.939
ACC-1890605467,38,133.0,15941.57,,CUS-1478398256,2018-10-04,Alexander,M,-37.66,143.88,,,,,,,debit,posted,f178b7d7ebe341dc90755dab6ffc4368,INTER BANK,30-40,2018,10,4,15,0,Thursday,14 days,95147.939
ACC-1890605467,38,65.44,15876.13,1.0,CUS-1478398256,2018-10-05,Alexander,M,-37.66,143.88,,4009eacb-a18b-477b-b4e5-bc4eb97fcbe2,-37.57,145.64,VIC,Narbethong,debit,authorized,3dfa7f861678420d800f6df55f8bf655,POS,30-40,2018,10,5,11,2,Friday,14 days,95147.939
ACC-1890605467,38,58.24,15817.89,1.0,CUS-1478398256,2018-10-05,Alexander,M,-37.66,143.88,,c146edca-f223-4efc-89d0-770cc0d934ae,-37.64,144.93,VIC,Roxburgh Park,debit,authorized,9d7d91883c1c4e269cf71f2921d390f8,POS,30-40,2018,10,5,14,53,Friday,14 days,95147.939
ACC-1890605467,38,58.9,19408.5,1.0,CUS-1478398256,2018-10-06,Alexander,M,-37.66,143.88,,ec986b61-74bd-48d1-be51-3748899591fe,-37.6,144.94,VIC,Craigieburn,debit,authorized,ea610437b2aa401abdf4bbcdf853cb08,SALES-POS,30-40,2018,10,6,9,56,Saturday,14 days,95147.939
ACC-1890605467,38,28.78,19379.72,1.0,CUS-1478398256,2018-10-06,Alexander,M,-37.66,143.88,,d981a2bd-207c-45ec-b921-1d0d68fa4aa2,-37.78,144.98,VIC,Fitzroy North,debit,authorized,8508bfb708ad4e4bb67bc3524e58d3cc,POS,30-40,2018,10,6,21,57,Saturday,14 days,95147.939
ACC-1890605467,38,102.06,19277.66,1.0,CUS-1478398256,2018-10-07,Alexander,M,-37.66,143.88,,41c75d6c-ef5d-4ee6-a172-d4c491308800,-37.81,145.23,VIC,Ringwood,debit,authorized,bd3774c3e8e14bbf843baba629325c8f,SALES-POS,30-40,2018,10,7,16,48,Sunday,14 days,95147.939
ACC-1890605467,38,183.0,19094.66,,CUS-1478398256,2018-10-08,Alexander,M,-37.66,143.88,,,,,,,debit,posted,2148a353833342689bf770277759f770,PAYMENT,30-40,2018,10,8,8,0,Monday,14 days,95147.939
ACC-1890605467,38,42.0,19052.66,,CUS-1478398256,2018-10-09,Alexander,M,-37.66,143.88,,,,,,,debit,posted,ac5dafb58c9d4fd99a4853c0eb66691a,INTER BANK,30-40,2018,10,9,5,0,Tuesday,14 days,95147.939
ACC-1890605467,38,18.81,19033.85,1.0,CUS-1478398256,2018-10-10,Alexander,M,-37.66,143.88,,b6db740d-3adc-420c-9efc-96e0bd670fc4,-37.81,144.97,VIC,Melbourne,debit,authorized,2dc107d86a3a4d74aa2aee92837a3da6,SALES-POS,30-40,2018,10,10,8,44,Wednesday,14 days,95147.939
ACC-1890605467,38,157.87,18875.98,1.0,CUS-1478398256,2018-10-10,Alexander,M,-37.66,143.88,,d2152b22-0e11-4f3c-ac81-4d2051b6d0f2,-30.49,151.64,NSW,Armidale,debit,authorized,8ca7ecc79cc54f6e94718f0c73046370,SALES-POS,30-40,2018,10,10,12,32,Wednesday,14 days,95147.939
ACC-1890605467,38,32.66,18843.32,1.0,CUS-1478398256,2018-10-11,Alexander,M,-37.66,143.88,,b553f703-fd7c-4a65-bc3a-c30c8dc5b2b8,-37.79,145.12,VIC,Doncaster,debit,authorized,c1d0249ff7714eed88698e016a953a86,POS,30-40,2018,10,11,19,52,Thursday,14 days,95147.939
ACC-1890605467,38,42.0,18801.32,,CUS-1478398256,2018-10-16,Alexander,M,-37.66,143.88,,,,,,,debit,posted,1cdbea768ec643de9e2cb521b44ac083,INTER BANK,30-40,2018,10,16,5,0,Tuesday,14 days,95147.939
ACC-1890605467,38,112.89,18688.43,0.0,CUS-1478398256,2018-10-16,Alexander,M,-37.66,143.88,,c05793a8-011a-4cee-bb28-54127559c420,-33.87,151.21,NSW,Sydney,debit,authorized,2c399854aa324ba4bd87882a60d1b18f,SALES-POS,30-40,2018,10,16,8,43,Tuesday,14 days,95147.939
ACC-1890605467,38,25.05,22312.89,0.0,CUS-1478398256,2018-10-20,Alexander,M,-37.66,143.88,,b53bc667-bb5c-4901-9955-3c4401cc6c7c,-37.84,147.6,VIC,Bairnsdale,debit,authorized,153eb93a063843ceb0700bc2e7e10db1,SALES-POS,30-40,2018,10,20,21,36,Saturday,14 days,95147.939
ACC-1890605467,38,19.14,22293.75,1.0,CUS-1478398256,2018-10-21,Alexander,M,-37.66,143.88,,b6db740d-3adc-420c-9efc-96e0bd670fc4,-37.81,144.97,VIC,Melbourne,debit,authorized,6d2d00d5a5a54380b8d30459bc299431,POS,30-40,2018,10,21,10,59,Sunday,14 days,95147.939
ACC-1890605467,38,42.0,22251.75,,CUS-1478398256,2018-10-23,Alexander,M,-37.66,143.88,,,,,,,debit,posted,c1abaee0db264951a4ef56c0d20dc0a1,INTER BANK,30-40,2018,10,23,5,0,Tuesday,14 days,95147.939
ACC-1890605467,38,37.98,22213.77,0.0,CUS-1478398256,2018-10-25,Alexander,M,-37.66,143.88,,14334930-efd3-42a8-98b2-1adbf32213cc,-37.58,144.73,VIC,Sunbury,debit,authorized,4e1569bbcb684c68a5428d2784f0b19e,SALES-POS,30-40,2018,10,25,18,18,Thursday,14 days,95147.939
ACC-1890605467,38,134.0,22079.77,,CUS-1478398256,2018-10-26,Alexander,M,-37.66,143.88,,,,,,,debit,posted,1b2501a1ec504268acfe75a3c705755c,INTER BANK,30-40,2018,10,26,8,0,Friday,14 days,95147.939
ACC-1890605467,38,34.34,22045.43,1.0,CUS-1478398256,2018-10-26,Alexander,M,-37.66,143.88,,4feeaa23-5dd7-4589-8f8e-390875a82c6d,-37.77,144.92,VIC,Moonee Ponds,debit,authorized,d4f8bc64c3514b798fdc6512b13f4fc3,SALES-POS,30-40,2018,10,26,14,18,Friday,14 days,95147.939
ACC-1890605467,38,5.23,22040.2,1.0,CUS-1478398256,2018-10-27,Alexander,M,-37.66,143.88,,606e59e2-285f-4955-83b1-de242970d5b5,-33.9,151.21,NSW,Waterloo,debit,authorized,d539c5a0582e4d8487d828df0d570b65,POS,30-40,2018,10,27,4,52,Saturday,14 days,95147.939
ACC-1890605467,38,42.0,21998.2,,CUS-1478398256,2018-10-30,Alexander,M,-37.66,143.88,,,,,,,debit,posted,02e376ef5de04d5ba18c9485d0461ce6,INTER BANK,30-40,2018,10,30,5,0,Tuesday,14 days,95147.939
ACC-1890605467,38,33.42,21964.78,0.0,CUS-1478398256,2018-10-30,Alexander,M,-37.66,143.88,,51a001aa-0c3d-4d54-ac7f-1cb65616fb0c,-37.67,144.95,VIC,Campbellfield,debit,authorized,59bb8003ca2a49fdac227ca2226915f5,POS,30-40,2018,10,30,8,3,Tuesday,14 days,95147.939
ACC-1890605467,38,33.13,21931.65,1.0,CUS-1478398256,2018-10-31,Alexander,M,-37.66,143.88,,654f2746-6db1-4620-99fe-a16cff87db6e,-33.8,151.18,NSW,Chatswood West,debit,authorized,9098080fb8f24c5aaad0a180d9c2394c,POS,30-40,2018,10,31,1,24,Wednesday,14 days,95147.939
ACC-1890605467,38,47.18,21884.47,1.0,CUS-1478398256,2018-10-31,Alexander,M,-37.66,143.88,,e8f43636-ef18-488c-af1a-11d66ae2e941,-37.79,145.17,VIC,Donvale,debit,authorized,0b4f18419df34fcc8c0b08413c3827f1,POS,30-40,2018,10,31,14,5,Wednesday,14 days,95147.939
ACC-53508546,35,70.28,996.97,1.0,CUS-72755508,2018-08-02,Kimberly,F,-33.76,150.62,,1064ce7c-6fce-428f-9d56-a6980e100997,-33.79,151,NSW,Northmead,debit,authorized,5e77936ee19e46a281bc73dc51e9740f,SALES-POS,30-40,2018,8,2,19,59,Thursday,7 days,37820.257
ACC-53508546,35,23.83,973.14,1.0,CUS-72755508,2018-08-04,Kimberly,F,-33.76,150.62,,ecaf1382-48ea-4028-970d-fdcaa367fc0f,-33.78,151.02,NSW,North Rocks,debit,authorized,d7b5d2ccd4da4747ab0cf5982fc93c0b,POS,30-40,2018,8,4,17,51,Saturday,7 days,37820.257
ACC-53508546,35,32.98,1665.48,1.0,CUS-72755508,2018-08-10,Kimberly,F,-33.76,150.62,,e6ab2ad0-2da6-42ef-bce3-f9668cb0af9a,-33.78,151.13,NSW,Macquarie Park,debit,authorized,05c9efe3d3754f82a0033da9bbd14dab,SALES-POS,30-40,2018,8,10,20,33,Friday,7 days,37820.257
ACC-53508546,35,41.0,1624.48,1.0,CUS-72755508,2018-08-15,Kimberly,F,-33.76,150.62,,0abbf261-6fff-4d67-be32-444cba7d2099,-33.69,151.11,NSW,Asquith,debit,authorized,bc127ca6a743482e89a74437e1258ecb,SALES-POS,30-40,2018,8,15,13,19,Wednesday,7 days,37820.257
ACC-53508546,35,22.27,1602.21,1.0,CUS-72755508,2018-08-15,Kimberly,F,-33.76,150.62,,f8a06431-170e-406c-bcae-9f705557f9a8,-33.81,151.11,NSW,Ryde,debit,authorized,1da1b2c419ed4e2fbe147157c31fea1f,SALES-POS,30-40,2018,8,15,17,0,Wednesday,7 days,37820.257
ACC-53508546,35,228.06,2099.47,1.0,CUS-72755508,2018-08-17,Kimberly,F,-33.76,150.62,,187bc0a4-053a-414d-9ff3-af7d49ef536d,-33.87,151.21,NSW,Sydney,debit,authorized,ca2d78c4735840a4b0ebab1b03433295,SALES-POS,30-40,2018,8,17,14,18,Friday,7 days,37820.257
ACC-53508546,35,11.66,2087.81,1.0,CUS-72755508,2018-08-18,Kimberly,F,-33.76,150.62,,4910d30d-0e61-497d-b829-3deac4033aa7,-33.79,151.19,NSW,Chatswood,debit,authorized,6d41b23ceddd46439ac9059aaf622c1c,SALES-POS,30-40,2018,8,18,10,10,Saturday,7 days,37820.257
ACC-53508546,35,7.76,2080.05,1.0,CUS-72755508,2018-08-19,Kimberly,F,-33.76,150.62,,76583118-644b-4ff3-8b9c-e080822d3669,-33.81,151.17,NSW,Lane Cove,debit,authorized,58828ce0004e4c8ebe6ea5fec271f6a7,SALES-POS,30-40,2018,8,19,0,1,Sunday,7 days,37820.257
ACC-53508546,35,27.87,2052.18,1.0,CUS-72755508,2018-08-19,Kimberly,F,-33.76,150.62,,c0e1a229-b104-4fb5-aeeb-4067b41e83a3,-33.69,117.56,WA,Katanning,debit,authorized,f972362632bf49a5ba95c664ddb0c48e,SALES-POS,30-40,2018,8,19,9,50,Sunday,7 days,37820.257
ACC-53508546,35,130.08,1922.1,1.0,CUS-72755508,2018-08-21,Kimberly,F,-33.76,150.62,,57e5fc86-cc20-4e09-b031-367af7aa6164,-33.69,150.93,NSW,Rouse Hill,debit,authorized,3e594936100c46459a96a906f609fb95,SALES-POS,30-40,2018,8,21,17,48,Tuesday,7 days,37820.257
ACC-53508546,35,8.2,1913.9,0.0,CUS-72755508,2018-08-22,Kimberly,F,-33.76,150.62,,5a856249-6d46-4c0e-b5dd-f75561a22575,-33.76,151.28,NSW,Dee Why,debit,authorized,84d07a3b093945d7b2cd46d5f169fd8c,SALES-POS,30-40,2018,8,22,10,54,Wednesday,7 days,37820.257
ACC-53508546,35,21.39,1892.51,1.0,CUS-72755508,2018-08-23,Kimberly,F,-33.76,150.62,,c92e1a33-eedc-45b6-a380-c298231f6ca2,-33.8,151.18,NSW,Chatswood,debit,authorized,ac7e7cf5b4d148098c6722c8145d7d02,SALES-POS,30-40,2018,8,23,0,51,Thursday,7 days,37820.257
ACC-53508546,35,20.6,1871.91,1.0,CUS-72755508,2018-08-23,Kimberly,F,-33.76,150.62,,41889285-f86b-481c-b1db-09b8bc042ccc,-33.78,151.12,NSW,North Ryde,debit,authorized,40e6b976d5ff4518a585452e7d6d279a,POS,30-40,2018,8,23,8,30,Thursday,7 days,37820.257
ACC-53508546,35,9.87,2587.36,1.0,CUS-72755508,2018-08-25,Kimberly,F,-33.76,150.62,,6457e617-f317-4fc2-be31-b44f41be1148,-33.69,151.29,NSW,Warriewood,debit,authorized,20549a029d22404c824aad17b4009240,POS,30-40,2018,8,25,1,40,Saturday,7 days,37820.257
ACC-53508546,35,40.29,3272.39,1.0,CUS-72755508,2018-08-30,Kimberly,F,-33.76,150.62,,68d2fed9-2a8f-4d14-ac52-51e1afdacbc5,-33.81,150.97,NSW,Wentworthville,debit,authorized,d77c41a4722c40e2925cb6cf2d51865f,SALES-POS,30-40,2018,8,30,20,13,Thursday,7 days,37820.257
ACC-53508546,35,10.98,3986.73,1.0,CUS-72755508,2018-09-07,Kimberly,F,-33.76,150.62,,8c3ebdf3-ba3a-48da-a54a-5985d91fcde8,-33.8,151.18,NSW,Chatswood,debit,authorized,a805f13a95d1458cbc2ccf023d8708e0,SALES-POS,30-40,2018,9,7,20,1,Friday,7 days,37820.257
ACC-53508546,35,8.81,3977.92,0.0,CUS-72755508,2018-09-09,Kimberly,F,-33.76,150.62,,ccb3672c-9b7e-4414-ba30-d1016fbf1273,-33.73,150.9,NSW,Quakers Hill,debit,authorized,f5b224a456f247d2a8823456cc614d3d,POS,30-40,2018,9,9,20,31,Sunday,7 days,37820.257
ACC-53508546,35,90.74,3887.18,1.0,CUS-72755508,2018-09-11,Kimberly,F,-33.76,150.62,,21bb0379-bda2-4eb2-8b11-4c6cbec91cc7,-33.73,151.01,NSW,Castle Hill,debit,authorized,7a2a77bb2ae74dc59c5db524d0c851bf,SALES-POS,30-40,2018,9,11,9,49,Tuesday,7 days,37820.257
ACC-53508546,35,6.66,3880.52,1.0,CUS-72755508,2018-09-12,Kimberly,F,-33.76,150.62,,bdf4377a-77a8-4634-ae40-db1fd8128577,-33.9,151.17,NSW,Enmore,debit,authorized,6b8c826fdcbd4e33872718e6c591c54a,POS,30-40,2018,9,12,11,43,Wednesday,7 days,37820.257
ACC-53508546,35,26.94,4578.9,1.0,CUS-72755508,2018-09-14,Kimberly,F,-33.76,150.62,,ed56d0c6-0c74-45d4-92aa-67d4afe698ed,-33.79,151.08,NSW,Eastwood,debit,authorized,547df22076364f2683ced17855f27ffe,POS,30-40,2018,9,14,13,12,Friday,7 days,37820.257
ACC-53508546,35,40.0,4538.9,1.0,CUS-72755508,2018-09-17,Kimberly,F,-33.76,150.62,,f5fa6091-a464-4f01-b563-4a3cba0ae50c,-33.69,117.56,WA,Katanning,debit,authorized,17174f54e38042c6b36e0232432b7bbf,SALES-POS,30-40,2018,9,17,10,36,Monday,7 days,37820.257
ACC-53508546,35,15.04,5249.18,1.0,CUS-72755508,2018-09-26,Kimberly,F,-33.76,150.62,,60ee928a-e166-4322-8e84-2cd8ebdab596,-33.78,151.11,NSW,Macquarie Park,debit,authorized,2124ef244f6e4a838df07bf4f0c7d96c,POS,30-40,2018,9,26,11,10,Wednesday,7 days,37820.257
ACC-53508546,35,38.61,5935.89,1.0,CUS-72755508,2018-09-28,Kimberly,F,-33.76,150.62,,70402493-baff-49c0-adb7-661218d0c561,-33.79,151.26,NSW,Balgowlah,debit,authorized,d7f167a16ba647439d1afc7de6afa60b,POS,30-40,2018,9,28,22,30,Friday,7 days,37820.257
ACC-53508546,35,17.92,5917.97,1.0,CUS-72755508,2018-09-29,Kimberly,F,-33.76,150.62,,aaf60573-7bad-4bb4-a335-2d6c6c266658,-33.8,151.18,NSW,Chatswood,debit,authorized,f99b7c2ffe1043b8b6df130b73e0b864,SALES-POS,30-40,2018,9,29,11,36,Saturday,7 days,37820.257
ACC-53508546,35,23.26,5894.71,1.0,CUS-72755508,2018-10-01,Kimberly,F,-33.76,150.62,,9245d2a5-e78e-40cf-a459-58cc8142ca90,-33.77,151.17,NSW,Lindfield,debit,authorized,c881ea8f2877458d94969029ae6f3add,SALES-POS,30-40,2018,10,1,9,4,Monday,7 days,37820.257
ACC-53508546,35,11.57,5883.14,0.0,CUS-72755508,2018-10-01,Kimberly,F,-33.76,150.62,,536bf79f-9a64-4729-bca8-04bd391a024e,-33.81,151,NSW,Parramatta,debit,authorized,16fb7239dfd245788f46f783dc5380a1,SALES-POS,30-40,2018,10,1,9,18,Monday,7 days,37820.257
ACC-53508546,35,18.54,5864.6,0.0,CUS-72755508,2018-10-01,Kimberly,F,-33.76,150.62,,a89086cf-e639-43bc-8039-eb0b46ae7fd2,-37.81,144.96,VIC,Melbourne,debit,authorized,1b670d71426f420ca4579068a2cf9e7d,SALES-POS,30-40,2018,10,1,9,55,Monday,7 days,37820.257
ACC-53508546,35,10.74,5853.86,1.0,CUS-72755508,2018-10-02,Kimberly,F,-33.76,150.62,,9dd4a41c-f6ee-4829-be6d-a1b1a380c61c,-33.81,151.01,NSW,Parramatta,debit,authorized,82ff6b1344a744b6a9427ebb9e399934,SALES-POS,30-40,2018,10,2,9,0,Tuesday,7 days,37820.257
ACC-53508546,35,12.31,5841.55,1.0,CUS-72755508,2018-10-03,Kimberly,F,-33.76,150.62,,a4eafe0f-9f92-435d-a550-15ec6aa522cc,-33.8,151.29,NSW,Manly,debit,authorized,fdbde6fb54b24787968e4e2858f8234c,POS,30-40,2018,10,3,14,16,Wednesday,7 days,37820.257
ACC-53508546,35,142.14,6424.73,1.0,CUS-72755508,2018-10-04,Kimberly,F,-33.76,150.62,,d2c28ef2-e05a-4f22-963b-f6093de9201c,-33.74,150.95,NSW,Bella Vista,debit,authorized,25e203a4298e49b49ebbd7ac0b46c822,SALES-POS,30-40,2018,10,4,21,53,Thursday,7 days,37820.257
ACC-53508546,35,16.79,6407.94,0.0,CUS-72755508,2018-10-04,Kimberly,F,-33.76,150.62,,86771e1a-dccb-4caa-9789-f93b4925ffa4,-33.77,150.91,NSW,Blacktown,debit,authorized,d76a00230d3d44f3b8568b08203d7455,SALES-POS,30-40,2018,10,4,23,40,Thursday,7 days,37820.257
ACC-53508546,35,1180.0,5227.94,,CUS-72755508,2018-10-09,Kimberly,F,-33.76,150.62,,,,,,,debit,posted,47985dc1cd6d476d9d2f137c10a81afd,PAYMENT,30-40,2018,10,9,17,0,Tuesday,7 days,37820.257
ACC-53508546,35,33.69,5194.25,1.0,CUS-72755508,2018-10-09,Kimberly,F,-33.76,150.62,,51f03efa-4903-425b-b27e-c7ecfbc7789d,-33.81,151.02,NSW,Parramatta,debit,authorized,31fc6972ee56401282a82d9308a87f70,POS,30-40,2018,10,9,23,57,Tuesday,7 days,37820.257
ACC-53508546,35,23.32,5170.93,1.0,CUS-72755508,2018-10-10,Kimberly,F,-33.76,150.62,,e9d93864-dff9-4a9f-b327-8d03f64591e2,-33.8,151.18,NSW,Chatswood,debit,authorized,54f21ccd953b4dbab311e89381e0499f,SALES-POS,30-40,2018,10,10,9,50,Wednesday,7 days,37820.257
ACC-53508546,35,17.78,5878.47,1.0,CUS-72755508,2018-10-12,Kimberly,F,-33.76,150.62,,99b83958-65d2-4d5a-8895-e99a38d43dc3,-33.77,150.82,NSW,Mount Druitt,debit,authorized,50bb27d59967429fa35f8fa9aa197a7f,POS,30-40,2018,10,12,20,19,Friday,7 days,37820.257
ACC-53508546,35,22.14,5856.33,1.0,CUS-72755508,2018-10-13,Kimberly,F,-33.76,150.62,,db9467d3-6379-446a-9698-d5941e42aa43,-33.78,151.12,NSW,North Ryde,debit,authorized,c6eb072339974a5abc9d8c584b22e584,SALES-POS,30-40,2018,10,13,9,21,Saturday,7 days,37820.257
ACC-53508546,35,10.86,5845.47,1.0,CUS-72755508,2018-10-13,Kimberly,F,-33.76,150.62,,c6e68256-60d6-4a60-863f-722d05e45826,-33.78,151.04,NSW,Carlingford,debit,authorized,9b16b1e469e44e20b92fe59d471dd2f9,SALES-POS,30-40,2018,10,13,10,32,Saturday,7 days,37820.257
ACC-53508546,35,10.76,5834.71,1.0,CUS-72755508,2018-10-15,Kimberly,F,-33.76,150.62,,4f88af43-5e1f-4494-a491-17cd0553e0ab,-33.81,151.09,NSW,West Ryde,debit,authorized,7f2a236dc2b44ed0a5131ece011a9e2b,SALES-POS,30-40,2018,10,15,13,25,Monday,7 days,37820.257
ACC-53508546,35,5.19,6554.84,1.0,CUS-72755508,2018-10-18,Kimberly,F,-33.76,150.62,,5d3d4cce-eb06-43e8-b671-56f7f687598e,-33.81,151.01,NSW,Parramatta,debit,authorized,a9afc245bc0f4ab8b50d5ffa51cb28db,POS,30-40,2018,10,18,22,30,Thursday,7 days,37820.257
ACC-53508546,35,29.8,6525.04,0.0,CUS-72755508,2018-10-19,Kimberly,F,-33.76,150.62,,be524cb9-6f7d-406c-9cee-06e58260cc4c,-33.79,151.19,NSW,Chatswood,debit,authorized,1a7895dd11b04ed4b81e1d107ac1e6a4,SALES-POS,30-40,2018,10,19,8,19,Friday,7 days,37820.257
ACC-53508546,35,60.4,6464.64,1.0,CUS-72755508,2018-10-25,Kimberly,F,-33.76,150.62,,e234cbd2-be0c-4e7d-8e4b-2b84b5bac0d6,-33.87,151.21,NSW,Sydney,debit,authorized,a8d9b4bb62704ee69e7cd3073c4fb39c,POS,30-40,2018,10,25,9,22,Thursday,7 days,37820.257
ACC-53508546,35,26.89,6437.75,1.0,CUS-72755508,2018-10-25,Kimberly,F,-33.76,150.62,,22f1dbd9-7510-4dc8-a34b-512013ffa50f,-33.79,151.19,NSW,Chatswood,debit,authorized,cd74314b14c84f749aae2a784d5430f6,SALES-POS,30-40,2018,10,25,14,35,Thursday,7 days,37820.257
ACC-53508546,35,25.98,7137.09,1.0,CUS-72755508,2018-10-25,Kimberly,F,-33.76,150.62,,c9744c93-e984-40f0-82b4-aa09b945fe50,-34.43,150.89,NSW,Wollongong,debit,authorized,499e689b3a7a48d080f5d3fc328e5cd8,SALES-POS,30-40,2018,10,25,19,4,Thursday,7 days,37820.257
ACC-53508546,35,19.73,7117.36,1.0,CUS-72755508,2018-10-28,Kimberly,F,-33.76,150.62,,96257b5b-1646-452f-b3fa-f979cc18a6b4,-33.7,115.19,WA,Carbunup River,debit,authorized,28df650273ba429f941b2a68df911f7a,SALES-POS,30-40,2018,10,28,21,23,Sunday,7 days,37820.257
ACC-53508546,35,10.22,7107.14,1.0,CUS-72755508,2018-10-30,Kimberly,F,-33.76,150.62,,5eaf5637-e53b-42d1-b3d2-ee473a60bab3,-33.78,151.05,NSW,Carlingford,debit,authorized,49666bd95fc54ca3ada7afa2d4212895,SALES-POS,30-40,2018,10,30,12,56,Tuesday,7 days,37820.257
ACC-53508546,35,70.58,7036.56,1.0,CUS-72755508,2018-10-31,Kimberly,F,-33.76,150.62,,e42055f4-e6a9-4915-9936-035981fd3de2,-33.79,151.12,NSW,North Ryde,debit,authorized,7830702140b44d03af6d33ee79a9c6f1,POS,30-40,2018,10,31,19,57,Wednesday,7 days,37820.257
ACC-1424176027,22,195.0,290.88,,CUS-3431016847,2018-08-02,Donald,M,-33.93,151.08,,,,,,,debit,posted,a8401bad8bcb490b938a06a09ae38642,PAYMENT,20-30,2018,8,2,20,0,Thursday,14 days,50291.004
ACC-1424176027,22,23.25,485.88,1.0,CUS-3431016847,2018-08-02,Donald,M,-33.93,151.08,,9fafd25e-2baa-44ee-8ca3-bd2edfcd9150,-33.91,150.92,NSW,Liverpool,debit,authorized,2750e465d9d24cd595425cb4046a4a4f,POS,20-30,2018,8,2,20,32,Thursday,14 days,50291.004
ACC-1424176027,22,7.56,283.32,0.0,CUS-3431016847,2018-08-03,Donald,M,-33.93,151.08,,8ec841ad-1293-4bf5-9920-6e1088bc414d,-34.19,142.16,VIC,Mildura,debit,authorized,623213708c7c4af288028cd581c1380d,SALES-POS,20-30,2018,8,3,9,28,Friday,14 days,50291.004
ACC-1424176027,22,12.16,271.16,1.0,CUS-3431016847,2018-08-03,Donald,M,-33.93,151.08,,88787513-a6c7-494f-8f23-09faee181335,-33.9,151.25,NSW,Waverley,debit,authorized,9b9681d296d3468e954166d6fbd04375,SALES-POS,20-30,2018,8,3,11,28,Friday,14 days,50291.004
ACC-1424176027,22,4.77,2195.36,1.0,CUS-3431016847,2018-08-11,Donald,M,-33.93,151.08,,955893db-32f0-4efb-9e1b-ecc690aa742f,-33.89,151.26,NSW,Bondi Junction,debit,authorized,64274e8302a947bb90618ad3330ffd3c,SALES-POS,20-30,2018,8,11,8,18,Saturday,14 days,50291.004
ACC-1424176027,22,186.0,2009.36,,CUS-3431016847,2018-08-11,Donald,M,-33.93,151.08,,,,,,,debit,posted,36b141557d844f3282a70c54a18739c2,PAYMENT,20-30,2018,8,11,19,0,Saturday,14 days,50291.004
ACC-1424176027,22,55.76,1953.6,1.0,CUS-3431016847,2018-08-15,Donald,M,-33.93,151.08,,f4cfc3c1-9926-47ad-b094-d912f325ae3f,-33.87,151.21,NSW,Sydney,debit,authorized,228cc14b93694fbeb9a073df9b1a6813,POS,20-30,2018,8,15,9,53,Wednesday,14 days,50291.004
ACC-1424176027,22,9.88,1943.72,1.0,CUS-3431016847,2018-08-15,Donald,M,-33.93,151.08,,c091541c-c2cc-4657-a44d-8ce2611f2951,-33.94,151.2,NSW,Botany,debit,authorized,6c1785a25d82451097990c98c0cb840b,SALES-POS,20-30,2018,8,15,12,43,Wednesday,14 days,50291.004
ACC-1424176027,22,15.59,1928.13,0.0,CUS-3431016847,2018-08-15,Donald,M,-33.93,151.08,,20f3ff9a-d1e4-45f3-82ee-9cae00f3c2fc,-33.85,151.03,NSW,Auburn,debit,authorized,160f4a8a99644829b1320179b2cae086,POS,20-30,2018,8,15,14,45,Wednesday,14 days,50291.004
ACC-1424176027,22,14.46,1913.67,1.0,CUS-3431016847,2018-08-15,Donald,M,-33.93,151.08,,62eb2c20-ff3d-43ae-ae2d-925a05c39f02,-33.94,151.19,NSW,Mascot,debit,authorized,0525c0ace11542d49e7a156e4cbffc4b,SALES-POS,20-30,2018,8,15,17,21,Wednesday,14 days,50291.004
ACC-1424176027,22,14.3,3828.34,1.0,CUS-3431016847,2018-08-24,Donald,M,-33.93,151.08,,9e6d9ce2-bf46-46f4-a9e6-9e2d5ffbd09d,-33.68,122.54,WA,Condingup,debit,authorized,459ec3ded9bb4017933f00a34d1c748a,SALES-POS,20-30,2018,8,24,5,26,Friday,14 days,50291.004
ACC-1424176027,22,21.66,3806.68,0.0,CUS-3431016847,2018-08-24,Donald,M,-33.93,151.08,,87a18ada-8920-45c7-aae8-66861e9ae6fa,-33.91,150.96,NSW,Chipping Norton,debit,authorized,049793fec41b4027a790b5fb1e90b2d8,POS,20-30,2018,8,24,8,59,Friday,14 days,50291.004
ACC-1424176027,22,3.55,3803.13,1.0,CUS-3431016847,2018-08-24,Donald,M,-33.93,151.08,,3350d0c0-b4e3-47ee-8fd2-cdd42100e258,-33.9,151.16,NSW,Marrickville,debit,authorized,699ed8be97dc4607baf9ca77d559796e,POS,20-30,2018,8,24,13,21,Friday,14 days,50291.004
ACC-1424176027,22,16.9,3786.23,1.0,CUS-3431016847,2018-08-31,Donald,M,-33.93,151.08,,3a1a327b-db5e-4db3-bd83-df84d8253096,-33.68,136.93,SA,Cowell,debit,authorized,96cce48cb606485ea051cc223d88d617,POS,20-30,2018,8,31,9,14,Friday,14 days,50291.004
ACC-1424176027,22,47.83,3738.4,1.0,CUS-3431016847,2018-08-31,Donald,M,-33.93,151.08,,20350a17-ead5-464b-bea9-5cbf33362de2,-37.9,145.09,VIC,Oakleigh,debit,authorized,1476d6c58cc44e64a56036158ed4ae0a,POS,20-30,2018,8,31,13,24,Friday,14 days,50291.004
ACC-1424176027,22,14.21,3724.19,1.0,CUS-3431016847,2018-08-31,Donald,M,-33.93,151.08,,08f4f809-fafc-4123-8a7d-a0ab650b27cd,-33.79,151.12,NSW,Ryde,debit,authorized,5284ecd11125439fbac2054190804317,POS,20-30,2018,8,31,21,9,Friday,14 days,50291.004
ACC-1424176027,22,195.0,3529.19,,CUS-3431016847,2018-09-02,Donald,M,-33.93,151.08,,,,,,,debit,posted,16b1d8ae70de4556b640498a35c34617,PAYMENT,20-30,2018,9,2,20,0,Sunday,14 days,50291.004
ACC-1424176027,22,23.46,3505.73,1.0,CUS-3431016847,2018-09-02,Donald,M,-33.93,151.08,,a79036c3-1880-4066-81cf-2daea81ac507,-33.9,151.21,NSW,Redfern,debit,authorized,769d6a3c7ee34d63bdca4f599bd97a63,POS,20-30,2018,9,2,21,11,Sunday,14 days,50291.004
ACC-1424176027,22,15.4,3490.33,1.0,CUS-3431016847,2018-09-03,Donald,M,-33.93,151.08,,58112f2c-95ea-4cb7-90c7-c10640aa8b13,-33.81,150.97,NSW,Wentworthville,debit,authorized,807a6dd8a26e49d8ad00ddd3203b860b,SALES-POS,20-30,2018,9,3,18,7,Monday,14 days,50291.004
ACC-1424176027,22,15.07,3475.26,1.0,CUS-3431016847,2018-09-04,Donald,M,-33.93,151.08,,c3f4ae28-c55c-4a59-b41c-ed2553ce0ca7,-33.94,151.22,NSW,Eastgardens,debit,authorized,bcbe8e6b88d94094b123d3227d57c90f,POS,20-30,2018,9,4,10,46,Tuesday,14 days,50291.004
ACC-1424176027,22,53.09,3422.17,0.0,CUS-3431016847,2018-09-04,Donald,M,-33.93,151.08,,41649cbd-5b5f-4c3b-8428-80ccec68d3c0,-33.89,151.21,NSW,Surry Hills,debit,authorized,e397d5578fc3484ba7d836a501c0dbd5,POS,20-30,2018,9,4,16,38,Tuesday,14 days,50291.004
ACC-1424176027,22,6.45,3415.72,1.0,CUS-3431016847,2018-09-04,Donald,M,-33.93,151.08,,cc8b5572-d5b4-4493-9c1c-e0d00df22efa,-33.82,151.01,NSW,Harris Park,debit,authorized,934b75add82041d797de0fd60d0991eb,SALES-POS,20-30,2018,9,4,16,59,Tuesday,14 days,50291.004
ACC-1424176027,22,12.56,3403.16,1.0,CUS-3431016847,2018-09-06,Donald,M,-33.93,151.08,,fd1c9a34-9224-4338-9716-e8f10005b83a,-27.43,153,QLD,Alderley,debit,authorized,7f5da0cdf08a4094a6abe0996ac9f269,SALES-POS,20-30,2018,9,6,14,31,Thursday,14 days,50291.004
ACC-1424176027,22,9.2,5322.93,1.0,CUS-3431016847,2018-09-06,Donald,M,-33.93,151.08,,33c2ce8e-ff31-4ae1-a28c-df1af2715bf9,-33.88,151.21,NSW,Surry Hills,debit,authorized,bc2b080084794c12993b5f0ae8275faf,SALES-POS,20-30,2018,9,6,21,14,Thursday,14 days,50291.004
ACC-1424176027,22,11.34,5311.59,1.0,CUS-3431016847,2018-09-07,Donald,M,-33.93,151.08,,442dd83e-297a-46e7-83af-8c82e549886b,-33.89,151.28,NSW,Bondi Beach,debit,authorized,0c95dd22cd4c4d9d8474b0bfd8b5d746,POS,20-30,2018,9,7,9,14,Friday,14 days,50291.004
ACC-1424176027,22,13.88,5297.71,1.0,CUS-3431016847,2018-09-07,Donald,M,-33.93,151.08,,718a6999-71c3-4289-9b5e-faceee179ff6,-33.89,151.25,NSW,Bondi Junction,debit,authorized,2d848ba2092d437c87cef9773b9a8847,SALES-POS,20-30,2018,9,7,9,20,Friday,14 days,50291.004
ACC-1424176027,22,24.43,5273.28,1.0,CUS-3431016847,2018-09-07,Donald,M,-33.93,151.08,,e255f424-a557-4e38-ba6b-53af1055b3cc,-33.84,151.2,NSW,Waverton,debit,authorized,b05b355cdb284d5ba1c9b04a5c9408be,POS,20-30,2018,9,7,12,58,Friday,14 days,50291.004
ACC-1424176027,22,14.24,5259.04,1.0,CUS-3431016847,2018-09-07,Donald,M,-33.93,151.08,,810f6ad7-0020-4158-974b-77a8b86ed691,-33.86,151.21,NSW,Sydney,debit,authorized,a171c4c17f5a4cc290b0140296611353,POS,20-30,2018,9,7,14,31,Friday,14 days,50291.004
ACC-1424176027,22,8.74,5250.3,1.0,CUS-3431016847,2018-09-08,Donald,M,-33.93,151.08,,bb6ec4f9-6fe1-4f95-8c81-0f5e866a132f,-33.93,150.89,NSW,Prestons,debit,authorized,879bbad8a49e4000a4fc4cfdd07e4d08,SALES-POS,20-30,2018,9,8,6,57,Saturday,14 days,50291.004
ACC-1424176027,22,186.0,5064.3,,CUS-3431016847,2018-09-11,Donald,M,-33.93,151.08,,,,,,,debit,posted,c512103b059a437c83d4db49104d140c,PAYMENT,20-30,2018,9,11,19,0,Tuesday,14 days,50291.004
ACC-1424176027,22,34.36,6958.91,1.0,CUS-3431016847,2018-09-22,Donald,M,-33.93,151.08,,fb8b1c61-aa5b-4830-bb26-810929d6aa85,-33.68,151.23,NSW,Terrey Hills,debit,authorized,e808ec1dc9d74779a56f0a4589470324,POS,20-30,2018,9,22,15,51,Saturday,14 days,50291.004
ACC-1424176027,22,11.01,6947.9,1.0,CUS-3431016847,2018-09-22,Donald,M,-33.93,151.08,,b462d997-f440-4b25-8da9-a02bdc53d4f1,-33.79,151.19,NSW,Chatswood,debit,authorized,2ccb31cf747f47b48e2ba84331882508,POS,20-30,2018,9,22,16,5,Saturday,14 days,50291.004
ACC-1424176027,22,18.45,6929.45,1.0,CUS-3431016847,2018-09-22,Donald,M,-33.93,151.08,,f9179fe3-5d59-4119-8562-c54a05269bb8,-33.86,151.18,NSW,Balmain,debit,authorized,6d9905f79a6145f39c834b539d4a20ad,SALES-POS,20-30,2018,9,22,17,37,Saturday,14 days,50291.004
ACC-1424176027,22,6.38,6923.07,1.0,CUS-3431016847,2018-09-28,Donald,M,-33.93,151.08,,da8181d4-efb8-4c5f-a88a-0892c60a97d9,-33.83,151.05,NSW,Silverwater,debit,authorized,d4e67c0aeea64928b3c53ab669339afa,POS,20-30,2018,9,28,4,50,Friday,14 days,50291.004
ACC-1424176027,22,46.05,6877.02,1.0,CUS-3431016847,2018-09-28,Donald,M,-33.93,151.08,,8a7abe86-6950-491c-a6c0-5e83e1e5fdbe,-27.59,153.1,QLD,Eight Mile Plains,debit,authorized,ab450b4c122b467f9b8352d00e52fa98,SALES-POS,20-30,2018,9,28,10,13,Friday,14 days,50291.004
ACC-1424176027,22,7.88,6869.14,0.0,CUS-3431016847,2018-09-28,Donald,M,-33.93,151.08,,68c05695-d552-4a40-b4a8-cc9f8d88b18f,-33.97,139,SA,Robertson,debit,authorized,9d6de7035e824f598f98c5c24ddf6ea5,POS,20-30,2018,9,28,11,38,Friday,14 days,50291.004
ACC-1424176027,22,7.66,6861.48,1.0,CUS-3431016847,2018-10-01,Donald,M,-33.93,151.08,,0bb3f6d5-ed4b-4ec2-8666-7989564d231d,-33.88,151.26,NSW,Rose Bay,debit,authorized,89eaff402c8a445fab644c291b45660f,SALES-POS,20-30,2018,10,1,17,49,Monday,14 days,50291.004
ACC-1424176027,22,195.0,6666.48,,CUS-3431016847,2018-10-02,Donald,M,-33.93,151.08,,,,,,,debit,posted,a617cdfacc224dc9b9979c5e05ddc8eb,PAYMENT,20-30,2018,10,2,20,0,Tuesday,14 days,50291.004
ACC-1424176027,22,29.07,6637.41,0.0,CUS-3431016847,2018-10-03,Donald,M,-33.93,151.08,,af8eb8c2-52ad-4590-9373-1b34be90c338,-33.9,151,NSW,Bass Hill,debit,authorized,e7b867e0f1fd417ea9e7db9b939295ec,POS,20-30,2018,10,3,19,47,Wednesday,14 days,50291.004
ACC-1424176027,22,19.04,6618.37,1.0,CUS-3431016847,2018-10-04,Donald,M,-33.93,151.08,,c38d0948-0f40-4c37-994e-9f7fee3a844d,-33.73,151.08,NSW,Thornleigh,debit,authorized,563d87419f5b451186bd263912134542,POS,20-30,2018,10,4,9,50,Thursday,14 days,50291.004
ACC-1424176027,22,13.43,6604.94,1.0,CUS-3431016847,2018-10-04,Donald,M,-33.93,151.08,,422e4c44-2a4c-4159-b466-98fa440d4919,-33.76,150.99,NSW,Baulkham Hills,debit,authorized,9b400a6220104041895a97ec25d20b9b,SALES-POS,20-30,2018,10,4,10,41,Thursday,14 days,50291.004
ACC-1424176027,22,10.11,8523.8,0.0,CUS-3431016847,2018-10-06,Donald,M,-33.93,151.08,,d45734b6-bb82-4a47-af48-848ca00f786c,-33.75,150.74,NSW,Werrington County,debit,authorized,367715be154a4ef59de3bf54f5ecca7b,SALES-POS,20-30,2018,10,6,19,46,Saturday,14 days,50291.004
ACC-1424176027,22,11.57,8512.23,1.0,CUS-3431016847,2018-10-07,Donald,M,-33.93,151.08,,0fadddf3-a178-4d76-8d7a-f4352b2434a2,-33.91,151.26,NSW,Clovelly,debit,authorized,c5a2ac87461c4375acb195dea0ade303,POS,20-30,2018,10,7,15,23,Sunday,14 days,50291.004
ACC-1424176027,22,39.67,8472.56,1.0,CUS-3431016847,2018-10-08,Donald,M,-33.93,151.08,,52be1d52-533e-45ec-8f27-7721f9535c87,-33.91,150.87,NSW,Green Valley,debit,authorized,c1dff3c710f44e36bf81d201aed9101a,POS,20-30,2018,10,8,18,13,Monday,14 days,50291.004
ACC-1424176027,22,186.0,8286.56,,CUS-3431016847,2018-10-11,Donald,M,-33.93,151.08,,,,,,,debit,posted,48ed26ed8ead45f5bb4b716534e7c1bb,PAYMENT,20-30,2018,10,11,19,0,Thursday,14 days,50291.004
ACC-1424176027,22,10.86,8275.7,1.0,CUS-3431016847,2018-10-12,Donald,M,-33.93,151.08,,e6522fb2-6e98-457d-bbd8-290011d0984b,-33.7,151.3,NSW,North Narrabeen,debit,authorized,b3df3ce1efc644d090cfc24b037090b5,SALES-POS,20-30,2018,10,12,1,19,Friday,14 days,50291.004
ACC-1424176027,22,14.27,8261.43,1.0,CUS-3431016847,2018-10-12,Donald,M,-33.93,151.08,,6002d4a8-6e1e-4ac6-9732-b7325af6c530,-31.06,151.05,NSW,Kootingal,debit,authorized,57a04283c36f4304b368df2229be020f,SALES-POS,20-30,2018,10,12,2,39,Friday,14 days,50291.004
ACC-1424176027,22,4.49,8256.94,1.0,CUS-3431016847,2018-10-12,Donald,M,-33.93,151.08,,1a597f73-2485-40b0-98fa-6cfccf294adb,-33.88,151.28,NSW,Dover Heights,debit,authorized,bd54909b34994e05af0615b704455d02,SALES-POS,20-30,2018,10,12,19,53,Friday,14 days,50291.004
ACC-1424176027,22,1854.0,8331.91,,CUS-3431016847,2018-10-23,Donald,M,-33.93,151.08,,,,,,,debit,posted,894539f2f12448f8943f248d98aac0e9,PAYMENT,20-30,2018,10,23,17,0,Tuesday,14 days,50291.004
ACC-3317636250,35,42.94,147.58,0.0,CUS-2738291516,2018-08-02,Kenneth,M,-27.66,153.02,,e3e28ad9-50a4-4a33-b675-bb611d49b517,-27.7,114.17,WA,Kalbarri,debit,authorized,46057999ca3d45b98dc5fa7442a43708,POS,30-40,2018,8,2,21,14,Thursday,7 days,132691.057
ACC-3317636250,35,28.21,119.37,1.0,CUS-2738291516,2018-08-02,Kenneth,M,-27.66,153.02,,c650b4d8-848b-411a-a56e-70a914fbba7c,-27.67,153.14,QLD,Meadowbrook,debit,authorized,bd9b4e94145f4f47bdd7f9fe8af40376,SALES-POS,30-40,2018,8,2,21,47,Thursday,7 days,132691.057
ACC-3317636250,35,18.51,100.86,1.0,CUS-2738291516,2018-08-03,Kenneth,M,-27.66,153.02,,2c947b40-d708-44b7-9ec0-1889e016aeac,-27.08,152.96,QLD,Caboolture,debit,authorized,0753aa9b6f324a07a779e5133f19faa7,POS,30-40,2018,8,3,4,39,Friday,7 days,132691.057
ACC-3317636250,35,25.15,2620.47,1.0,CUS-2738291516,2018-08-03,Kenneth,M,-27.66,153.02,,abf31fa7-2b8d-421b-85ca-1c81a4a04b64,-33.87,151.2,NSW,Sydney,debit,authorized,7e82849423a2434caba02925c91e8324,SALES-POS,30-40,2018,8,3,21,14,Friday,7 days,132691.057
ACC-3317636250,35,38.06,2582.41,1.0,CUS-2738291516,2018-08-04,Kenneth,M,-27.66,153.02,,8875d96e-09c6-4eeb-a080-e185fbcfc278,-27.49,153.22,QLD,Birkdale,debit,authorized,15ce948d953749dca38d9bf432cf3453,SALES-POS,30-40,2018,8,4,11,34,Saturday,7 days,132691.057
ACC-3317636250,35,28.51,2553.9,1.0,CUS-2738291516,2018-08-05,Kenneth,M,-27.66,153.02,,5ad21473-0dd2-400d-a915-1971c1c828d6,-26.4,153.09,QLD,Noosa Heads,debit,authorized,a58b62ea520344528b8d395187849c73,SALES-POS,30-40,2018,8,5,21,55,Sunday,7 days,132691.057
ACC-3317636250,35,29.71,2524.19,0.0,CUS-2738291516,2018-08-06,Kenneth,M,-27.66,153.02,,f9023826-e226-4a52-a886-bedc6a0f03eb,-33.87,151.21,NSW,Sydney,debit,authorized,61b7bb46497349f7b7c9b47a283653d0,SALES-POS,30-40,2018,8,6,17,48,Monday,7 days,132691.057
ACC-3317636250,35,45.09,2479.1,1.0,CUS-2738291516,2018-08-06,Kenneth,M,-27.66,153.02,,c9342e41-f513-47c1-9d7c-a54ca1963ef0,-27.23,153.09,QLD,Kippa-Ring,debit,authorized,0ce414278e054c9f8b22299c54ae2b1c,SALES-POS,30-40,2018,8,6,21,46,Monday,7 days,132691.057
ACC-3317636250,35,30.72,2448.38,1.0,CUS-2738291516,2018-08-08,Kenneth,M,-27.66,153.02,,1a2e2110-bbbd-4ab9-b1b7-0a13e0c06064,-27.62,153.11,QLD,Woodridge,debit,authorized,cc5117aa6f7d4a2f858182b6f5347f84,POS,30-40,2018,8,8,4,8,Wednesday,7 days,132691.057
ACC-3317636250,35,73.0,2375.38,,CUS-2738291516,2018-08-09,Kenneth,M,-27.66,153.02,,,,,,,debit,posted,87d2203fd4484eca9729f3fbdacc9ed6,INTER BANK,30-40,2018,8,9,12,0,Thursday,7 days,132691.057
ACC-3317636250,35,44.14,4876.0,1.0,CUS-2738291516,2018-08-10,Kenneth,M,-27.66,153.02,,a90a2529-156f-4628-a5da-875a6e49b626,-27.23,153.09,QLD,Kippa-Ring,debit,authorized,9620b8118cf04c6287f6802eb2186ac4,SALES-POS,30-40,2018,8,10,19,38,Friday,7 days,132691.057
ACC-3317636250,35,43.96,4832.04,0.0,CUS-2738291516,2018-08-11,Kenneth,M,-27.66,153.02,,fe6cc23e-fe99-490d-8186-efaa0c2ad029,-27.59,152.93,QLD,Wacol,debit,authorized,1b5ba43d42634ad594be97f65793e1a7,SALES-POS,30-40,2018,8,11,19,19,Saturday,7 days,132691.057
ACC-3317636250,35,75.0,4757.04,1.0,CUS-2738291516,2018-08-17,Kenneth,M,-27.66,153.02,,1636b21a-186b-4139-b6f0-14495992bed4,-27.5,153.4,QLD,Dunwich,debit,authorized,4540be2d198946409edd22152986ad1f,SALES-POS,30-40,2018,8,17,11,17,Friday,7 days,132691.057
ACC-3317636250,35,2.63,4754.41,1.0,CUS-2738291516,2018-08-17,Kenneth,M,-27.66,153.02,,8527fb30-cc8e-415a-9008-9a30c9739cb1,-27.52,152.98,QLD,Graceville,debit,authorized,d29369ee32b64386a48bfcd13fb661aa,POS,30-40,2018,8,17,14,10,Friday,7 days,132691.057
ACC-3317636250,35,10.09,7289.08,1.0,CUS-2738291516,2018-08-17,Kenneth,M,-27.66,153.02,,bbf16eba-77de-40e7-adf1-edd981936615,-27.5,153.21,QLD,Birkdale,debit,authorized,84e94f9e161b481dbf4039e07242e5a9,SALES-POS,30-40,2018,8,17,20,36,Friday,7 days,132691.057
ACC-3317636250,35,90.0,7199.08,,CUS-2738291516,2018-08-18,Kenneth,M,-27.66,153.02,,,,,,,debit,posted,a0efabe96cc14b0bb2c9788b810c1c08,INTER BANK,30-40,2018,8,18,2,0,Saturday,7 days,132691.057
ACC-3317636250,35,31.27,7167.81,0.0,CUS-2738291516,2018-08-18,Kenneth,M,-27.66,153.02,,78cd8c14-6242-4d07-a49f-af519ac27d02,-27.66,153.18,QLD,Shailer Park,debit,authorized,7fad3a0b8b5d493f9117c6acc904c130,POS,30-40,2018,8,18,10,58,Saturday,7 days,132691.057
ACC-3317636250,35,13.54,7154.27,1.0,CUS-2738291516,2018-08-18,Kenneth,M,-27.66,153.02,,0a677d71-967c-4aa1-b23c-98a70786e501,-27.52,152.94,QLD,Kenmore,debit,authorized,09b18894051f446eb2901d67de47070e,SALES-POS,30-40,2018,8,18,15,19,Saturday,7 days,132691.057
ACC-3317636250,35,38.63,7115.64,1.0,CUS-2738291516,2018-08-18,Kenneth,M,-27.66,153.02,,6d7ab2fc-2496-4747-b772-3cc637966896,-27.36,153.04,QLD,Zillmere,debit,authorized,e0d2cc0bbabb45fba9c7b883de0ecc0f,POS,30-40,2018,8,18,16,41,Saturday,7 days,132691.057
ACC-3317636250,35,121.0,6994.64,,CUS-2738291516,2018-08-22,Kenneth,M,-27.66,153.02,,,,,,,debit,posted,facf5182259e429298bdb7aa65d31575,PAYMENT,30-40,2018,8,22,17,0,Wednesday,7 days,132691.057
ACC-3317636250,35,11.27,6983.37,1.0,CUS-2738291516,2018-08-23,Kenneth,M,-27.66,153.02,,4533f924-6d16-48cc-b96b-d784a2473fb9,-34.86,138.65,SA,Windsor Gardens,debit,authorized,5762ef1cfefa4e05961883d077a34f7a,POS,30-40,2018,8,23,12,48,Thursday,7 days,132691.057
ACC-3317636250,35,32.67,6950.7,1.0,CUS-2738291516,2018-08-24,Kenneth,M,-27.66,153.02,,554ed673-fb01-448d-aaf3-7afe00828ceb,-27.53,152.95,QLD,Jindalee,debit,authorized,00e0294ceca54fe8804390cfe683878c,SALES-POS,30-40,2018,8,24,13,40,Friday,7 days,132691.057
ACC-3317636250,35,31.52,6919.18,1.0,CUS-2738291516,2018-08-24,Kenneth,M,-27.66,153.02,,7cbc7858-b82d-4ba3-884f-be894d456fb2,-27.42,153.06,QLD,Clayfield,debit,authorized,8d238e6a45b7466fad333e0b00469558,POS,30-40,2018,8,24,14,17,Friday,7 days,132691.057
ACC-3317636250,35,28.95,9434.99,1.0,CUS-2738291516,2018-08-26,Kenneth,M,-27.66,153.02,,ea58019c-28c3-491e-a912-546868e39b0f,-27.44,153.02,QLD,Windsor,debit,authorized,7767729fea4043cda6caf76eccd3a33b,POS,30-40,2018,8,26,15,42,Sunday,7 days,132691.057
ACC-3317636250,35,44.96,9390.03,1.0,CUS-2738291516,2018-08-26,Kenneth,M,-27.66,153.02,,153c2c0b-f692-4ce0-9e3d-3257b6936d36,-27.56,152.93,QLD,Middle Park,debit,authorized,a7f7418ecb25448b87520df8b67f8a0a,SALES-POS,30-40,2018,8,26,19,36,Sunday,7 days,132691.057
ACC-3317636250,35,24.84,9365.19,1.0,CUS-2738291516,2018-08-27,Kenneth,M,-27.66,153.02,,49cefe94-8c21-4db7-af58-cc5fbd9e8809,-27.71,114.16,WA,Kalbarri,debit,authorized,3ce012bdf3fc40da912fd99365fff4ea,SALES-POS,30-40,2018,8,27,9,44,Monday,7 days,132691.057
ACC-3317636250,35,93.0,9272.19,,CUS-2738291516,2018-08-28,Kenneth,M,-27.66,153.02,,,,,,,debit,posted,a81ab27940ab4840bdff62fa0f1d7fc2,PAYMENT,30-40,2018,8,28,8,0,Tuesday,7 days,132691.057
ACC-3317636250,35,1551.0,7721.19,,CUS-2738291516,2018-08-30,Kenneth,M,-27.66,153.02,,,,,,,debit,posted,cbee2e46d2d74a1f8dee14034c1d4d73,PAYMENT,30-40,2018,8,30,23,0,Thursday,7 days,132691.057
ACC-3317636250,35,75.73,10190.22,0.0,CUS-2738291516,2018-09-03,Kenneth,M,-27.66,153.02,,c317edf0-8d1a-4dfd-b272-dee1ea4f3331,-27.56,151.95,QLD,Toowoomba City,debit,authorized,04d2f7502ecc4ff2a576a00698aded81,SALES-POS,30-40,2018,9,3,9,55,Monday,7 days,132691.057
ACC-3317636250,35,19.68,10170.54,1.0,CUS-2738291516,2018-09-05,Kenneth,M,-27.66,153.02,,bdcf9ea0-9997-4409-b44f-a05b96fb41d8,-37.85,144.98,VIC,Melbourne,debit,authorized,cb9fe0a6b3da4ec6b7577f4373244f3c,POS,30-40,2018,9,5,11,17,Wednesday,7 days,132691.057
ACC-3317636250,35,6.4,10164.14,1.0,CUS-2738291516,2018-09-06,Kenneth,M,-27.66,153.02,,0e976dfc-9444-4756-930f-164e5d5aaa21,-37.85,145.05,VIC,Hawthorn East,debit,authorized,70bbc35baad542b49751ee521ee674b8,SALES-POS,30-40,2018,9,6,11,41,Thursday,7 days,132691.057
ACC-3317636250,35,73.0,12635.9,,CUS-2738291516,2018-09-09,Kenneth,M,-27.66,153.02,,,,,,,debit,posted,54870dcbff844331b28f16c37deec8cf,INTER BANK,30-40,2018,9,9,12,0,Sunday,7 days,132691.057
ACC-3317636250,35,1965.0,10670.9,,CUS-2738291516,2018-09-10,Kenneth,M,-27.66,153.02,,,,,,,debit,posted,8081958577114f8f81639e51ef029eec,PAYMENT,30-40,2018,9,10,16,0,Monday,7 days,132691.057
ACC-3317636250,35,90.0,13125.66,,CUS-2738291516,2018-09-18,Kenneth,M,-27.66,153.02,,,,,,,debit,posted,eaac29ece96e44089b2285a5ca8f19d1,INTER BANK,30-40,2018,9,18,2,0,Tuesday,7 days,132691.057
ACC-3317636250,35,8.06,13117.6,1.0,CUS-2738291516,2018-09-20,Kenneth,M,-27.66,153.02,,c9eea420-8414-40c3-bb4a-104465d3a461,-27.5,153.09,QLD,Carina,debit,authorized,f777cf5dde944edfb878638bdbba902e,POS,30-40,2018,9,20,21,3,Thursday,7 days,132691.057
ACC-3317636250,35,30.63,13086.97,1.0,CUS-2738291516,2018-09-21,Kenneth,M,-27.66,153.02,,780c3e1e-47b6-49d3-a59f-6c86b4d1c924,-27.76,153.25,QLD,Ormeau,debit,authorized,777d8eb51aca4644901c15a80b88a496,POS,30-40,2018,9,21,15,30,Friday,7 days,132691.057
ACC-3317636250,35,121.0,15510.73,,CUS-2738291516,2018-09-22,Kenneth,M,-27.66,153.02,,,,,,,debit,posted,3f8c43eee9924a779747327628586fdf,PAYMENT,30-40,2018,9,22,17,0,Saturday,7 days,132691.057
ACC-3317636250,35,1174.0,14336.73,,CUS-2738291516,2018-09-24,Kenneth,M,-27.66,153.02,,,,,,,debit,posted,3e440285e5114683a255c193ece2585c,PAYMENT,30-40,2018,9,24,19,0,Monday,7 days,132691.057
ACC-3317636250,35,93.0,14243.73,,CUS-2738291516,2018-09-28,Kenneth,M,-27.66,153.02,,,,,,,debit,posted,9cbe4c192ad74a2e9c6a8a41cec7c88d,PAYMENT,30-40,2018,9,28,8,0,Friday,7 days,132691.057
ACC-3317636250,35,4233.0,12555.49,0.0,CUS-2738291516,2018-09-29,Kenneth,M,-27.66,153.02,,e5b2b589-812a-44a1-a1bb-403d9ee9a1b4,-33.94,151.17,NSW,Mascot,debit,authorized,da7fd2164f2e4fd7b5987162904df352,SALES-POS,30-40,2018,9,29,14,6,Saturday,7 days,132691.057
ACC-3317636250,35,627.97,11927.52,1.0,CUS-2738291516,2018-09-30,Kenneth,M,-27.66,153.02,,2f6e94d7-87fc-46e0-8552-690216d5c493,-27.57,153.13,QLD,Rochedale,debit,authorized,beb84a368d404fa88136b94c7ff2513c,SALES-POS,30-40,2018,9,30,9,4,Sunday,7 days,132691.057
ACC-3317636250,35,38.08,11889.44,1.0,CUS-2738291516,2018-10-01,Kenneth,M,-27.66,153.02,,eeffa7cc-911b-4755-b44a-12e26618985a,-26.73,153.06,QLD,Sippy Downs,debit,authorized,14ca3b4d86f74a32810f6f6daf765fba,SALES-POS,30-40,2018,10,1,9,27,Monday,7 days,132691.057
ACC-3317636250,35,24.34,11865.1,1.0,CUS-2738291516,2018-10-01,Kenneth,M,-27.66,153.02,,c9aa63e2-f399-424b-8cd4-0816aa5c11d9,-27.49,153.03,QLD,Woolloongabba,debit,authorized,22440aa8f4a94015bc879f0fcbf04786,SALES-POS,30-40,2018,10,1,11,26,Monday,7 days,132691.057
ACC-3317636250,35,10.25,11854.85,1.0,CUS-2738291516,2018-10-03,Kenneth,M,-27.66,153.02,,be80a19a-6f0d-4ced-a2ed-f3baa5e365cf,-27.47,153.03,QLD,Brisbane City,debit,authorized,e1f17441dc79427dbcc0246f803d07d3,POS,30-40,2018,10,3,9,8,Wednesday,7 days,132691.057
ACC-3317636250,35,12.24,11842.61,1.0,CUS-2738291516,2018-10-04,Kenneth,M,-27.66,153.02,,6caf69ab-48e4-4d87-9cac-55d0a6528f19,-27.53,153.07,QLD,Mount Gravatt,debit,authorized,94053c2219124a97a66de61c68761d7c,POS,30-40,2018,10,4,16,39,Thursday,7 days,132691.057
ACC-3317636250,35,14.51,14372.86,1.0,CUS-2738291516,2018-10-05,Kenneth,M,-27.66,153.02,,6d400acf-6aa9-404f-9cf0-f932559d0c38,-27.82,153.32,QLD,Pimpama,debit,authorized,e5d8a13f8c9247f69ba3d8960cca46cd,SALES-POS,30-40,2018,10,5,19,5,Friday,7 days,132691.057
ACC-3317636250,35,21.87,14350.99,1.0,CUS-2738291516,2018-10-05,Kenneth,M,-27.66,153.02,,1b9a5c03-02c3-4604-8e87-89aa4f4c2322,-33.84,151.21,NSW,North Sydney,debit,authorized,1d4741a6f94d45d8b5d6c9a924fbda1a,SALES-POS,30-40,2018,10,5,20,52,Friday,7 days,132691.057
ACC-3317636250,35,23.99,14327.0,1.0,CUS-2738291516,2018-10-05,Kenneth,M,-27.66,153.02,,fbad67d5-cb18-44a8-8307-b2f18cb8a4db,-27.67,152.92,QLD,Springfield Lakes,debit,authorized,a61155ffec874777b33496aa547ba08e,POS,30-40,2018,10,5,22,15,Friday,7 days,132691.057
ACC-3317636250,35,15.26,14311.74,1.0,CUS-2738291516,2018-10-05,Kenneth,M,-27.66,153.02,,76021e87-8da7-42a0-aa26-6d44e380df28,-27.46,153.03,QLD,Fortitude Valley,debit,authorized,629931af890d434aa3dd799b7968e0d7,POS,30-40,2018,10,5,23,45,Friday,7 days,132691.057
ACC-3317636250,35,73.0,14238.74,,CUS-2738291516,2018-10-09,Kenneth,M,-27.66,153.02,,,,,,,debit,posted,7980a841c25e43d1a9d9c5ec49c38569,INTER BANK,30-40,2018,10,9,12,0,Tuesday,7 days,132691.057
ACC-3317636250,35,26.41,14212.33,1.0,CUS-2738291516,2018-10-09,Kenneth,M,-27.66,153.02,,f51fc2a7-0502-4454-b619-e1ff20a862f6,-27.52,152.23,QLD,Ringwood,debit,authorized,2eabe1ebe44447f0bbbf78ebd062c01b,POS,30-40,2018,10,9,21,50,Tuesday,7 days,132691.057
ACC-3317636250,35,32.24,14180.09,1.0,CUS-2738291516,2018-10-10,Kenneth,M,-27.66,153.02,,2c1b1acc-257c-436a-91a5-030203816469,-27.56,151.95,QLD,Toowoomba City,debit,authorized,9065efab3abb4869be55477d2f0f009f,SALES-POS,30-40,2018,10,10,1,56,Wednesday,7 days,132691.057
ACC-3317636250,35,48.64,14131.45,1.0,CUS-2738291516,2018-10-10,Kenneth,M,-27.66,153.02,,9a78829c-237b-4dd5-ae08-a75eb4095c7a,-27.79,153.25,QLD,Ormeau,debit,authorized,9bc793a5c02d492eb1d711621d17b68c,POS,30-40,2018,10,10,14,53,Wednesday,7 days,132691.057
ACC-3317636250,35,90.0,16586.21,,CUS-2738291516,2018-10-18,Kenneth,M,-27.66,153.02,,,,,,,debit,posted,1d236c7bebd04a26b4c6b90704997051,INTER BANK,30-40,2018,10,18,2,0,Thursday,7 days,132691.057
ACC-3317636250,35,223.06,18907.91,1.0,CUS-2738291516,2018-10-21,Kenneth,M,-27.66,153.02,,af8c71f9-7ff7-42f6-8a8e-11cf83ac7c56,-27.5,153.04,QLD,Woolloongabba,debit,authorized,88aff565e636499b8687684e5f9b1a56,POS,30-40,2018,10,21,1,50,Sunday,7 days,132691.057
ACC-3317636250,35,22.58,18885.33,1.0,CUS-2738291516,2018-10-21,Kenneth,M,-27.66,153.02,,00b75ac3-5f25-44cf-879b-2f9d80ca6c53,-27.47,153.07,QLD,Morningside,debit,authorized,a19313b5e051435f98f9dc9a5c177a7e,SALES-POS,30-40,2018,10,21,9,6,Sunday,7 days,132691.057
ACC-3317636250,35,9.14,18876.19,1.0,CUS-2738291516,2018-10-22,Kenneth,M,-27.66,153.02,,f7a4ce77-7c3e-4fde-afb5-456995ce97bc,-27.56,151.95,QLD,Toowoomba City,debit,authorized,27eba3806d9b43b98587bf5c509ae578,SALES-POS,30-40,2018,10,22,9,32,Monday,7 days,132691.057
ACC-3317636250,35,35.15,18841.04,1.0,CUS-2738291516,2018-10-22,Kenneth,M,-27.66,153.02,,87898f6b-97a4-4a26-80a8-c15f0322af30,-27.49,153.03,QLD,Woolloongabba,debit,authorized,69d856871f5f47209e69dc82aa526869,SALES-POS,30-40,2018,10,22,10,20,Monday,7 days,132691.057
ACC-3317636250,35,121.0,18720.04,,CUS-2738291516,2018-10-22,Kenneth,M,-27.66,153.02,,,,,,,debit,posted,cdd5839c03034761907cf81f484f3838,PAYMENT,30-40,2018,10,22,17,0,Monday,7 days,132691.057
ACC-3317636250,35,60.61,18659.43,1.0,CUS-2738291516,2018-10-24,Kenneth,M,-27.66,153.02,,68ee595c-7a0b-48b6-8093-73442f894183,-27.51,153.05,QLD,Greenslopes,debit,authorized,2b56c494d3f14f7094ba5deda9073b85,SALES-POS,30-40,2018,10,24,9,49,Wednesday,7 days,132691.057
ACC-3317636250,35,8.04,18651.39,1.0,CUS-2738291516,2018-10-24,Kenneth,M,-27.66,153.02,,a7abcaee-3216-438d-8419-15b60e3f5646,-27.47,153.02,QLD,Brisbane City,debit,authorized,ea76ae18d73e4b41a180d76d1475795b,POS,30-40,2018,10,24,11,6,Wednesday,7 days,132691.057
ACC-3317636250,35,46.65,18604.74,1.0,CUS-2738291516,2018-10-24,Kenneth,M,-27.66,153.02,,bb114176-22b5-4fc2-b6cb-3878142c3e20,-27.76,150.25,QLD,Moonie,debit,authorized,df4944f589c04cff99f8ec69f9a0ef6d,POS,30-40,2018,10,24,11,11,Wednesday,7 days,132691.057
ACC-3317636250,35,28.41,18576.33,1.0,CUS-2738291516,2018-10-24,Kenneth,M,-27.66,153.02,,5dce61ef-78ab-492a-9124-486ff9b84665,-27.44,153.01,QLD,Newmarket,debit,authorized,679c151e64b24b2d86b5b24b271f4bb0,POS,30-40,2018,10,24,13,4,Wednesday,7 days,132691.057
ACC-3317636250,35,93.0,21028.09,,CUS-2738291516,2018-10-28,Kenneth,M,-27.66,153.02,,,,,,,debit,posted,a70a9d9de79f43809f6947a5bb4984de,PAYMENT,30-40,2018,10,28,8,0,Sunday,7 days,132691.057
ACC-3317636250,35,24.39,21003.7,0.0,CUS-2738291516,2018-10-28,Kenneth,M,-27.66,153.02,,cfce0f5c-07c5-40fd-ac84-d8b1d701e12b,-27.5,152.97,QLD,Indooroopilly,debit,authorized,0bb3ca7540f2474094f65e295d044d2b,SALES-POS,30-40,2018,10,28,16,10,Sunday,7 days,132691.057
ACC-3317636250,35,49.12,20954.58,0.0,CUS-2738291516,2018-10-29,Kenneth,M,-27.66,153.02,,37e9c950-5136-4f86-9e9b-1ded5c0c8d5c,-27.43,117.89,WA,Cue,debit,authorized,9c3b65c1d6b24e518e9d9d92012a4bc5,SALES-POS,30-40,2018,10,29,19,29,Monday,7 days,132691.057
ACC-3317636250,35,9.46,20945.12,1.0,CUS-2738291516,2018-10-30,Kenneth,M,-27.66,153.02,,4c71f1fb-c2fc-433b-a67c-59a60b308f28,-27.56,153.08,QLD,Upper Mount Gravatt,debit,authorized,aa3d5e120fe54e08936ed54117393c72,SALES-POS,30-40,2018,10,30,3,19,Tuesday,7 days,132691.057
ACC-2970114956,26,14.36,6708.49,1.0,CUS-880898248,2018-08-02,Robert,M,-37.69,144.89,,29bb0d4c-f4dd-435b-9b98-1d17590575ce,-37.74,144.8,VIC,Saint Albans,debit,authorized,7446b3c881a94384bc73bb1d1fd38ba2,SALES-POS,20-30,2018,8,2,21,58,Thursday,14 days,36668.91714285714
ACC-2970114956,26,61.0,6647.49,,CUS-880898248,2018-08-06,Robert,M,-37.69,144.89,,,,,,,debit,posted,2497c1d1bb1c4f42abe7eca9d153bb28,PAYMENT,20-30,2018,8,6,23,0,Monday,14 days,36668.91714285714
ACC-2970114956,26,14.45,6633.04,1.0,CUS-880898248,2018-08-07,Robert,M,-37.69,144.89,,469cd883-7db8-4e55-903a-12c6f509f400,-37.9,145.23,VIC,Scoresby,debit,authorized,b91a92167682452a92ce696d6894c1ad,SALES-POS,20-30,2018,8,7,10,7,Tuesday,14 days,36668.91714285714
ACC-2970114956,26,9.52,6623.52,1.0,CUS-880898248,2018-08-07,Robert,M,-37.69,144.89,,7994e667-5779-41e7-a469-20299af52afe,-37.9,144.75,VIC,Point Cook,debit,authorized,ed28ef960a004e17870b3aa4f0681215,SALES-POS,20-30,2018,8,7,15,51,Tuesday,14 days,36668.91714285714
ACC-2970114956,26,671.23,5952.29,1.0,CUS-880898248,2018-08-07,Robert,M,-37.69,144.89,,b04f283c-5807-4329-ad1d-a113d5f25bc1,-37.79,145.16,VIC,Doncaster East,debit,authorized,d53774f347754c78be12b700741e482e,SALES-POS,20-30,2018,8,7,20,42,Tuesday,14 days,36668.91714285714
ACC-2970114956,26,7.54,5944.75,0.0,CUS-880898248,2018-08-08,Robert,M,-37.69,144.89,,08fa85a5-f949-47b2-9fd6-8fe2a7119e36,-34.5,144.84,NSW,Hay,debit,authorized,fe796e8203ad4f228e9a03b2f264597b,SALES-POS,20-30,2018,8,8,8,10,Wednesday,14 days,36668.91714285714
ACC-2970114956,26,14.46,5930.29,0.0,CUS-880898248,2018-08-08,Robert,M,-37.69,144.89,,66a0231a-2397-4bf1-ba73-5b8ec0b069b4,-37.86,145.03,VIC,Malvern,debit,authorized,8bda112635114c9098e51e06f8be3038,SALES-POS,20-30,2018,8,8,14,34,Wednesday,14 days,36668.91714285714
ACC-2970114956,26,13.17,5917.12,1.0,CUS-880898248,2018-08-08,Robert,M,-37.69,144.89,,c72f5ec0-d8f8-4db0-9425-87e98de8d82f,-37.64,144.81,VIC,Bulla,debit,authorized,45df400483814c4a87641b54c8231ce9,SALES-POS,20-30,2018,8,8,19,23,Wednesday,14 days,36668.91714285714
ACC-2970114956,26,32.28,5884.84,1.0,CUS-880898248,2018-08-09,Robert,M,-37.69,144.89,,a0af2fdd-0f45-49a8-8426-50d7ff53146c,-33.76,151.26,NSW,Brookvale,debit,authorized,a8730c85a7cd4aa9840cc09d50308f56,POS,20-30,2018,8,9,1,24,Thursday,14 days,36668.91714285714
ACC-2970114956,26,36.39,5848.45,1.0,CUS-880898248,2018-08-09,Robert,M,-37.69,144.89,,ae25e03e-2770-49f2-b1e1-4474577c194f,-37.79,145.27,VIC,Croydon,debit,authorized,afdbced00f634157a072e518a3ac20c7,SALES-POS,20-30,2018,8,9,9,8,Thursday,14 days,36668.91714285714
ACC-2970114956,26,14.93,5833.52,1.0,CUS-880898248,2018-08-10,Robert,M,-37.69,144.89,,13d33868-3a85-46f4-b5f0-73f2c148dc4c,-37.89,144.62,VIC,Wyndham Vale,debit,authorized,cc4b566042974861b98d1d017250f69e,SALES-POS,20-30,2018,8,10,22,13,Friday,14 days,36668.91714285714
ACC-2970114956,26,6.13,5827.39,1.0,CUS-880898248,2018-08-10,Robert,M,-37.69,144.89,,a3cf11b6-eee5-4b6a-8b32-61ceb8fa205d,-37.81,144.97,VIC,Melbourne,debit,authorized,c254305b864d43999bd9f1f97a3ee95b,SALES-POS,20-30,2018,8,10,22,55,Friday,14 days,36668.91714285714
ACC-2970114956,26,12.34,5815.05,1.0,CUS-880898248,2018-08-11,Robert,M,-37.69,144.89,,f12038bd-8665-4b3c-9c7e-759783d7ed90,-37.76,145.05,VIC,Eaglemont,debit,authorized,66ce839e8b2b413e9f6d4ec781c1bfd2,POS,20-30,2018,8,11,3,51,Saturday,14 days,36668.91714285714
ACC-2970114956,26,6.53,5808.52,1.0,CUS-880898248,2018-08-11,Robert,M,-37.69,144.89,,23065e38-2fed-49c2-b0e4-ef115a1ecde9,-37.84,145.05,VIC,Hawthorn East,debit,authorized,85fc391ea8c34cf590bfb346a11dba04,SALES-POS,20-30,2018,8,11,19,30,Saturday,14 days,36668.91714285714
ACC-2970114956,26,16.97,5791.55,1.0,CUS-880898248,2018-08-11,Robert,M,-37.69,144.89,,76e726d9-9def-48ee-a330-1996e8d5fcf0,-37.86,145.18,VIC,Vermont South,debit,authorized,3a7683b80bed442e85df8e7bc784eb83,SALES-POS,20-30,2018,8,11,21,10,Saturday,14 days,36668.91714285714
ACC-2970114956,26,5.93,5785.62,1.0,CUS-880898248,2018-08-13,Robert,M,-37.69,144.89,,e412ae01-abdb-434d-8016-10bba8b76c1a,-37.76,145.31,VIC,Chirnside Park,debit,authorized,4b44087c15df4324968d6994c49824c0,POS,20-30,2018,8,13,13,46,Monday,14 days,36668.91714285714
ACC-2970114956,26,5.8,5779.82,0.0,CUS-880898248,2018-08-13,Robert,M,-37.69,144.89,,f9f244e9-3f3b-4a7a-ba03-e9c5fae5bac1,-37.68,145.14,VIC,Saint Helena,debit,authorized,37d85e955e0c44dbb8cca212906264b1,POS,20-30,2018,8,13,14,11,Monday,14 days,36668.91714285714
ACC-2970114956,26,61.0,5718.82,,CUS-880898248,2018-08-13,Robert,M,-37.69,144.89,,,,,,,debit,posted,fe630b1a722645c18115301c81f573e9,PAYMENT,20-30,2018,8,13,23,0,Monday,14 days,36668.91714285714
ACC-2970114956,26,7.14,5711.68,1.0,CUS-880898248,2018-08-14,Robert,M,-37.69,144.89,,d887d414-368c-4332-a219-a9a33c87628a,-37.62,145.03,VIC,Wollert,debit,authorized,eace84d84db64755a7d54e28b72acd15,POS,20-30,2018,8,14,15,24,Tuesday,14 days,36668.91714285714
ACC-2970114956,26,149.0,5562.68,,CUS-880898248,2018-08-14,Robert,M,-37.69,144.89,,,,,,,debit,posted,fbb9135a89f547abafd053c470427b7b,PAYMENT,20-30,2018,8,14,19,0,Tuesday,14 days,36668.91714285714
ACC-2970114956,26,16.55,6858.54,1.0,CUS-880898248,2018-08-17,Robert,M,-37.69,144.89,,2c7c42ec-73a2-479e-8e2c-0f84cba09a76,-37.77,145.04,VIC,Ivanhoe,debit,authorized,ea6e7e0c89ae46cbb6d272e7fbc01ff6,POS,20-30,2018,8,17,6,53,Friday,14 days,36668.91714285714
ACC-2970114956,26,19.65,6838.89,1.0,CUS-880898248,2018-08-17,Robert,M,-37.69,144.89,,1aba8377-fcb4-429a-a91b-e2321d39934c,-37.84,145.13,VIC,Box Hill South,debit,authorized,bf375cc8f3e848b1ac3619a52dab731f,POS,20-30,2018,8,17,8,47,Friday,14 days,36668.91714285714
ACC-2970114956,26,12.56,6826.33,1.0,CUS-880898248,2018-08-20,Robert,M,-37.69,144.89,,9ceb9e51-60f0-4e1a-9656-caad3dd9a75f,-37.72,145.01,VIC,Reservoir,debit,authorized,896b087d8f4e48afb0816e43b623b552,POS,20-30,2018,8,20,9,53,Monday,14 days,36668.91714285714
ACC-2970114956,26,61.0,6765.33,,CUS-880898248,2018-08-20,Robert,M,-37.69,144.89,,,,,,,debit,posted,83f61fc4a36e44539a9ab3f393b3aa27,PAYMENT,20-30,2018,8,20,23,0,Monday,14 days,36668.91714285714
ACC-2970114956,26,25.08,6740.25,1.0,CUS-880898248,2018-08-24,Robert,M,-37.69,144.89,,4c2bef46-6b43-4b1b-be8f-240c86b8035c,-37.88,145.26,VIC,Knoxfield,debit,authorized,8e0dc63021864d429309a45571fb3821,SALES-POS,20-30,2018,8,24,9,7,Friday,14 days,36668.91714285714
ACC-2970114956,26,21.9,6718.35,1.0,CUS-880898248,2018-08-24,Robert,M,-37.69,144.89,,a7cbf1bd-cf6c-423d-bb38-f6913d8a69d1,-37.82,145.01,VIC,Richmond,debit,authorized,21ecb989276b4b54a4aa897d8a98705f,SALES-POS,20-30,2018,8,24,10,22,Friday,14 days,36668.91714285714
ACC-2970114956,26,6.04,6712.31,0.0,CUS-880898248,2018-08-26,Robert,M,-37.69,144.89,,1dd9c86d-b32f-4025-b6fb-bb51b938b45b,-37.82,145.04,VIC,Hawthorn,debit,authorized,9ba432fb11fb4d0bac50202e35fcd12b,SALES-POS,20-30,2018,8,26,21,17,Sunday,14 days,36668.91714285714
ACC-2970114956,26,61.0,6651.31,,CUS-880898248,2018-08-27,Robert,M,-37.69,144.89,,,,,,,debit,posted,17cc3673240c4638a9773da78f622b86,PAYMENT,20-30,2018,8,27,23,0,Monday,14 days,36668.91714285714
ACC-2970114956,26,29.94,6621.37,1.0,CUS-880898248,2018-08-29,Robert,M,-37.69,144.89,,99529eec-3416-4ee1-9e02-d6c118401b0d,-37.85,145.05,VIC,Hawthorn East,debit,authorized,199d2cebb1a14ced80003f9cd15f60ce,SALES-POS,20-30,2018,8,29,12,14,Wednesday,14 days,36668.91714285714
ACC-2970114956,26,15.64,6605.73,0.0,CUS-880898248,2018-08-29,Robert,M,-37.69,144.89,,a1393fa3-196b-4b47-bc66-91e287c25733,-33.84,151.21,NSW,North Sydney,debit,authorized,af2b0e4f403d4eba993ac5aaeca6d565,SALES-POS,20-30,2018,8,29,12,51,Wednesday,14 days,36668.91714285714
ACC-2970114956,26,61.0,7978.71,,CUS-880898248,2018-09-03,Robert,M,-37.69,144.89,,,,,,,debit,posted,cc2f542d526148ca9701ffd49b1f998f,PAYMENT,20-30,2018,9,3,23,0,Monday,14 days,36668.91714285714
ACC-2970114956,26,8.62,7970.09,1.0,CUS-880898248,2018-09-05,Robert,M,-37.69,144.89,,81fe1636-2edb-4a2f-ae93-3d375027047b,-37.76,145.31,VIC,Chirnside Park,debit,authorized,f1d0532d47fa45d0890a036805357809,SALES-POS,20-30,2018,9,5,9,8,Wednesday,14 days,36668.91714285714
ACC-2970114956,26,10.01,7960.08,1.0,CUS-880898248,2018-09-05,Robert,M,-37.69,144.89,,12516b1d-40f0-4f78-ae05-c501dc709386,-37.74,142.02,VIC,Hamilton,debit,authorized,2fbf821175ff47a785e979e537be0dc3,POS,20-30,2018,9,5,14,31,Wednesday,14 days,36668.91714285714
ACC-2970114956,26,22.33,7937.75,1.0,CUS-880898248,2018-09-06,Robert,M,-37.69,144.89,,47cbdb73-1156-4e3e-92ef-83149bb30178,-37.91,145.21,VIC,Scoresby,debit,authorized,09d2bd66bece4a4f9a13c78e29901f00,SALES-POS,20-30,2018,9,6,15,19,Thursday,14 days,36668.91714285714
ACC-2970114956,26,19.11,7918.64,1.0,CUS-880898248,2018-09-07,Robert,M,-37.69,144.89,,28fc99de-3536-4863-bd8f-5353c5276ec0,-37.71,145.05,VIC,Bundoora,debit,authorized,21fbb6bc9f6047708b77a6123018252d,SALES-POS,20-30,2018,9,7,1,17,Friday,14 days,36668.91714285714
ACC-2970114956,26,5.09,7913.55,1.0,CUS-880898248,2018-09-07,Robert,M,-37.69,144.89,,1b56f398-ffe7-4bb4-8a7a-8b495ea9938c,-37.97,146.98,VIC,Maffra,debit,authorized,5811ed30d2da4f759d5e8417044b1daf,POS,20-30,2018,9,7,21,26,Friday,14 days,36668.91714285714
ACC-2970114956,26,61.0,7852.55,,CUS-880898248,2018-09-10,Robert,M,-37.69,144.89,,,,,,,debit,posted,5680e5230d1b49b29ea60c5a1ee249d1,PAYMENT,20-30,2018,9,10,23,0,Monday,14 days,36668.91714285714
ACC-2970114956,26,149.0,9137.53,,CUS-880898248,2018-09-14,Robert,M,-37.69,144.89,,,,,,,debit,posted,7d570042f04e4ab0a21df8d347946614,PAYMENT,20-30,2018,9,14,19,0,Friday,14 days,36668.91714285714
ACC-2970114956,26,19.09,9118.44,1.0,CUS-880898248,2018-09-15,Robert,M,-37.69,144.89,,285250a6-f38a-4865-86d7-caa91e66047b,-37.55,143.85,VIC,Ballarat Central,debit,authorized,172b8798ff474f72afa83cd01fde6b70,POS,20-30,2018,9,15,17,59,Saturday,14 days,36668.91714285714
ACC-2970114956,26,22.03,9096.41,1.0,CUS-880898248,2018-09-16,Robert,M,-37.69,144.89,,16d3882b-d540-41f4-b6ee-4ae7eb3ad73a,-37.86,144.97,VIC,St Kilda,debit,authorized,1fca6b2d34e842f1a2431d3c0ea48456,POS,20-30,2018,9,16,1,55,Sunday,14 days,36668.91714285714
ACC-2970114956,26,18.77,9077.64,1.0,CUS-880898248,2018-09-17,Robert,M,-37.69,144.89,,3f73d42e-596a-4301-95d2-17de3c7b3766,-37.99,145.11,VIC,Braeside,debit,authorized,94a4742c6f4f49499b09c14cd4700da6,POS,20-30,2018,9,17,10,54,Monday,14 days,36668.91714285714
ACC-2970114956,26,9.67,9067.97,1.0,CUS-880898248,2018-09-17,Robert,M,-37.69,144.89,,b3225338-e857-4439-a128-3bdc6f4a4162,-37.83,145.16,VIC,Melbourne,debit,authorized,cd5f2708e50d4991a11141c5be8d37f6,SALES-POS,20-30,2018,9,17,11,54,Monday,14 days,36668.91714285714
ACC-2970114956,26,61.0,9006.97,,CUS-880898248,2018-09-17,Robert,M,-37.69,144.89,,,,,,,debit,posted,65aca2de5c60482ea8f298b63084f7f4,PAYMENT,20-30,2018,9,17,23,0,Monday,14 days,36668.91714285714
ACC-2970114956,26,12.73,8994.24,1.0,CUS-880898248,2018-09-18,Robert,M,-37.69,144.89,,63d61fe8-63ac-44f7-89f6-2cd40c0fa413,-37.82,145.25,VIC,Ringwood East,debit,authorized,ec14c6a690874dcdb2656897c1b4e6f4,SALES-POS,20-30,2018,9,18,1,17,Tuesday,14 days,36668.91714285714
ACC-2970114956,26,61.0,8933.24,,CUS-880898248,2018-09-24,Robert,M,-37.69,144.89,,,,,,,debit,posted,034bd2ef24734a4dada6ce506e688d44,PAYMENT,20-30,2018,9,24,23,0,Monday,14 days,36668.91714285714
ACC-2970114956,26,61.0,10306.22,,CUS-880898248,2018-10-01,Robert,M,-37.69,144.89,,,,,,,debit,posted,9ea3fa4cc85840779806ab7d1db8ac1a,PAYMENT,20-30,2018,10,1,23,0,Monday,14 days,36668.91714285714
ACC-2970114956,26,27.93,10278.29,0.0,CUS-880898248,2018-10-07,Robert,M,-37.69,144.89,,e8d3e859-db04-4b1b-9e7c-0ae39f23ca67,-37.78,145.16,VIC,Doncaster East,debit,authorized,e8087495bca9448ab9aab33ae75f6014,SALES-POS,20-30,2018,10,7,20,24,Sunday,14 days,36668.91714285714
ACC-2970114956,26,13.3,10264.99,1.0,CUS-880898248,2018-10-07,Robert,M,-37.69,144.89,,b89d48ff-342d-4d4b-80ed-eaa740240f1e,-37.8,145,VIC,Abbotsford,debit,authorized,72ae2e973514405cbe4782bdb8401c83,POS,20-30,2018,10,7,21,39,Sunday,14 days,36668.91714285714
ACC-2970114956,26,51.51,10213.48,1.0,CUS-880898248,2018-10-08,Robert,M,-37.69,144.89,,eaf9bdd3-ba78-4b02-a87e-900f05e20fc9,-37.73,144.96,VIC,Coburg,debit,authorized,bf634c94cc974ee7ab6099f632914b61,POS,20-30,2018,10,8,8,29,Monday,14 days,36668.91714285714
ACC-2970114956,26,61.0,10152.48,,CUS-880898248,2018-10-08,Robert,M,-37.69,144.89,,,,,,,debit,posted,f9cc4a91a1c946ea988bbc1bca79b3da,PAYMENT,20-30,2018,10,8,23,0,Monday,14 days,36668.91714285714
ACC-2970114956,26,7.94,10144.54,1.0,CUS-880898248,2018-10-09,Robert,M,-37.69,144.89,,603c0f89-3378-4f11-8418-4b65c1321390,-37.8,144.9,VIC,Footscray,debit,authorized,a3bc78f4fee248ca8fbe059e6f171861,SALES-POS,20-30,2018,10,9,8,47,Tuesday,14 days,36668.91714285714
ACC-2970114956,26,33.6,10110.94,1.0,CUS-880898248,2018-10-09,Robert,M,-37.69,144.89,,ecfa48c1-8eb4-4066-a210-777d0b41c414,-37.87,145.09,VIC,Ashburton,debit,authorized,b7b606f7eafa42918877d1d277a7cda0,SALES-POS,20-30,2018,10,9,9,11,Tuesday,14 days,36668.91714285714
ACC-2970114956,26,11.23,10099.71,1.0,CUS-880898248,2018-10-10,Robert,M,-37.69,144.89,,c43b9034-b67b-41f8-b5eb-b019056a3387,-33.92,151.2,NSW,Alexandria,debit,authorized,447ace23b7b548a99498c36f37171ad2,SALES-POS,20-30,2018,10,10,1,11,Wednesday,14 days,36668.91714285714
ACC-2970114956,26,19.04,10080.67,1.0,CUS-880898248,2018-10-10,Robert,M,-37.69,144.89,,2df71d90-3c5f-425f-81e0-b73057ae0be2,-37.79,144.93,VIC,Flemington,debit,authorized,ab48b92916b74bc78c1a32ecfb1d7a5d,SALES-POS,20-30,2018,10,10,14,14,Wednesday,14 days,36668.91714285714
ACC-2970114956,26,4.43,10076.24,1.0,CUS-880898248,2018-10-10,Robert,M,-37.69,144.89,,5fc47620-fbc3-4d50-9514-a5678962d2f2,-37.82,144.99,VIC,Richmond,debit,authorized,155d652bdf5241fc86feda5bd1d9b512,SALES-POS,20-30,2018,10,10,22,18,Wednesday,14 days,36668.91714285714
ACC-2970114956,26,6.87,10069.37,0.0,CUS-880898248,2018-10-11,Robert,M,-37.69,144.89,,56615985-6856-4d24-a3f7-74a975f58cb6,-37.81,144.97,VIC,Melbourne,debit,authorized,06b69b41fbec45cc94f5f9005275ce1c,SALES-POS,20-30,2018,10,11,8,39,Thursday,14 days,36668.91714285714
ACC-2970114956,26,12.25,10057.12,0.0,CUS-880898248,2018-10-11,Robert,M,-37.69,144.89,,238774cb-e57c-4054-815a-be7606a52038,-37.83,140.78,SA,Mount Gambier,debit,authorized,8a47da05d4be4b42813a2dd6b931cc24,SALES-POS,20-30,2018,10,11,10,22,Thursday,14 days,36668.91714285714
ACC-2970114956,26,149.0,11342.1,,CUS-880898248,2018-10-14,Robert,M,-37.69,144.89,,,,,,,debit,posted,734dd625fb7049d7860aa57b75ddde22,PAYMENT,20-30,2018,10,14,19,0,Sunday,14 days,36668.91714285714
ACC-2970114956,26,61.0,11281.1,,CUS-880898248,2018-10-15,Robert,M,-37.69,144.89,,,,,,,debit,posted,92b9b585f6394220948132ab0b3db57f,PAYMENT,20-30,2018,10,15,23,0,Monday,14 days,36668.91714285714
ACC-2970114956,26,26.77,11254.33,1.0,CUS-880898248,2018-10-17,Robert,M,-37.69,144.89,,16c4b7f9-7ceb-4a4d-9698-6314676d0a20,-37.81,145.23,VIC,Ringwood,debit,authorized,cb093e4750144f08a6038cbf04b240a8,POS,20-30,2018,10,17,14,37,Wednesday,14 days,36668.91714285714
ACC-2970114956,26,6.36,11247.97,1.0,CUS-880898248,2018-10-17,Robert,M,-37.69,144.89,,ba23d4fd-81e8-4850-8e24-412e2e985541,-35.32,149.18,ACT,Fyshwick,debit,authorized,14f9ce13e1434f5798dde225b7f37d57,SALES-POS,20-30,2018,10,17,16,9,Wednesday,14 days,36668.91714285714
ACC-2970114956,26,19.37,11228.6,1.0,CUS-880898248,2018-10-17,Robert,M,-37.69,144.89,,48f43ea0-bd65-4ba4-95a8-f6870e1fada2,-37.78,145.07,VIC,Balwyn North,debit,authorized,3ab6521f22c14fac9f5dc1d709b2156d,POS,20-30,2018,10,17,17,2,Wednesday,14 days,36668.91714285714
ACC-2970114956,26,7.85,11220.75,1.0,CUS-880898248,2018-10-18,Robert,M,-37.69,144.89,,09b1b064-49fd-4941-b4dc-dcd5d4f5022c,-37.81,147.63,VIC,Eastwood,debit,authorized,3c378d7e39534d0ea5d5ebca1e808f06,SALES-POS,20-30,2018,10,18,14,54,Thursday,14 days,36668.91714285714
ACC-2970114956,26,32.62,11188.13,1.0,CUS-880898248,2018-10-18,Robert,M,-37.69,144.89,,56de3ecb-71a8-4a1a-93e6-9828e89152c3,-37.83,145.06,VIC,Camberwell,debit,authorized,92d9c41da44345aaaaae0647983cb928,SALES-POS,20-30,2018,10,18,16,19,Thursday,14 days,36668.91714285714
ACC-2970114956,26,10.3,11177.83,1.0,CUS-880898248,2018-10-19,Robert,M,-37.69,144.89,,b3f0ec8c-9033-4935-9826-6c7069dc80ab,-37.88,145.28,VIC,Ferntree Gully,debit,authorized,6cf076fd40f44461ac7bc3dedd93109d,SALES-POS,20-30,2018,10,19,0,51,Friday,14 days,36668.91714285714
ACC-2970114956,26,18.3,11159.53,1.0,CUS-880898248,2018-10-19,Robert,M,-37.69,144.89,,466ed508-7fe5-4da2-aa2e-d4682e6b8aad,-37.88,144.68,VIC,Werribee,debit,authorized,016e48cddac84b698346e76004ce3559,POS,20-30,2018,10,19,2,15,Friday,14 days,36668.91714285714
ACC-2970114956,26,52.23,11107.3,1.0,CUS-880898248,2018-10-19,Robert,M,-37.69,144.89,,ca81094e-ca7c-4d45-b6a6-bcd8fc0d5ac8,-33.75,151.24,NSW,Frenchs Forest,debit,authorized,25b9831c8d1b4fc188045bb3c6b81228,POS,20-30,2018,10,19,8,13,Friday,14 days,36668.91714285714
ACC-2970114956,26,37.51,11069.79,1.0,CUS-880898248,2018-10-19,Robert,M,-37.69,144.89,,0671cb55-dcac-47a4-9a1e-d587cb7b189a,-37.56,143.86,VIC,Ballarat Central,debit,authorized,7f80bb7ff7e34aa5b7961d1fb45d240c,POS,20-30,2018,10,19,8,32,Friday,14 days,36668.91714285714
ACC-2970114956,26,61.0,11008.79,,CUS-880898248,2018-10-22,Robert,M,-37.69,144.89,,,,,,,debit,posted,92eada9c08ae43aaac33aa349caa0f89,PAYMENT,20-30,2018,10,22,23,0,Monday,14 days,36668.91714285714
ACC-2970114956,26,15.9,10992.89,1.0,CUS-880898248,2018-10-25,Robert,M,-37.69,144.89,,5c1caf8e-7772-4e9a-a69d-53dc0397c1b2,-37.88,145.16,VIC,Glen Waverley,debit,authorized,823d9bb527fb486184dc1269b7d8af08,POS,20-30,2018,10,25,11,40,Thursday,14 days,36668.91714285714
ACC-2970114956,26,19.28,12407.59,1.0,CUS-880898248,2018-10-25,Robert,M,-37.69,144.89,,6102e64f-516d-4b51-bc28-87dbfe089f5c,-37.83,144.97,VIC,Southbank,debit,authorized,a9776242e8be45b19429e5c7f5d0cfb0,SALES-POS,20-30,2018,10,25,21,8,Thursday,14 days,36668.91714285714
ACC-2970114956,26,61.0,12346.59,,CUS-880898248,2018-10-29,Robert,M,-37.69,144.89,,,,,,,debit,posted,69321c60c5184f17bb9cce1151be1a90,PAYMENT,20-30,2018,10,29,23,0,Monday,14 days,36668.91714285714
ACC-3741880913,25,32.0,2795.85,,CUS-1220154422,2018-08-02,Ashley,F,-23.40,150.50,,,,,,,debit,posted,8837c347249a45a496ceafa6592f5c6a,PAYMENT,20-30,2018,8,2,22,0,Thursday,14 days,59504.386
ACC-3741880913,25,35.43,2760.42,1.0,CUS-1220154422,2018-08-03,Ashley,F,-23.40,150.50,,6a8e369b-555b-4151-b281-e5e6309bfbbb,-24.41,150.5,QLD,Biloela,debit,authorized,7a5172a7957143199d71d786b5359447,SALES-POS,20-30,2018,8,3,15,40,Friday,14 days,59504.386
ACC-3741880913,25,172.0,4870.78,,CUS-1220154422,2018-08-03,Ashley,F,-23.40,150.50,,,,,,,debit,posted,5fa1d1d57804452782978f721cec468e,PAYMENT,20-30,2018,8,3,17,0,Friday,14 days,59504.386
ACC-3741880913,25,15.35,4855.43,1.0,CUS-1220154422,2018-08-03,Ashley,F,-23.40,150.50,,a3c73b8b-be80-4609-afde-8cf5569923e7,-23.38,150.51,QLD,Rockhampton City,debit,authorized,979c1ee0e11e4dc0aa25a62d4039d264,POS,20-30,2018,8,3,23,27,Friday,14 days,59504.386
ACC-3741880913,25,35.87,4819.56,0.0,CUS-1220154422,2018-08-08,Ashley,F,-23.40,150.50,,6a8e369b-555b-4151-b281-e5e6309bfbbb,-24.41,150.5,QLD,Biloela,debit,authorized,3e3840fcd5614becb13409389768c007,SALES-POS,20-30,2018,8,8,15,13,Wednesday,14 days,59504.386
ACC-3741880913,25,32.0,4787.56,,CUS-1220154422,2018-08-09,Ashley,F,-23.40,150.50,,,,,,,debit,posted,204eb76a76b749a89c89b3b849de2eb4,PAYMENT,20-30,2018,8,9,22,0,Thursday,14 days,59504.386
ACC-3741880913,25,106.48,4681.08,1.0,CUS-1220154422,2018-08-10,Ashley,F,-23.40,150.50,,7607ed87-a183-463a-be4e-ab846fc9744c,-37.81,144.99,VIC,Collingwood,debit,authorized,9eea738aab9949edb118080f47f4fa8a,SALES-POS,20-30,2018,8,10,9,57,Friday,14 days,59504.386
ACC-3741880913,25,11.1,4669.98,0.0,CUS-1220154422,2018-08-10,Ashley,F,-23.40,150.50,,89ff4a05-ba92-4da5-9833-891dafbfafab,-34.74,150.53,NSW,Kangaroo Valley,debit,authorized,73ffd45898784513b8525b4f769b8cf9,POS,20-30,2018,8,10,10,36,Friday,14 days,59504.386
ACC-3741880913,25,131.0,4538.98,,CUS-1220154422,2018-08-11,Ashley,F,-23.40,150.50,,,,,,,debit,posted,28f01a8c31f9436a877a99958c9baf36,PAYMENT,20-30,2018,8,11,7,0,Saturday,14 days,59504.386
ACC-3741880913,25,32.0,6063.16,,CUS-1220154422,2018-08-23,Ashley,F,-23.40,150.50,,,,,,,debit,posted,e1aa42cd916e474c9049a5c8323c7065,PAYMENT,20-30,2018,8,23,22,0,Thursday,14 days,59504.386
ACC-3741880913,25,59.94,6003.22,0.0,CUS-1220154422,2018-08-24,Ashley,F,-23.40,150.50,,55fcdb20-741d-4cc1-8e8a-7ceb7bd356dc,-34.44,150.47,NSW,Mittagong,debit,authorized,3eb44ba4c0be4bd18fd5e566080a5671,POS,20-30,2018,8,24,17,49,Friday,14 days,59504.386
ACC-3741880913,25,14.18,5989.04,1.0,CUS-1220154422,2018-08-30,Ashley,F,-23.40,150.50,,46336324-57b4-4cf9-98c0-b74a4097c717,-24.4,150.51,QLD,Biloela,debit,authorized,f997022d37e34640b0c1c6545863fd44,SALES-POS,20-30,2018,8,30,20,48,Thursday,14 days,59504.386
ACC-3741880913,25,32.0,5957.04,,CUS-1220154422,2018-08-30,Ashley,F,-23.40,150.50,,,,,,,debit,posted,0ee3f8cedf854eec84d7ea39af46b210,PAYMENT,20-30,2018,8,30,22,0,Thursday,14 days,59504.386
ACC-3741880913,25,10.77,8228.63,1.0,CUS-1220154422,2018-09-01,Ashley,F,-23.40,150.50,,6f7d6056-ab46-4f90-8c33-840e1986c030,-35.32,150.47,NSW,Narrawallee,debit,authorized,aa867dffd04e4d89b23f4b1fae74292b,POS,20-30,2018,9,1,18,12,Saturday,14 days,59504.386
ACC-3741880913,25,113.76,8114.87,0.0,CUS-1220154422,2018-09-02,Ashley,F,-23.40,150.50,,a7362ad4-39ad-40ed-a2c8-646ae8b1568d,-37.83,144.95,VIC,South Melbourne,debit,authorized,d0d2eeb3705a4b488e557bf19e9c162e,POS,20-30,2018,9,2,10,1,Sunday,14 days,59504.386
ACC-3741880913,25,20.97,8093.9,1.0,CUS-1220154422,2018-09-02,Ashley,F,-23.40,150.50,,8bd01dc0-2bf8-49a0-8765-efd6b0676edd,-24.4,150.51,QLD,Biloela,debit,authorized,a0c17ef744124d95b46b804225de97cd,SALES-POS,20-30,2018,9,2,21,17,Sunday,14 days,59504.386
ACC-3741880913,25,145.92,7947.98,0.0,CUS-1220154422,2018-09-03,Ashley,F,-23.40,150.50,,633d03c8-2319-4802-aaa9-f2c9c366a820,-23.39,119.8,WA,Newman,debit,authorized,a3607eaafd44432982fcccb53cfa950a,SALES-POS,20-30,2018,9,3,10,23,Monday,14 days,59504.386
ACC-3741880913,25,172.0,7775.98,,CUS-1220154422,2018-09-03,Ashley,F,-23.40,150.50,,,,,,,debit,posted,7ebe27832d944c7e913397f0d0c4a4fc,PAYMENT,20-30,2018,9,3,17,0,Monday,14 days,59504.386
ACC-3741880913,25,21.72,7754.26,1.0,CUS-1220154422,2018-09-04,Ashley,F,-23.40,150.50,,87620d95-8b80-4280-b37f-06630416adf0,-33.82,151,NSW,Parramatta,debit,authorized,83467d25181e4cbd92cf62a4b3a985fd,SALES-POS,20-30,2018,9,4,12,9,Tuesday,14 days,59504.386
ACC-3741880913,25,147.19,7607.07,1.0,CUS-1220154422,2018-09-05,Ashley,F,-23.40,150.50,,633d03c8-2319-4802-aaa9-f2c9c366a820,-23.39,119.8,WA,Newman,debit,authorized,9fbba727705744d292707734fb6ce564,POS,20-30,2018,9,5,1,44,Wednesday,14 days,59504.386
ACC-3741880913,25,145.53,7461.54,1.0,CUS-1220154422,2018-09-06,Ashley,F,-23.40,150.50,,633d03c8-2319-4802-aaa9-f2c9c366a820,-23.39,119.8,WA,Newman,debit,authorized,b88b7752dba44ddf8cbf1bcf6cfb8250,POS,20-30,2018,9,6,13,10,Thursday,14 days,59504.386
ACC-3741880913,25,31.78,7429.76,1.0,CUS-1220154422,2018-09-06,Ashley,F,-23.40,150.50,,f4387204-9de1-4104-a184-5e7da463c50e,-23.38,150.51,QLD,Rockhampton City,debit,authorized,d65cc82971404ba595301f62059029a4,POS,20-30,2018,9,6,16,31,Thursday,14 days,59504.386
ACC-3741880913,25,32.0,7397.76,,CUS-1220154422,2018-09-06,Ashley,F,-23.40,150.50,,,,,,,debit,posted,b70656027dc943bc94c8629844be7843,PAYMENT,20-30,2018,9,6,22,0,Thursday,14 days,59504.386
ACC-3741880913,25,20.94,7376.82,1.0,CUS-1220154422,2018-09-07,Ashley,F,-23.40,150.50,,a2d881a3-218c-45f6-8a5d-dd30c656fbf8,-34.29,150.53,NSW,Balmoral,debit,authorized,0b7ce5c4f55a4d6f8a48ca8cc194d0dc,POS,20-30,2018,9,7,11,48,Friday,14 days,59504.386
ACC-3741880913,25,145.02,7231.8,1.0,CUS-1220154422,2018-09-08,Ashley,F,-23.40,150.50,,633d03c8-2319-4802-aaa9-f2c9c366a820,-23.39,119.8,WA,Newman,debit,authorized,efcaec2ee3a7431bb3ba1b0f61bc7f91,POS,20-30,2018,9,8,10,28,Saturday,14 days,59504.386
ACC-3741880913,25,131.0,7100.8,,CUS-1220154422,2018-09-11,Ashley,F,-23.40,150.50,,,,,,,debit,posted,918043db189545039a795d004f46c3a0,PAYMENT,20-30,2018,9,11,7,0,Tuesday,14 days,59504.386
ACC-3741880913,25,32.0,7068.8,,CUS-1220154422,2018-09-13,Ashley,F,-23.40,150.50,,,,,,,debit,posted,bd201c99677a41ad9a42ded46b09e970,PAYMENT,20-30,2018,9,13,22,0,Thursday,14 days,59504.386
ACC-3741880913,25,34.77,7034.03,1.0,CUS-1220154422,2018-09-14,Ashley,F,-23.40,150.50,,6a8e369b-555b-4151-b281-e5e6309bfbbb,-24.41,150.5,QLD,Biloela,debit,authorized,4cd18c196c8145efbed627b26f395f23,SALES-POS,20-30,2018,9,14,10,48,Friday,14 days,59504.386
ACC-3741880913,25,10.61,9305.78,0.0,CUS-1220154422,2018-09-15,Ashley,F,-23.40,150.50,,fafaa229-b437-4640-9f1d-a48fe80d8cca,-35.34,150.47,NSW,Mollymook,debit,authorized,2d5bb6a080f0479f95096a513c71fde0,POS,20-30,2018,9,15,10,19,Saturday,14 days,59504.386
ACC-3741880913,25,81.0,9224.78,,CUS-1220154422,2018-09-16,Ashley,F,-23.40,150.50,,,,,,,debit,posted,c952b9c9bd1a4674b27b268d2bfbc4c6,PAYMENT,20-30,2018,9,16,19,0,Sunday,14 days,59504.386
ACC-3741880913,25,83.58,9141.2,1.0,CUS-1220154422,2018-09-17,Ashley,F,-23.40,150.50,,fe89d1fa-f803-47e8-aa9b-ec996ce2593e,-34.43,150.49,NSW,Braemar,debit,authorized,3a1db1877f864cbe8c6667ab176a04e4,SALES-POS,20-30,2018,9,17,9,16,Monday,14 days,59504.386
ACC-3741880913,25,13.22,9127.98,1.0,CUS-1220154422,2018-09-18,Ashley,F,-23.40,150.50,,2ad77476-1279-414b-9793-7744c8c19306,-33.89,151.21,NSW,Surry Hills,debit,authorized,5fbf85d2d7b34e64a443889d65aafd85,POS,20-30,2018,9,18,9,50,Tuesday,14 days,59504.386
ACC-3741880913,25,168.74,8959.24,1.0,CUS-1220154422,2018-09-19,Ashley,F,-23.40,150.50,,0d9b4621-238e-4057-8e52-809fc42aaebd,-23.36,150.52,QLD,Berserker,debit,authorized,d096e90c2c25438e9cbc9d16cec4835a,SALES-POS,20-30,2018,9,19,9,7,Wednesday,14 days,59504.386
ACC-3741880913,25,84.15,8875.09,1.0,CUS-1220154422,2018-09-19,Ashley,F,-23.40,150.50,,fe89d1fa-f803-47e8-aa9b-ec996ce2593e,-34.43,150.49,NSW,Braemar,debit,authorized,f07a01013ba54e9aba3e7ccd26e0458f,SALES-POS,20-30,2018,9,19,11,52,Wednesday,14 days,59504.386
ACC-3741880913,25,32.0,8843.09,,CUS-1220154422,2018-09-20,Ashley,F,-23.40,150.50,,,,,,,debit,posted,f1ff017649b34aa99d0c90476a299104,PAYMENT,20-30,2018,9,20,22,0,Thursday,14 days,59504.386
ACC-3741880913,25,31.48,8811.61,0.0,CUS-1220154422,2018-09-22,Ashley,F,-23.40,150.50,,5dff36d2-8931-400a-ab57-8ec3a5e2879c,-34.41,150.52,NSW,Alpine,debit,authorized,f43d334deb9447f9be464a6d2c4dde35,SALES-POS,20-30,2018,9,22,2,12,Saturday,14 days,59504.386
ACC-3741880913,25,146.89,8664.72,0.0,CUS-1220154422,2018-09-22,Ashley,F,-23.40,150.50,,633d03c8-2319-4802-aaa9-f2c9c366a820,-23.39,119.8,WA,Newman,debit,authorized,0a532d4f312141b48aa173e15f663054,POS,20-30,2018,9,22,7,21,Saturday,14 days,59504.386
ACC-3741880913,25,161.62,8503.1,1.0,CUS-1220154422,2018-09-22,Ashley,F,-23.40,150.50,,f82e6e6e-13a2-42e4-9b36-ee31e951e54e,-33.76,151.26,NSW,Brookvale,debit,authorized,d1d7a9b5b3054823a66894b6549f6dba,POS,20-30,2018,9,22,11,16,Saturday,14 days,59504.386
ACC-3741880913,25,20.14,8482.96,0.0,CUS-1220154422,2018-09-22,Ashley,F,-23.40,150.50,,30e1920f-6a0a-4405-b444-b48caeb2bc5c,-23.37,119.73,WA,Newman,debit,authorized,e1fe32845bdd4115a587c608a1ae92c2,POS,20-30,2018,9,22,16,55,Saturday,14 days,59504.386
ACC-3741880913,25,13.19,8469.77,0.0,CUS-1220154422,2018-09-23,Ashley,F,-23.40,150.50,,66ee4703-fab7-4d4f-8fba-a8499dfa29c3,-23.38,150.51,QLD,Rockhampton City,debit,authorized,2762df5e6d354adfb301c50fc54e0d9e,POS,20-30,2018,9,23,9,57,Sunday,14 days,59504.386
ACC-3741880913,25,10.94,8458.83,1.0,CUS-1220154422,2018-09-25,Ashley,F,-23.40,150.50,,6f3b653c-32af-4df0-acee-5a5d4f3bfbea,-23.38,150.52,QLD,Rockhampton City,debit,authorized,feb45e0cfc484f8dacb1f45b4d8cacce,SALES-POS,20-30,2018,9,25,9,19,Tuesday,14 days,59504.386
ACC-3741880913,25,70.72,8388.11,1.0,CUS-1220154422,2018-09-26,Ashley,F,-23.40,150.50,,123b7812-cc1f-4377-8166-d4eec932305a,-33.86,151.2,NSW,Sydney,debit,authorized,ca146d796aaa4202a38bb049c6306813,SALES-POS,20-30,2018,9,26,14,3,Wednesday,14 days,59504.386
ACC-3741880913,25,146.78,8241.33,1.0,CUS-1220154422,2018-09-27,Ashley,F,-23.40,150.50,,633d03c8-2319-4802-aaa9-f2c9c366a820,-23.39,119.8,WA,Newman,debit,authorized,2e8251a62ff648ff82e97d0fff493d41,SALES-POS,20-30,2018,9,27,1,3,Thursday,14 days,59504.386
ACC-3741880913,25,32.0,8209.33,,CUS-1220154422,2018-09-27,Ashley,F,-23.40,150.50,,,,,,,debit,posted,835a667f65b34f198b3459e73ac1dea9,PAYMENT,20-30,2018,9,27,22,0,Thursday,14 days,59504.386
ACC-3741880913,25,55.26,8154.07,1.0,CUS-1220154422,2018-09-28,Ashley,F,-23.40,150.50,,9e8bc335-17f4-45ea-80d1-998f2ab25873,-23.35,150.52,QLD,Park Avenue,debit,authorized,011326fd5b0d42e695082ecb0a24b074,SALES-POS,20-30,2018,9,28,9,18,Friday,14 days,59504.386
ACC-3741880913,25,68.41,8085.66,1.0,CUS-1220154422,2018-09-28,Ashley,F,-23.40,150.50,,b0b80e1c-896a-44ab-aa56-6969c36ebb7d,-27.47,153.02,QLD,Brisbane City,debit,authorized,9729dd84468d4666ace6c7e9b5017f0f,POS,20-30,2018,9,28,11,31,Friday,14 days,59504.386
ACC-3741880913,25,21.39,10346.63,1.0,CUS-1220154422,2018-10-03,Ashley,F,-23.40,150.50,,a2d881a3-218c-45f6-8a5d-dd30c656fbf8,-34.29,150.53,NSW,Balmoral,debit,authorized,dbaea14bea6b4ffe9414f83ce79b812d,SALES-POS,20-30,2018,10,3,15,59,Wednesday,14 days,59504.386
ACC-3741880913,25,172.0,10174.63,,CUS-1220154422,2018-10-03,Ashley,F,-23.40,150.50,,,,,,,debit,posted,4ee38550bcc742ac9f9a848a09245967,PAYMENT,20-30,2018,10,3,17,0,Wednesday,14 days,59504.386
ACC-3741880913,25,77.61,10097.02,1.0,CUS-1220154422,2018-10-04,Ashley,F,-23.40,150.50,,ed79e83c-c802-4088-953a-888796e14480,-35.36,150.47,NSW,Ulladulla,debit,authorized,c1a229540ad64a31bc2c6f0510910980,SALES-POS,20-30,2018,10,4,1,7,Thursday,14 days,59504.386
ACC-3741880913,25,32.0,10065.02,,CUS-1220154422,2018-10-04,Ashley,F,-23.40,150.50,,,,,,,debit,posted,cd508cd776bf4230856aad6f67160c57,PAYMENT,20-30,2018,10,4,22,0,Thursday,14 days,59504.386
ACC-3741880913,25,29.68,10035.34,1.0,CUS-1220154422,2018-10-06,Ashley,F,-23.40,150.50,,5dff36d2-8931-400a-ab57-8ec3a5e2879c,-34.41,150.52,NSW,Alpine,debit,authorized,587833c2448541468da927b564f1d38a,POS,20-30,2018,10,6,19,24,Saturday,14 days,59504.386
ACC-3741880913,25,30.53,10004.81,1.0,CUS-1220154422,2018-10-10,Ashley,F,-23.40,150.50,,5dff36d2-8931-400a-ab57-8ec3a5e2879c,-34.41,150.52,NSW,Alpine,debit,authorized,6c2ee5e7f5164e59b4a6534cfd9c1fcf,POS,20-30,2018,10,10,11,51,Wednesday,14 days,59504.386
ACC-3741880913,25,31.23,9973.58,1.0,CUS-1220154422,2018-10-10,Ashley,F,-23.40,150.50,,5dff36d2-8931-400a-ab57-8ec3a5e2879c,-34.41,150.52,NSW,Alpine,debit,authorized,07fdc8bc2c8c484c979cc2c118cec8a6,POS,20-30,2018,10,10,15,1,Wednesday,14 days,59504.386
ACC-3741880913,25,131.0,9842.58,,CUS-1220154422,2018-10-11,Ashley,F,-23.40,150.50,,,,,,,debit,posted,a9bc883d5430460b98dd4f6c522c42d7,PAYMENT,20-30,2018,10,11,7,0,Thursday,14 days,59504.386
ACC-3741880913,25,32.0,9810.58,,CUS-1220154422,2018-10-11,Ashley,F,-23.40,150.50,,,,,,,debit,posted,ec0c87be94234ffca1bcd026e37ab119,PAYMENT,20-30,2018,10,11,22,0,Thursday,14 days,59504.386
ACC-3741880913,25,31.94,9778.64,0.0,CUS-1220154422,2018-10-12,Ashley,F,-23.40,150.50,,e2feaaa7-ea2e-4033-bafe-f31520453e9c,-23.43,150.45,QLD,Gracemere,debit,authorized,3e9a8d47bcf84b4e9aafe69a7d45ffad,SALES-POS,20-30,2018,10,12,9,34,Friday,14 days,59504.386
ACC-3741880913,25,85.21,11975.79,1.0,CUS-1220154422,2018-10-12,Ashley,F,-23.40,150.50,,fe89d1fa-f803-47e8-aa9b-ec996ce2593e,-34.43,150.49,NSW,Braemar,debit,authorized,df14ed901e7e42faac7b2aa178f8d464,POS,20-30,2018,10,12,20,47,Friday,14 days,59504.386
ACC-3741880913,25,81.0,11894.79,,CUS-1220154422,2018-10-16,Ashley,F,-23.40,150.50,,,,,,,debit,posted,bc4fb14a6f8e4182aab1331544a0b074,PAYMENT,20-30,2018,10,16,19,0,Tuesday,14 days,59504.386
ACC-3741880913,25,32.0,11862.79,,CUS-1220154422,2018-10-18,Ashley,F,-23.40,150.50,,,,,,,debit,posted,09a9f66c836a4f41b4921bad3a63228c,PAYMENT,20-30,2018,10,18,22,0,Thursday,14 days,59504.386
ACC-3741880913,25,148.55,11714.24,1.0,CUS-1220154422,2018-10-19,Ashley,F,-23.40,150.50,,633d03c8-2319-4802-aaa9-f2c9c366a820,-23.39,119.8,WA,Newman,debit,authorized,9e9a87c1fea74fdeb112e7196b4dfb63,SALES-POS,20-30,2018,10,19,14,22,Friday,14 days,59504.386
ACC-3741880913,25,21.24,11693.0,1.0,CUS-1220154422,2018-10-19,Ashley,F,-23.40,150.50,,30e1920f-6a0a-4405-b444-b48caeb2bc5c,-23.37,119.73,WA,Newman,debit,authorized,17addf108cdd440a884c6a634128b44b,SALES-POS,20-30,2018,10,19,15,56,Friday,14 days,59504.386
ACC-3741880913,25,148.22,11544.78,0.0,CUS-1220154422,2018-10-21,Ashley,F,-23.40,150.50,,633d03c8-2319-4802-aaa9-f2c9c366a820,-23.39,119.8,WA,Newman,debit,authorized,d27d9acea4fa4f02955f2c2f2a10daa3,POS,20-30,2018,10,21,14,0,Sunday,14 days,59504.386
ACC-3741880913,25,71.64,11473.14,1.0,CUS-1220154422,2018-10-21,Ashley,F,-23.40,150.50,,21ea414a-1c7a-4de2-8a0e-d2e579d38c03,-37.84,144.98,VIC,Melbourne,debit,authorized,d7e4f6348c034946925974a94676a24f,POS,20-30,2018,10,21,15,51,Sunday,14 days,59504.386
ACC-3741880913,25,10.53,11462.61,1.0,CUS-1220154422,2018-10-22,Ashley,F,-23.40,150.50,,6f7d6056-ab46-4f90-8c33-840e1986c030,-35.32,150.47,NSW,Narrawallee,debit,authorized,6c833d1acf824f418dd829b951465659,POS,20-30,2018,10,22,6,55,Monday,14 days,59504.386
ACC-3741880913,25,148.64,11313.97,1.0,CUS-1220154422,2018-10-24,Ashley,F,-23.40,150.50,,633d03c8-2319-4802-aaa9-f2c9c366a820,-23.39,119.8,WA,Newman,debit,authorized,ebefd824dd0248eaa969337719c0a673,POS,20-30,2018,10,24,21,5,Wednesday,14 days,59504.386
ACC-3741880913,25,21.79,11292.18,1.0,CUS-1220154422,2018-10-25,Ashley,F,-23.40,150.50,,30e1920f-6a0a-4405-b444-b48caeb2bc5c,-23.37,119.73,WA,Newman,debit,authorized,332fe3dd9305452b995a2985db548aae,POS,20-30,2018,10,25,9,8,Thursday,14 days,59504.386
ACC-3741880913,25,83.94,11208.24,1.0,CUS-1220154422,2018-10-25,Ashley,F,-23.40,150.50,,fe89d1fa-f803-47e8-aa9b-ec996ce2593e,-34.43,150.49,NSW,Braemar,debit,authorized,2a2821d393c94de6b69f732b6273f517,POS,20-30,2018,10,25,14,57,Thursday,14 days,59504.386
ACC-3741880913,25,32.0,11176.24,,CUS-1220154422,2018-10-25,Ashley,F,-23.40,150.50,,,,,,,debit,posted,565c9b6921354b21a8b1c3f93cefcc76,PAYMENT,20-30,2018,10,25,22,0,Thursday,14 days,59504.386
ACC-2265520058,26,33.0,45.89,,CUS-331942311,2018-08-02,Catherine,F,-33.85,151.27,,,,,,,debit,posted,0475d2052a3b48b5a7415eb1a9575331,PAYMENT,20-30,2018,8,2,22,0,Thursday,14 days,48053.293
ACC-2265520058,26,5.12,40.77,1.0,CUS-331942311,2018-08-03,Catherine,F,-33.85,151.27,,b1a88e2a-7b07-4cb0-bc9b-547dd5d70f85,-33.95,115.07,WA,Margaret River,debit,authorized,f67022f23cf846b3a622cea384fb766c,POS,20-30,2018,8,3,11,43,Friday,14 days,48053.293
ACC-2265520058,26,22.32,18.45,1.0,CUS-331942311,2018-08-04,Catherine,F,-33.85,151.27,,f2c76ff1-b59a-4739-8e40-fa5cde1289c5,-33.98,151.11,NSW,South Hurstville,debit,authorized,bc07760e31424f80be5ef05e37e4070e,SALES-POS,20-30,2018,8,4,10,34,Saturday,14 days,48053.293
ACC-2265520058,26,8.3,10.15,1.0,CUS-331942311,2018-08-06,Catherine,F,-33.85,151.27,,4f91a7dc-62cb-4abb-9d0e-3838684e33fc,-33.77,150.73,NSW,Kingswood,debit,authorized,4c8e9058febe47988068215aa55a54b4,SALES-POS,20-30,2018,8,6,20,55,Monday,14 days,48053.293
ACC-2265520058,26,7.56,1845.73,1.0,CUS-331942311,2018-08-14,Catherine,F,-33.85,151.27,,a41ea38b-0b76-482e-86fc-9e2e48cd148d,-33.72,150.31,NSW,Katoomba,debit,authorized,099b126f2d5c4b4ca8fced8d88ae6a79,POS,20-30,2018,8,14,9,8,Tuesday,14 days,48053.293
ACC-2265520058,26,124.0,1688.73,,CUS-331942311,2018-08-18,Catherine,F,-33.85,151.27,,,,,,,debit,posted,783520032d254d58a1cf9519ae00d9fc,PAYMENT,20-30,2018,8,18,9,0,Saturday,14 days,48053.293
ACC-2265520058,26,84.0,1604.73,,CUS-331942311,2018-08-18,Catherine,F,-33.85,151.27,,,,,,,debit,posted,487d60fb186144ceb2d8861c3a116650,PAYMENT,20-30,2018,8,18,10,0,Saturday,14 days,48053.293
ACC-2265520058,26,33.0,1571.73,,CUS-331942311,2018-08-23,Catherine,F,-33.85,151.27,,,,,,,debit,posted,17abd454b6fe419e99d025983c195370,PAYMENT,20-30,2018,8,23,22,0,Thursday,14 days,48053.293
ACC-2265520058,26,42.5,3372.37,1.0,CUS-331942311,2018-08-29,Catherine,F,-33.85,151.27,,54ebf871-2553-4bb2-8542-cde92fc2b8d0,-33.8,151.18,NSW,Chatswood,debit,authorized,0482b6589e9f45ff99c7b221f217994f,SALES-POS,20-30,2018,8,29,8,34,Wednesday,14 days,48053.293
ACC-2265520058,26,33.0,3339.37,,CUS-331942311,2018-08-30,Catherine,F,-33.85,151.27,,,,,,,debit,posted,e29913940c9f465bac1307dd080c9bb0,PAYMENT,20-30,2018,8,30,22,0,Thursday,14 days,48053.293
ACC-2265520058,26,43.57,3295.8,1.0,CUS-331942311,2018-08-31,Catherine,F,-33.85,151.27,,6fcf2543-343c-497c-ab74-63660c75cac5,-33.89,151.27,NSW,Bondi Beach,debit,authorized,cb130761591b4095b1fb922aba36ec48,SALES-POS,20-30,2018,8,31,23,15,Friday,14 days,48053.293
ACC-2265520058,26,92.0,3203.8,,CUS-331942311,2018-09-05,Catherine,F,-33.85,151.27,,,,,,,debit,posted,69daa37c82614562997d61d3ff33ad83,PAYMENT,20-30,2018,9,5,18,0,Wednesday,14 days,48053.293
ACC-2265520058,26,53.37,3150.43,1.0,CUS-331942311,2018-09-06,Catherine,F,-33.85,151.27,,6681f9d3-cbeb-4049-9c51-dfdbc17fa3ba,-33.79,150.96,NSW,Toongabbie,debit,authorized,9cf7211e2a1f4734950a380c4e151f0c,SALES-POS,20-30,2018,9,6,16,47,Thursday,14 days,48053.293
ACC-2265520058,26,33.0,3117.43,,CUS-331942311,2018-09-06,Catherine,F,-33.85,151.27,,,,,,,debit,posted,0e5c76d6cd324039a07703acee189585,PAYMENT,20-30,2018,9,6,22,0,Thursday,14 days,48053.293
ACC-2265520058,26,16.61,3100.82,1.0,CUS-331942311,2018-09-07,Catherine,F,-33.85,151.27,,c070823f-f985-4974-b7ac-7a0090b26ddc,-33.97,151.09,NSW,Penshurst,debit,authorized,1cf4232ba16940ee968d4a00280e96bd,SALES-POS,20-30,2018,9,7,6,13,Friday,14 days,48053.293
ACC-2265520058,26,1060.8,2040.02,1.0,CUS-331942311,2018-09-07,Catherine,F,-33.85,151.27,,174c502e-6804-4d22-bf4c-2b362b0b9c14,-33.9,151.18,NSW,Newtown,debit,authorized,9d1713b88f404ab693a8ba3505a08865,SALES-POS,20-30,2018,9,7,19,13,Friday,14 days,48053.293
ACC-2265520058,26,90.0,1950.02,,CUS-331942311,2018-09-09,Catherine,F,-33.85,151.27,,,,,,,debit,posted,b43518427e4e4a77834c02e6856ea24a,PAYMENT,20-30,2018,9,9,9,0,Sunday,14 days,48053.293
ACC-2265520058,26,39.64,1910.38,1.0,CUS-331942311,2018-09-10,Catherine,F,-33.85,151.27,,44c6a224-417c-4ccb-9c79-005fc93ef087,-33.92,151.17,NSW,Tempe,debit,authorized,debdff91e3a842bf9a4f151f452abf38,SALES-POS,20-30,2018,9,10,8,48,Monday,14 days,48053.293
ACC-2265520058,26,10.8,1899.58,1.0,CUS-331942311,2018-09-10,Catherine,F,-33.85,151.27,,95a7ad25-7a74-4bf2-b437-bb327c21ee6c,-33.84,151.09,NSW,Concord West,debit,authorized,51aa654545e54445bcb35f8b29e2bdac,POS,20-30,2018,9,10,9,10,Monday,14 days,48053.293
ACC-2265520058,26,57.08,3685.64,1.0,CUS-331942311,2018-09-10,Catherine,F,-33.85,151.27,,904ce8b6-42da-4f7e-b26e-fd528cdef66d,-33.92,151.09,NSW,Belmore,debit,authorized,29652537269b45d1af6ad8bbd100dd5d,POS,20-30,2018,9,10,15,2,Monday,14 days,48053.293
ACC-2265520058,26,103.0,3582.64,,CUS-331942311,2018-09-11,Catherine,F,-33.85,151.27,,,,,,,debit,posted,b65dff09d0ba4238b5e8febc4a0d42a1,PAYMENT,20-30,2018,9,11,4,0,Tuesday,14 days,48053.293
ACC-2265520058,26,64.14,3518.5,1.0,CUS-331942311,2018-09-13,Catherine,F,-33.85,151.27,,de98ea25-1956-40e1-afe5-d3f32586269d,-33.77,150.91,NSW,Blacktown,debit,authorized,8348fbf3a4944f03a52749fb3c6163f0,SALES-POS,20-30,2018,9,13,17,6,Thursday,14 days,48053.293
ACC-2265520058,26,33.0,3485.5,,CUS-331942311,2018-09-13,Catherine,F,-33.85,151.27,,,,,,,debit,posted,f65edeeb1054488ca1b3f17a1913531a,PAYMENT,20-30,2018,9,13,22,0,Thursday,14 days,48053.293
ACC-2265520058,26,52.81,3432.69,0.0,CUS-331942311,2018-09-14,Catherine,F,-33.85,151.27,,bc6f62e0-7120-4631-ac30-0115e2679ec7,-33.76,151.28,NSW,Brookvale,debit,authorized,b2ecfffcabed474282eaafb1e1f1520b,POS,20-30,2018,9,14,20,48,Friday,14 days,48053.293
ACC-2265520058,26,35.34,3397.35,1.0,CUS-331942311,2018-09-14,Catherine,F,-33.85,151.27,,7c27c261-9d34-40e2-89d2-d32c5626712d,-27.42,153.03,QLD,Lutwyche,debit,authorized,b4e696b1256749b7badedf78114073ce,POS,20-30,2018,9,14,21,26,Friday,14 days,48053.293
ACC-2265520058,26,85.43,3311.92,1.0,CUS-331942311,2018-09-15,Catherine,F,-33.85,151.27,,89e7ab50-95ec-48c6-8364-dc4562f59bd1,-33.73,150.98,NSW,Castle Hill,debit,authorized,4cc8553d417540d68337e11c6d640856,SALES-POS,20-30,2018,9,15,0,42,Saturday,14 days,48053.293
ACC-2265520058,26,124.0,3187.92,,CUS-331942311,2018-09-18,Catherine,F,-33.85,151.27,,,,,,,debit,posted,69cfab1063904a30af58cd35d5210ea7,PAYMENT,20-30,2018,9,18,9,0,Tuesday,14 days,48053.293
ACC-2265520058,26,84.0,3103.92,,CUS-331942311,2018-09-18,Catherine,F,-33.85,151.27,,,,,,,debit,posted,3ae0b670fa324e0796a2fd0a77189b4d,PAYMENT,20-30,2018,9,18,10,0,Tuesday,14 days,48053.293
ACC-2265520058,26,0.1,3103.82,1.0,CUS-331942311,2018-09-20,Catherine,F,-33.85,151.27,,3e900109-863e-431a-8287-2ff69fe3b8f2,-33.89,151.25,NSW,Woollahra,debit,authorized,dd9a6c8d1c454705a62e7a67592698be,POS,20-30,2018,9,20,21,49,Thursday,14 days,48053.293
ACC-2265520058,26,33.0,3070.82,,CUS-331942311,2018-09-20,Catherine,F,-33.85,151.27,,,,,,,debit,posted,d897f7c15932411195e381cbc3c197b1,PAYMENT,20-30,2018,9,20,22,0,Thursday,14 days,48053.293
ACC-2265520058,26,23.11,3047.71,0.0,CUS-331942311,2018-09-21,Catherine,F,-33.85,151.27,,a5a19f64-ed9a-4e49-9e20-66f2ac96b81f,-33.95,115.07,WA,Margaret River,debit,authorized,c0e11efb6c294739bf2198b80ef2806a,SALES-POS,20-30,2018,9,21,14,21,Friday,14 days,48053.293
ACC-2265520058,26,27.76,3019.95,1.0,CUS-331942311,2018-09-24,Catherine,F,-33.85,151.27,,6cacdd75-f8e6-49e7-9eef-e6669ea7605a,-33.74,150.95,NSW,Bella Vista,debit,authorized,fba91b3557fa432195de059759775c66,SALES-POS,20-30,2018,9,24,9,47,Monday,14 days,48053.293
ACC-2265520058,26,33.0,4830.09,,CUS-331942311,2018-09-27,Catherine,F,-33.85,151.27,,,,,,,debit,posted,b44756840af64d2bb3f0238f58a267d0,PAYMENT,20-30,2018,9,27,22,0,Thursday,14 days,48053.293
ACC-2265520058,26,33.0,4797.09,,CUS-331942311,2018-10-04,Catherine,F,-33.85,151.27,,,,,,,debit,posted,260112acf30e4898b86d326b8ce9ae20,PAYMENT,20-30,2018,10,4,22,0,Thursday,14 days,48053.293
ACC-2265520058,26,92.0,4705.09,,CUS-331942311,2018-10-05,Catherine,F,-33.85,151.27,,,,,,,debit,posted,e8302494eda046d2871a384defc54235,PAYMENT,20-30,2018,10,5,18,0,Friday,14 days,48053.293
ACC-2265520058,26,90.0,6458.23,,CUS-331942311,2018-10-09,Catherine,F,-33.85,151.27,,,,,,,debit,posted,81e788bb484d4f18b3aa11d358a60eca,PAYMENT,20-30,2018,10,9,9,0,Tuesday,14 days,48053.293
ACC-2265520058,26,103.0,6355.23,,CUS-331942311,2018-10-11,Catherine,F,-33.85,151.27,,,,,,,debit,posted,38bbaba1cb0e4095b7ffcc2ceb7a625a,PAYMENT,20-30,2018,10,11,4,0,Thursday,14 days,48053.293
ACC-2265520058,26,37.21,6318.02,1.0,CUS-331942311,2018-10-11,Catherine,F,-33.85,151.27,,7e7ef94c-c33b-4a59-83b1-94e320c23baf,-33.82,151.01,NSW,Harris Park,debit,authorized,e01f8d27cb734cd48b01799ab1d3534c,POS,20-30,2018,10,11,9,32,Thursday,14 days,48053.293
ACC-2265520058,26,32.9,6285.12,1.0,CUS-331942311,2018-10-11,Catherine,F,-33.85,151.27,,35683434-cb66-4544-b8e8-6ca8372e6e3f,-33.89,150.94,NSW,Canley Vale,debit,authorized,414b5cb597e840a1996facafa18662de,POS,20-30,2018,10,11,12,47,Thursday,14 days,48053.293
ACC-2265520058,26,33.0,6252.12,,CUS-331942311,2018-10-11,Catherine,F,-33.85,151.27,,,,,,,debit,posted,c03ac8513dbf415db2202663c4b826c2,PAYMENT,20-30,2018,10,11,22,0,Thursday,14 days,48053.293
ACC-2265520058,26,20.47,6231.65,1.0,CUS-331942311,2018-10-12,Catherine,F,-33.85,151.27,,ac66436c-786a-4af2-8deb-2c081095bbb8,-33.7,150.94,NSW,Beaumont Hills,debit,authorized,eee757621d8742b9ac51d9a35c62a410,SALES-POS,20-30,2018,10,12,9,19,Friday,14 days,48053.293
ACC-2265520058,26,85.65,6146.0,1.0,CUS-331942311,2018-10-12,Catherine,F,-33.85,151.27,,ddef268d-2cc6-4103-a09c-d69822a4bb53,-33.87,151.2,NSW,Sydney,debit,authorized,ff2d68b46e6b41ad9d7e92cde00f2cf2,POS,20-30,2018,10,12,20,6,Friday,14 days,48053.293
ACC-2265520058,26,75.39,6070.61,1.0,CUS-331942311,2018-10-12,Catherine,F,-33.85,151.27,,c1468f3e-98a2-4758-bb44-c537d180b3ce,-33.75,151.22,NSW,Frenchs Forest,debit,authorized,ec0a64a60e01442ab4704e620d882325,POS,20-30,2018,10,12,23,35,Friday,14 days,48053.293
ACC-2265520058,26,72.48,5998.13,1.0,CUS-331942311,2018-10-13,Catherine,F,-33.85,151.27,,e888ea98-4249-485d-a03d-531742ecbfad,-33.74,150.95,NSW,Bella Vista,debit,authorized,b6e8d68e22c94c44bff01086404cb4ae,SALES-POS,20-30,2018,10,13,8,3,Saturday,14 days,48053.293
ACC-2265520058,26,23.52,5974.61,0.0,CUS-331942311,2018-10-16,Catherine,F,-33.85,151.27,,2168f07b-f8db-4d7b-8d06-5cd3fd85a4f9,-33.95,151.26,NSW,Maroubra,debit,authorized,e10247f3439041fba36fd15dfcf27895,POS,20-30,2018,10,16,12,59,Tuesday,14 days,48053.293
ACC-2265520058,26,124.0,5850.61,,CUS-331942311,2018-10-18,Catherine,F,-33.85,151.27,,,,,,,debit,posted,a4120bd63ae94b198497f1d1c870f5cb,PAYMENT,20-30,2018,10,18,9,0,Thursday,14 days,48053.293
ACC-2265520058,26,84.0,5766.61,,CUS-331942311,2018-10-18,Catherine,F,-33.85,151.27,,,,,,,debit,posted,374cbcb8c8f142aca6680d497ea2a073,PAYMENT,20-30,2018,10,18,10,0,Thursday,14 days,48053.293
ACC-2265520058,26,33.0,5733.61,,CUS-331942311,2018-10-18,Catherine,F,-33.85,151.27,,,,,,,debit,posted,cf29a5423c3d443eb68dd1e7b0108469,PAYMENT,20-30,2018,10,18,22,0,Thursday,14 days,48053.293
ACC-2265520058,26,39.96,5693.65,1.0,CUS-331942311,2018-10-21,Catherine,F,-33.85,151.27,,1995af85-039f-4d54-b08e-808b632f98cf,-33.81,151.17,NSW,Lane Cove,debit,authorized,382e882cd0494f5d9afebe4487f5b923,POS,20-30,2018,10,21,20,34,Sunday,14 days,48053.293
ACC-2265520058,26,40.14,5653.51,1.0,CUS-331942311,2018-10-21,Catherine,F,-33.85,151.27,,d6191103-722d-4593-b4e2-b6d4bf7a40b5,-33.86,151.2,NSW,Sydney,debit,authorized,7b7f14e8d53d403ba1168c4ac0a31a87,POS,20-30,2018,10,21,22,0,Sunday,14 days,48053.293
ACC-2265520058,26,10.21,7486.44,1.0,CUS-331942311,2018-10-22,Catherine,F,-33.85,151.27,,cb3563c8-e066-43f0-85e8-95c20411624c,-33.74,150.95,NSW,Bella Vista,debit,authorized,23438c8bcd1e4359b585ecfa57e2e20e,SALES-POS,20-30,2018,10,22,22,43,Monday,14 days,48053.293
ACC-2265520058,26,18.36,7468.08,1.0,CUS-331942311,2018-10-23,Catherine,F,-33.85,151.27,,052fee4a-a751-435f-9dbd-20f01b906420,-33.72,150.92,NSW,Stanhope Gardens,debit,authorized,9e6f649d36734e4da740a6fe6dd7a249,SALES-POS,20-30,2018,10,23,9,42,Tuesday,14 days,48053.293
ACC-2265520058,26,33.0,7435.08,,CUS-331942311,2018-10-25,Catherine,F,-33.85,151.27,,,,,,,debit,posted,2a1b6db0eb044e6d82fa3cc0e4f6eafa,PAYMENT,20-30,2018,10,25,22,0,Thursday,14 days,48053.293
ACC-2265520058,26,15.45,7419.63,1.0,CUS-331942311,2018-10-27,Catherine,F,-33.85,151.27,,50bbb2e3-8bd1-4605-9105-9ac1fd37ec4c,-33.87,151.28,NSW,Rose Bay,debit,authorized,fe5e5846c4694278b93f0b6f910cbd12,POS,20-30,2018,10,27,22,17,Saturday,14 days,48053.293
ACC-2265520058,26,123.18,7296.45,1.0,CUS-331942311,2018-10-28,Catherine,F,-33.85,151.27,,90bcda32-430a-4719-a097-ab1202a77317,-33.97,151.14,NSW,Kogarah,debit,authorized,36b1f1b9bf0743158bd0c5fad76d0a5b,SALES-POS,20-30,2018,10,28,21,9,Sunday,14 days,48053.293
ACC-2265520058,26,55.39,7241.06,1.0,CUS-331942311,2018-10-30,Catherine,F,-33.85,151.27,,abd7bf8d-f8ca-4003-a634-ad5219729cb5,-33.93,151.18,NSW,Mascot,debit,authorized,324d395023214bcc90257b62338fb97a,POS,20-30,2018,10,30,15,50,Tuesday,14 days,48053.293
ACC-2650850707,42,193.0,103466.38,,CUS-2819545904,2018-08-03,Brian,M,-23.52,148.16,,,,,,,debit,posted,ee4cc3a59dbd49b3b792682fd8ec0d41,PAYMENT,40-50,2018,8,3,16,0,Friday,14 days,84243.564
ACC-2650850707,42,53.34,103413.04,1.0,CUS-2819545904,2018-08-03,Brian,M,-23.52,148.16,,6e829426-63c4-4042-8ba3-d657464d4519,-33.13,148.17,NSW,Parkes,debit,authorized,18ddca4dd414466e90356ac9fd78f2f3,SALES-POS,40-50,2018,8,3,23,13,Friday,14 days,84243.564
ACC-2650850707,42,118.0,103295.04,,CUS-2819545904,2018-08-04,Brian,M,-23.52,148.16,,,,,,,debit,posted,feef3a9b6e5e41b0a09636da74ba7723,INTER BANK,40-50,2018,8,4,16,0,Saturday,14 days,84243.564
ACC-2650850707,42,78.15,103216.89,0.0,CUS-2819545904,2018-08-05,Brian,M,-23.52,148.16,,ffb0e319-decb-424f-8bb9-33bfc9170e01,-23.52,148.15,QLD,Emerald,debit,authorized,5925d7c2499d459fb7653411a6e8a1c9,SALES-POS,40-50,2018,8,5,17,39,Sunday,14 days,84243.564
ACC-2650850707,42,51.57,103165.32,1.0,CUS-2819545904,2018-08-05,Brian,M,-23.52,148.16,,92a44610-b83a-46e9-99b0-46e00afb295b,-30.02,148.12,NSW,Walgett,debit,authorized,69f311fde77b4a6d8cf65953f4ae9aa4,SALES-POS,40-50,2018,8,5,20,54,Sunday,14 days,84243.564
ACC-2650850707,42,33.0,106363.58,,CUS-2819545904,2018-08-06,Brian,M,-23.52,148.16,,,,,,,debit,posted,a3374eebbd5b45adba2a2796af22a0e1,PAYMENT,40-50,2018,8,6,20,0,Monday,14 days,84243.564
ACC-2650850707,42,187.0,106176.58,,CUS-2819545904,2018-08-09,Brian,M,-23.52,148.16,,,,,,,debit,posted,b127dc9d5edf4f04ade88bd6a05ac0d9,PAYMENT,40-50,2018,8,9,22,0,Thursday,14 days,84243.564
ACC-2650850707,42,33.0,106143.58,,CUS-2819545904,2018-08-13,Brian,M,-23.52,148.16,,,,,,,debit,posted,1d94bb2b3c40444f8d8ba0540e178f5f,PAYMENT,40-50,2018,8,13,20,0,Monday,14 days,84243.564
ACC-2650850707,42,62.99,106080.59,1.0,CUS-2819545904,2018-08-15,Brian,M,-23.52,148.16,,395894a9-69a5-47d6-8d07-4cf67cc10024,-20,148.24,QLD,Bowen,debit,authorized,1856fa35d4ff4c05b8ed48836da3c769,POS,40-50,2018,8,15,1,24,Wednesday,14 days,84243.564
ACC-2650850707,42,31.18,106049.41,0.0,CUS-2819545904,2018-08-15,Brian,M,-23.52,148.16,,cf5ce0ba-0001-498e-9bb8-f534bcbc96d6,-23.49,150.28,QLD,Kalapa,debit,authorized,67f5516d9e0a4287b40a428771cfcaf9,POS,40-50,2018,8,15,1,46,Wednesday,14 days,84243.564
ACC-2650850707,42,107.42,105941.99,0.0,CUS-2819545904,2018-08-15,Brian,M,-23.52,148.16,,a23aa978-bd00-4654-80cb-2b6ab00e13df,-33.14,148.17,NSW,Parkes,debit,authorized,659e5694c18c4f95816e49789908c16f,POS,40-50,2018,8,15,4,53,Wednesday,14 days,84243.564
ACC-2650850707,42,90.0,105851.99,1.0,CUS-2819545904,2018-08-15,Brian,M,-23.52,148.16,,19935a6d-45b3-4311-a6ec-ac73c61ecc7e,-23.53,148.16,QLD,Emerald,debit,authorized,13424466c90545018f8beb77b99b4dc2,SALES-POS,40-50,2018,8,15,7,38,Wednesday,14 days,84243.564
ACC-2650850707,42,33.0,108758.32,,CUS-2819545904,2018-08-20,Brian,M,-23.52,148.16,,,,,,,debit,posted,c1aab9e279514888a3ccef7831ffa991,PAYMENT,40-50,2018,8,20,20,0,Monday,14 days,84243.564
ACC-2650850707,42,351.06,108407.26,1.0,CUS-2819545904,2018-08-23,Brian,M,-23.52,148.16,,f82e6e6e-13a2-42e4-9b36-ee31e951e54e,-33.76,151.26,NSW,Brookvale,debit,authorized,e34368dbc7de4653843e173f5e230fbd,POS,40-50,2018,8,23,18,19,Thursday,14 days,84243.564
ACC-2650850707,42,627.0,107780.26,,CUS-2819545904,2018-08-25,Brian,M,-23.52,148.16,,,,,,,debit,posted,fde75b015b2c4c4197b6c5ae1d841ba0,PAYMENT,40-50,2018,8,25,14,0,Saturday,14 days,84243.564
ACC-2650850707,42,43.07,107737.19,1.0,CUS-2819545904,2018-08-25,Brian,M,-23.52,148.16,,493c9aac-8cb8-4621-a565-59e08ecbd3cd,-23.52,148.15,QLD,Emerald,debit,authorized,fb6107e8a59246c78b8949cec615fd0e,POS,40-50,2018,8,25,20,6,Saturday,14 days,84243.564
ACC-2650850707,42,38.65,107698.54,1.0,CUS-2819545904,2018-08-25,Brian,M,-23.52,148.16,,6c924952-b052-4561-88e1-01e6ef24e5d6,-41.46,148.26,TAS,Scamander,debit,authorized,dd4622e164994490ab58ebb127eadb7e,POS,40-50,2018,8,25,23,39,Saturday,14 days,84243.564
ACC-2650850707,42,17.2,107681.34,0.0,CUS-2819545904,2018-08-26,Brian,M,-23.52,148.16,,df7809c8-ddda-4b06-a593-ebe38f26d467,-23.59,148.89,QLD,Blackwater,debit,authorized,aefefe9a6d7445d3a077bb50748da69c,POS,40-50,2018,8,26,9,24,Sunday,14 days,84243.564
ACC-2650850707,42,197.0,107484.34,,CUS-2819545904,2018-08-27,Brian,M,-23.52,148.16,,,,,,,debit,posted,6cfaebbab13d4a42af8b4df8f35917f5,INTER BANK,40-50,2018,8,27,11,0,Monday,14 days,84243.564
ACC-2650850707,42,33.0,107451.34,,CUS-2819545904,2018-08-27,Brian,M,-23.52,148.16,,,,,,,debit,posted,fb4f9b78849a48948f6627a17994efe1,PAYMENT,40-50,2018,8,27,20,0,Monday,14 days,84243.564
ACC-2650850707,42,49.99,107401.35,1.0,CUS-2819545904,2018-08-27,Brian,M,-23.52,148.16,,9a658f0a-e753-4367-befe-950ff80f40af,-35.08,148.09,NSW,Gundagai,debit,authorized,025520641488451a97e509854861cf65,SALES-POS,40-50,2018,8,27,22,23,Monday,14 days,84243.564
ACC-2650850707,42,53.83,107347.52,1.0,CUS-2819545904,2018-08-27,Brian,M,-23.52,148.16,,07302d5b-4c80-4fd3-9db9-dcc4e673732d,-23.53,148.17,QLD,Emerald,debit,authorized,079c430190524ed88ae1ddf74f2ec8c3,SALES-POS,40-50,2018,8,27,22,44,Monday,14 days,84243.564
ACC-2650850707,42,88.75,107258.77,1.0,CUS-2819545904,2018-08-29,Brian,M,-23.52,148.16,,7640c58c-f7d8-4cb5-971f-7754e72a8070,-23.55,145.28,QLD,Barcaldine,debit,authorized,0fd9424ab27343f9b1543e8ecfc6339e,SALES-POS,40-50,2018,8,29,11,9,Wednesday,14 days,84243.564
ACC-2650850707,42,86.9,107171.87,1.0,CUS-2819545904,2018-08-30,Brian,M,-23.52,148.16,,b141b0c5-537d-4b2e-8776-39396d8d20c0,-33.89,148.16,NSW,Grenfell,debit,authorized,1c425475758b4b65bb518b1102413f3a,POS,40-50,2018,8,30,1,31,Thursday,14 days,84243.564
ACC-2650850707,42,41.51,107130.36,1.0,CUS-2819545904,2018-08-30,Brian,M,-23.52,148.16,,25c15dab-30e0-4df3-bcb1-85b76bb7ec2b,-23.46,150.45,QLD,Gracemere,debit,authorized,426d8b14a0184f039290cd6ee751c0eb,SALES-POS,40-50,2018,8,30,9,23,Thursday,14 days,84243.564
ACC-2650850707,42,193.0,110168.62,,CUS-2819545904,2018-09-03,Brian,M,-23.52,148.16,,,,,,,debit,posted,226a16dba6104f149713510567324066,PAYMENT,40-50,2018,9,3,16,0,Monday,14 days,84243.564
ACC-2650850707,42,33.0,110135.62,,CUS-2819545904,2018-09-03,Brian,M,-23.52,148.16,,,,,,,debit,posted,1bf09a1f29ce49bd9f2c11e2dc08bd33,PAYMENT,40-50,2018,9,3,20,0,Monday,14 days,84243.564
ACC-2650850707,42,118.0,110017.62,,CUS-2819545904,2018-09-04,Brian,M,-23.52,148.16,,,,,,,debit,posted,22d0b3d4faf243efa4578d422d05c8af,INTER BANK,40-50,2018,9,4,16,0,Tuesday,14 days,84243.564
ACC-2650850707,42,30.92,109986.7,1.0,CUS-2819545904,2018-09-08,Brian,M,-23.52,148.16,,cf5ce0ba-0001-498e-9bb8-f534bcbc96d6,-23.49,150.28,QLD,Kalapa,debit,authorized,4c31b748a72442ef890ece1fefbd9aa8,SALES-POS,40-50,2018,9,8,23,26,Saturday,14 days,84243.564
ACC-2650850707,42,187.0,109799.7,,CUS-2819545904,2018-09-09,Brian,M,-23.52,148.16,,,,,,,debit,posted,293cb0210d6c493289d107cebe6e971b,PAYMENT,40-50,2018,9,9,22,0,Sunday,14 days,84243.564
ACC-2650850707,42,33.0,109766.7,,CUS-2819545904,2018-09-10,Brian,M,-23.52,148.16,,,,,,,debit,posted,c93f617d100544df9105f3e5f3b74c25,PAYMENT,40-50,2018,9,10,20,0,Monday,14 days,84243.564
ACC-2650850707,42,161.0,109605.7,,CUS-2819545904,2018-09-16,Brian,M,-23.52,148.16,,,,,,,debit,posted,3b38a9c5b1324c109db6849993794735,INTER BANK,40-50,2018,9,16,7,0,Sunday,14 days,84243.564
ACC-2650850707,42,33.0,112803.96,,CUS-2819545904,2018-09-17,Brian,M,-23.52,148.16,,,,,,,debit,posted,ca6e5694d83f4f97a64fb3c89b3b28e0,PAYMENT,40-50,2018,9,17,20,0,Monday,14 days,84243.564
ACC-2650850707,42,80.41,112723.55,1.0,CUS-2819545904,2018-09-22,Brian,M,-23.52,148.16,,cb54ec1c-4a25-4c3c-87ac-82d1daf10607,-23.59,148.89,QLD,Blackwater,debit,authorized,8fdf05b38ce441f697681650e70c9459,POS,40-50,2018,9,22,14,1,Saturday,14 days,84243.564
ACC-2650850707,42,49.84,112673.71,0.0,CUS-2819545904,2018-09-23,Brian,M,-23.52,148.16,,8d7c3b90-f653-45da-8afd-a53c94fb05dd,-33.87,151.21,NSW,Sydney,debit,authorized,c134f9c1e363421089df617dfee2f222,SALES-POS,40-50,2018,9,23,10,32,Sunday,14 days,84243.564
ACC-2650850707,42,33.0,112640.71,,CUS-2819545904,2018-09-24,Brian,M,-23.52,148.16,,,,,,,debit,posted,0e4904c7520042969edde12b7a37cd0f,PAYMENT,40-50,2018,9,24,20,0,Monday,14 days,84243.564
ACC-2650850707,42,197.0,112443.71,,CUS-2819545904,2018-09-27,Brian,M,-23.52,148.16,,,,,,,debit,posted,21a5966087b34c5ba8de23a4bde7981d,INTER BANK,40-50,2018,9,27,11,0,Thursday,14 days,84243.564
ACC-2650850707,42,33.0,115641.97,,CUS-2819545904,2018-10-01,Brian,M,-23.52,148.16,,,,,,,debit,posted,68575559ac0343709a7099400e064b11,PAYMENT,40-50,2018,10,1,20,0,Monday,14 days,84243.564
ACC-2650850707,42,193.0,115448.97,,CUS-2819545904,2018-10-03,Brian,M,-23.52,148.16,,,,,,,debit,posted,8dc7226df48640bc8bee9713ea05104b,PAYMENT,40-50,2018,10,3,16,0,Wednesday,14 days,84243.564
ACC-2650850707,42,118.0,115330.97,,CUS-2819545904,2018-10-04,Brian,M,-23.52,148.16,,,,,,,debit,posted,6908aa8aa614473ab9b95d2d848b000f,INTER BANK,40-50,2018,10,4,16,0,Thursday,14 days,84243.564
ACC-2650850707,42,33.0,115297.97,,CUS-2819545904,2018-10-08,Brian,M,-23.52,148.16,,,,,,,debit,posted,01bfc177e4c8411c9e0df7e336257840,PAYMENT,40-50,2018,10,8,20,0,Monday,14 days,84243.564
ACC-2650850707,42,187.0,115110.97,,CUS-2819545904,2018-10-09,Brian,M,-23.52,148.16,,,,,,,debit,posted,a96e999b595849868f8edee19cc7358c,PAYMENT,40-50,2018,10,9,22,0,Tuesday,14 days,84243.564
ACC-2650850707,42,33.0,118309.23,,CUS-2819545904,2018-10-15,Brian,M,-23.52,148.16,,,,,,,debit,posted,3e8d057068474ac4be06d2d4238b2f43,PAYMENT,40-50,2018,10,15,20,0,Monday,14 days,84243.564
ACC-2650850707,42,161.0,118148.23,,CUS-2819545904,2018-10-16,Brian,M,-23.52,148.16,,,,,,,debit,posted,52222bb4257d4ab3bf053f0d8073b0ea,INTER BANK,40-50,2018,10,16,7,0,Tuesday,14 days,84243.564
ACC-2650850707,42,44.82,118103.41,1.0,CUS-2819545904,2018-10-17,Brian,M,-23.52,148.16,,74c7d9ca-3ccb-487a-8634-a8ec3493d2cd,-35.3,148.22,NSW,Tumut,debit,authorized,f8c1c6b5691b4e4795b7a08a3375a7aa,SALES-POS,40-50,2018,10,17,14,57,Wednesday,14 days,84243.564
ACC-2650850707,42,114.01,117989.4,1.0,CUS-2819545904,2018-10-20,Brian,M,-23.52,148.16,,e9059249-10c8-41aa-8d7f-2bbbe9c536f1,-41.32,148.25,TAS,Saint Helens,debit,authorized,3f30061fde4645a392286a8d8770a209,POS,40-50,2018,10,20,19,57,Saturday,14 days,84243.564
ACC-2650850707,42,114.83,117874.57,1.0,CUS-2819545904,2018-10-20,Brian,M,-23.52,148.16,,e9059249-10c8-41aa-8d7f-2bbbe9c536f1,-41.32,148.25,TAS,Saint Helens,debit,authorized,a8fab948ffac4f07a22a87c2d1ad93b0,SALES-POS,40-50,2018,10,20,20,49,Saturday,14 days,84243.564
ACC-2650850707,42,58.02,117816.55,1.0,CUS-2819545904,2018-10-21,Brian,M,-23.52,148.16,,c97702a0-6251-4ff6-a6a1-4cb4084ef276,-23.44,144.25,QLD,Longreach,debit,authorized,b7273319cfbd4e35ac0dae6231547bc4,SALES-POS,40-50,2018,10,21,11,56,Sunday,14 days,84243.564
ACC-2650850707,42,41.07,117775.48,1.0,CUS-2819545904,2018-10-22,Brian,M,-23.52,148.16,,3f35e14e-a975-44b0-8e88-be3b6bc32502,-22.05,148.07,QLD,Moranbah,debit,authorized,2a9b7cb2b1ee429498495080f8c5603a,POS,40-50,2018,10,22,10,9,Monday,14 days,84243.564
ACC-2650850707,42,45.03,117730.45,0.0,CUS-2819545904,2018-10-22,Brian,M,-23.52,148.16,,f7f1a4c4-9947-47f5-a461-2fed2ca3324c,-37.82,144.96,VIC,Melbourne,debit,authorized,423de7f8c2ba4770886404266f54e659,SALES-POS,40-50,2018,10,22,12,42,Monday,14 days,84243.564
ACC-2650850707,42,33.0,117697.45,,CUS-2819545904,2018-10-22,Brian,M,-23.52,148.16,,,,,,,debit,posted,5d9c3ee1a3e74fb5bf39a441aed38090,PAYMENT,40-50,2018,10,22,20,0,Monday,14 days,84243.564
ACC-2650850707,42,68.44,117629.01,1.0,CUS-2819545904,2018-10-25,Brian,M,-23.52,148.16,,fdecec5d-579d-4384-874e-565034c484da,-23.43,150.46,QLD,Gracemere,debit,authorized,5d77708bc24a4795aa37e7402c03561b,SALES-POS,40-50,2018,10,25,8,58,Thursday,14 days,84243.564
ACC-2650850707,42,255.9,117373.11,1.0,CUS-2819545904,2018-10-25,Brian,M,-23.52,148.16,,98b1745c-e4d7-4363-8c2a-9d04ca89f1e4,-37.82,144.97,VIC,Melbourne,debit,authorized,b4cb03e43c5f40858fbc52735bc6f451,SALES-POS,40-50,2018,10,25,9,50,Thursday,14 days,84243.564
ACC-2650850707,42,197.0,117176.11,,CUS-2819545904,2018-10-27,Brian,M,-23.52,148.16,,,,,,,debit,posted,d4f4b0e05f784913a5f4857ce3132c17,INTER BANK,40-50,2018,10,27,11,0,Saturday,14 days,84243.564
ACC-2650850707,42,34.76,117141.35,1.0,CUS-2819545904,2018-10-27,Brian,M,-23.52,148.16,,111ac773-ce9a-4767-9727-8c4447c5aef2,-23.59,148.88,QLD,Blackwater,debit,authorized,443e931bd10b470790e95de6b68aa540,SALES-POS,40-50,2018,10,27,17,6,Saturday,14 days,84243.564
ACC-2650850707,42,33.0,120339.61,,CUS-2819545904,2018-10-29,Brian,M,-23.52,148.16,,,,,,,debit,posted,642455fb0d22412aadaaea94e6bf8736,PAYMENT,40-50,2018,10,29,20,0,Monday,14 days,84243.564
ACC-1998563091,42,51.59,13218.65,1.0,CUS-3395687666,2018-08-04,David,M,-35.25,149.03,,8009fd96-fd9e-4a11-b72e-34f051f315fa,-23.58,148.89,QLD,Blackwater,debit,authorized,1bca38c5b867487fa1a13205264f58ae,POS,40-50,2018,8,4,1,59,Saturday,14 days,45828.618
ACC-1998563091,42,45.0,13173.65,,CUS-3395687666,2018-08-04,David,M,-35.25,149.03,,,,,,,debit,posted,f74358738a89472d87c2e2c7e11b395c,PAYMENT,40-50,2018,8,4,12,0,Saturday,14 days,45828.618
ACC-1998563091,42,45.5,13128.15,1.0,CUS-3395687666,2018-08-08,David,M,-35.25,149.03,,80f556e8-cff2-4dad-bbb6-9f3f9672bb55,-33.89,151.21,NSW,Surry Hills,debit,authorized,62cf79903db8419fbb02c2b9449db75f,POS,40-50,2018,8,8,11,8,Wednesday,14 days,45828.618
ACC-1998563091,42,159.0,12969.15,,CUS-3395687666,2018-08-09,David,M,-35.25,149.03,,,,,,,debit,posted,00a3d2d18cf54ce29b548a8040f3b19b,INTER BANK,40-50,2018,8,9,2,0,Thursday,14 days,45828.618
ACC-1998563091,42,45.0,12924.15,,CUS-3395687666,2018-08-11,David,M,-35.25,149.03,,,,,,,debit,posted,d9f29bf307274049bc97ca734d70a135,PAYMENT,40-50,2018,8,11,12,0,Saturday,14 days,45828.618
ACC-1998563091,42,116.0,12808.15,,CUS-3395687666,2018-08-11,David,M,-35.25,149.03,,,,,,,debit,posted,642e730b127648928210a6fc456dd73f,PAYMENT,40-50,2018,8,11,12,0,Saturday,14 days,45828.618
ACC-1998563091,42,45.0,14520.96,,CUS-3395687666,2018-08-18,David,M,-35.25,149.03,,,,,,,debit,posted,fe25ab7cd02b4bc48e1a20cd5df905f0,PAYMENT,40-50,2018,8,18,12,0,Saturday,14 days,45828.618
ACC-1998563091,42,45.0,14475.96,,CUS-3395687666,2018-08-25,David,M,-35.25,149.03,,,,,,,debit,posted,ebf60b6e96374411affa3b2bc9bf1b0e,PAYMENT,40-50,2018,8,25,12,0,Saturday,14 days,45828.618
ACC-1998563091,42,37.66,16196.11,1.0,CUS-3395687666,2018-08-31,David,M,-35.25,149.03,,467279fa-b8a2-4468-86aa-af8aa15a1d6e,-35.32,150.44,NSW,Milton,debit,authorized,e714f9776a774276a28f4c86b7b18bc8,POS,40-50,2018,8,31,15,18,Friday,14 days,45828.618
ACC-1998563091,42,45.0,16151.11,,CUS-3395687666,2018-09-01,David,M,-35.25,149.03,,,,,,,debit,posted,3392333cd1b84f8d89a0da672cbc8b32,PAYMENT,40-50,2018,9,1,12,0,Saturday,14 days,45828.618
ACC-1998563091,42,39.25,16111.86,1.0,CUS-3395687666,2018-09-01,David,M,-35.25,149.03,,f759fd6a-0d41-4a72-a65a-a9ae2d47eee0,-35.14,138.47,SA,Christies Beach,debit,authorized,00c7e252fb31417394073456694c0666,SALES-POS,40-50,2018,9,1,14,1,Saturday,14 days,45828.618
ACC-1998563091,42,29.5,16082.36,0.0,CUS-3395687666,2018-09-04,David,M,-35.25,149.03,,44baeca2-bfcd-4fc6-882d-1b659e00f3d2,-33.29,149.11,NSW,Orange,debit,authorized,82adbb0a8a234ae181caa69746d98d06,SALES-POS,40-50,2018,9,4,22,3,Tuesday,14 days,45828.618
ACC-1998563091,42,45.0,16037.36,,CUS-3395687666,2018-09-08,David,M,-35.25,149.03,,,,,,,debit,posted,ab6f9e28f6f14527a6e0e07341a39230,PAYMENT,40-50,2018,9,8,12,0,Saturday,14 days,45828.618
ACC-1998563091,42,159.0,15878.36,,CUS-3395687666,2018-09-09,David,M,-35.25,149.03,,,,,,,debit,posted,9d5afaa2168444079f1d2332e044f2ec,INTER BANK,40-50,2018,9,9,2,0,Sunday,14 days,45828.618
ACC-1998563091,42,116.0,15762.36,,CUS-3395687666,2018-09-11,David,M,-35.25,149.03,,,,,,,debit,posted,f43ed33d56e6432fbd1fe2d0dfbb6bf6,PAYMENT,40-50,2018,9,11,12,0,Tuesday,14 days,45828.618
ACC-1998563091,42,1404.0,16116.17,,CUS-3395687666,2018-09-13,David,M,-35.25,149.03,,,,,,,debit,posted,f92037c189404462b6471c966561cec7,PAYMENT,40-50,2018,9,13,9,0,Thursday,14 days,45828.618
ACC-1998563091,42,45.0,16071.17,,CUS-3395687666,2018-09-15,David,M,-35.25,149.03,,,,,,,debit,posted,19e16e0801f34575aa7bbe7a5ab28375,PAYMENT,40-50,2018,9,15,12,0,Saturday,14 days,45828.618
ACC-1998563091,42,45.0,16026.17,,CUS-3395687666,2018-09-22,David,M,-35.25,149.03,,,,,,,debit,posted,2c285dcf6baa4038b1509c8705c8acae,PAYMENT,40-50,2018,9,22,12,0,Saturday,14 days,45828.618
ACC-1998563091,42,45.0,17738.98,,CUS-3395687666,2018-09-29,David,M,-35.25,149.03,,,,,,,debit,posted,0f4b99411a854e1d89fb7b7dc37ee447,PAYMENT,40-50,2018,9,29,12,0,Saturday,14 days,45828.618
ACC-1998563091,42,179.33,17559.65,1.0,CUS-3395687666,2018-09-30,David,M,-35.25,149.03,,d076eb9a-abe5-4936-8182-d626bf62d504,-33.87,151.21,NSW,Sydney,debit,authorized,f59367f6c00c442e9955c7e7c1529c2b,SALES-POS,40-50,2018,9,30,22,11,Sunday,14 days,45828.618
ACC-1998563091,42,43.13,17516.52,1.0,CUS-3395687666,2018-10-02,David,M,-35.25,149.03,,c8968173-48a5-43ad-8e3c-77d2cdfc2cc8,-35.03,138.53,SA,Seacliff Park,debit,authorized,310ad97ad28c473d9e61ff025b94a56c,POS,40-50,2018,10,2,8,23,Tuesday,14 days,45828.618
ACC-1998563091,42,29.09,17487.43,1.0,CUS-3395687666,2018-10-04,David,M,-35.25,149.03,,7fbd6363-a171-4ce6-ad92-c59fd7991396,-33.86,151.06,NSW,Lidcombe,debit,authorized,079adb726bb4425aad644aa0dc9aa88f,SALES-POS,40-50,2018,10,4,15,56,Thursday,14 days,45828.618
ACC-1998563091,42,45.0,17442.43,,CUS-3395687666,2018-10-06,David,M,-35.25,149.03,,,,,,,debit,posted,544e87c5f6c545ec9467339e710cee00,PAYMENT,40-50,2018,10,6,12,0,Saturday,14 days,45828.618
ACC-1998563091,42,159.0,17283.43,,CUS-3395687666,2018-10-09,David,M,-35.25,149.03,,,,,,,debit,posted,e89a56fe7afc452c87a0bb905a3695fe,INTER BANK,40-50,2018,10,9,2,0,Tuesday,14 days,45828.618
ACC-1998563091,42,116.0,18925.24,,CUS-3395687666,2018-10-11,David,M,-35.25,149.03,,,,,,,debit,posted,b0bdbc4e7d4d4f3181afdc2bfe6b6c1e,PAYMENT,40-50,2018,10,11,12,0,Thursday,14 days,45828.618
ACC-1998563091,42,45.0,18880.24,,CUS-3395687666,2018-10-13,David,M,-35.25,149.03,,,,,,,debit,posted,883cd0ec3f7f4248b517fe63e519d44a,PAYMENT,40-50,2018,10,13,12,0,Saturday,14 days,45828.618
ACC-1998563091,42,39.12,18841.12,0.0,CUS-3395687666,2018-10-14,David,M,-35.25,149.03,,4f333982-d8b3-400b-abee-a60dab451977,-35.1,138.55,SA,Woodcroft,debit,authorized,b0ea578a60514f01bffd36269ce96115,SALES-POS,40-50,2018,10,14,13,38,Sunday,14 days,45828.618
ACC-1998563091,42,31.72,18809.4,1.0,CUS-3395687666,2018-10-14,David,M,-35.25,149.03,,b13e0228-b536-4a81-bbbd-64e7ae7574c1,-21.17,149.15,QLD,Ooralea,debit,authorized,00354454a68b46cf896ab1090cdbda77,POS,40-50,2018,10,14,15,32,Sunday,14 days,45828.618
ACC-1998563091,42,17.92,18791.48,1.0,CUS-3395687666,2018-10-14,David,M,-35.25,149.03,,18f16bcf-eee5-4723-b66c-9c82d64c532d,-35.3,149.15,ACT,Russell,debit,authorized,a36bd15477d14df08de76d5d06426dff,SALES-POS,40-50,2018,10,14,22,1,Sunday,14 days,45828.618
ACC-1998563091,42,235.26,18556.22,0.0,CUS-3395687666,2018-10-17,David,M,-35.25,149.03,,0bb9a68e-ba79-4ca9-adea-b92d1768eb5e,-31.95,115.86,WA,Perth,debit,authorized,2c72827b58594378838950c3621be211,SALES-POS,40-50,2018,10,17,17,26,Wednesday,14 days,45828.618
ACC-1998563091,42,45.0,18511.22,,CUS-3395687666,2018-10-20,David,M,-35.25,149.03,,,,,,,debit,posted,428e9ea5d76d4f2eaa1ac8f90fd75227,PAYMENT,40-50,2018,10,20,12,0,Saturday,14 days,45828.618
ACC-1998563091,42,45.0,20224.03,,CUS-3395687666,2018-10-27,David,M,-35.25,149.03,,,,,,,debit,posted,cef864adc0274182a2ffae6be9eb0b62,PAYMENT,40-50,2018,10,27,12,0,Saturday,14 days,45828.618
ACC-1998563091,42,28.37,20195.66,1.0,CUS-3395687666,2018-10-29,David,M,-35.25,149.03,,7b0b91c6-77b9-4367-a5ea-f65ae7673962,-35.32,150.44,NSW,Milton,debit,authorized,de4d94e11dd8496ca4894e9843d0c90d,SALES-POS,40-50,2018,10,29,20,36,Monday,14 days,45828.618
ACC-1998563091,42,47.71,20147.95,1.0,CUS-3395687666,2018-10-31,David,M,-35.25,149.03,,8fef99ec-a34c-4d6e-b936-074ce0acb02e,-21.15,149.17,QLD,West Mackay,debit,authorized,32f6c1da0fa8451592b4042d2956199b,SALES-POS,40-50,2018,10,31,13,53,Wednesday,14 days,45828.618
ACC-1199531521,52,6.31,3795.1,1.0,CUS-134833760,2018-08-04,Billy,M,-31.87,116.02,,bdf4377a-77a8-4634-ae40-db1fd8128577,-33.9,151.17,NSW,Enmore,debit,authorized,c75343f5762447f2a4ac6928dc45e5d5,POS,50-60,2018,8,4,7,34,Saturday,14 days,98700.693
ACC-1199531521,52,83.0,3712.1,,CUS-134833760,2018-08-04,Billy,M,-31.87,116.02,,,,,,,debit,posted,a3f7f32671ac42dfadd49830fbd442b1,INTER BANK,50-60,2018,8,4,11,0,Saturday,14 days,98700.693
ACC-1199531521,52,115.96,3596.14,1.0,CUS-134833760,2018-08-05,Billy,M,-31.87,116.02,,95acff5e-45de-453d-9fa3-fd055412b58c,-31.87,115.86,WA,Mirrabooka,debit,authorized,6fd5f396c1e94a4396122a82d1d2991a,POS,50-60,2018,8,5,10,48,Sunday,14 days,98700.693
ACC-1199531521,52,129.0,3467.14,,CUS-134833760,2018-08-05,Billy,M,-31.87,116.02,,,,,,,debit,posted,98e844d321b04dfa8585fc51c9090c1d,PAYMENT,50-60,2018,8,5,13,0,Sunday,14 days,98700.693
ACC-1199531521,52,18.82,3448.32,1.0,CUS-134833760,2018-08-05,Billy,M,-31.87,116.02,,60a6942b-58ed-4908-a17c-7a5447146cbb,-32.12,115.83,WA,Yangebup,debit,authorized,874873416a4949a5b350668eab895556,SALES-POS,50-60,2018,8,5,19,11,Sunday,14 days,98700.693
ACC-1199531521,52,20.0,3428.32,,CUS-134833760,2018-08-07,Billy,M,-31.87,116.02,,,,,,,debit,posted,58f10fbb14b747cb8b6ec2afb5aa9a13,PAYMENT,50-60,2018,8,7,20,0,Tuesday,14 days,98700.693
ACC-1199531521,52,51.95,3376.37,0.0,CUS-134833760,2018-08-08,Billy,M,-31.87,116.02,,028bc621-f7ce-4c0f-88e1-116a536b34f5,-33.86,151.05,NSW,Lidcombe,debit,authorized,878ffeb37866431e9ef518453977a220,POS,50-60,2018,8,8,14,24,Wednesday,14 days,98700.693
ACC-1199531521,52,145.0,3231.37,,CUS-134833760,2018-08-11,Billy,M,-31.87,116.02,,,,,,,debit,posted,30c61f2a7c3b490f995fa2a5134ee19b,INTER BANK,50-60,2018,8,11,20,0,Saturday,14 days,98700.693
ACC-1199531521,52,28.72,3202.65,1.0,CUS-134833760,2018-08-12,Billy,M,-31.87,116.02,,913b04d1-6a23-4e54-b751-0e7ddd329d00,-31.88,115.78,WA,Karrinyup,debit,authorized,42f88382addd489e92c9ff740d8b2ca9,SALES-POS,50-60,2018,8,12,9,12,Sunday,14 days,98700.693
ACC-1199531521,52,27.15,3175.5,1.0,CUS-134833760,2018-08-13,Billy,M,-31.87,116.02,,c0fb68c6-935b-47ae-8594-e3da036d0f94,-28,153.36,QLD,Gold Coast,debit,authorized,aa95da6fedc14f338fedefc3ccf1433a,POS,50-60,2018,8,13,8,20,Monday,14 days,98700.693
ACC-1199531521,52,20.0,3155.5,,CUS-134833760,2018-08-14,Billy,M,-31.87,116.02,,,,,,,debit,posted,245f5c913ea447c99ff11841b169bcc9,PAYMENT,50-60,2018,8,14,20,0,Tuesday,14 days,98700.693
ACC-1199531521,52,18.44,6922.84,1.0,CUS-134833760,2018-08-20,Billy,M,-31.87,116.02,,65124281-f65d-4b9d-9e45-8a6a4dada399,-31.88,115.78,WA,Karrinyup,debit,authorized,ebe5b7d7efb44e7dbbb6f28c4ef5cc19,POS,50-60,2018,8,20,9,28,Monday,14 days,98700.693
ACC-1199531521,52,20.0,6902.84,,CUS-134833760,2018-08-21,Billy,M,-31.87,116.02,,,,,,,debit,posted,8e0cfab1b3fb4026b04b886e7e9e99ee,PAYMENT,50-60,2018,8,21,20,0,Tuesday,14 days,98700.693
ACC-1199531521,52,12.19,6890.65,0.0,CUS-134833760,2018-08-23,Billy,M,-31.87,116.02,,e12f71dd-85cc-4323-9a67-c20038c4acdd,-31.89,115.76,WA,Scarborough,debit,authorized,62866e7ca9a14491aa0cf859b638bd89,POS,50-60,2018,8,23,8,5,Thursday,14 days,98700.693
ACC-1199531521,52,41.63,6849.02,1.0,CUS-134833760,2018-08-23,Billy,M,-31.87,116.02,,2bfbb5f6-d287-4700-9c86-273b13f57722,-31.86,115.88,WA,Malaga,debit,authorized,a70baecb5c104a848a4bc66c63eb3b6d,SALES-POS,50-60,2018,8,23,12,29,Thursday,14 days,98700.693
ACC-1199531521,52,35.24,6813.78,1.0,CUS-134833760,2018-08-23,Billy,M,-31.87,116.02,,8096c474-820e-43b4-bfe5-c4ef722d0677,-31.82,115.74,WA,Hillarys,debit,authorized,2de0e5c7b49f4b4b9570222e6331b32f,SALES-POS,50-60,2018,8,23,15,53,Thursday,14 days,98700.693
ACC-1199531521,52,16.59,6797.19,0.0,CUS-134833760,2018-08-23,Billy,M,-31.87,116.02,,29591d82-c18f-429a-a8f8-14567dfe7a80,-31.94,115.86,WA,Perth,debit,authorized,fd37989a7adf47f983ec5c38dae6fe41,POS,50-60,2018,8,23,21,42,Thursday,14 days,98700.693
ACC-1199531521,52,29.65,6767.54,1.0,CUS-134833760,2018-08-24,Billy,M,-31.87,116.02,,334ab003-f7d7-44fc-9355-b0f07e612c05,-31.94,115.81,WA,Wembley,debit,authorized,598e8271ccb143c0a0960c9ac8a4c703,POS,50-60,2018,8,24,17,0,Friday,14 days,98700.693
ACC-1199531521,52,19.3,6748.24,1.0,CUS-134833760,2018-08-26,Billy,M,-31.87,116.02,,ccbd17fa-2dc0-43d3-b0b1-95af4b6363c4,-32.08,115.78,WA,Hamilton Hill,debit,authorized,414e2a91254b4f87ac8f2f23d1e172af,POS,50-60,2018,8,26,22,54,Sunday,14 days,98700.693
ACC-1199531521,52,29.24,6719.0,0.0,CUS-134833760,2018-08-26,Billy,M,-31.87,116.02,,2d87c9e2-b0aa-472b-8afe-f7c1e1156af7,-31.87,115.75,WA,North Beach,debit,authorized,a2510e26ac9f4ef29ada6d3f5f17826e,SALES-POS,50-60,2018,8,26,23,42,Sunday,14 days,98700.693
ACC-1199531521,52,10.22,6708.78,1.0,CUS-134833760,2018-08-28,Billy,M,-31.87,116.02,,116a4a48-eb6b-4ff8-8898-e758c2d5e379,-32.13,115.8,WA,Beeliar,debit,authorized,46857db6ec3044cfa6a3bd24d3279ad8,SALES-POS,50-60,2018,8,28,10,21,Tuesday,14 days,98700.693
ACC-1199531521,52,93.0,6615.78,,CUS-134833760,2018-08-28,Billy,M,-31.87,116.02,,,,,,,debit,posted,3e6c44ee8b3941c581a565cdb99d7b8b,PAYMENT,50-60,2018,8,28,17,0,Tuesday,14 days,98700.693
ACC-1199531521,52,20.0,6595.78,,CUS-134833760,2018-08-28,Billy,M,-31.87,116.02,,,,,,,debit,posted,7b4e8591c05e47ed8ff945c722e7c2bb,PAYMENT,50-60,2018,8,28,20,0,Tuesday,14 days,98700.693
ACC-1199531521,52,29.46,6566.32,0.0,CUS-134833760,2018-08-29,Billy,M,-31.87,116.02,,2df8bd3d-ef44-4d84-8ef2-bace9ccfd7fb,-31.88,115.78,WA,Karrinyup,debit,authorized,485eb85557b1449cad09729f89bf00e2,POS,50-60,2018,8,29,17,26,Wednesday,14 days,98700.693
ACC-1199531521,52,28.67,6537.65,0.0,CUS-134833760,2018-08-29,Billy,M,-31.87,116.02,,f70d646b-d9a2-44a5-9ffa-becda2a18792,-33.88,151.19,NSW,Glebe,debit,authorized,1395b4931ef74935a7faf237040bf9dc,SALES-POS,50-60,2018,8,29,21,54,Wednesday,14 days,98700.693
ACC-1199531521,52,39.9,6497.75,1.0,CUS-134833760,2018-08-30,Billy,M,-31.87,116.02,,a3277e6b-3fe9-4c89-95fc-3b76207c2ccc,-31.88,115.89,WA,Noranda,debit,authorized,aa1f0addc76d42f09bdeab37ef6ad5a1,POS,50-60,2018,8,30,5,3,Thursday,14 days,98700.693
ACC-1199531521,52,13.96,6483.79,0.0,CUS-134833760,2018-08-30,Billy,M,-31.87,116.02,,294193ff-d76e-445f-b240-dea59df2caf8,-31.94,141.47,NSW,Broken Hill,debit,authorized,0606bc7a6ed24fb6beaaca9a70dc8ac9,POS,50-60,2018,8,30,9,47,Thursday,14 days,98700.693
ACC-1199531521,52,24.24,6459.55,1.0,CUS-134833760,2018-08-30,Billy,M,-31.87,116.02,,2596ec05-2838-49c6-a444-83548cad42a0,-32.05,115.81,WA,Myaree,debit,authorized,9d98bfd7266b4e7e8b9a69ca8eb3652e,SALES-POS,50-60,2018,8,30,10,42,Thursday,14 days,98700.693
ACC-1199531521,52,34.01,6425.54,1.0,CUS-134833760,2018-08-30,Billy,M,-31.87,116.02,,641b16cf-f933-45da-a71b-c4565a2aa4e9,-31.87,115.83,WA,Balcatta,debit,authorized,694697a8b46d4504afa62c1f9297eecd,POS,50-60,2018,8,30,21,17,Thursday,14 days,98700.693
ACC-1199531521,52,27.25,6398.29,0.0,CUS-134833760,2018-08-30,Billy,M,-31.87,116.02,,a9d29a36-f712-4595-b775-2514f47c5917,-32.03,115.83,WA,Booragoon,debit,authorized,8142fc938368488e94666caa60b3d500,POS,50-60,2018,8,30,21,42,Thursday,14 days,98700.693
ACC-1199531521,52,7.67,6390.62,0.0,CUS-134833760,2018-08-31,Billy,M,-31.87,116.02,,dbb1b4e2-04ae-4f77-b40c-7ea9495c7f21,-31.87,115.84,WA,Westminster,debit,authorized,de755b39f63645249c0401523b94f68d,POS,50-60,2018,8,31,7,14,Friday,14 days,98700.693
ACC-1199531521,52,83.0,10093.4,,CUS-134833760,2018-09-04,Billy,M,-31.87,116.02,,,,,,,debit,posted,b63a421283324cf5b6eed9eccf7054c2,INTER BANK,50-60,2018,9,4,11,0,Tuesday,14 days,98700.693
ACC-1199531521,52,20.0,10073.4,,CUS-134833760,2018-09-04,Billy,M,-31.87,116.02,,,,,,,debit,posted,58d5300a2cc344b2a150d07dbf64b5d5,PAYMENT,50-60,2018,9,4,20,0,Tuesday,14 days,98700.693
ACC-1199531521,52,129.0,9944.4,,CUS-134833760,2018-09-05,Billy,M,-31.87,116.02,,,,,,,debit,posted,3d4f139bbcf6475988ca23e669594186,PAYMENT,50-60,2018,9,5,13,0,Wednesday,14 days,98700.693
ACC-1199531521,52,31.82,9912.58,0.0,CUS-134833760,2018-09-08,Billy,M,-31.87,116.02,,2c040a35-00d6-4e1b-9a38-f68df3b873c5,-31.89,116.01,WA,Midland,debit,authorized,b9f73092d9a04ce585d603da8df19f71,SALES-POS,50-60,2018,9,8,21,52,Saturday,14 days,98700.693
ACC-1199531521,52,35.99,9876.59,1.0,CUS-134833760,2018-09-09,Billy,M,-31.87,116.02,,5a4aef9b-6476-4a8c-b8ec-c09ca59453f2,-32.11,115.84,WA,South Lake,debit,authorized,6add87ecb7cf4d868eb8fbef80a2ad97,SALES-POS,50-60,2018,9,9,20,13,Sunday,14 days,98700.693
ACC-1199531521,52,491.0,9385.59,,CUS-134833760,2018-09-10,Billy,M,-31.87,116.02,,,,,,,debit,posted,aba0271762a6445280fcdd374ff33498,INTER BANK,50-60,2018,9,10,14,0,Monday,14 days,98700.693
ACC-1199531521,52,20.0,9365.59,,CUS-134833760,2018-09-11,Billy,M,-31.87,116.02,,,,,,,debit,posted,8c9e6cfd783842c9a2f2b0fdc8eb13c2,PAYMENT,50-60,2018,9,11,20,0,Tuesday,14 days,98700.693
ACC-1199531521,52,145.0,9220.59,,CUS-134833760,2018-09-11,Billy,M,-31.87,116.02,,,,,,,debit,posted,7438b826881a493c9a6b038c44908d17,INTER BANK,50-60,2018,9,11,20,0,Tuesday,14 days,98700.693
ACC-1199531521,52,135.95,9084.64,1.0,CUS-134833760,2018-09-12,Billy,M,-31.87,116.02,,ff61dd5e-938a-4acb-a1fd-03d1d2fbba4e,-33.87,151.21,NSW,Sydney,debit,authorized,5f241e0ac6d34c17b2dcf51ed3a68d85,SALES-POS,50-60,2018,9,12,21,2,Wednesday,14 days,98700.693
ACC-1199531521,52,21.7,9062.94,1.0,CUS-134833760,2018-09-13,Billy,M,-31.87,116.02,,e31795fc-3756-48c8-97f8-3c55599cd769,-31.97,115.79,WA,Claremont,debit,authorized,90bf4e0c5cde494b966a2ec69953dd8f,SALES-POS,50-60,2018,9,13,9,46,Thursday,14 days,98700.693
ACC-1199531521,52,20.0,12828.72,,CUS-134833760,2018-09-18,Billy,M,-31.87,116.02,,,,,,,debit,posted,d326a658f6394242aefa0265dc0bd794,PAYMENT,50-60,2018,9,18,20,0,Tuesday,14 days,98700.693
ACC-1199531521,52,1957.0,10871.72,,CUS-134833760,2018-09-19,Billy,M,-31.87,116.02,,,,,,,debit,posted,2b4802c1ca014b3fae4512e4d94470f2,PAYMENT,50-60,2018,9,19,10,0,Wednesday,14 days,98700.693
ACC-1199531521,52,23.93,10847.79,1.0,CUS-134833760,2018-09-23,Billy,M,-31.87,116.02,,877c3184-2b92-448b-9b90-fc1e328a5a03,-31.87,115.84,WA,Westminster,debit,authorized,65e96bb6db6c4d40b1950d11ea16fffe,POS,50-60,2018,9,23,21,36,Sunday,14 days,98700.693
ACC-1199531521,52,20.0,10827.79,,CUS-134833760,2018-09-25,Billy,M,-31.87,116.02,,,,,,,debit,posted,f42d43cf200446a390cb8d965aa7bdf8,PAYMENT,50-60,2018,9,25,20,0,Tuesday,14 days,98700.693
ACC-1199531521,52,21.42,10806.37,1.0,CUS-134833760,2018-09-26,Billy,M,-31.87,116.02,,8ae15cfd-7ffc-4987-8e62-c75c1b555bbd,-31.87,115.81,WA,Balcatta,debit,authorized,dcb0e10555954292a39dd76876b00c9d,POS,50-60,2018,9,26,23,53,Wednesday,14 days,98700.693
ACC-1199531521,52,14.03,10792.34,1.0,CUS-134833760,2018-09-27,Billy,M,-31.87,116.02,,3ff6d55a-6d2f-4c60-89b1-0129e0a53ae1,-32.05,115.75,WA,Fremantle,debit,authorized,c2b973d35a88484896139bc1c17b6b50,SALES-POS,50-60,2018,9,27,13,27,Thursday,14 days,98700.693
ACC-1199531521,52,27.04,10765.3,1.0,CUS-134833760,2018-09-28,Billy,M,-31.87,116.02,,67a29937-53b9-493d-bcaa-5f8a7c651cd9,-31.89,115.79,WA,Innaloo,debit,authorized,6f04b5ee028b41749ccb6ac5f6e1e031,POS,50-60,2018,9,28,8,33,Friday,14 days,98700.693
ACC-1199531521,52,33.15,10732.15,1.0,CUS-134833760,2018-09-28,Billy,M,-31.87,116.02,,80f02371-f821-459f-8ad0-0f62a568c122,-32.05,115.98,WA,Maddington,debit,authorized,f80a6d1cb712462fb4f00cd891b1707c,SALES-POS,50-60,2018,9,28,10,31,Friday,14 days,98700.693
ACC-1199531521,52,26.96,10705.19,1.0,CUS-134833760,2018-09-28,Billy,M,-31.87,116.02,,5c09d618-0deb-466f-9ec3-7dad7778b9f0,-12.46,130.84,NT,Darwin City,debit,authorized,545c1196c5d946a4893e1d1ad1d53396,SALES-POS,50-60,2018,9,28,11,3,Friday,14 days,98700.693
ACC-1199531521,52,93.0,14397.97,,CUS-134833760,2018-09-28,Billy,M,-31.87,116.02,,,,,,,debit,posted,1a924d7c58854206b683b45c376d3f4b,PAYMENT,50-60,2018,9,28,17,0,Friday,14 days,98700.693
ACC-1199531521,52,15.23,14382.74,1.0,CUS-134833760,2018-09-29,Billy,M,-31.87,116.02,,294193ff-d76e-445f-b240-dea59df2caf8,-31.94,141.47,NSW,Broken Hill,debit,authorized,be7cf4ace7f3407bbd222731f63c91a5,SALES-POS,50-60,2018,9,29,12,53,Saturday,14 days,98700.693
ACC-1199531521,52,25.8,14356.94,1.0,CUS-134833760,2018-09-29,Billy,M,-31.87,116.02,,635f3dfb-bead-4f60-9a01-0acc24dc4f46,-33.29,149.1,NSW,Orange,debit,authorized,55967e4746ad499eaf8d960ae305df7c,POS,50-60,2018,9,29,21,29,Saturday,14 days,98700.693
ACC-1199531521,52,20.0,14336.94,,CUS-134833760,2018-10-02,Billy,M,-31.87,116.02,,,,,,,debit,posted,5b2a5fa570f14ff0a2b061c7c1aab836,PAYMENT,50-60,2018,10,2,20,0,Tuesday,14 days,98700.693
ACC-1199531521,52,83.0,14253.94,,CUS-134833760,2018-10-04,Billy,M,-31.87,116.02,,,,,,,debit,posted,0e8bf4ebdc64427ba6b69efc2d72ecce,INTER BANK,50-60,2018,10,4,11,0,Thursday,14 days,98700.693
ACC-1199531521,52,129.0,14124.94,,CUS-134833760,2018-10-05,Billy,M,-31.87,116.02,,,,,,,debit,posted,1709a194495f4b299fb45c6962f8bad0,PAYMENT,50-60,2018,10,5,13,0,Friday,14 days,98700.693
ACC-1199531521,52,14.92,14110.02,1.0,CUS-134833760,2018-10-08,Billy,M,-31.87,116.02,,6afc3c05-aea8-4472-a7a4-e3ecc2eef67d,-32.05,115.75,WA,Fremantle,debit,authorized,12ffbf983aeb41149328720763731911,POS,50-60,2018,10,8,8,9,Monday,14 days,98700.693
ACC-1199531521,52,33.17,14076.85,1.0,CUS-134833760,2018-10-08,Billy,M,-31.87,116.02,,904d5817-ae65-464d-bb02-8e0e474cc69d,-31.88,115.8,WA,Gwelup,debit,authorized,11661f54940c4ee296ce5a989a7aadb7,SALES-POS,50-60,2018,10,8,9,38,Monday,14 days,98700.693
ACC-1199531521,52,20.0,14056.85,,CUS-134833760,2018-10-09,Billy,M,-31.87,116.02,,,,,,,debit,posted,b443a31544664ac2926151e82a57a270,PAYMENT,50-60,2018,10,9,20,0,Tuesday,14 days,98700.693
ACC-1199531521,52,145.0,13911.85,,CUS-134833760,2018-10-11,Billy,M,-31.87,116.02,,,,,,,debit,posted,2565ccfee74d4b22949c9c5efb9afaad,INTER BANK,50-60,2018,10,11,20,0,Thursday,14 days,98700.693
ACC-1199531521,52,20.0,17677.63,,CUS-134833760,2018-10-16,Billy,M,-31.87,116.02,,,,,,,debit,posted,271bf2ab60624058945fcd128db18659,PAYMENT,50-60,2018,10,16,20,0,Tuesday,14 days,98700.693
ACC-1199531521,52,20.0,17657.63,,CUS-134833760,2018-10-23,Billy,M,-31.87,116.02,,,,,,,debit,posted,0399ef21b4d84a2c84081bf5f849f7d5,PAYMENT,50-60,2018,10,23,20,0,Tuesday,14 days,98700.693
ACC-1199531521,52,6.78,17650.85,1.0,CUS-134833760,2018-10-25,Billy,M,-31.87,116.02,,8dc4d831-3b44-45c7-87b9-eeae39a4afd2,-32.08,115.78,WA,Hamilton Hill,debit,authorized,873c2c075e954a5496fe20f838e1c001,SALES-POS,50-60,2018,10,25,8,12,Thursday,14 days,98700.693
ACC-1199531521,52,448.97,17201.88,0.0,CUS-134833760,2018-10-25,Billy,M,-31.87,116.02,,16749edf-3f58-4cd1-98c5-b1fb8a5e6cdb,-37.85,145.08,VIC,Camberwell,debit,authorized,078888f817c343a681dba47821896a00,POS,50-60,2018,10,25,9,3,Thursday,14 days,98700.693
ACC-1199531521,52,18.8,17183.08,1.0,CUS-134833760,2018-10-25,Billy,M,-31.87,116.02,,c130a12f-4c13-44e4-9947-cbca5d64c7b0,-31.89,116.77,WA,York,debit,authorized,edfef312dc3e4918bc8df3f1ff3e841e,POS,50-60,2018,10,25,16,11,Thursday,14 days,98700.693
ACC-1199531521,52,27.22,17155.86,1.0,CUS-134833760,2018-10-25,Billy,M,-31.87,116.02,,ec3d42e8-4ddd-4a32-a150-cc0bc63799f8,-32.15,115.99,WA,Armadale,debit,authorized,cb284273ded84daa8cc255e1e5541433,SALES-POS,50-60,2018,10,25,17,43,Thursday,14 days,98700.693
ACC-1199531521,52,93.0,20848.64,,CUS-134833760,2018-10-28,Billy,M,-31.87,116.02,,,,,,,debit,posted,04978f2ae27543e2b4970f3c5347633f,PAYMENT,50-60,2018,10,28,17,0,Sunday,14 days,98700.693
ACC-1199531521,52,37.56,20811.08,1.0,CUS-134833760,2018-10-28,Billy,M,-31.87,116.02,,1ea473e9-35af-4c45-997c-b4e15ebddec8,-31.87,115.77,WA,Karrinyup,debit,authorized,79352b17eb4049b98cd230481173d774,POS,50-60,2018,10,28,20,34,Sunday,14 days,98700.693
ACC-1199531521,52,20.0,20791.08,,CUS-134833760,2018-10-30,Billy,M,-31.87,116.02,,,,,,,debit,posted,08489cfe9fd1456cbc3fb80e61c388c3,PAYMENT,50-60,2018,10,30,20,0,Tuesday,14 days,98700.693
ACC-1199531521,52,17.7,20773.38,1.0,CUS-134833760,2018-10-31,Billy,M,-31.87,116.02,,4c90fdf3-5b7d-4fdc-b734-8bd894ed6a89,-32.12,133.67,SA,Ceduna,debit,authorized,3096bfb888e649b4bccd241077ea5bf0,POS,50-60,2018,10,31,16,37,Wednesday,14 days,98700.693
ACC-3233697971,34,46.0,1680.28,,CUS-1147642491,2018-08-06,Robin,F,-33.77,151.04,,,,,,,debit,posted,d30a45ee5617464f86d3f98ce9f76235,PAYMENT,30-40,2018,8,6,11,0,Monday,7 days,89236.764
ACC-3233697971,34,39.77,1640.51,1.0,CUS-1147642491,2018-08-13,Robin,F,-33.77,151.04,,3fc4f485-b90c-4029-8b7b-1eae6b668b4f,-32.28,150.9,NSW,Muswellbrook South,debit,authorized,6fabd59f6e5d4a618a978910d60fed39,SALES-POS,30-40,2018,8,13,10,38,Monday,7 days,89236.764
ACC-3233697971,34,46.0,3305.9,,CUS-1147642491,2018-08-13,Robin,F,-33.77,151.04,,,,,,,debit,posted,287fcfdb2c6a4081a418209cbe298cd1,PAYMENT,30-40,2018,8,13,11,0,Monday,7 days,89236.764
ACC-3233697971,34,79.0,3226.9,,CUS-1147642491,2018-08-13,Robin,F,-33.77,151.04,,,,,,,debit,posted,82a0454705c34862818e490eece0b081,PAYMENT,30-40,2018,8,13,11,0,Monday,7 days,89236.764
ACC-3233697971,34,173.0,3053.9,,CUS-1147642491,2018-08-14,Robin,F,-33.77,151.04,,,,,,,debit,posted,a9604842afd34666a638450bb8984211,PAYMENT,30-40,2018,8,14,3,0,Tuesday,7 days,89236.764
ACC-3233697971,34,160.0,2893.9,,CUS-1147642491,2018-08-14,Robin,F,-33.77,151.04,,,,,,,debit,posted,a42dc0ae7d554a748f6d59970b36aa58,PAYMENT,30-40,2018,8,14,11,0,Tuesday,7 days,89236.764
ACC-3233697971,34,45.85,2848.05,1.0,CUS-1147642491,2018-08-15,Robin,F,-33.77,151.04,,968914e4-3ece-4a56-b95a-27666afedeb3,-33.92,151.25,NSW,Coogee,debit,authorized,bc1ea2d2e98d4f90b9086efd976f040d,POS,30-40,2018,8,15,15,21,Wednesday,7 days,89236.764
ACC-3233697971,34,40.3,2664.75,0.0,CUS-1147642491,2018-08-17,Robin,F,-33.77,151.04,,4890e28b-05ec-44f2-9ab0-bb2e7348c756,-33.92,151.04,NSW,Bankstown,debit,authorized,be50d882ecbb47b78cac1f21dff063cf,POS,30-40,2018,8,17,15,0,Friday,7 days,89236.764
ACC-3233697971,34,159.0,2505.75,,CUS-1147642491,2018-08-17,Robin,F,-33.77,151.04,,,,,,,debit,posted,c796d888614149ee8eb907bce8223092,PAYMENT,30-40,2018,8,17,17,0,Friday,7 days,89236.764
ACC-3233697971,34,28.18,2477.57,1.0,CUS-1147642491,2018-08-17,Robin,F,-33.77,151.04,,74991e65-5c75-42fc-8d01-ae06d2d66179,-33.93,150.92,NSW,Liverpool,debit,authorized,bf486f62de0f4d16b3104318a0971774,POS,30-40,2018,8,17,22,53,Friday,7 days,89236.764
ACC-3233697971,34,54.9,2422.67,0.0,CUS-1147642491,2018-08-18,Robin,F,-33.77,151.04,,889d1da4-9b1a-4e33-a8a5-3632916adf2c,-33.88,151.02,NSW,Auburn,debit,authorized,fa0419dcfc0c4afb84a9bdf839d10a5f,POS,30-40,2018,8,18,9,58,Saturday,7 days,89236.764
ACC-3233697971,34,46.0,4088.06,,CUS-1147642491,2018-08-20,Robin,F,-33.77,151.04,,,,,,,debit,posted,693b8b17cf244f60a28ebb47b5986960,PAYMENT,30-40,2018,8,20,11,0,Monday,7 days,89236.764
ACC-3233697971,34,8.78,4079.28,1.0,CUS-1147642491,2018-08-21,Robin,F,-33.77,151.04,,1c4f68a3-f7a0-4b36-8216-cf1c5ddc47ae,-33.87,151.21,NSW,Sydney,debit,authorized,a4899df7a5df405d84984dd220707c2e,SALES-POS,30-40,2018,8,21,18,46,Tuesday,7 days,89236.764
ACC-3233697971,34,10.28,4069.0,1.0,CUS-1147642491,2018-08-23,Robin,F,-33.77,151.04,,d2c254f4-7323-431e-baa0-392b35435298,-33.91,151.02,NSW,Yagoona,debit,authorized,51220f89e6284d2e87b36cf82b68e364,POS,30-40,2018,8,23,16,16,Thursday,7 days,89236.764
ACC-3233697971,34,17.65,4051.35,1.0,CUS-1147642491,2018-08-24,Robin,F,-33.77,151.04,,7cb793ae-7f62-459f-84c4-0e22ac325e31,-33.73,150.98,NSW,Castle Hill,debit,authorized,b468f62c6c144bf6ac7e88fd90ecfc41,POS,30-40,2018,8,24,8,18,Friday,7 days,89236.764
ACC-3233697971,34,43.68,4007.67,1.0,CUS-1147642491,2018-08-24,Robin,F,-33.77,151.04,,3bd0782a-b3e2-46eb-a29f-d69328c31103,-33.8,151.18,NSW,Chatswood,debit,authorized,5e60603d72ec4c84a13ab7559cea7b2a,POS,30-40,2018,8,24,10,43,Friday,7 days,89236.764
ACC-3233697971,34,46.0,5673.06,,CUS-1147642491,2018-08-27,Robin,F,-33.77,151.04,,,,,,,debit,posted,f36efa3952b44115970d34f254c980c7,PAYMENT,30-40,2018,8,27,11,0,Monday,7 days,89236.764
ACC-3233697971,34,15.39,5657.67,1.0,CUS-1147642491,2018-08-28,Robin,F,-33.77,151.04,,a336bf1c-1a4c-4848-8b0d-ee3122510a32,-33.88,151.21,NSW,Haymarket,debit,authorized,cd37578a0921482e92b6e398774824ea,SALES-POS,30-40,2018,8,28,9,48,Tuesday,7 days,89236.764
ACC-3233697971,34,432.92,5224.75,1.0,CUS-1147642491,2018-08-28,Robin,F,-33.77,151.04,,77e29db9-c34c-4dc9-9948-074140255ddb,-33.76,150.72,NSW,Kingswood,debit,authorized,9536d7bce9944c4f93ba24392332dc29,POS,30-40,2018,8,28,19,41,Tuesday,7 days,89236.764
ACC-3233697971,34,301.91,4922.84,0.0,CUS-1147642491,2018-08-28,Robin,F,-33.77,151.04,,bd534126-c967-4847-a0ec-97ee74e93f74,-33.81,150.97,NSW,Wentworthville,debit,authorized,2d22336061e745549fca3a459db0c4d3,POS,30-40,2018,8,28,23,50,Tuesday,7 days,89236.764
ACC-3233697971,34,59.73,4863.11,1.0,CUS-1147642491,2018-08-29,Robin,F,-33.77,151.04,,648492a5-bfe0-4fd2-ae9b-07b8fe742e3c,-33.86,150.94,NSW,Fairfield Heights,debit,authorized,ee3cca5fda6d4fb7949214c4036496b0,SALES-POS,30-40,2018,8,29,8,46,Wednesday,7 days,89236.764
ACC-3233697971,34,63.07,4800.04,0.0,CUS-1147642491,2018-08-29,Robin,F,-33.77,151.04,,5cd13a16-b6cc-46d3-b5c4-18e4f10114ac,-33.67,115.35,WA,Busselton,debit,authorized,8e8bf36270e44a879b076aeeed635328,POS,30-40,2018,8,29,11,25,Wednesday,7 days,89236.764
ACC-3233697971,34,23.97,4776.07,1.0,CUS-1147642491,2018-08-29,Robin,F,-33.77,151.04,,b106ee11-e182-40e9-97fd-b27844e78289,-33.73,151.08,NSW,Thornleigh,debit,authorized,22eb0e42dcfb49a4a37b47eb4ddd5e56,SALES-POS,30-40,2018,8,29,17,4,Wednesday,7 days,89236.764
ACC-3233697971,34,51.11,4724.96,1.0,CUS-1147642491,2018-08-29,Robin,F,-33.77,151.04,,d7effe6e-ecfb-464b-aab6-6bb1390ffe97,-33.8,151.18,NSW,Chatswood,debit,authorized,db4252e6f7d74c2a82e1b40420e45617,SALES-POS,30-40,2018,8,29,20,18,Wednesday,7 days,89236.764
ACC-3233697971,34,17.48,4707.48,1.0,CUS-1147642491,2018-08-31,Robin,F,-33.77,151.04,,05494f88-46bb-4e8f-a3c1-e9e98d7b7c5f,-33.69,117.56,WA,Katanning,debit,authorized,9d9b13ce36de4d59ab2cbbc747e407b9,SALES-POS,30-40,2018,8,31,11,51,Friday,7 days,89236.764
ACC-3233697971,34,125.0,4582.48,,CUS-1147642491,2018-09-02,Robin,F,-33.77,151.04,,,,,,,debit,posted,aa310f299b2245f3ad19de21c52423ba,INTER BANK,30-40,2018,9,2,17,0,Sunday,7 days,89236.764
ACC-3233697971,34,46.0,6247.87,,CUS-1147642491,2018-09-03,Robin,F,-33.77,151.04,,,,,,,debit,posted,f4a15ff333744e41bfbc9ce2c0e32e5b,PAYMENT,30-40,2018,9,3,11,0,Monday,7 days,89236.764
ACC-3233697971,34,17.08,6230.79,1.0,CUS-1147642491,2018-09-05,Robin,F,-33.77,151.04,,72b45b15-6d63-44ff-98f0-3c2172a1b723,-33.8,151.18,NSW,Chatswood,debit,authorized,3660733c8e3b47b2b4e170b7202f746c,SALES-POS,30-40,2018,9,5,11,37,Wednesday,7 days,89236.764
ACC-3233697971,34,23.57,6207.22,1.0,CUS-1147642491,2018-09-05,Robin,F,-33.77,151.04,,b5bb457a-1505-44e6-8b8b-cd50864c699f,-33.83,138.61,SA,Clare,debit,authorized,915237d14b154ec990bda04fdfe18feb,SALES-POS,30-40,2018,9,5,15,27,Wednesday,7 days,89236.764
ACC-3233697971,34,46.0,7872.61,,CUS-1147642491,2018-09-10,Robin,F,-33.77,151.04,,,,,,,debit,posted,d811c5bc5113435784bb7d6bf89eabb3,PAYMENT,30-40,2018,9,10,11,0,Monday,7 days,89236.764
ACC-3233697971,34,30.61,7842.0,1.0,CUS-1147642491,2018-09-11,Robin,F,-33.77,151.04,,275f8670-2dc3-4113-88b7-6e1849bcd6b3,-33.81,151,NSW,Parramatta,debit,authorized,06f3c071077046e3b5bae5fdbd427021,SALES-POS,30-40,2018,9,11,22,52,Tuesday,7 days,89236.764
ACC-3233697971,34,171.73,7670.27,1.0,CUS-1147642491,2018-09-12,Robin,F,-33.77,151.04,,4a5de989-4ee7-4c92-a7a7-a94a8f05ec28,-33.79,151.09,NSW,Eastwood,debit,authorized,a67da6d7e0eb438c9f75ba877c54b4b5,SALES-POS,30-40,2018,9,12,11,15,Wednesday,7 days,89236.764
ACC-3233697971,34,45.69,7624.58,1.0,CUS-1147642491,2018-09-12,Robin,F,-33.77,151.04,,38d95127-2a37-47d4-af68-56356470c98d,-33.87,151.21,NSW,Sydney,debit,authorized,81b877fbdb8542fca0d1c8b09ec656fb,POS,30-40,2018,9,12,16,41,Wednesday,7 days,89236.764
ACC-3233697971,34,29.25,7595.33,1.0,CUS-1147642491,2018-09-13,Robin,F,-33.77,151.04,,d8bc8141-7903-408f-a626-c41c5e45dde6,-31.09,150.92,NSW,Tamworth,debit,authorized,ea67cf0f638a484a9cdb1cc05f76cf7e,POS,30-40,2018,9,13,5,49,Thursday,7 days,89236.764
ACC-3233697971,34,79.0,7516.33,,CUS-1147642491,2018-09-13,Robin,F,-33.77,151.04,,,,,,,debit,posted,1fe8f5216b3143cc850453915f5f3a02,PAYMENT,30-40,2018,9,13,11,0,Thursday,7 days,89236.764
ACC-3233697971,34,173.0,7343.33,,CUS-1147642491,2018-09-14,Robin,F,-33.77,151.04,,,,,,,debit,posted,bf25dd4a61284cde8980ffb210be642e,PAYMENT,30-40,2018,9,14,3,0,Friday,7 days,89236.764
ACC-3233697971,34,160.0,7183.33,,CUS-1147642491,2018-09-14,Robin,F,-33.77,151.04,,,,,,,debit,posted,ee2052fe805b45109ce388f336686d41,PAYMENT,30-40,2018,9,14,11,0,Friday,7 days,89236.764
ACC-3233697971,34,19.29,7164.04,1.0,CUS-1147642491,2018-09-14,Robin,F,-33.77,151.04,,be297f2d-e16e-469f-8f9c-50752519eb16,-33.92,151.08,NSW,Lakemba,debit,authorized,548f6e09806441d3bbfea4ebf72b9a0a,POS,30-40,2018,9,14,14,47,Friday,7 days,89236.764
ACC-3233697971,34,35.86,7128.18,1.0,CUS-1147642491,2018-09-14,Robin,F,-33.77,151.04,,146cffd0-87c3-47e3-b0f3-815483a532b9,-33.96,137.71,SA,Kadina,debit,authorized,10685223e78c4ae9ba2fcac96bb9251c,SALES-POS,30-40,2018,9,14,15,40,Friday,7 days,89236.764
ACC-3233697971,34,113.29,7014.89,0.0,CUS-1147642491,2018-09-15,Robin,F,-33.77,151.04,,c0c8afe3-0ae6-4233-b856-6c310c2b0791,-33.96,151.14,NSW,Rockdale,debit,authorized,1bbd4903af004098891993f48581bf01,POS,30-40,2018,9,15,15,29,Saturday,7 days,89236.764
ACC-3233697971,34,29.35,6985.54,0.0,CUS-1147642491,2018-09-15,Robin,F,-33.77,151.04,,45e5d618-4430-47a8-b50f-24759c469e60,-33.87,151.22,NSW,Potts Point,debit,authorized,e0dc283b72664b18aa3b3c4c2968da03,POS,30-40,2018,9,15,21,24,Saturday,7 days,89236.764
ACC-3233697971,34,32.09,6953.45,1.0,CUS-1147642491,2018-09-15,Robin,F,-33.77,151.04,,93ea2db0-ad5b-4fed-96f7-87d2332e23c8,-33.86,151.01,NSW,South Granville,debit,authorized,a88333850304490ba213cc34f4f252fe,SALES-POS,30-40,2018,9,15,21,49,Saturday,7 days,89236.764
ACC-3233697971,34,25.41,6928.04,1.0,CUS-1147642491,2018-09-15,Robin,F,-33.77,151.04,,9ec02ccd-ec22-4d6a-969c-46ad8c96d847,-33.69,117.56,WA,Katanning,debit,authorized,39498881a22f49c28482871e9fd5796f,SALES-POS,30-40,2018,9,15,21,54,Saturday,7 days,89236.764
ACC-3233697971,34,143.0,6785.04,,CUS-1147642491,2018-09-16,Robin,F,-33.77,151.04,,,,,,,debit,posted,82904e0332394e58a4700d44d38ce35d,PAYMENT,30-40,2018,9,16,20,0,Sunday,7 days,89236.764
ACC-3233697971,34,46.0,8450.43,,CUS-1147642491,2018-09-17,Robin,F,-33.77,151.04,,,,,,,debit,posted,df357e6a72784214a3b58330dc24b6e5,PAYMENT,30-40,2018,9,17,11,0,Monday,7 days,89236.764
ACC-3233697971,34,159.0,8291.43,,CUS-1147642491,2018-09-17,Robin,F,-33.77,151.04,,,,,,,debit,posted,9a3b3fc659174536a6d3bb74998996fa,PAYMENT,30-40,2018,9,17,17,0,Monday,7 days,89236.764
ACC-3233697971,34,50.79,8240.64,1.0,CUS-1147642491,2018-09-21,Robin,F,-33.77,151.04,,bd85d473-00fd-46dc-bbd4-b781170cae0c,-33.83,151.24,NSW,Mosman,debit,authorized,012dc0ee88024aafbfa36cc766612b41,POS,30-40,2018,9,21,22,1,Friday,7 days,89236.764
ACC-3233697971,34,29.77,8210.87,0.0,CUS-1147642491,2018-09-21,Robin,F,-33.77,151.04,,4169b2ec-88ea-4de2-9323-7ce2ecc2b86f,-34.25,140.46,SA,Barmera,debit,authorized,47fb4cd6429f45379ae2c8df011ebe90,POS,30-40,2018,9,21,22,33,Friday,7 days,89236.764
ACC-3233697971,34,30.55,8180.32,1.0,CUS-1147642491,2018-09-22,Robin,F,-33.77,151.04,,d31e7b0a-33e3-4c5b-86dd-0e2bd027fb19,-33.95,151.25,NSW,Maroubra,debit,authorized,3a21ce12b0734fdc824f6b817fac2940,POS,30-40,2018,9,22,17,27,Saturday,7 days,89236.764
ACC-3233697971,34,17.46,8162.86,1.0,CUS-1147642491,2018-09-23,Robin,F,-33.77,151.04,,80a1393a-4528-4c47-9b99-7c2eb233d4ee,-33.87,151.21,NSW,Sydney,debit,authorized,1dfb9c3660ef4532a9a4b342527236db,POS,30-40,2018,9,23,9,25,Sunday,7 days,89236.764
ACC-3233697971,34,34.99,8127.87,1.0,CUS-1147642491,2018-09-23,Robin,F,-33.77,151.04,,c69a4e96-466b-4819-9318-484b6ed92b96,-33.9,151.18,NSW,Newtown,debit,authorized,5d829afbf2a54297a95f2f221d59d7a0,POS,30-40,2018,9,23,17,18,Sunday,7 days,89236.764
ACC-3233697971,34,36.35,8091.52,1.0,CUS-1147642491,2018-09-23,Robin,F,-33.77,151.04,,585fdd2e-e514-4574-81b2-7ac234ccae2e,-33.76,138.44,SA,Hart,debit,authorized,fe987e79bcf14f1788c59f514bb4461c,POS,30-40,2018,9,23,22,13,Sunday,7 days,89236.764
ACC-3233697971,34,42.14,8049.38,1.0,CUS-1147642491,2018-09-23,Robin,F,-33.77,151.04,,50b966cd-5400-41dc-8dcd-dbc2fd97cc92,-33.95,115.08,WA,Margaret River,debit,authorized,47a1c58568a84070ba400138e2676a02,POS,30-40,2018,9,23,22,41,Sunday,7 days,89236.764
ACC-3233697971,34,46.0,9714.77,,CUS-1147642491,2018-09-24,Robin,F,-33.77,151.04,,,,,,,debit,posted,a0b807d241094919a199479b9188752d,PAYMENT,30-40,2018,9,24,11,0,Monday,7 days,89236.764
ACC-3233697971,34,27.48,9687.29,0.0,CUS-1147642491,2018-09-24,Robin,F,-33.77,151.04,,142d45ab-8d51-47d2-87ad-cb2bbf7e23fc,-33.95,115.07,WA,Margaret River,debit,authorized,9816a0ecaf424ceb81b124169817fc88,POS,30-40,2018,9,24,13,53,Monday,7 days,89236.764
ACC-3233697971,34,40.54,9646.75,0.0,CUS-1147642491,2018-09-24,Robin,F,-33.77,151.04,,c01e6c61-f72d-40cb-96fc-90cafe1885c8,-33.88,151.24,NSW,Double Bay,debit,authorized,1b833991058e4e7eb06feda14981ce3d,SALES-POS,30-40,2018,9,24,20,29,Monday,7 days,89236.764
ACC-3233697971,34,17.84,9628.91,1.0,CUS-1147642491,2018-09-25,Robin,F,-33.77,151.04,,85f62f5b-b46b-4cd7-b994-d10614274b39,-33.7,151.03,NSW,Dural,debit,authorized,f1adfa03440a42bc84723f00b75df72e,SALES-POS,30-40,2018,9,25,18,35,Tuesday,7 days,89236.764
ACC-3233697971,34,40.81,9588.1,1.0,CUS-1147642491,2018-09-25,Robin,F,-33.77,151.04,,fc15dc0d-fc08-402e-9d3d-efa5ee9375ca,-33.86,121.89,WA,Esperance,debit,authorized,58df338f5228407fa68e30ee0275838d,POS,30-40,2018,9,25,21,46,Tuesday,7 days,89236.764
ACC-3233697971,34,30.3,9557.8,1.0,CUS-1147642491,2018-09-25,Robin,F,-33.77,151.04,,11e413bc-a737-4704-9a80-b78a85902d1a,-33.9,150.9,NSW,Mount Pritchard,debit,authorized,7d726167811a4db6825507b466fa84bf,SALES-POS,30-40,2018,9,25,22,33,Tuesday,7 days,89236.764
ACC-3233697971,34,83.38,9474.42,1.0,CUS-1147642491,2018-09-30,Robin,F,-33.77,151.04,,2cc53184-c4f2-43b9-84bd-7a6127f6a781,-33.64,150.29,NSW,Blackheath,debit,authorized,94f405d1bdcc41c38fa2a524bec4e2d4,SALES-POS,30-40,2018,9,30,19,47,Sunday,7 days,89236.764
ACC-3233697971,34,46.0,11139.81,,CUS-1147642491,2018-10-01,Robin,F,-33.77,151.04,,,,,,,debit,posted,bb06f705ce504d80a938db65fb606b04,PAYMENT,30-40,2018,10,1,11,0,Monday,7 days,89236.764
ACC-3233697971,34,47.09,11092.72,1.0,CUS-1147642491,2018-10-02,Robin,F,-33.77,151.04,,64529278-23c6-4ce2-aa0b-f8e3cf0af77f,-33.92,151.19,NSW,Alexandria,debit,authorized,803b93dcfb6a484ab43f582698390d50,POS,30-40,2018,10,2,12,35,Tuesday,7 days,89236.764
ACC-3233697971,34,125.0,10967.72,,CUS-1147642491,2018-10-02,Robin,F,-33.77,151.04,,,,,,,debit,posted,7ff5ec4aa6d5435eb590deb01e5c1e94,INTER BANK,30-40,2018,10,2,17,0,Tuesday,7 days,89236.764
ACC-3233697971,34,21.05,10946.67,1.0,CUS-1147642491,2018-10-03,Robin,F,-33.77,151.04,,56998a42-5a61-41c9-9e85-d0ee9a35b01e,-34.01,151.02,NSW,Menai,debit,authorized,94fb4b1035ec445cbbf4c1605537ff09,SALES-POS,30-40,2018,10,3,13,29,Wednesday,7 days,89236.764
ACC-3233697971,34,16.83,10929.84,1.0,CUS-1147642491,2018-10-05,Robin,F,-33.77,151.04,,5cede3d3-a59b-45dc-91f5-9233b65306a1,-33.91,151.24,NSW,Randwick,debit,authorized,638f29dffb2940f0844be0862f4b2ccc,SALES-POS,30-40,2018,10,5,8,33,Friday,7 days,89236.764
ACC-3233697971,34,36.93,10892.91,1.0,CUS-1147642491,2018-10-05,Robin,F,-33.77,151.04,,79fa6665-968c-46c0-9079-770be6070182,-33.93,151.12,NSW,Earlwood,debit,authorized,8e8d8ac619d849c3a0597b8e1d392470,SALES-POS,30-40,2018,10,5,14,27,Friday,7 days,89236.764
ACC-3233697971,34,31.02,10861.89,1.0,CUS-1147642491,2018-10-05,Robin,F,-33.77,151.04,,0369675e-6828-4093-8032-d46879121dd9,-33.91,151.03,NSW,Bankstown,debit,authorized,945b154408df4e85a606fe56999e2b84,SALES-POS,30-40,2018,10,5,21,20,Friday,7 days,89236.764
ACC-3233697971,34,11.14,10850.75,0.0,CUS-1147642491,2018-10-06,Robin,F,-33.77,151.04,,8561280d-ea30-4616-8403-83f1fc217f88,-33.87,151.21,NSW,Sydney,debit,authorized,de4703d3560f45c1bd0aff9065cfe1f6,SALES-POS,30-40,2018,10,6,1,31,Saturday,7 days,89236.764
ACC-3233697971,34,24.39,10826.36,0.0,CUS-1147642491,2018-10-06,Robin,F,-33.77,151.04,,b2813c25-0d20-4081-8d84-e7cb91fa8ef8,-33.92,151.17,NSW,Tempe,debit,authorized,c659a2cfac01486aaea3876d8cabac4f,SALES-POS,30-40,2018,10,6,18,17,Saturday,7 days,89236.764
ACC-3233697971,34,41.7,10784.66,0.0,CUS-1147642491,2018-10-06,Robin,F,-33.77,151.04,,efc08534-0d8d-4bf0-b4fc-4362fb67b93d,-33.68,115.25,WA,Vasse,debit,authorized,7412718951ef4ff6b265b9dee76187f4,POS,30-40,2018,10,6,21,13,Saturday,7 days,89236.764
ACC-3233697971,34,46.0,12450.05,,CUS-1147642491,2018-10-08,Robin,F,-33.77,151.04,,,,,,,debit,posted,d577c9e3dbad4579a084b7c4b1a1ca22,PAYMENT,30-40,2018,10,8,11,0,Monday,7 days,89236.764
ACC-3233697971,34,79.0,12371.05,,CUS-1147642491,2018-10-13,Robin,F,-33.77,151.04,,,,,,,debit,posted,bc88b8019fd94243920f93eea34858db,PAYMENT,30-40,2018,10,13,11,0,Saturday,7 days,89236.764
ACC-3233697971,34,11.31,12359.74,1.0,CUS-1147642491,2018-10-13,Robin,F,-33.77,151.04,,46b96575-6bd4-4a5f-a115-3f796a24b3dc,-33.88,151.05,NSW,Lidcombe,debit,authorized,e32853adb0534cea843f8672ead23e83,POS,30-40,2018,10,13,16,47,Saturday,7 days,89236.764
ACC-3233697971,34,94.77,12264.97,1.0,CUS-1147642491,2018-10-13,Robin,F,-33.77,151.04,,3c3d907e-bd5d-4980-a7f4-2f4309747497,-33.89,151.21,NSW,Surry Hills,debit,authorized,3c37ba340b1c48c9b9c24afa2a640c1c,SALES-POS,30-40,2018,10,13,19,8,Saturday,7 days,89236.764
ACC-3233697971,34,37.74,12227.23,0.0,CUS-1147642491,2018-10-13,Robin,F,-33.77,151.04,,4fd067c9-5565-4282-b701-6352d677ad14,-33.79,150.99,NSW,Northmead,debit,authorized,eb0fc62f5d844c9094d19a0efe81746a,POS,30-40,2018,10,13,19,39,Saturday,7 days,89236.764
ACC-3233697971,34,173.0,12054.23,,CUS-1147642491,2018-10-14,Robin,F,-33.77,151.04,,,,,,,debit,posted,612459a9f42144eaa66f77a471f6f562,PAYMENT,30-40,2018,10,14,3,0,Sunday,7 days,89236.764
ACC-3233697971,34,160.0,11894.23,,CUS-1147642491,2018-10-14,Robin,F,-33.77,151.04,,,,,,,debit,posted,39ec7b24dee441d781bbf810a2f91999,PAYMENT,30-40,2018,10,14,11,0,Sunday,7 days,89236.764
ACC-3233697971,34,46.0,13559.62,,CUS-1147642491,2018-10-15,Robin,F,-33.77,151.04,,,,,,,debit,posted,e989c2ca58004db5803f76daa558d7bf,PAYMENT,30-40,2018,10,15,11,0,Monday,7 days,89236.764
ACC-3233697971,34,143.0,13416.62,,CUS-1147642491,2018-10-16,Robin,F,-33.77,151.04,,,,,,,debit,posted,17eaa87d72274f79b604bec5221a8520,PAYMENT,30-40,2018,10,16,20,0,Tuesday,7 days,89236.764
ACC-3233697971,34,159.0,13257.62,,CUS-1147642491,2018-10-17,Robin,F,-33.77,151.04,,,,,,,debit,posted,3b2c4edfb4574d9cb7ee367842346735,PAYMENT,30-40,2018,10,17,17,0,Wednesday,7 days,89236.764
ACC-3233697971,34,44.3,13213.32,1.0,CUS-1147642491,2018-10-19,Robin,F,-33.77,151.04,,d97a1736-4076-4aee-801d-a350f244aa30,-33.8,151.29,NSW,Manly,debit,authorized,0bd009c1423c4caaa044ba1d400e169a,SALES-POS,30-40,2018,10,19,8,45,Friday,7 days,89236.764
ACC-3233697971,34,80.21,13133.11,1.0,CUS-1147642491,2018-10-19,Robin,F,-33.77,151.04,,98b27c00-c03e-4bd5-82ad-8dd92890e57e,-27.47,153.02,QLD,Brisbane City,debit,authorized,0b61ea3b699c4d28a04c5c7b2534e032,SALES-POS,30-40,2018,10,19,22,37,Friday,7 days,89236.764
ACC-3233697971,34,21.83,13111.28,0.0,CUS-1147642491,2018-10-20,Robin,F,-33.77,151.04,,ffd41c3e-ba1d-4d09-8963-cf8a276f1700,-33.79,151.29,NSW,Manly,debit,authorized,360eb3dc647c40be863a155861a95d6e,SALES-POS,30-40,2018,10,20,7,19,Saturday,7 days,89236.764
ACC-3233697971,34,17.79,13093.49,1.0,CUS-1147642491,2018-10-20,Robin,F,-33.77,151.04,,7ec68ffc-ad74-4180-9996-c4657529944f,-33.71,150.38,NSW,Wentworth Falls,debit,authorized,28581e1aae504053b928a191e9fe05cd,SALES-POS,30-40,2018,10,20,9,7,Saturday,7 days,89236.764
ACC-3233697971,34,38.39,13055.1,1.0,CUS-1147642491,2018-10-20,Robin,F,-33.77,151.04,,a038df8c-bade-40e9-b864-9371758a8745,-33.87,151.2,NSW,Pyrmont,debit,authorized,1fedcc3ec12c4eb5aa6c11b2adfcb739,POS,30-40,2018,10,20,11,57,Saturday,7 days,89236.764
ACC-3233697971,34,39.8,13015.3,1.0,CUS-1147642491,2018-10-20,Robin,F,-33.77,151.04,,7ce5471b-363c-46ab-b398-ca517347829a,-33.87,151.21,NSW,Sydney,debit,authorized,b7f2d2c8f9eb42939f5a55ad2133a08a,SALES-POS,30-40,2018,10,20,20,23,Saturday,7 days,89236.764
ACC-3233697971,34,55.38,12959.92,1.0,CUS-1147642491,2018-10-20,Robin,F,-33.77,151.04,,860b915d-93f8-4949-b412-0082b29d9591,-33.89,151.23,NSW,Moore Park,debit,authorized,ed2dd2c0b1724fafadd9de49cb3f04ac,SALES-POS,30-40,2018,10,20,21,10,Saturday,7 days,89236.764
ACC-3233697971,34,317.15,12642.77,1.0,CUS-1147642491,2018-10-21,Robin,F,-33.77,151.04,,c6ef8420-7cca-4837-b2c7-79c4a60c3835,-33.81,151.11,NSW,Ryde,debit,authorized,2c7c360bb5cd4faa9a5946e3cc7dec16,SALES-POS,30-40,2018,10,21,16,20,Sunday,7 days,89236.764
ACC-3233697971,34,46.0,14308.16,,CUS-1147642491,2018-10-22,Robin,F,-33.77,151.04,,,,,,,debit,posted,b89db0bfa89446529669a076dbde3c16,PAYMENT,30-40,2018,10,22,11,0,Monday,7 days,89236.764
ACC-3233697971,34,13.35,14294.81,0.0,CUS-1147642491,2018-10-22,Robin,F,-33.77,151.04,,529d6637-d8df-4877-9024-d259a2884ccd,-33.84,151.2,NSW,Mcmahons Point,debit,authorized,ce9eae4e13c5459284b54623d8c8cdb0,POS,30-40,2018,10,22,13,26,Monday,7 days,89236.764
ACC-3233697971,34,41.66,14253.15,1.0,CUS-1147642491,2018-10-24,Robin,F,-33.77,151.04,,71ad796b-9872-4a78-bb73-cd418e50c801,-33.67,150.81,NSW,Berkshire Park,debit,authorized,618d2287da634b449b25e8f4cbe87dea,POS,30-40,2018,10,24,9,40,Wednesday,7 days,89236.764
ACC-3233697971,34,11.44,14241.71,1.0,CUS-1147642491,2018-10-24,Robin,F,-33.77,151.04,,919e5c7e-4032-4143-94f4-0b18e5a5e1f0,-33.88,151.22,NSW,Darlinghurst,debit,authorized,ceda5dc0c81b444da4afcf26d2e6b93f,SALES-POS,30-40,2018,10,24,12,45,Wednesday,7 days,89236.764
ACC-3233697971,34,38.07,14203.64,1.0,CUS-1147642491,2018-10-25,Robin,F,-33.77,151.04,,0699be84-d893-4775-b1b2-baa2abcfaabe,-33.75,150.69,NSW,Penrith,debit,authorized,712d255cc883401ab42aa0bf989e6e91,POS,30-40,2018,10,25,15,42,Thursday,7 days,89236.764
ACC-3233697971,34,39.05,14164.59,0.0,CUS-1147642491,2018-10-26,Robin,F,-33.77,151.04,,fe87d8f6-9502-418a-8ce7-851b86b8f819,-37.82,145.22,VIC,Ringwood,debit,authorized,a51f5606f9e94694a2b95585a51174a4,SALES-POS,30-40,2018,10,26,9,36,Friday,7 days,89236.764
ACC-3233697971,34,11.91,14152.68,0.0,CUS-1147642491,2018-10-27,Robin,F,-33.77,151.04,,bb9ea428-ab07-4ae2-842a-b6be05258cbf,-33.92,150.93,NSW,Liverpool,debit,authorized,40092a68acfe418987dbd7c8e4de8a32,POS,30-40,2018,10,27,3,41,Saturday,7 days,89236.764
ACC-3233697971,34,38.08,14114.6,1.0,CUS-1147642491,2018-10-27,Robin,F,-33.77,151.04,,3b4cef6e-7b92-41cb-92cb-2602d25486b6,-37.82,145.03,VIC,Hawthorn,debit,authorized,e94eac529580473f89b542e688013f64,POS,30-40,2018,10,27,6,24,Saturday,7 days,89236.764
ACC-3233697971,34,38.45,14076.15,1.0,CUS-1147642491,2018-10-27,Robin,F,-33.77,151.04,,64f5d0e8-21a6-4430-807c-2f116a06f85c,-33.91,151.03,NSW,Yagoona,debit,authorized,36e463b040394a14819ac15654ccb85f,POS,30-40,2018,10,27,21,10,Saturday,7 days,89236.764
ACC-3233697971,34,67.83,14008.32,1.0,CUS-1147642491,2018-10-28,Robin,F,-33.77,151.04,,8cb20ca6-7977-430e-9cc1-fed261ef1f2f,-33.87,151.21,NSW,Sydney,debit,authorized,2f4af18d8e3c410391ad652b6ebaab03,SALES-POS,30-40,2018,10,28,0,47,Sunday,7 days,89236.764
ACC-3233697971,34,98.21,13910.11,1.0,CUS-1147642491,2018-10-28,Robin,F,-33.77,151.04,,743e887c-1aec-4e1f-82f9-79daa5b3b2ec,-33.87,151.21,NSW,Sydney,debit,authorized,c05d9b09f1244d95ac753941e0a48a5b,SALES-POS,30-40,2018,10,28,11,22,Sunday,7 days,89236.764
ACC-3233697971,34,27.73,13882.38,1.0,CUS-1147642491,2018-10-28,Robin,F,-33.77,151.04,,642b3498-9ce7-422c-b2fc-0cbb3773fb7a,-33.82,151.21,NSW,Cammeray,debit,authorized,bc7ef0b43a8949ceaf82f469f9354c0f,POS,30-40,2018,10,28,20,54,Sunday,7 days,89236.764
ACC-3233697971,34,21.14,13861.24,0.0,CUS-1147642491,2018-10-29,Robin,F,-33.77,151.04,,68b25786-f854-4deb-9e9b-bc3e11217907,-33.81,150.99,NSW,Westmead,debit,authorized,3b354681d2114743ac8e859980af8da4,POS,30-40,2018,10,29,6,27,Monday,7 days,89236.764
ACC-3233697971,34,40.17,13821.07,1.0,CUS-1147642491,2018-10-29,Robin,F,-33.77,151.04,,4d8ec525-a8fc-4cf7-b133-6d36f67c5c74,-33.75,151.3,NSW,Dee Why,debit,authorized,aa3cbe5893e3486f93813d390db83c12,SALES-POS,30-40,2018,10,29,8,13,Monday,7 days,89236.764
ACC-3233697971,34,46.0,15486.46,,CUS-1147642491,2018-10-29,Robin,F,-33.77,151.04,,,,,,,debit,posted,bc8568032169433ba2b460fe22a4e073,PAYMENT,30-40,2018,10,29,11,0,Monday,7 days,89236.764
ACC-3233697971,34,69.74,15416.72,0.0,CUS-1147642491,2018-10-30,Robin,F,-33.77,151.04,,30c69d30-dbad-40dd-8933-689c2ab45f4b,-33.67,115.25,WA,Vasse,debit,authorized,cb8bfff3209041c3a7aa3f3bec42dde5,POS,30-40,2018,10,30,12,28,Tuesday,7 days,89236.764
ACC-3233697971,34,29.51,15387.21,1.0,CUS-1147642491,2018-10-31,Robin,F,-33.77,151.04,,4bfe3e5b-32e0-4fa5-a5a5-375377f6c851,-33.89,151.2,NSW,Redfern,debit,authorized,28c16e53128b4371b8fea2cf393f3a84,SALES-POS,30-40,2018,10,31,8,29,Wednesday,7 days,89236.764
ACC-240804743,29,43.0,4364.89,,CUS-261674136,2018-08-07,Kenneth,M,-30.75,121.48,,,,,,,debit,posted,e617de0f0ee6430d8361d26c6cf0ec10,PHONE BANK,20-30,2018,8,7,3,0,Tuesday,14 days,114852.464
ACC-240804743,29,56.0,4308.89,,CUS-261674136,2018-08-08,Kenneth,M,-30.75,121.48,,,,,,,debit,posted,7a70e5c62df249659bc3376dc37efe3d,PAYMENT,20-30,2018,8,8,14,0,Wednesday,14 days,114852.464
ACC-240804743,29,39.0,4253.74,,CUS-261674136,2018-08-08,Kenneth,M,-30.75,121.48,,,,,,,debit,posted,5e5fa5ef65b44815a1be149d1a8cd951,PAYMENT,20-30,2018,8,8,23,0,Wednesday,14 days,114852.464
ACC-240804743,29,16.15,4292.74,1.0,CUS-261674136,2018-08-08,Kenneth,M,-30.75,121.48,,41aa5103-841a-4f87-8cd2-577fe3e2b269,-30.8,152.87,QLD,Loganholme,debit,authorized,c66c757f75004b0fa16f027d1af584e2,SALES-POS,20-30,2018,8,8,23,24,Wednesday,14 days,114852.464
ACC-240804743,29,48.0,4205.74,,CUS-261674136,2018-08-12,Kenneth,M,-30.75,121.48,,,,,,,debit,posted,3d27e8a8055244cda7cac82031b868d9,PAYMENT,20-30,2018,8,12,20,0,Sunday,14 days,114852.464
ACC-240804743,29,43.0,4162.74,,CUS-261674136,2018-08-14,Kenneth,M,-30.75,121.48,,,,,,,debit,posted,851fbbd69b60413f8014317f7ba32ffc,PHONE BANK,20-30,2018,8,14,3,0,Tuesday,14 days,114852.464
ACC-240804743,29,29.76,4132.98,1.0,CUS-261674136,2018-08-15,Kenneth,M,-30.75,121.48,,d6191103-722d-4593-b4e2-b6d4bf7a40b5,-33.86,151.2,NSW,Sydney,debit,authorized,54927574a3e6440d89c48a0945774a21,SALES-POS,20-30,2018,8,15,9,33,Wednesday,14 days,114852.464
ACC-240804743,29,16.28,4116.7,1.0,CUS-261674136,2018-08-15,Kenneth,M,-30.75,121.48,,e28c426d-cbef-4e2d-aa06-1ba0b6b1902f,-30.7,150.04,NSW,Boggabri,debit,authorized,aefc1c877e6b45f297a4ca27542b8ca3,SALES-POS,20-30,2018,8,15,9,41,Wednesday,14 days,114852.464
ACC-240804743,29,56.0,4060.7,,CUS-261674136,2018-08-15,Kenneth,M,-30.75,121.48,,,,,,,debit,posted,b1f36c08f83647afbfbd9064b5610914,PAYMENT,20-30,2018,8,15,14,0,Wednesday,14 days,114852.464
ACC-240804743,29,138.0,3922.7,,CUS-261674136,2018-08-15,Kenneth,M,-30.75,121.48,,,,,,,debit,posted,b78aeea5cdfd4fdfa249066de866687d,PAYMENT,20-30,2018,8,15,15,0,Wednesday,14 days,114852.464
ACC-240804743,29,89.33,3833.37,1.0,CUS-261674136,2018-08-15,Kenneth,M,-30.75,121.48,,f126f15e-30c2-456f-8b10-a28f9762e41d,-27.47,153.02,QLD,Brisbane City,debit,authorized,12fc8ee4898e49abba59d2fac632547b,POS,20-30,2018,8,15,17,41,Wednesday,14 days,114852.464
ACC-240804743,29,39.0,3794.37,,CUS-261674136,2018-08-15,Kenneth,M,-30.75,121.48,,,,,,,debit,posted,fa1f5c3b9eff46279c6c877436526f4a,PAYMENT,20-30,2018,8,15,23,0,Wednesday,14 days,114852.464
ACC-240804743,29,48.0,3631.37,,CUS-261674136,2018-08-19,Kenneth,M,-30.75,121.48,,,,,,,debit,posted,db7127825c09402e9cd895c444d02bd8,PAYMENT,20-30,2018,8,19,20,0,Sunday,14 days,114852.464
ACC-240804743,29,39.62,3591.75,1.0,CUS-261674136,2018-08-20,Kenneth,M,-30.75,121.48,,8d9595b6-812e-4e32-8a58-fedbe856b2f2,-31.95,115.82,WA,Subiaco,debit,authorized,950f9094eb6043a1815d56d94656c4fe,SALES-POS,20-30,2018,8,20,1,20,Monday,14 days,114852.464
ACC-240804743,29,35.84,3555.91,1.0,CUS-261674136,2018-08-20,Kenneth,M,-30.75,121.48,,06d1fe57-be2a-4f84-b3db-c4e25e6b24d3,-31.98,115.78,WA,Claremont,debit,authorized,d012ae9811cc4d8999a5f4feae29bf34,SALES-POS,20-30,2018,8,20,9,10,Monday,14 days,114852.464
ACC-240804743,29,43.0,7918.21,,CUS-261674136,2018-08-21,Kenneth,M,-30.75,121.48,,,,,,,debit,posted,90358948f0464ec89eac54c705a38d75,PHONE BANK,20-30,2018,8,21,3,0,Tuesday,14 days,114852.464
ACC-240804743,29,56.0,7862.21,,CUS-261674136,2018-08-22,Kenneth,M,-30.75,121.48,,,,,,,debit,posted,874a32c352b749d191a17f0ad5878716,PAYMENT,20-30,2018,8,22,14,0,Wednesday,14 days,114852.464
ACC-240804743,29,39.0,7823.21,,CUS-261674136,2018-08-22,Kenneth,M,-30.75,121.48,,,,,,,debit,posted,2d011a35ba034ab9a62109bc07231f03,PAYMENT,20-30,2018,8,22,23,0,Wednesday,14 days,114852.464
ACC-240804743,29,15.89,7807.32,1.0,CUS-261674136,2018-08-25,Kenneth,M,-30.75,121.48,,c0729f54-a126-4607-968d-f7d4b0babcf3,-30.75,121.47,WA,Kalgoorlie,debit,authorized,a86baf1d2f9b40be89d6bac10356e9b6,POS,20-30,2018,8,25,18,19,Saturday,14 days,114852.464
ACC-240804743,29,48.0,7759.32,,CUS-261674136,2018-08-26,Kenneth,M,-30.75,121.48,,,,,,,debit,posted,00b48eb305104fa8ad64c22de42b269c,PAYMENT,20-30,2018,8,26,20,0,Sunday,14 days,114852.464
ACC-240804743,29,43.0,7716.32,,CUS-261674136,2018-08-28,Kenneth,M,-30.75,121.48,,,,,,,debit,posted,b654c553e82e4d11b1b6f01ca08ad75a,PHONE BANK,20-30,2018,8,28,3,0,Tuesday,14 days,114852.464
ACC-240804743,29,8.86,7707.46,1.0,CUS-261674136,2018-08-29,Kenneth,M,-30.75,121.48,,30d360f5-0df8-4949-997a-9ee51f7b9613,-30.76,121.46,WA,Somerville,debit,authorized,a332c280946c4d419ba5e53812743067,SALES-POS,20-30,2018,8,29,9,57,Wednesday,14 days,114852.464
ACC-240804743,29,56.0,7651.46,,CUS-261674136,2018-08-29,Kenneth,M,-30.75,121.48,,,,,,,debit,posted,010cfffccf6c4fefb0a7d0b88a6d68da,PAYMENT,20-30,2018,8,29,14,0,Wednesday,14 days,114852.464
ACC-240804743,29,39.0,7612.46,,CUS-261674136,2018-08-29,Kenneth,M,-30.75,121.48,,,,,,,debit,posted,ca97d65b5a9e49498a9342d2b0e8e771,PAYMENT,20-30,2018,8,29,23,0,Wednesday,14 days,114852.464
ACC-240804743,29,16.27,7596.19,1.0,CUS-261674136,2018-08-30,Kenneth,M,-30.75,121.48,,e28c426d-cbef-4e2d-aa06-1ba0b6b1902f,-30.7,150.04,NSW,Boggabri,debit,authorized,71679ffbd59940e2be1927b300f7fc55,SALES-POS,20-30,2018,8,30,13,55,Thursday,14 days,114852.464
ACC-240804743,29,8.89,7587.3,1.0,CUS-261674136,2018-08-30,Kenneth,M,-30.75,121.48,,40f16a84-480f-47a5-bd17-16aecfb896cb,-30.73,121.45,WA,Hannans,debit,authorized,bae05eb9c4b947bca8fd8e8cb761e94b,SALES-POS,20-30,2018,8,30,17,42,Thursday,14 days,114852.464
ACC-240804743,29,17.24,7570.06,1.0,CUS-261674136,2018-09-01,Kenneth,M,-30.75,121.48,,41aa5103-841a-4f87-8cd2-577fe3e2b269,-30.8,152.87,QLD,Loganholme,debit,authorized,f9f908c893e24ccf8dbfdb781fbe90b9,POS,20-30,2018,9,1,19,39,Saturday,14 days,114852.464
ACC-240804743,29,56.17,7513.89,1.0,CUS-261674136,2018-09-01,Kenneth,M,-30.75,121.48,,f66f5f5a-ebd4-4fd5-9471-3dbbc4c65894,-27.47,153,QLD,Milton,debit,authorized,7a173ad8a2ed420abf60a4719d907d18,SALES-POS,20-30,2018,9,1,20,20,Saturday,14 days,114852.464
ACC-240804743,29,75.0,7438.89,,CUS-261674136,2018-09-02,Kenneth,M,-30.75,121.48,,,,,,,debit,posted,f7e58243b7ed4ed382048667b2652d8e,PAYMENT,20-30,2018,9,2,8,0,Sunday,14 days,114852.464
ACC-240804743,29,48.0,7371.46,,CUS-261674136,2018-09-02,Kenneth,M,-30.75,121.48,,,,,,,debit,posted,27db9e61adf84b1280177a95c3a6bc00,PAYMENT,20-30,2018,9,2,20,0,Sunday,14 days,114852.464
ACC-240804743,29,19.43,7419.46,1.0,CUS-261674136,2018-09-02,Kenneth,M,-30.75,121.48,,15e1c7bb-bd96-4304-8679-5815422382b1,-30.75,121.47,WA,Kalgoorlie,debit,authorized,7ff0113af6074e94a75ff83fc1991ed7,POS,20-30,2018,9,2,20,33,Sunday,14 days,114852.464
ACC-240804743,29,23.37,7348.09,1.0,CUS-261674136,2018-09-03,Kenneth,M,-30.75,121.48,,8cd6e1d8-7197-416b-bfbc-b621fb041d71,-30.66,152.99,NSW,Nambucca Heads,debit,authorized,48e4b39f1fb64f53937a389952c29db4,SALES-POS,20-30,2018,9,3,9,45,Monday,14 days,114852.464
ACC-240804743,29,43.0,11710.39,,CUS-261674136,2018-09-04,Kenneth,M,-30.75,121.48,,,,,,,debit,posted,e89e64a690f04fb4889728689ae23855,PHONE BANK,20-30,2018,9,4,3,0,Tuesday,14 days,114852.464
ACC-240804743,29,71.0,11639.39,,CUS-261674136,2018-09-04,Kenneth,M,-30.75,121.48,,,,,,,debit,posted,921d84bf410b4b1eaf9756f1500421d4,PAYMENT,20-30,2018,9,4,17,0,Tuesday,14 days,114852.464
ACC-240804743,29,56.0,11583.39,,CUS-261674136,2018-09-05,Kenneth,M,-30.75,121.48,,,,,,,debit,posted,a52623398ab345f5b7485c4422d1c736,PAYMENT,20-30,2018,9,5,14,0,Wednesday,14 days,114852.464
ACC-240804743,29,39.0,11544.39,,CUS-261674136,2018-09-05,Kenneth,M,-30.75,121.48,,,,,,,debit,posted,d0021cc789784f90b09abe183468ec9a,PAYMENT,20-30,2018,9,5,23,0,Wednesday,14 days,114852.464
ACC-240804743,29,48.0,11496.39,,CUS-261674136,2018-09-09,Kenneth,M,-30.75,121.48,,,,,,,debit,posted,ef751b7dc1ae4b4ba749c537d9cc3009,PAYMENT,20-30,2018,9,9,20,0,Sunday,14 days,114852.464
ACC-240804743,29,43.0,11453.39,,CUS-261674136,2018-09-11,Kenneth,M,-30.75,121.48,,,,,,,debit,posted,17901e61ae13422c9747c967b408d064,PHONE BANK,20-30,2018,9,11,3,0,Tuesday,14 days,114852.464
ACC-240804743,29,56.0,11390.27,,CUS-261674136,2018-09-12,Kenneth,M,-30.75,121.48,,,,,,,debit,posted,34b605f522704ac585465cf38ed3f4fd,PAYMENT,20-30,2018,9,12,14,0,Wednesday,14 days,114852.464
ACC-240804743,29,7.12,11446.27,1.0,CUS-261674136,2018-09-12,Kenneth,M,-30.75,121.48,,61bec0f3-20b1-4235-95e2-febd8a89f079,-30.75,121.48,WA,Kalgoorlie,debit,authorized,4f72853b601e4fee8cbcd3d7ad6cdc74,SALES-POS,20-30,2018,9,12,14,22,Wednesday,14 days,114852.464
ACC-240804743,29,23.93,11366.34,0.0,CUS-261674136,2018-09-12,Kenneth,M,-30.75,121.48,,abf814cc-5f46-4652-a768-39865adf4319,-32.08,115.81,WA,Coolbellup,debit,authorized,f0acc4e718ab4805a2bd957df1ee181a,SALES-POS,20-30,2018,9,12,16,5,Wednesday,14 days,114852.464
ACC-240804743,29,36.92,11329.42,1.0,CUS-261674136,2018-09-12,Kenneth,M,-30.75,121.48,,404684ec-68bb-4c3c-89ba-1d57c607ca32,-30.74,121.47,WA,Piccadilly,debit,authorized,2a51859dd296471fbc82c55bd1f9fa6c,SALES-POS,20-30,2018,9,12,18,10,Wednesday,14 days,114852.464
ACC-240804743,29,39.0,11260.3,,CUS-261674136,2018-09-12,Kenneth,M,-30.75,121.48,,,,,,,debit,posted,5ee578c6a37245e4b8df7a22fbf31d9d,PAYMENT,20-30,2018,9,12,23,0,Wednesday,14 days,114852.464
ACC-240804743,29,30.12,11299.3,1.0,CUS-261674136,2018-09-12,Kenneth,M,-30.75,121.48,,c90572a4-d494-4374-8dcd-33a240007c62,-30.75,121.47,WA,Kalgoorlie,debit,authorized,602971eb2617427085b799e740e68c88,SALES-POS,20-30,2018,9,12,23,18,Wednesday,14 days,114852.464
ACC-240804743,29,17.01,11243.29,1.0,CUS-261674136,2018-09-13,Kenneth,M,-30.75,121.48,,1b687605-2f01-43e0-84f2-297f3dd86f53,-30.77,121.48,WA,Boulder,debit,authorized,102b2606f7dc4d3c8d1df783e4708c64,SALES-POS,20-30,2018,9,13,14,29,Thursday,14 days,114852.464
ACC-240804743,29,10.72,11232.57,1.0,CUS-261674136,2018-09-14,Kenneth,M,-30.75,121.48,,40f16a84-480f-47a5-bd17-16aecfb896cb,-30.73,121.45,WA,Hannans,debit,authorized,953e51a468e94e20b4fca259548f5b77,SALES-POS,20-30,2018,9,14,15,11,Friday,14 days,114852.464
ACC-240804743,29,63.26,11169.31,1.0,CUS-261674136,2018-09-14,Kenneth,M,-30.75,121.48,,0888ed2d-076f-4688-a446-28a0af4cc360,-33.87,151.21,NSW,Sydney,debit,authorized,60aa5fee29bb43938ef2c41d7f6acffc,SALES-POS,20-30,2018,9,14,19,59,Friday,14 days,114852.464
ACC-240804743,29,22.47,11146.84,0.0,CUS-261674136,2018-09-14,Kenneth,M,-30.75,121.48,,c818980d-52a2-4831-912e-f4f6ef0f61a2,-30.74,121.47,WA,Piccadilly,debit,authorized,a42d1819e3774fd99c840542001193db,POS,20-30,2018,9,14,20,18,Friday,14 days,114852.464
ACC-240804743,29,9.14,11137.7,1.0,CUS-261674136,2018-09-14,Kenneth,M,-30.75,121.48,,9a479b0e-cf88-4060-b7fb-030aa88f5ffd,-30.78,121.44,WA,West Kalgoorlie,debit,authorized,3c59799308e443ca9d7634c0d743a82b,SALES-POS,20-30,2018,9,14,20,58,Friday,14 days,114852.464
ACC-240804743,29,16.67,11121.03,1.0,CUS-261674136,2018-09-14,Kenneth,M,-30.75,121.48,,41aa5103-841a-4f87-8cd2-577fe3e2b269,-30.8,152.87,QLD,Loganholme,debit,authorized,bb894addac05426f926faa8eaa75eccc,POS,20-30,2018,9,14,23,17,Friday,14 days,114852.464
ACC-240804743,29,138.0,10983.03,,CUS-261674136,2018-09-15,Kenneth,M,-30.75,121.48,,,,,,,debit,posted,a4b8f39276614053bbbde4e1d4f8b928,PAYMENT,20-30,2018,9,15,15,0,Saturday,14 days,114852.464
ACC-240804743,29,115.0,10868.03,,CUS-261674136,2018-09-16,Kenneth,M,-30.75,121.48,,,,,,,debit,posted,64c97a2ab3b7475eb1ad07d5e33f8969,PAYMENT,20-30,2018,9,16,8,0,Sunday,14 days,114852.464
ACC-240804743,29,48.0,10820.03,,CUS-261674136,2018-09-16,Kenneth,M,-30.75,121.48,,,,,,,debit,posted,c4401fdaec6a4736b32a814cfa207ce2,PAYMENT,20-30,2018,9,16,20,0,Sunday,14 days,114852.464
ACC-240804743,29,43.0,15182.33,,CUS-261674136,2018-09-18,Kenneth,M,-30.75,121.48,,,,,,,debit,posted,90849be34f554a6c9f98f73eaa8dbfd4,PHONE BANK,20-30,2018,9,18,3,0,Tuesday,14 days,114852.464
ACC-240804743,29,56.0,15126.33,,CUS-261674136,2018-09-19,Kenneth,M,-30.75,121.48,,,,,,,debit,posted,f93cf0d9e3d94fb998c9db8c7c6aa3d7,PAYMENT,20-30,2018,9,19,14,0,Wednesday,14 days,114852.464
ACC-240804743,29,39.0,15087.33,,CUS-261674136,2018-09-19,Kenneth,M,-30.75,121.48,,,,,,,debit,posted,d27ec76c46a74e368f2b7ca1fb96938b,PAYMENT,20-30,2018,9,19,23,0,Wednesday,14 days,114852.464
ACC-240804743,29,48.0,15039.33,,CUS-261674136,2018-09-23,Kenneth,M,-30.75,121.48,,,,,,,debit,posted,a88eb95f839c4c899dd5006a8133fa35,PAYMENT,20-30,2018,9,23,20,0,Sunday,14 days,114852.464
ACC-240804743,29,43.0,14996.33,,CUS-261674136,2018-09-25,Kenneth,M,-30.75,121.48,,,,,,,debit,posted,e279f9e4a4e34281b9c1b854ea9087ed,PHONE BANK,20-30,2018,9,25,3,0,Tuesday,14 days,114852.464
ACC-240804743,29,56.0,14940.33,,CUS-261674136,2018-09-26,Kenneth,M,-30.75,121.48,,,,,,,debit,posted,c7a552f415a54bbeba65da2f50fa901d,PAYMENT,20-30,2018,9,26,14,0,Wednesday,14 days,114852.464
ACC-240804743,29,39.0,14901.33,,CUS-261674136,2018-09-26,Kenneth,M,-30.75,121.48,,,,,,,debit,posted,23628a2d188340d0a3189fbaeac83e5e,PAYMENT,20-30,2018,9,26,23,0,Wednesday,14 days,114852.464
ACC-240804743,29,14.0,14887.33,0.0,CUS-261674136,2018-09-27,Kenneth,M,-30.75,121.48,,c0031b2f-c40c-4c9d-be7f-7889e79e8057,-30.75,121.46,WA,Kalgoorlie,debit,authorized,120199fb606b497696e4b5a25e5fde07,POS,20-30,2018,9,27,6,3,Thursday,14 days,114852.464
ACC-240804743,29,8.27,14879.06,0.0,CUS-261674136,2018-09-27,Kenneth,M,-30.75,121.48,,bc0c2a50-9134-47da-bbab-0dd01f39fe6c,-30.75,121.47,WA,Kalgoorlie,debit,authorized,7891c7d65d054d138a1f1fa9c6f5663d,SALES-POS,20-30,2018,9,27,14,40,Thursday,14 days,114852.464
ACC-240804743,29,48.0,14831.06,,CUS-261674136,2018-09-30,Kenneth,M,-30.75,121.48,,,,,,,debit,posted,7b968982dca54a1d9e5a0d1c6c888052,PAYMENT,20-30,2018,9,30,20,0,Sunday,14 days,114852.464
ACC-240804743,29,12.54,19223.82,0.0,CUS-261674136,2018-10-01,Kenneth,M,-30.75,121.48,,8cd7c6bf-1c7d-42fe-a840-6ec0ced67fc6,-30.71,150.04,NSW,Boggabri,debit,authorized,72b637ab14664529803cd82c73e021c2,SALES-POS,20-30,2018,10,1,21,30,Monday,14 days,114852.464
ACC-240804743,29,43.0,19180.82,,CUS-261674136,2018-10-02,Kenneth,M,-30.75,121.48,,,,,,,debit,posted,9f99f941b16b4aa7adc4d0a22c6dd70e,PHONE BANK,20-30,2018,10,2,3,0,Tuesday,14 days,114852.464
ACC-240804743,29,75.0,19105.82,,CUS-261674136,2018-10-02,Kenneth,M,-30.75,121.48,,,,,,,debit,posted,3847e1b1bf094302a9725f5521f16479,PAYMENT,20-30,2018,10,2,8,0,Tuesday,14 days,114852.464
ACC-240804743,29,8.39,19097.43,1.0,CUS-261674136,2018-10-03,Kenneth,M,-30.75,121.48,,9a479b0e-cf88-4060-b7fb-030aa88f5ffd,-30.78,121.44,WA,West Kalgoorlie,debit,authorized,00da5e3e028f40eab0c6f8b4564f75e8,SALES-POS,20-30,2018,10,3,9,5,Wednesday,14 days,114852.464
ACC-240804743,29,28.15,19069.28,0.0,CUS-261674136,2018-10-03,Kenneth,M,-30.75,121.48,,14fcf842-f26d-42cd-85c0-dde0d363fae4,-30.75,121.47,WA,Kalgoorlie,debit,authorized,133b99f0625d45e19d0e4aa2b2e08b2d,POS,20-30,2018,10,3,9,20,Wednesday,14 days,114852.464
ACC-240804743,29,23.22,19046.06,1.0,CUS-261674136,2018-10-03,Kenneth,M,-30.75,121.48,,90f5265e-3a66-4aaf-9d27-4905ee61a158,-30.75,121.48,WA,Kalgoorlie,debit,authorized,2962672b3eeb48eebedd8d0cdfea131f,POS,20-30,2018,10,3,9,57,Wednesday,14 days,114852.464
ACC-240804743,29,80.68,18965.38,1.0,CUS-261674136,2018-10-03,Kenneth,M,-30.75,121.48,,b84567a3-427c-4f40-ac7d-65b10b336113,-34.43,150.89,NSW,Wollongong,debit,authorized,1a61f6f218164229b4bac3f14295de67,POS,20-30,2018,10,3,11,18,Wednesday,14 days,114852.464
ACC-240804743,29,56.0,18909.38,,CUS-261674136,2018-10-03,Kenneth,M,-30.75,121.48,,,,,,,debit,posted,277ac5f2e32441f0a2c212bbb79e3ef7,PAYMENT,20-30,2018,10,3,14,0,Wednesday,14 days,114852.464
ACC-240804743,29,16.02,18893.36,1.0,CUS-261674136,2018-10-03,Kenneth,M,-30.75,121.48,,e28c426d-cbef-4e2d-aa06-1ba0b6b1902f,-30.7,150.04,NSW,Boggabri,debit,authorized,8fa9bf86430d46638be3548328cd8976,POS,20-30,2018,10,3,16,52,Wednesday,14 days,114852.464
ACC-240804743,29,39.0,18854.36,,CUS-261674136,2018-10-03,Kenneth,M,-30.75,121.48,,,,,,,debit,posted,67158a88bf6940c38bad11b0ddaee855,PAYMENT,20-30,2018,10,3,23,0,Wednesday,14 days,114852.464
ACC-240804743,29,25.23,18829.13,1.0,CUS-261674136,2018-10-04,Kenneth,M,-30.75,121.48,,90f5265e-3a66-4aaf-9d27-4905ee61a158,-30.75,121.48,WA,Kalgoorlie,debit,authorized,0086b5d83dff493d9f05baec79a090ac,POS,20-30,2018,10,4,14,12,Thursday,14 days,114852.464
ACC-240804743,29,71.0,18758.13,,CUS-261674136,2018-10-04,Kenneth,M,-30.75,121.48,,,,,,,debit,posted,3c702e5e340b43c0904cfcb3bed4ef07,PAYMENT,20-30,2018,10,4,17,0,Thursday,14 days,114852.464
ACC-240804743,29,20.91,18737.22,1.0,CUS-261674136,2018-10-06,Kenneth,M,-30.75,121.48,,f4c25daa-db9b-4373-9d40-645cd4654f40,-33.89,151.2,NSW,Chippendale,debit,authorized,05fd5a64f34141a888185f4d6bbb187a,POS,20-30,2018,10,6,19,35,Saturday,14 days,114852.464
ACC-240804743,29,16.91,18720.31,1.0,CUS-261674136,2018-10-06,Kenneth,M,-30.75,121.48,,e28c426d-cbef-4e2d-aa06-1ba0b6b1902f,-30.7,150.04,NSW,Boggabri,debit,authorized,8c43cfde1d2d43458537ca22a37a97a6,SALES-POS,20-30,2018,10,6,23,22,Saturday,14 days,114852.464
ACC-240804743,29,19.17,18701.14,1.0,CUS-261674136,2018-10-07,Kenneth,M,-30.75,121.48,,bd7c8ead-26c3-4eda-a06e-136afa82dd1a,-30.78,121.49,WA,Boulder,debit,authorized,a3515b68ca3a4a8dbe9353f16a656171,SALES-POS,20-30,2018,10,7,12,12,Sunday,14 days,114852.464
ACC-240804743,29,48.0,18653.14,,CUS-261674136,2018-10-07,Kenneth,M,-30.75,121.48,,,,,,,debit,posted,a0f6dc390cce4cf892d39a303926615e,PAYMENT,20-30,2018,10,7,20,0,Sunday,14 days,114852.464
ACC-240804743,29,43.0,18610.14,,CUS-261674136,2018-10-09,Kenneth,M,-30.75,121.48,,,,,,,debit,posted,5b88ce9cc99b4e509b3d8658cf89c1fa,PHONE BANK,20-30,2018,10,9,3,0,Tuesday,14 days,114852.464
ACC-240804743,29,56.0,18554.14,,CUS-261674136,2018-10-10,Kenneth,M,-30.75,121.48,,,,,,,debit,posted,1484982a8430469e8c3b5f0c0b0730f2,PAYMENT,20-30,2018,10,10,14,0,Wednesday,14 days,114852.464
ACC-240804743,29,18.12,18536.02,1.0,CUS-261674136,2018-10-10,Kenneth,M,-30.75,121.48,,41aa5103-841a-4f87-8cd2-577fe3e2b269,-30.8,152.87,QLD,Loganholme,debit,authorized,cb1faf868dbc4b95a0425c10c3bcdf32,SALES-POS,20-30,2018,10,10,15,39,Wednesday,14 days,114852.464
ACC-240804743,29,39.0,18497.02,,CUS-261674136,2018-10-10,Kenneth,M,-30.75,121.48,,,,,,,debit,posted,4c749e5c674543429ecd37441f41240b,PAYMENT,20-30,2018,10,10,23,0,Wednesday,14 days,114852.464
ACC-240804743,29,17.72,18479.3,1.0,CUS-261674136,2018-10-11,Kenneth,M,-30.75,121.48,,e28c426d-cbef-4e2d-aa06-1ba0b6b1902f,-30.7,150.04,NSW,Boggabri,debit,authorized,8b428b0eccc940ae9836a5a7815ab034,POS,20-30,2018,10,11,8,4,Thursday,14 days,114852.464
ACC-240804743,29,18.01,18461.29,0.0,CUS-261674136,2018-10-11,Kenneth,M,-30.75,121.48,,e28c426d-cbef-4e2d-aa06-1ba0b6b1902f,-30.7,150.04,NSW,Boggabri,debit,authorized,0cd0d8c965114c5fbbea63b8a2298eb8,POS,20-30,2018,10,11,16,21,Thursday,14 days,114852.464
ACC-240804743,29,9.27,18452.02,1.0,CUS-261674136,2018-10-14,Kenneth,M,-30.75,121.48,,8405c9b6-d3ad-4d9a-b69c-db9482cbb3a9,-30.78,121.49,WA,Boulder,debit,authorized,3820fdfcc8ad48bf9732c3016a6b54a5,POS,20-30,2018,10,14,14,40,Sunday,14 days,114852.464
ACC-240804743,29,15.1,18436.92,0.0,CUS-261674136,2018-10-14,Kenneth,M,-30.75,121.48,,8281a040-04b5-47a5-941e-7152f50a6af6,-30.71,152.92,NSW,Macksville,debit,authorized,b07e3db1fa184afd9bbdb9f2a8ab7e6a,POS,20-30,2018,10,14,15,50,Sunday,14 days,114852.464
ACC-240804743,29,48.0,18388.92,,CUS-261674136,2018-10-14,Kenneth,M,-30.75,121.48,,,,,,,debit,posted,370ad2ce760b497082a46b9cac5b9303,PAYMENT,20-30,2018,10,14,20,0,Sunday,14 days,114852.464
ACC-240804743,29,9.29,18379.63,1.0,CUS-261674136,2018-10-15,Kenneth,M,-30.75,121.48,,30d360f5-0df8-4949-997a-9ee51f7b9613,-30.76,121.46,WA,Somerville,debit,authorized,f93736301baf422486f0f8f6d4f97581,POS,20-30,2018,10,15,9,5,Monday,14 days,114852.464
ACC-240804743,29,15.8,22769.13,1.0,CUS-261674136,2018-10-15,Kenneth,M,-30.75,121.48,,41aa5103-841a-4f87-8cd2-577fe3e2b269,-30.8,152.87,QLD,Loganholme,debit,authorized,eb316e08583f45e69184ab56d75d2c38,SALES-POS,20-30,2018,10,15,12,42,Monday,14 days,114852.464
ACC-240804743,29,138.0,22631.13,,CUS-261674136,2018-10-15,Kenneth,M,-30.75,121.48,,,,,,,debit,posted,003399de814e402386fe44d0e2b9ec26,PAYMENT,20-30,2018,10,15,15,0,Monday,14 days,114852.464
ACC-240804743,29,34.01,22597.12,1.0,CUS-261674136,2018-10-15,Kenneth,M,-30.75,121.48,,a0af2fdd-0f45-49a8-8426-50d7ff53146c,-33.76,151.26,NSW,Brookvale,debit,authorized,f717a345afcc498082cc5e40bb99307c,POS,20-30,2018,10,15,18,5,Monday,14 days,114852.464
ACC-240804743,29,63.02,22534.1,1.0,CUS-261674136,2018-10-16,Kenneth,M,-30.75,121.48,,e973fecc-5b2c-4ad1-91e3-fc6b6ace8022,-30.75,121.47,WA,Kalgoorlie,debit,authorized,f59e472d143a4df3a004e189f77b1574,SALES-POS,20-30,2018,10,16,1,53,Tuesday,14 days,114852.464
ACC-240804743,29,43.0,22491.1,,CUS-261674136,2018-10-16,Kenneth,M,-30.75,121.48,,,,,,,debit,posted,c7f8e8d2c027452ea3f73ffe9d5a2c9a,PHONE BANK,20-30,2018,10,16,3,0,Tuesday,14 days,114852.464
ACC-240804743,29,115.0,22376.1,,CUS-261674136,2018-10-16,Kenneth,M,-30.75,121.48,,,,,,,debit,posted,a99e88d05495496884b09e0e59af66ad,PAYMENT,20-30,2018,10,16,8,0,Tuesday,14 days,114852.464
ACC-240804743,29,18.02,22358.08,1.0,CUS-261674136,2018-10-16,Kenneth,M,-30.75,121.48,,3505551c-2dfe-41a4-9c7b-d36bd70ea869,-37.9,145.09,VIC,Oakleigh,debit,authorized,a05eaa3d560f4c80a90c6cac2710c587,SALES-POS,20-30,2018,10,16,17,50,Tuesday,14 days,114852.464
ACC-240804743,29,42.65,22315.43,1.0,CUS-261674136,2018-10-16,Kenneth,M,-30.75,121.48,,04f1f4ef-1ffa-4038-9ff2-e2924bdd6efb,-27.98,153.34,QLD,Ashmore,debit,authorized,60dfb23e147649759e6300c693a84828,SALES-POS,20-30,2018,10,16,19,6,Tuesday,14 days,114852.464
ACC-240804743,29,18.12,22297.31,0.0,CUS-261674136,2018-10-17,Kenneth,M,-30.75,121.48,,e28c426d-cbef-4e2d-aa06-1ba0b6b1902f,-30.7,150.04,NSW,Boggabri,debit,authorized,68c66d2530b145a8b2d7dc6c93074321,SALES-POS,20-30,2018,10,17,8,26,Wednesday,14 days,114852.464
ACC-240804743,29,19.82,22277.49,1.0,CUS-261674136,2018-10-17,Kenneth,M,-30.75,121.48,,ea74dd90-6681-4d97-bb41-7bf308fa6388,-27.46,153.03,QLD,Brisbane City,debit,authorized,f874f6a2ce4f462ca308b13efc02278f,SALES-POS,20-30,2018,10,17,10,12,Wednesday,14 days,114852.464
ACC-240804743,29,56.0,22215.45,,CUS-261674136,2018-10-17,Kenneth,M,-30.75,121.48,,,,,,,debit,posted,9e064fd8cd994e9996a8ce7561816a91,PAYMENT,20-30,2018,10,17,14,0,Wednesday,14 days,114852.464
ACC-240804743,29,6.04,22271.45,1.0,CUS-261674136,2018-10-17,Kenneth,M,-30.75,121.48,,ba23d4fd-81e8-4850-8e24-412e2e985541,-35.32,149.18,ACT,Fyshwick,debit,authorized,8e68806654544721ba70334c79d5fe7e,POS,20-30,2018,10,17,14,17,Wednesday,14 days,114852.464
ACC-240804743,29,39.0,22176.45,,CUS-261674136,2018-10-17,Kenneth,M,-30.75,121.48,,,,,,,debit,posted,73c1349b59724a0fa52590fd2924e475,PAYMENT,20-30,2018,10,17,23,0,Wednesday,14 days,114852.464
ACC-240804743,29,26.1,22150.35,1.0,CUS-261674136,2018-10-18,Kenneth,M,-30.75,121.48,,8cd6e1d8-7197-416b-bfbc-b621fb041d71,-30.66,152.99,NSW,Nambucca Heads,debit,authorized,4963ff588dc74b7e9726483c6f15d1db,POS,20-30,2018,10,18,13,39,Thursday,14 days,114852.464
ACC-240804743,29,123.41,22026.94,1.0,CUS-261674136,2018-10-20,Kenneth,M,-30.75,121.48,,ab835c75-1a73-45bf-8b06-40c4f53a1105,-33.87,151.21,NSW,Sydney,debit,authorized,4a561bff15744172b678fc9b3c5a7877,POS,20-30,2018,10,20,4,23,Saturday,14 days,114852.464
ACC-240804743,29,8.33,22018.61,1.0,CUS-261674136,2018-10-20,Kenneth,M,-30.75,121.48,,30d360f5-0df8-4949-997a-9ee51f7b9613,-30.76,121.46,WA,Somerville,debit,authorized,dcdb8d3f4f6a47a79215bb6c8bd970f1,POS,20-30,2018,10,20,6,19,Saturday,14 days,114852.464
ACC-240804743,29,17.69,22000.92,1.0,CUS-261674136,2018-10-20,Kenneth,M,-30.75,121.48,,1b687605-2f01-43e0-84f2-297f3dd86f53,-30.77,121.48,WA,Boulder,debit,authorized,39ea56011052484a98fefdc8e2baa1e2,POS,20-30,2018,10,20,9,16,Saturday,14 days,114852.464
ACC-240804743,29,19.88,21981.04,0.0,CUS-261674136,2018-10-20,Kenneth,M,-30.75,121.48,,c777afde-ae7d-43c4-9490-cb7e497fb790,-30.75,121.47,WA,Kalgoorlie,debit,authorized,e5091fa737d74206909cd04534a8b51a,POS,20-30,2018,10,20,13,5,Saturday,14 days,114852.464
ACC-240804743,29,18.24,21962.8,1.0,CUS-261674136,2018-10-20,Kenneth,M,-30.75,121.48,,41aa5103-841a-4f87-8cd2-577fe3e2b269,-30.8,152.87,QLD,Loganholme,debit,authorized,fc39f77ddd144680af7ad4a981acb77a,POS,20-30,2018,10,20,21,45,Saturday,14 days,114852.464
ACC-240804743,29,16.89,21945.91,0.0,CUS-261674136,2018-10-20,Kenneth,M,-30.75,121.48,,e28c426d-cbef-4e2d-aa06-1ba0b6b1902f,-30.7,150.04,NSW,Boggabri,debit,authorized,c088bc03684242db993889e5fc773ddb,SALES-POS,20-30,2018,10,20,21,49,Saturday,14 days,114852.464
ACC-240804743,29,48.0,21897.91,,CUS-261674136,2018-10-21,Kenneth,M,-30.75,121.48,,,,,,,debit,posted,39d8acf98c1f4f3ca9ef65d68d3c2cbe,PAYMENT,20-30,2018,10,21,20,0,Sunday,14 days,114852.464
ACC-240804743,29,1038.32,20859.59,0.0,CUS-261674136,2018-10-22,Kenneth,M,-30.75,121.48,,d17bf82c-2b7c-4def-afa0-56c15b9aa8a3,-33.86,151.21,NSW,Sydney,debit,authorized,be3effe674074c4a91563f26033517f9,SALES-POS,20-30,2018,10,22,21,4,Monday,14 days,114852.464
ACC-240804743,29,43.0,20816.59,,CUS-261674136,2018-10-23,Kenneth,M,-30.75,121.48,,,,,,,debit,posted,bf0e01ba11e845a9849878e246e0eecd,PHONE BANK,20-30,2018,10,23,3,0,Tuesday,14 days,114852.464
ACC-240804743,29,14.96,20801.63,1.0,CUS-261674136,2018-10-23,Kenneth,M,-30.75,121.48,,efbb9b50-63af-4660-bb5c-37e05fca9f3f,-27.12,152.95,QLD,Morayfield,debit,authorized,60c4d11f6b3f4e41944d7deae4f04953,POS,20-30,2018,10,23,11,4,Tuesday,14 days,114852.464
ACC-240804743,29,8.13,20793.5,1.0,CUS-261674136,2018-10-24,Kenneth,M,-30.75,121.48,,bc0c2a50-9134-47da-bbab-0dd01f39fe6c,-30.75,121.47,WA,Kalgoorlie,debit,authorized,7d04220ee9f84696a5b2fc98b05d1741,POS,20-30,2018,10,24,0,12,Wednesday,14 days,114852.464
ACC-240804743,29,56.0,20737.5,,CUS-261674136,2018-10-24,Kenneth,M,-30.75,121.48,,,,,,,debit,posted,7b9dd5c186d34d6cb6183feb7786e288,PAYMENT,20-30,2018,10,24,14,0,Wednesday,14 days,114852.464
ACC-240804743,29,39.0,20698.5,,CUS-261674136,2018-10-24,Kenneth,M,-30.75,121.48,,,,,,,debit,posted,8b65d7c55ced476fabedd23b8191e3a7,PAYMENT,20-30,2018,10,24,23,0,Wednesday,14 days,114852.464
ACC-240804743,29,6.11,20692.39,0.0,CUS-261674136,2018-10-25,Kenneth,M,-30.75,121.48,,30d360f5-0df8-4949-997a-9ee51f7b9613,-30.76,121.46,WA,Somerville,debit,authorized,1e432db8fbb84f08b7f6be7fc9f6a678,SALES-POS,20-30,2018,10,25,11,50,Thursday,14 days,114852.464
ACC-240804743,29,34.07,20658.32,0.0,CUS-261674136,2018-10-26,Kenneth,M,-30.75,121.48,,0772f158-8ebc-4fc6-bedd-7146a68a3219,-30.75,121.47,WA,Kalgoorlie,debit,authorized,b261d4ee83c54d959722559a690fa85a,SALES-POS,20-30,2018,10,26,9,11,Friday,14 days,114852.464
ACC-240804743,29,16.08,20642.24,1.0,CUS-261674136,2018-10-26,Kenneth,M,-30.75,121.48,,e28c426d-cbef-4e2d-aa06-1ba0b6b1902f,-30.7,150.04,NSW,Boggabri,debit,authorized,a99ad902b94941c8be6ff19a64956c5c,POS,20-30,2018,10,26,21,27,Friday,14 days,114852.464
ACC-240804743,29,37.22,20605.02,0.0,CUS-261674136,2018-10-28,Kenneth,M,-30.75,121.48,,404684ec-68bb-4c3c-89ba-1d57c607ca32,-30.74,121.47,WA,Piccadilly,debit,authorized,5943c735bf284215ae899847a49d72c5,SALES-POS,20-30,2018,10,28,2,34,Sunday,14 days,114852.464
ACC-240804743,29,48.0,20557.02,,CUS-261674136,2018-10-28,Kenneth,M,-30.75,121.48,,,,,,,debit,posted,a57640bdcee1461ba14ca1a0de950a6f,PAYMENT,20-30,2018,10,28,20,0,Sunday,14 days,114852.464
ACC-240804743,29,16.93,20540.09,1.0,CUS-261674136,2018-10-29,Kenneth,M,-30.75,121.48,,e28c426d-cbef-4e2d-aa06-1ba0b6b1902f,-30.7,150.04,NSW,Boggabri,debit,authorized,c1177cb9ea7744f4872d91d0500f1b0b,SALES-POS,20-30,2018,10,29,8,23,Monday,14 days,114852.464
ACC-240804743,29,15.4,20524.69,1.0,CUS-261674136,2018-10-29,Kenneth,M,-30.75,121.48,,15f95e2b-b264-42da-843b-bde7a0d9c62a,-34.83,138.69,SA,Modbury,debit,authorized,c8f8373eb2a14cc0afabad019c5619b5,POS,20-30,2018,10,29,9,41,Monday,14 days,114852.464
ACC-240804743,29,43.0,24886.99,,CUS-261674136,2018-10-30,Kenneth,M,-30.75,121.48,,,,,,,debit,posted,db9abbbe8d214174b79ff65ca421b0da,PHONE BANK,20-30,2018,10,30,3,0,Tuesday,14 days,114852.464
ACC-240804743,29,16.33,24870.66,1.0,CUS-261674136,2018-10-30,Kenneth,M,-30.75,121.48,,e28c426d-cbef-4e2d-aa06-1ba0b6b1902f,-30.7,150.04,NSW,Boggabri,debit,authorized,02eb25c2447d4287bc5f62950f63130c,SALES-POS,20-30,2018,10,30,21,27,Tuesday,14 days,114852.464
ACC-240804743,29,56.0,24814.66,,CUS-261674136,2018-10-31,Kenneth,M,-30.75,121.48,,,,,,,debit,posted,1e4115fe5c8f4f74be8f9ddcd4ab3e8d,PAYMENT,20-30,2018,10,31,14,0,Wednesday,14 days,114852.464
ACC-240804743,29,39.0,24775.66,,CUS-261674136,2018-10-31,Kenneth,M,-30.75,121.48,,,,,,,debit,posted,c7bc398b9eb04e73933dc6d5a7beae0b,PAYMENT,20-30,2018,10,31,23,0,Wednesday,14 days,114852.464
ACC-2528867619,40,42.66,1913.92,1.0,CUS-2505971401,2018-08-08,Abigail,F,-34.96,138.58,,ea247b5c-61ee-4106-988f-84c3036ce5e0,-34.92,150.6,NSW,South Nowra,debit,authorized,a916b60869c94bc69e95e212d4581718,SALES-POS,30-40,2018,8,8,4,38,Wednesday,7 days,101499.721
ACC-2528867619,40,18.68,1895.24,1.0,CUS-2505971401,2018-08-08,Abigail,F,-34.96,138.58,,8927cdaf-73bc-49c2-ad75-0ebfbe983053,-34.84,148.91,NSW,Yass,debit,authorized,34ccea941f844b94be7aa894a14e6e8c,SALES-POS,30-40,2018,8,8,8,49,Wednesday,7 days,101499.721
ACC-2528867619,40,45.02,1850.22,1.0,CUS-2505971401,2018-08-08,Abigail,F,-34.96,138.58,,d47efc0a-2443-47d0-ad6b-4379779d2e3e,-35.03,117.89,WA,Albany,debit,authorized,62439234cc7748d787db7678cd886c70,POS,30-40,2018,8,8,17,29,Wednesday,7 days,101499.721
ACC-2528867619,40,19.96,1830.26,1.0,CUS-2505971401,2018-08-08,Abigail,F,-34.96,138.58,,21960650-c56e-4411-bc06-56e9964daf8e,-34.89,138.56,SA,Allenby Gardens,debit,authorized,a6b80b62044441dca4ad8c94a108cfe6,POS,30-40,2018,8,8,21,40,Wednesday,7 days,101499.721
ACC-2528867619,40,76.0,1754.26,,CUS-2505971401,2018-08-09,Abigail,F,-34.96,138.58,,,,,,,debit,posted,947184c7f3eb47c8895a6b78c4e68358,INTER BANK,30-40,2018,8,9,3,0,Thursday,7 days,101499.721
ACC-2528867619,40,18.88,1735.38,1.0,CUS-2505971401,2018-08-09,Abigail,F,-34.96,138.58,,b327cceb-f5ec-40d2-be18-d7315f2b8f54,-34.76,138.64,SA,Salisbury,debit,authorized,7d53d44b6b5045efb24dc2eb3584f554,POS,30-40,2018,8,9,15,31,Thursday,7 days,101499.721
ACC-2528867619,40,35.7,1699.68,1.0,CUS-2505971401,2018-08-09,Abigail,F,-34.96,138.58,,2a1bebdc-3f02-4cce-a261-81a8010a93fc,-34.83,138.69,SA,Modbury,debit,authorized,2966394a3e684adf95f9d205077200d5,POS,30-40,2018,8,9,17,30,Thursday,7 days,101499.721
ACC-2528867619,40,80.0,1619.68,,CUS-2505971401,2018-08-10,Abigail,F,-34.96,138.58,,,,,,,debit,posted,32227bc9ed8e4f9ab8f0e4244976dd31,PAYMENT,30-40,2018,8,10,10,0,Friday,7 days,101499.721
ACC-2528867619,40,17.12,3549.13,0.0,CUS-2505971401,2018-08-11,Abigail,F,-34.96,138.58,,a722d174-679d-43b2-beb3-926e781a8cd1,-34.88,150.6,NSW,Nowra,debit,authorized,cb476a06dafb4379972a9110da27b80d,POS,30-40,2018,8,11,13,56,Saturday,7 days,101499.721
ACC-2528867619,40,12.52,3536.61,1.0,CUS-2505971401,2018-08-11,Abigail,F,-34.96,138.58,,418f3602-0122-49c7-b9b2-66f77ad5bed2,-34.88,150.6,NSW,Nowra,debit,authorized,e708b00c82424c5d994eae8e9496e45d,POS,30-40,2018,8,11,17,19,Saturday,7 days,101499.721
ACC-2528867619,40,16.19,3520.42,1.0,CUS-2505971401,2018-08-11,Abigail,F,-34.96,138.58,,9963311e-cb2a-4460-b155-826503cc2cee,-34.92,150.61,NSW,South Nowra,debit,authorized,0f4e5a2e903f44d3a9739e4302601794,POS,30-40,2018,8,11,21,43,Saturday,7 days,101499.721
ACC-2528867619,40,26.84,3493.58,1.0,CUS-2505971401,2018-08-12,Abigail,F,-34.96,138.58,,0a0b9723-63c1-4ac5-b679-7299fa3758bb,-35.03,117.88,WA,Albany,debit,authorized,b0e11a77d58c4147a316d5261ca9e273,SALES-POS,30-40,2018,8,12,20,9,Sunday,7 days,101499.721
ACC-2528867619,40,25.98,3467.6,1.0,CUS-2505971401,2018-08-12,Abigail,F,-34.96,138.58,,10a1d7f0-edd5-44db-b1df-26120c3fbb04,-35.18,149.13,ACT,Gungahlin,debit,authorized,ac0356567534496092a938db0d8b7892,POS,30-40,2018,8,12,20,26,Sunday,7 days,101499.721
ACC-2528867619,40,196.0,3271.6,,CUS-2505971401,2018-08-13,Abigail,F,-34.96,138.58,,,,,,,debit,posted,7e695a563e4948e6bb979e9427c6f526,PAYMENT,30-40,2018,8,13,12,0,Monday,7 days,101499.721
ACC-2528867619,40,6.05,3265.55,1.0,CUS-2505971401,2018-08-14,Abigail,F,-34.96,138.58,,22641e3c-8ec3-4703-b34e-32626d61c4f1,-34.97,138.59,SA,Cumberland Park,debit,authorized,909c0b84f5584ee9ab1e4e78b7291111,SALES-POS,30-40,2018,8,14,18,28,Tuesday,7 days,101499.721
ACC-2528867619,40,18.9,3246.65,1.0,CUS-2505971401,2018-08-15,Abigail,F,-34.96,138.58,,ef9d0697-ac13-46b3-bc0d-4859d0ba7504,-34.97,138.61,SA,Mitcham,debit,authorized,db92b251c1ee4592b8fe8d317089246b,SALES-POS,30-40,2018,8,15,8,4,Wednesday,7 days,101499.721
ACC-2528867619,40,80.82,3165.83,1.0,CUS-2505971401,2018-08-15,Abigail,F,-34.96,138.58,,a9628aa8-2286-4201-88f6-28f2ae0c12b0,-35.01,138.74,SA,Aldgate,debit,authorized,65f3bfb675694f44b45689b8a528e82d,SALES-POS,30-40,2018,8,15,18,31,Wednesday,7 days,101499.721
ACC-2528867619,40,6.05,3159.78,0.0,CUS-2505971401,2018-08-15,Abigail,F,-34.96,138.58,,bf78c4a2-a256-4e77-a17d-e889a47ac204,-35.22,138.54,SA,Mclaren Vale,debit,authorized,5af01fa3cd964906b4e024991c470887,SALES-POS,30-40,2018,8,15,22,49,Wednesday,7 days,101499.721
ACC-2528867619,40,73.0,5002.31,,CUS-2505971401,2018-08-19,Abigail,F,-34.96,138.58,,,,,,,debit,posted,7f8ebc47c3fc49c5b78f880f5ca18043,PAYMENT,30-40,2018,8,19,18,0,Sunday,7 days,101499.721
ACC-2528867619,40,39.14,4963.17,0.0,CUS-2505971401,2018-08-19,Abigail,F,-34.96,138.58,,3f182df8-9373-4415-8826-11ab9cebae7a,-34.84,138.54,SA,Wingfield,debit,authorized,6b71e98559804299aeb789fee9e052f5,SALES-POS,30-40,2018,8,19,23,39,Sunday,7 days,101499.721
ACC-2528867619,40,116.0,4847.17,,CUS-2505971401,2018-08-21,Abigail,F,-34.96,138.58,,,,,,,debit,posted,e949f17430b44503aec6c7fbf7b229b7,PAYMENT,30-40,2018,8,21,7,0,Tuesday,7 days,101499.721
ACC-2528867619,40,82.0,4765.17,,CUS-2505971401,2018-08-22,Abigail,F,-34.96,138.58,,,,,,,debit,posted,2704ad14527e455c8f3cdb063d219d15,PAYMENT,30-40,2018,8,22,8,0,Wednesday,7 days,101499.721
ACC-2528867619,40,92.0,6619.74,,CUS-2505971401,2018-08-28,Abigail,F,-34.96,138.58,,,,,,,debit,posted,b31c4a89b4624870931cd623328125f4,PAYMENT,30-40,2018,8,28,20,0,Tuesday,7 days,101499.721
ACC-2528867619,40,33.88,6585.86,1.0,CUS-2505971401,2018-08-30,Abigail,F,-34.96,138.58,,8f49e7a9-c5ca-4c7a-81dc-911ec5e52ba6,-37.71,145.15,VIC,Ringwood,debit,authorized,c92b19ddce8743eab39cfd254cdb9a63,POS,30-40,2018,8,30,16,2,Thursday,7 days,101499.721
ACC-2528867619,40,134.45,8397.98,0.0,CUS-2505971401,2018-09-02,Abigail,F,-34.96,138.58,,2013fab2-4c62-4f96-8199-22db61f0d0ed,-33.82,151.01,NSW,Parramatta,debit,authorized,6bab267cc9e545aa847c6ad1edc5626a,SALES-POS,30-40,2018,9,2,21,59,Sunday,7 days,101499.721
ACC-2528867619,40,18.31,8379.67,1.0,CUS-2505971401,2018-09-03,Abigail,F,-34.96,138.58,,ab2d9fe5-e435-4c50-a839-3604df4c0def,-34.82,138.66,SA,Para Vista,debit,authorized,bc3bd5c20fed48c7bfd917355059dde0,POS,30-40,2018,9,3,7,41,Monday,7 days,101499.721
ACC-2528867619,40,11.95,8367.72,1.0,CUS-2505971401,2018-09-06,Abigail,F,-34.96,138.58,,e29e8e7a-547a-4d21-8dc3-035874552879,-34.93,138.61,SA,Adelaide,debit,authorized,9264d2a0a5c647a482e80b38fe006861,POS,30-40,2018,9,6,9,39,Thursday,7 days,101499.721
ACC-2528867619,40,91.94,8275.78,1.0,CUS-2505971401,2018-09-06,Abigail,F,-34.96,138.58,,a1506bc9-8acb-449d-840f-de8c2566d81f,-34.92,138.6,SA,Adelaide,debit,authorized,15a334fc858746be92c480fcfddf3d50,POS,30-40,2018,9,6,10,22,Thursday,7 days,101499.721
ACC-2528867619,40,20.45,8255.33,1.0,CUS-2505971401,2018-09-07,Abigail,F,-34.96,138.58,,7a2ee63d-876e-4b9f-aee3-07e3215ebdd6,-35.04,150.67,NSW,Huskisson,debit,authorized,63c43f350bd04a97aadf56713b3a6216,SALES-POS,30-40,2018,9,7,11,13,Friday,7 days,101499.721
ACC-2528867619,40,124.92,10076.98,1.0,CUS-2505971401,2018-09-07,Abigail,F,-34.96,138.58,,1ba5132e-e112-4048-9313-a8af0efeedec,-42.88,147.33,TAS,Hobart,debit,authorized,843130b813534b49a3a68ecd2756d8c2,SALES-POS,30-40,2018,9,7,22,8,Friday,7 days,101499.721
ACC-2528867619,40,40.0,10036.98,1.0,CUS-2505971401,2018-09-08,Abigail,F,-34.96,138.58,,98d84458-4f19-4d80-8063-09cedccf81f8,-34.74,150.77,NSW,Broughton Village,debit,authorized,50282a5051574af7904776b578ce02f0,SALES-POS,30-40,2018,9,8,8,19,Saturday,7 days,101499.721
ACC-2528867619,40,76.0,9960.98,,CUS-2505971401,2018-09-09,Abigail,F,-34.96,138.58,,,,,,,debit,posted,e54f4282efd848d0b8da05f8d35654c6,INTER BANK,30-40,2018,9,9,3,0,Sunday,7 days,101499.721
ACC-2528867619,40,24.94,9936.04,1.0,CUS-2505971401,2018-09-09,Abigail,F,-34.96,138.58,,688f472b-2e44-4c9a-aba6-ec6b9567dc89,-35.3,149.13,ACT,Parkes,debit,authorized,eec60016a1624ac9ab33620574045306,POS,30-40,2018,9,9,9,2,Sunday,7 days,101499.721
ACC-2528867619,40,10.14,9925.9,1.0,CUS-2505971401,2018-09-09,Abigail,F,-34.96,138.58,,09561fb4-4930-4463-bcb5-d2f06804548a,-34.92,138.59,SA,Adelaide,debit,authorized,dea7d9ef116b458dbc11332dc44a4b24,POS,30-40,2018,9,9,9,51,Sunday,7 days,101499.721
ACC-2528867619,40,80.0,9845.9,,CUS-2505971401,2018-09-10,Abigail,F,-34.96,138.58,,,,,,,debit,posted,f27b0e73ecee4fb9aee8dfffd2484dd1,PAYMENT,30-40,2018,9,10,10,0,Monday,7 days,101499.721
ACC-2528867619,40,29.6,9816.3,0.0,CUS-2505971401,2018-09-12,Abigail,F,-34.96,138.58,,39d8e31d-aa6c-443e-b9de-9f0031c33578,-33.86,151.19,NSW,Pyrmont,debit,authorized,8973be5e464e4acba843ea03bafa1f43,POS,30-40,2018,9,12,9,13,Wednesday,7 days,101499.721
ACC-2528867619,40,29.92,9786.38,1.0,CUS-2505971401,2018-09-12,Abigail,F,-34.96,138.58,,412dd7cb-04ba-4b6f-bfd7-5d97e1ae55d6,-34.79,138.61,SA,Parafield Gardens,debit,authorized,bc98d79254d548ebaeb32e0d6d5a8c7d,POS,30-40,2018,9,12,14,3,Wednesday,7 days,101499.721
ACC-2528867619,40,10.59,9775.79,1.0,CUS-2505971401,2018-09-12,Abigail,F,-34.96,138.58,,2bb1c6ed-d7d8-4086-acb5-59ab88e6eefd,-34.98,138.54,SA,Glenelg East,debit,authorized,88440e2926bb433db9b6b65ec549274b,SALES-POS,30-40,2018,9,12,15,14,Wednesday,7 days,101499.721
ACC-2528867619,40,196.0,9579.79,,CUS-2505971401,2018-09-13,Abigail,F,-34.96,138.58,,,,,,,debit,posted,c5c221e4759e4daf97d0bbbb3d3d215f,PAYMENT,30-40,2018,9,13,12,0,Thursday,7 days,101499.721
ACC-2528867619,40,23.5,11502.86,0.0,CUS-2505971401,2018-09-14,Abigail,F,-34.96,138.58,,f01cc8b4-1328-4501-8958-21e97b518510,-35.01,117.87,WA,Mount Melville,debit,authorized,5cf4cdcf60ec423caef01f156204b435,POS,30-40,2018,9,14,21,33,Friday,7 days,101499.721
ACC-2528867619,40,16.0,11486.86,1.0,CUS-2505971401,2018-09-15,Abigail,F,-34.96,138.58,,fbf92758-f678-4bdb-81fa-efe7f8643d6b,-34.91,138.6,SA,North Adelaide,debit,authorized,b20f83de23324dfe94d5b4546164e0dc,POS,30-40,2018,9,15,2,11,Saturday,7 days,101499.721
ACC-2528867619,40,73.0,11413.86,,CUS-2505971401,2018-09-19,Abigail,F,-34.96,138.58,,,,,,,debit,posted,5c36f0f54a314a44b391c8f09136f655,PAYMENT,30-40,2018,9,19,18,0,Wednesday,7 days,101499.721
ACC-2528867619,40,7.36,11406.5,0.0,CUS-2505971401,2018-09-20,Abigail,F,-34.96,138.58,,0e3bac29-6ad3-4efe-8843-019a88b23007,-35.12,147.36,NSW,Wagga Wagga,debit,authorized,05374657b6bd412f8f27dec0fed12ea1,POS,30-40,2018,9,20,8,57,Thursday,7 days,101499.721
ACC-2528867619,40,17.61,11388.89,1.0,CUS-2505971401,2018-09-20,Abigail,F,-34.96,138.58,,9a658f0a-e753-4367-befe-950ff80f40af,-35.08,148.09,NSW,Gundagai,debit,authorized,fa2ef8a5b55145d0b4d9001d47acff38,SALES-POS,30-40,2018,9,20,9,3,Thursday,7 days,101499.721
ACC-2528867619,40,10.48,11378.41,1.0,CUS-2505971401,2018-09-20,Abigail,F,-34.96,138.58,,5649ea7f-a589-49e7-b3d3-9724eb67cae2,-34.93,138.6,SA,Adelaide,debit,authorized,1735fa2212204214850da98282592d71,POS,30-40,2018,9,20,21,33,Thursday,7 days,101499.721
ACC-2528867619,40,116.0,11262.41,,CUS-2505971401,2018-09-21,Abigail,F,-34.96,138.58,,,,,,,debit,posted,e65ee497953f4bab9601b9fb785e7d55,PAYMENT,30-40,2018,9,21,7,0,Friday,7 days,101499.721
ACC-2528867619,40,20.47,11241.94,1.0,CUS-2505971401,2018-09-21,Abigail,F,-34.96,138.58,,6d5a36a7-9f83-40c2-94b9-4fb9e5f2dc23,-35.32,149.18,ACT,Fyshwick,debit,authorized,35e7241c35be4789bdc93339d2746f11,POS,30-40,2018,9,21,8,11,Friday,7 days,101499.721
ACC-2528867619,40,9.34,11232.6,0.0,CUS-2505971401,2018-09-21,Abigail,F,-34.96,138.58,,fd81629c-a33b-4221-8caf-a9caf6691787,-34.83,138.69,SA,Modbury,debit,authorized,65c76a5adfac424ba93bcf8e79f29c4f,SALES-POS,30-40,2018,9,21,11,43,Friday,7 days,101499.721
ACC-2528867619,40,64.97,13114.2,1.0,CUS-2505971401,2018-09-22,Abigail,F,-34.96,138.58,,02dc8434-5ba7-40ee-b1c5-5771560e0c1d,-34.87,150.59,NSW,Nowra North,debit,authorized,a6c87436e3064e09a3295f8eb705f633,POS,30-40,2018,9,22,4,41,Saturday,7 days,101499.721
ACC-2528867619,40,82.0,13032.2,,CUS-2505971401,2018-09-22,Abigail,F,-34.96,138.58,,,,,,,debit,posted,8bd111c565cd447791a933ee30bf73d0,PAYMENT,30-40,2018,9,22,8,0,Saturday,7 days,101499.721
ACC-2528867619,40,14.7,13017.5,0.0,CUS-2505971401,2018-09-22,Abigail,F,-34.96,138.58,,af80e38b-8bb8-4f42-b72d-8bde88500420,-34.92,117.23,WA,Denmark,debit,authorized,21775303ab82441782044c6bed5b7bbb,POS,30-40,2018,9,22,23,37,Saturday,7 days,101499.721
ACC-2528867619,40,45.92,12971.58,1.0,CUS-2505971401,2018-09-23,Abigail,F,-34.96,138.58,,ea247b5c-61ee-4106-988f-84c3036ce5e0,-34.92,150.6,NSW,South Nowra,debit,authorized,cc604a59e4354f33aa38e1c371fdd4d6,SALES-POS,30-40,2018,9,23,4,34,Sunday,7 days,101499.721
ACC-2528867619,40,44.1,12927.48,1.0,CUS-2505971401,2018-09-24,Abigail,F,-34.96,138.58,,8e6dd0ca-2a83-4881-9c93-6385cc287978,-35.12,147.37,NSW,Wagga Wagga,debit,authorized,aef01af7a1044492a8814daad82912e3,POS,30-40,2018,9,24,12,39,Monday,7 days,101499.721
ACC-2528867619,40,92.0,14782.05,,CUS-2505971401,2018-09-28,Abigail,F,-34.96,138.58,,,,,,,debit,posted,662b2bc483d54e7b892b3364e9fa602f,PAYMENT,30-40,2018,9,28,20,0,Friday,7 days,101499.721
ACC-2528867619,40,73.53,14708.52,1.0,CUS-2505971401,2018-10-04,Abigail,F,-34.96,138.58,,47fc49e8-5a7f-418e-8753-399439f09a57,-35.34,149.18,ACT,Fyshwick,debit,authorized,604d12ba718649ea88ba7afa25483058,POS,30-40,2018,10,4,23,54,Thursday,7 days,101499.721
ACC-2528867619,40,25.63,14682.89,1.0,CUS-2505971401,2018-10-05,Abigail,F,-34.96,138.58,,60e25947-c418-4213-afd2-e6c00ebf6a87,-35.02,117.89,WA,Centennial Park,debit,authorized,3f1566915b4a47f4a5ae67655ee865ee,SALES-POS,30-40,2018,10,5,11,47,Friday,7 days,101499.721
ACC-2528867619,40,111.34,16518.12,0.0,CUS-2505971401,2018-10-05,Abigail,F,-34.96,138.58,,9d51aada-0f7e-4664-aa5d-6119a888f759,-33.87,151.21,NSW,Sydney,debit,authorized,be240e100d5449bfa12ad07cb1688dbd,POS,30-40,2018,10,5,14,44,Friday,7 days,101499.721
ACC-2528867619,40,94.76,16423.36,1.0,CUS-2505971401,2018-10-05,Abigail,F,-34.96,138.58,,c0b0ca9e-ba47-4673-b8b2-ee44da6967f0,-34.95,138.6,SA,Goodwood,debit,authorized,794e68afd46949979eb91e55eb84f521,SALES-POS,30-40,2018,10,5,18,28,Friday,7 days,101499.721
ACC-2528867619,40,31.51,16391.85,1.0,CUS-2505971401,2018-10-05,Abigail,F,-34.96,138.58,,ab523591-340e-4293-ae1e-da2cb9d08dd4,-35.02,117.89,WA,Mira Mar,debit,authorized,7b23aff5e56048a8abcf65b171eb33bd,SALES-POS,30-40,2018,10,5,21,45,Friday,7 days,101499.721
ACC-2528867619,40,8.71,16383.14,1.0,CUS-2505971401,2018-10-05,Abigail,F,-34.96,138.58,,a6b022e8-823c-41bc-bcf5-e8a5c682a50b,-35.32,149.14,ACT,Griffith,debit,authorized,de190bde7ccb427da758ced811dead3d,SALES-POS,30-40,2018,10,5,22,54,Friday,7 days,101499.721
ACC-2528867619,40,20.53,16362.61,1.0,CUS-2505971401,2018-10-05,Abigail,F,-34.96,138.58,,abf31fa7-2b8d-421b-85ca-1c81a4a04b64,-33.87,151.2,NSW,Sydney,debit,authorized,9f14c33c82204db181f3effd176625fb,SALES-POS,30-40,2018,10,5,23,58,Friday,7 days,101499.721
ACC-2528867619,40,76.0,16286.61,,CUS-2505971401,2018-10-09,Abigail,F,-34.96,138.58,,,,,,,debit,posted,060e9b32043d42698b4d265ba13923d8,INTER BANK,30-40,2018,10,9,3,0,Tuesday,7 days,101499.721
ACC-2528867619,40,80.0,16206.61,,CUS-2505971401,2018-10-10,Abigail,F,-34.96,138.58,,,,,,,debit,posted,8bafcb6d45f3464e84753fe7c869947a,PAYMENT,30-40,2018,10,10,10,0,Wednesday,7 days,101499.721
ACC-2528867619,40,37.83,16168.78,1.0,CUS-2505971401,2018-10-10,Abigail,F,-34.96,138.58,,8cd6d3cc-f9f5-42e6-baab-b9028bd89959,-34.93,138.6,SA,Adelaide,debit,authorized,f6ea524f43a54c15a2d320f5515a0453,POS,30-40,2018,10,10,23,58,Wednesday,7 days,101499.721
ACC-2528867619,40,94.04,16074.74,1.0,CUS-2505971401,2018-10-11,Abigail,F,-34.96,138.58,,444355ca-d388-42e1-9f8a-edc07068bf57,-34.95,138.52,SA,Adelaide Airport,debit,authorized,7924368dd1694c628df36f64e3e710f3,SALES-POS,30-40,2018,10,11,13,47,Thursday,7 days,101499.721
ACC-2528867619,40,21.9,16052.84,1.0,CUS-2505971401,2018-10-11,Abigail,F,-34.96,138.58,,18ebf93d-50cc-43d6-8830-a5798e69949e,-35.02,138.55,SA,Oaklands Park,debit,authorized,36015bc465e5431882ac63d29afcc9f4,POS,30-40,2018,10,11,17,11,Thursday,7 days,101499.721
ACC-2528867619,40,19.4,17980.01,0.0,CUS-2505971401,2018-10-12,Abigail,F,-34.96,138.58,,52d79237-141f-417d-a248-23e96427643a,-34.79,138.62,SA,Parafield Gardens,debit,authorized,3e46e999f00b46f3a150438b4bc0f8b0,POS,30-40,2018,10,12,19,43,Friday,7 days,101499.721
ACC-2528867619,40,8.97,17971.04,1.0,CUS-2505971401,2018-10-13,Abigail,F,-34.96,138.58,,7d0d7b19-47f9-42a2-8ce5-3f78159cd2ba,-35.12,138.52,SA,Morphett Vale,debit,authorized,268f53ff6a384304ad9b2b9bc1eb0292,SALES-POS,30-40,2018,10,13,4,22,Saturday,7 days,101499.721
ACC-2528867619,40,196.0,17775.04,,CUS-2505971401,2018-10-13,Abigail,F,-34.96,138.58,,,,,,,debit,posted,4a595c9140b0410096de0a01495c6dd6,PAYMENT,30-40,2018,10,13,12,0,Saturday,7 days,101499.721
ACC-2528867619,40,17.36,17757.68,0.0,CUS-2505971401,2018-10-18,Abigail,F,-34.96,138.58,,9963311e-cb2a-4460-b155-826503cc2cee,-34.92,150.61,NSW,South Nowra,debit,authorized,a9d24f1a7186493882e9fb8903a3ef12,SALES-POS,30-40,2018,10,18,16,0,Thursday,7 days,101499.721
ACC-2528867619,40,26.77,17730.91,0.0,CUS-2505971401,2018-10-18,Abigail,F,-34.96,138.58,,7708f53b-813b-489b-9738-0e9e77a1c3ff,-35.03,138.53,SA,Seacliff Park,debit,authorized,141e47f25b1d40d089b58475291c7323,SALES-POS,30-40,2018,10,18,19,31,Thursday,7 days,101499.721
ACC-2528867619,40,49.48,17681.43,0.0,CUS-2505971401,2018-10-19,Abigail,F,-34.96,138.58,,acb35a48-0bc5-4170-bd2f-9ed0601af1ad,-35.01,138.71,SA,Stirling,debit,authorized,70a863c7b2304cedad320d7cd725dc47,SALES-POS,30-40,2018,10,19,8,7,Friday,7 days,101499.721
ACC-2528867619,40,16.95,19611.05,1.0,CUS-2505971401,2018-10-19,Abigail,F,-34.96,138.58,,20237aa3-e234-4ed6-a70d-d58071f03083,-34.76,149.72,NSW,Goulburn,debit,authorized,e098df7e16a04272bf1a64d499c0b201,SALES-POS,30-40,2018,10,19,15,46,Friday,7 days,101499.721
ACC-2528867619,40,73.0,19538.05,,CUS-2505971401,2018-10-19,Abigail,F,-34.96,138.58,,,,,,,debit,posted,b9a501ad13404f25af6e890e450fbed6,PAYMENT,30-40,2018,10,19,18,0,Friday,7 days,101499.721
ACC-2528867619,40,116.0,19422.05,,CUS-2505971401,2018-10-21,Abigail,F,-34.96,138.58,,,,,,,debit,posted,874b23dd65e8493ba2e8bf2e7ca796e3,PAYMENT,30-40,2018,10,21,7,0,Sunday,7 days,101499.721
ACC-2528867619,40,82.0,19340.05,,CUS-2505971401,2018-10-22,Abigail,F,-34.96,138.58,,,,,,,debit,posted,8fce4d03fa1144d3adc9ecffa5289e96,PAYMENT,30-40,2018,10,22,8,0,Monday,7 days,101499.721
ACC-2528867619,40,22.7,19317.35,1.0,CUS-2505971401,2018-10-25,Abigail,F,-34.96,138.58,,02cb9aab-54b3-489e-9189-e7750e0879aa,-34.88,150.61,NSW,Nowra,debit,authorized,2a7b3f6730944dc2afbe343a47af691e,SALES-POS,30-40,2018,10,25,15,49,Thursday,7 days,101499.721
ACC-2528867619,40,30.47,19286.88,1.0,CUS-2505971401,2018-10-26,Abigail,F,-34.96,138.58,,1c72944b-5615-4b0c-99f4-f7ed041af92e,-34.92,138.62,SA,Kent Town,debit,authorized,37083fb7fdc94420ac81acea04027071,POS,30-40,2018,10,26,4,33,Friday,7 days,101499.721
ACC-2528867619,40,11.52,19275.36,1.0,CUS-2505971401,2018-10-26,Abigail,F,-34.96,138.58,,d6da0a73-531c-4df4-9afa-90c883149a9f,-35.01,148.11,NSW,Gundagai,debit,authorized,257a250f5f744838b42e0dede0d7f05d,POS,30-40,2018,10,26,9,16,Friday,7 days,101499.721
ACC-2528867619,40,8.47,19266.89,1.0,CUS-2505971401,2018-10-26,Abigail,F,-34.96,138.58,,b4f2522e-2473-4dc5-a69c-4495f11d7de9,-34.98,138.51,SA,Glenelg,debit,authorized,60085e928d2748ecbf8badf5996161fc,POS,30-40,2018,10,26,11,39,Friday,7 days,101499.721
ACC-2528867619,40,12.62,21200.84,1.0,CUS-2505971401,2018-10-26,Abigail,F,-34.96,138.58,,5da9f113-d911-4709-b6a3-5ff1fbb0c7be,-34.85,150.61,NSW,Bomaderry,debit,authorized,627e304cb4e64e3a955d753282638ee4,POS,30-40,2018,10,26,23,0,Friday,7 days,101499.721
ACC-2528867619,40,10.7,21190.14,1.0,CUS-2505971401,2018-10-26,Abigail,F,-34.96,138.58,,8103babe-c526-4954-baf7-9f4e4845b4af,-35.02,138.52,SA,Brighton,debit,authorized,d081e5a850b8428d85c27f64816c2ffe,SALES-POS,30-40,2018,10,26,23,20,Friday,7 days,101499.721
ACC-2528867619,40,22.24,21167.9,1.0,CUS-2505971401,2018-10-27,Abigail,F,-34.96,138.58,,7529a910-fa4b-4b99-b255-12be002e57c7,-34.87,138.62,SA,Broadview,debit,authorized,b552b0e925f54761aba604ad9f0cfa29,POS,30-40,2018,10,27,9,53,Saturday,7 days,101499.721
ACC-2528867619,40,33.73,21134.17,1.0,CUS-2505971401,2018-10-27,Abigail,F,-34.96,138.58,,86f838e5-2161-4e93-b259-43f5ff0db914,-34.89,150.61,NSW,Nowra,debit,authorized,30526e57ff784a3ab2fad0608741da33,SALES-POS,30-40,2018,10,27,16,54,Saturday,7 days,101499.721
ACC-2528867619,40,28.3,21105.87,1.0,CUS-2505971401,2018-10-27,Abigail,F,-34.96,138.58,,19defd99-dbca-4133-a027-f4df4954f387,-34.92,138.6,SA,Adelaide,debit,authorized,9cdf7121d39f4e5586afee89290f3130,POS,30-40,2018,10,27,21,24,Saturday,7 days,101499.721
ACC-2528867619,40,64.01,21041.86,1.0,CUS-2505971401,2018-10-27,Abigail,F,-34.96,138.58,,02dc8434-5ba7-40ee-b1c5-5771560e0c1d,-34.87,150.59,NSW,Nowra North,debit,authorized,7f123bd8935c46239574f264fcd44bbc,POS,30-40,2018,10,27,21,56,Saturday,7 days,101499.721
ACC-2528867619,40,33.47,21008.39,1.0,CUS-2505971401,2018-10-27,Abigail,F,-34.96,138.58,,79169d98-7fa1-4569-9c37-fc17037801f4,-35.32,149.13,ACT,Griffith,debit,authorized,c8d30ce7dd35476293dd9d1f86bcf4a8,SALES-POS,30-40,2018,10,27,23,36,Saturday,7 days,101499.721
ACC-2528867619,40,92.0,20916.39,,CUS-2505971401,2018-10-28,Abigail,F,-34.96,138.58,,,,,,,debit,posted,4041ecce41514c269155e816057a681e,PAYMENT,30-40,2018,10,28,20,0,Sunday,7 days,101499.721
ACC-2528867619,40,38.52,20877.87,1.0,CUS-2505971401,2018-10-29,Abigail,F,-34.96,138.58,,abe51cc4-14e1-4655-b0ea-8dd27efdc316,-37.8,144.99,VIC,Collingwood,debit,authorized,133ed793822d4c4aaa327c0445872932,POS,30-40,2018,10,29,10,32,Monday,7 days,101499.721
ACC-588564840,23,3903.95,8342.11,,CUS-1462656821,2018-08-01,Isaiah,M,-33.76,151.27,0.0,,,,,,credit,posted,9ca281650e5d482d9e53f85e959baa66,PAY/SALARY,20-30,2018,8,1,11,0,Wednesday,14 days,101781.554
ACC-588564840,23,3903.95,10724.87,,CUS-1462656821,2018-08-15,Isaiah,M,-33.76,151.27,0.0,,,,,,credit,posted,a0ba656db7c5441dbb782f4bbc6755ac,PAY/SALARY,20-30,2018,8,15,11,0,Wednesday,14 days,101781.554
ACC-588564840,23,3903.95,13030.74,,CUS-1462656821,2018-08-29,Isaiah,M,-33.76,151.27,0.0,,,,,,credit,posted,0d496e23bf2d461eb3ac886c1a16f3b4,PAY/SALARY,20-30,2018,8,29,11,0,Wednesday,14 days,101781.554
ACC-588564840,23,3903.95,15523.69,,CUS-1462656821,2018-09-12,Isaiah,M,-33.76,151.27,0.0,,,,,,credit,posted,4e8da0f42d534b919b2b5c045204d8cf,PAY/SALARY,20-30,2018,9,12,11,0,Wednesday,14 days,101781.554
ACC-588564840,23,3903.95,17906.31,,CUS-1462656821,2018-09-26,Isaiah,M,-33.76,151.27,0.0,,,,,,credit,posted,3885424223de46eb894231ee607c28f2,PAY/SALARY,20-30,2018,9,26,11,0,Wednesday,14 days,101781.554
ACC-588564840,23,3903.95,21236.51,,CUS-1462656821,2018-10-10,Isaiah,M,-33.76,151.27,0.0,,,,,,credit,posted,0726e97b3df44344b4b7d0f762d7801a,PAY/SALARY,20-30,2018,10,10,11,0,Wednesday,14 days,101781.554
ACC-588564840,23,3903.95,24451.16,,CUS-1462656821,2018-10-24,Isaiah,M,-33.76,151.27,0.0,,,,,,credit,posted,d14a8667671948e8b688486d2f97d97f,PAY/SALARY,20-30,2018,10,24,11,0,Wednesday,14 days,101781.554
ACC-1650504218,23,1626.48,2040.58,,CUS-2500783281,2018-08-01,Marissa,F,-37.93,145.01,0.0,,,,,,credit,posted,1822eb0e1bbe4c9e95ebbb0fa2cc4323,PAY/SALARY,20-30,2018,8,1,12,0,Wednesday,7 days,84809.314
ACC-1650504218,23,1626.48,3287.56,,CUS-2500783281,2018-08-08,Marissa,F,-37.93,145.01,0.0,,,,,,credit,posted,3f88ba70530247e6a8489f627e7f7462,PAY/SALARY,20-30,2018,8,8,12,0,Wednesday,7 days,84809.314
ACC-1650504218,23,1626.48,4644.04,,CUS-2500783281,2018-08-15,Marissa,F,-37.93,145.01,0.0,,,,,,credit,posted,c33dccc92e1c41ef8580b1112c00d83c,PAY/SALARY,20-30,2018,8,15,12,0,Wednesday,7 days,84809.314
ACC-1650504218,23,1626.48,5697.52,,CUS-2500783281,2018-08-22,Marissa,F,-37.93,145.01,0.0,,,,,,credit,posted,dc875fcbcc4c48f79b4892c29f73fce6,PAY/SALARY,20-30,2018,8,22,12,0,Wednesday,7 days,84809.314
ACC-1650504218,23,1626.48,7208.0,,CUS-2500783281,2018-08-29,Marissa,F,-37.93,145.01,0.0,,,,,,credit,posted,1fefa57cc7474050ba48a830eb1f0df0,PAY/SALARY,20-30,2018,8,29,12,0,Wednesday,7 days,84809.314
ACC-1650504218,23,1626.48,8718.48,,CUS-2500783281,2018-09-05,Marissa,F,-37.93,145.01,0.0,,,,,,credit,posted,dc89bb751bd940eea1a4f8eba95b7939,PAY/SALARY,20-30,2018,9,5,12,0,Wednesday,7 days,84809.314
ACC-1650504218,23,1626.48,10228.96,,CUS-2500783281,2018-09-12,Marissa,F,-37.93,145.01,0.0,,,,,,credit,posted,1d197043a6f04b4f84a7237a28d64def,PAY/SALARY,20-30,2018,9,12,12,0,Wednesday,7 days,84809.314
ACC-1650504218,23,1626.48,11435.44,,CUS-2500783281,2018-09-19,Marissa,F,-37.93,145.01,0.0,,,,,,credit,posted,2b7768d21f034aa9af05d0c9b35d0415,PAY/SALARY,20-30,2018,9,19,12,0,Wednesday,7 days,84809.314
ACC-1650504218,23,1626.48,12638.92,,CUS-2500783281,2018-09-26,Marissa,F,-37.93,145.01,0.0,,,,,,credit,posted,724ec30de8584c079fff70762852437e,PAY/SALARY,20-30,2018,9,26,12,0,Wednesday,7 days,84809.314
ACC-1650504218,23,1626.48,14149.4,,CUS-2500783281,2018-10-03,Marissa,F,-37.93,145.01,0.0,,,,,,credit,posted,f0d2711b25494eeb8ee075d14a2c0dfd,PAY/SALARY,20-30,2018,10,3,12,0,Wednesday,7 days,84809.314
ACC-1650504218,23,1626.48,15659.88,,CUS-2500783281,2018-10-10,Marissa,F,-37.93,145.01,0.0,,,,,,credit,posted,54ebf76d9c1c45428d1acb84166cd9db,PAY/SALARY,20-30,2018,10,10,12,0,Wednesday,7 days,84809.314
ACC-1650504218,23,1626.48,17016.36,,CUS-2500783281,2018-10-17,Marissa,F,-37.93,145.01,0.0,,,,,,credit,posted,c29b711899aa4d66943d42f32c583bf3,PAY/SALARY,20-30,2018,10,17,12,0,Wednesday,7 days,84809.314
ACC-1650504218,23,1626.48,18069.84,,CUS-2500783281,2018-10-24,Marissa,F,-37.93,145.01,0.0,,,,,,credit,posted,b28872b3f95c4619a3739e94295c669e,PAY/SALARY,20-30,2018,10,24,12,0,Wednesday,7 days,84809.314
ACC-1650504218,23,1626.48,19580.32,,CUS-2500783281,2018-10-31,Marissa,F,-37.93,145.01,0.0,,,,,,credit,posted,4ddbc04d71054b38b13ed7b2c5d2fa78,PAY/SALARY,20-30,2018,10,31,12,0,Wednesday,7 days,84809.314
ACC-3326339947,22,983.36,3158.51,,CUS-326006476,2018-08-01,Eric,M,-33.80,151.18,0.0,,,,,,credit,posted,bd62b1799a454cedbbb56364f7c40cbf,PAY/SALARY,20-30,2018,8,1,12,0,Wednesday,7 days,51275.2
ACC-3326339947,22,983.36,3675.24,,CUS-326006476,2018-08-08,Eric,M,-33.80,151.18,0.0,,,,,,credit,posted,16eff28849484b3aa30ddfcabfedd0a7,PAY/SALARY,20-30,2018,8,8,12,0,Wednesday,7 days,51275.2
ACC-3326339947,22,983.36,4475.72,,CUS-326006476,2018-08-15,Eric,M,-33.80,151.18,0.0,,,,,,credit,posted,7c8c2d66d4ee4f758d6e0b155266ff17,PAY/SALARY,20-30,2018,8,15,12,0,Wednesday,7 days,51275.2
ACC-3326339947,22,983.36,5240.83,,CUS-326006476,2018-08-22,Eric,M,-33.80,151.18,0.0,,,,,,credit,posted,1d8547c49d6e4d9a9f3232eb84c34743,PAY/SALARY,20-30,2018,8,22,12,0,Wednesday,7 days,51275.2
ACC-3326339947,22,983.36,6224.19,,CUS-326006476,2018-08-29,Eric,M,-33.80,151.18,0.0,,,,,,credit,posted,590afc33a45d4c0c949d9b01112ad343,PAY/SALARY,20-30,2018,8,29,12,0,Wednesday,7 days,51275.2
ACC-3326339947,22,983.36,7207.55,,CUS-326006476,2018-09-05,Eric,M,-33.80,151.18,0.0,,,,,,credit,posted,31c01c223a944d488d886c965304ebe2,PAY/SALARY,20-30,2018,9,5,12,0,Wednesday,7 days,51275.2
ACC-3326339947,22,983.36,7839.91,,CUS-326006476,2018-09-12,Eric,M,-33.80,151.18,0.0,,,,,,credit,posted,380e0f8c350746a891ee7ce49033087b,PAY/SALARY,20-30,2018,9,12,12,0,Wednesday,7 days,51275.2
ACC-3326339947,22,983.36,8775.14,,CUS-326006476,2018-09-19,Eric,M,-33.80,151.18,0.0,,,,,,credit,posted,3ec14f453ab24800a4227d52476c48b4,PAY/SALARY,20-30,2018,9,19,12,0,Wednesday,7 days,51275.2
ACC-3326339947,22,983.36,9365.49,,CUS-326006476,2018-09-26,Eric,M,-33.80,151.18,0.0,,,,,,credit,posted,010f04dbb9cc4ed2bfe82c7f08b8dc0b,PAY/SALARY,20-30,2018,9,26,12,0,Wednesday,7 days,51275.2
ACC-3326339947,22,983.36,10348.85,,CUS-326006476,2018-10-03,Eric,M,-33.80,151.18,0.0,,,,,,credit,posted,9f1c833cde7048e187775fb50b112a58,PAY/SALARY,20-30,2018,10,3,12,0,Wednesday,7 days,51275.2
ACC-3326339947,22,983.36,11101.21,,CUS-326006476,2018-10-10,Eric,M,-33.80,151.18,0.0,,,,,,credit,posted,704716a0ce0d41b9bd7699d9ff095a04,PAY/SALARY,20-30,2018,10,10,12,0,Wednesday,7 days,51275.2
ACC-3326339947,22,983.36,12084.57,,CUS-326006476,2018-10-17,Eric,M,-33.80,151.18,0.0,,,,,,credit,posted,c819e371d93046548ba2b43fb771f9be,PAY/SALARY,20-30,2018,10,17,12,0,Wednesday,7 days,51275.2
ACC-3326339947,22,983.36,12978.93,,CUS-326006476,2018-10-24,Eric,M,-33.80,151.18,0.0,,,,,,credit,posted,8860723cc2ea444cb328f0d46e7c4c7f,PAY/SALARY,20-30,2018,10,24,12,0,Wednesday,7 days,51275.2
ACC-3326339947,22,983.36,13962.29,,CUS-326006476,2018-10-31,Eric,M,-33.80,151.18,0.0,,,,,,credit,posted,121fec2cb0b94a4b98df36583faa90a7,PAY/SALARY,20-30,2018,10,31,12,0,Wednesday,7 days,51275.2
ACC-3541460373,24,1408.08,2517.66,,CUS-1433879684,2018-08-01,Jeffrey,M,-37.83,145.00,0.0,,,,,,credit,posted,0d95c7c932bb48e5b44c2637bdd3efe9,PAY/SALARY,20-30,2018,8,1,13,0,Wednesday,14 days,36710.657
ACC-3541460373,24,1408.08,2713.59,,CUS-1433879684,2018-08-15,Jeffrey,M,-37.83,145.00,0.0,,,,,,credit,posted,5c5359548fa44145bde8bd98f5c8aff6,PAY/SALARY,20-30,2018,8,15,13,0,Wednesday,14 days,36710.657
ACC-3541460373,24,1408.08,3618.46,,CUS-1433879684,2018-08-29,Jeffrey,M,-37.83,145.00,0.0,,,,,,credit,posted,250cf46900ef455aa573e729321ccf45,PAY/SALARY,20-30,2018,8,29,13,0,Wednesday,14 days,36710.657
ACC-3541460373,24,1408.08,3874.97,,CUS-1433879684,2018-09-12,Jeffrey,M,-37.83,145.00,0.0,,,,,,credit,posted,8c612ef2320749d7adee5a757852656c,PAY/SALARY,20-30,2018,9,12,13,0,Wednesday,14 days,36710.657
ACC-3541460373,24,1408.08,4257.85,,CUS-1433879684,2018-09-26,Jeffrey,M,-37.83,145.00,0.0,,,,,,credit,posted,62a1ec9f0a3440bfa38d064c550cf0c3,PAY/SALARY,20-30,2018,9,26,13,0,Wednesday,14 days,36710.657
ACC-3541460373,24,1408.08,4756.59,,CUS-1433879684,2018-10-10,Jeffrey,M,-37.83,145.00,0.0,,,,,,credit,posted,aa21062a1680434fb85d92395ef69f1e,PAY/SALARY,20-30,2018,10,10,13,0,Wednesday,14 days,36710.657
ACC-3541460373,24,1408.08,5402.55,,CUS-1433879684,2018-10-24,Jeffrey,M,-37.83,145.00,0.0,,,,,,credit,posted,c11717ecdff1467f9bb7383bf1348ec4,PAY/SALARY,20-30,2018,10,24,13,0,Wednesday,14 days,36710.657
ACC-2776252858,43,1068.04,2271.79,,CUS-4123612273,2018-08-01,Kristin,F,-37.76,144.95,0.0,,,,,,credit,posted,f50ccf1195214d14a0acbfcb5a265193,PAY/SALARY,40-50,2018,8,1,13,0,Wednesday,7 days,55690.657
ACC-2776252858,43,1068.04,1151.74,,CUS-4123612273,2018-08-08,Kristin,F,-37.76,144.95,0.0,,,,,,credit,posted,1d59539c964b45d4b4ae0df3c2bd4edc,PAY/SALARY,40-50,2018,8,8,13,0,Wednesday,7 days,55690.657
ACC-2776252858,43,1068.04,1215.7,,CUS-4123612273,2018-08-15,Kristin,F,-37.76,144.95,0.0,,,,,,credit,posted,73cf2b1668554a12878429e0b347ca94,PAY/SALARY,40-50,2018,8,15,13,0,Wednesday,7 days,55690.657
ACC-2776252858,43,1068.04,2211.74,,CUS-4123612273,2018-08-22,Kristin,F,-37.76,144.95,0.0,,,,,,credit,posted,5c15034afec244d9b14a1fd33cdef95b,PAY/SALARY,40-50,2018,8,22,13,0,Wednesday,7 days,55690.657
ACC-2776252858,43,1068.04,3140.02,,CUS-4123612273,2018-08-29,Kristin,F,-37.76,144.95,0.0,,,,,,credit,posted,7a748507255e40d197ef649812661098,PAY/SALARY,40-50,2018,8,29,13,0,Wednesday,7 days,55690.657
ACC-2776252858,43,1068.04,3815.93,,CUS-4123612273,2018-09-05,Kristin,F,-37.76,144.95,0.0,,,,,,credit,posted,ef8b775ae72e400489c161b653be6d0b,PAY/SALARY,40-50,2018,9,5,13,0,Wednesday,7 days,55690.657
ACC-2776252858,43,1068.04,4602.87,,CUS-4123612273,2018-09-12,Kristin,F,-37.76,144.95,0.0,,,,,,credit,posted,72e059f24ccb4ee5a9969214b47ed92f,PAY/SALARY,40-50,2018,9,12,13,0,Wednesday,7 days,55690.657
ACC-2776252858,43,1068.04,5420.91,,CUS-4123612273,2018-09-19,Kristin,F,-37.76,144.95,0.0,,,,,,credit,posted,1b0f7eaad32945249589f2a2f968a659,PAY/SALARY,40-50,2018,9,19,13,0,Wednesday,7 days,55690.657
ACC-2776252858,43,1068.04,6416.95,,CUS-4123612273,2018-09-26,Kristin,F,-37.76,144.95,0.0,,,,,,credit,posted,0adb2154fb8343b4b78d99ef7001853a,PAY/SALARY,40-50,2018,9,26,13,0,Wednesday,7 days,55690.657
ACC-2776252858,43,1068.04,7215.99,,CUS-4123612273,2018-10-03,Kristin,F,-37.76,144.95,0.0,,,,,,credit,posted,861c1fb773c24d5faf9d52c39ba7f124,PAY/SALARY,40-50,2018,10,3,13,0,Wednesday,7 days,55690.657
ACC-2776252858,43,1068.04,7998.23,,CUS-4123612273,2018-10-10,Kristin,F,-37.76,144.95,0.0,,,,,,credit,posted,9e0ddb91deb2424cb54b15042d238bc7,PAY/SALARY,40-50,2018,10,10,13,0,Wednesday,7 days,55690.657
ACC-2776252858,43,1068.04,8816.27,,CUS-4123612273,2018-10-17,Kristin,F,-37.76,144.95,0.0,,,,,,credit,posted,eb831369c4ea4c508ff422fa3434f51a,PAY/SALARY,40-50,2018,10,17,13,0,Wednesday,7 days,55690.657
ACC-2776252858,43,1068.04,9812.31,,CUS-4123612273,2018-10-24,Kristin,F,-37.76,144.95,0.0,,,,,,credit,posted,9df3fba7d7914127882bc71fa392cfab,PAY/SALARY,40-50,2018,10,24,13,0,Wednesday,7 days,55690.657
ACC-2776252858,43,1068.04,8859.42,,CUS-4123612273,2018-10-31,Kristin,F,-37.76,144.95,0.0,,,,,,credit,posted,40b65a4c963c42a5821408bd071026ba,PAY/SALARY,40-50,2018,10,31,13,0,Wednesday,7 days,55690.657
ACC-1598451071,26,1013.67,1017.52,,CUS-2487424745,2018-08-01,Diana,F,-27.95,153.41,0.0,,,,,,credit,posted,a72c9dd8b4614a1982ff71f8b62677ad,PAY/SALARY,20-30,2018,8,1,14,0,Wednesday,7 days,52855.65
ACC-1598451071,26,1013.67,1343.65,,CUS-2487424745,2018-08-08,Diana,F,-27.95,153.41,0.0,,,,,,credit,posted,3fb647f098a642809f85f2f08c0e589b,PAY/SALARY,20-30,2018,8,8,14,0,Wednesday,7 days,52855.65
ACC-1598451071,26,1013.67,1440.22,,CUS-2487424745,2018-08-15,Diana,F,-27.95,153.41,0.0,,,,,,credit,posted,bdff41213228441e998c82d263983cc7,PAY/SALARY,20-30,2018,8,15,14,0,Wednesday,7 days,52855.65
ACC-1598451071,26,1013.67,1932.06,,CUS-2487424745,2018-08-22,Diana,F,-27.95,153.41,0.0,,,,,,credit,posted,72e4010a18564f15a097c97af6d309bc,PAY/SALARY,20-30,2018,8,22,14,0,Wednesday,7 days,52855.65
ACC-1598451071,26,1013.67,2273.97,,CUS-2487424745,2018-08-29,Diana,F,-27.95,153.41,0.0,,,,,,credit,posted,44941fc90d514b71990c07c2c09ce22a,PAY/SALARY,20-30,2018,8,29,14,0,Wednesday,7 days,52855.65
ACC-1598451071,26,1013.67,2145.75,,CUS-2487424745,2018-09-05,Diana,F,-27.95,153.41,0.0,,,,,,credit,posted,ba87ffc60b7346f8b726e8857e3ecacb,PAY/SALARY,20-30,2018,9,5,14,0,Wednesday,7 days,52855.65
ACC-1598451071,26,1013.67,2341.26,,CUS-2487424745,2018-09-12,Diana,F,-27.95,153.41,0.0,,,,,,credit,posted,25cf76b489414f6cac603e69aad03f9d,PAY/SALARY,20-30,2018,9,12,14,0,Wednesday,7 days,52855.65
ACC-1598451071,26,1013.67,2727.43,,CUS-2487424745,2018-09-19,Diana,F,-27.95,153.41,0.0,,,,,,credit,posted,63a5b2fc882e4a3a9704be310b85225d,PAY/SALARY,20-30,2018,9,19,14,0,Wednesday,7 days,52855.65
ACC-1598451071,26,1013.67,3365.26,,CUS-2487424745,2018-09-26,Diana,F,-27.95,153.41,0.0,,,,,,credit,posted,417263ea35184ef7b379496745031956,PAY/SALARY,20-30,2018,9,26,14,0,Wednesday,7 days,52855.65
ACC-1598451071,26,1013.67,3435.21,,CUS-2487424745,2018-10-03,Diana,F,-27.95,153.41,0.0,,,,,,credit,posted,f5026b5d7675414092f453c2224ffaa7,PAY/SALARY,20-30,2018,10,3,14,0,Wednesday,7 days,52855.65
ACC-1598451071,26,1013.67,2066.52,,CUS-2487424745,2018-10-10,Diana,F,-27.95,153.41,0.0,,,,,,credit,posted,c1ef680b82284ffeaaca45173d15ce4b,PAY/SALARY,20-30,2018,10,10,14,0,Wednesday,7 days,52855.65
ACC-1598451071,26,1013.67,1626.37,,CUS-2487424745,2018-10-17,Diana,F,-27.95,153.41,0.0,,,,,,credit,posted,583aba18701143d7b29b910665fb0ff4,PAY/SALARY,20-30,2018,10,17,14,0,Wednesday,7 days,52855.65
ACC-1598451071,26,1013.67,1966.78,,CUS-2487424745,2018-10-24,Diana,F,-27.95,153.41,0.0,,,,,,credit,posted,5a911352401c4d53928b8f08e34f5c47,PAY/SALARY,20-30,2018,10,24,14,0,Wednesday,7 days,52855.65
ACC-1598451071,26,1013.67,2281.79,,CUS-2487424745,2018-10-31,Diana,F,-27.95,153.41,0.0,,,,,,credit,posted,d46b9f66c65942458c211dee1f238e6a,PAY/SALARY,20-30,2018,10,31,14,0,Wednesday,7 days,52855.65
ACC-3485804958,34,3903.73,16433.32,,CUS-1196156254,2018-08-01,Jessica,F,-35.01,138.52,0.0,,,,,,credit,posted,cf378669537f46e4acee7321fa8accb1,PAY/SALARY,30-40,2018,8,1,16,0,Wednesday,14 days,101775.818
ACC-3485804958,34,3903.73,19199.85,,CUS-1196156254,2018-08-15,Jessica,F,-35.01,138.52,0.0,,,,,,credit,posted,91b6c25e46824d76871d03c626dac3f1,PAY/SALARY,30-40,2018,8,15,16,0,Wednesday,14 days,101775.818
ACC-3485804958,34,3903.73,21761.07,,CUS-1196156254,2018-08-29,Jessica,F,-35.01,138.52,0.0,,,,,,credit,posted,c1d8da8d4cdb48418e357451bacdb3c2,PAY/SALARY,30-40,2018,8,29,16,0,Wednesday,14 days,101775.818
ACC-3485804958,34,3903.73,23687.34,,CUS-1196156254,2018-09-12,Jessica,F,-35.01,138.52,0.0,,,,,,credit,posted,e1272b0080624715b8e4a976d657c316,PAY/SALARY,30-40,2018,9,12,16,0,Wednesday,14 days,101775.818
ACC-3485804958,34,3903.73,25958.84,,CUS-1196156254,2018-09-26,Jessica,F,-35.01,138.52,0.0,,,,,,credit,posted,61a1a182b1274396b66130ad15d34376,PAY/SALARY,30-40,2018,9,26,16,0,Wednesday,14 days,101775.818
ACC-3485804958,34,3903.73,28529.1,,CUS-1196156254,2018-10-10,Jessica,F,-35.01,138.52,0.0,,,,,,credit,posted,649c5de3b5f64814a52257a55a29e431,PAY/SALARY,30-40,2018,10,10,16,0,Wednesday,14 days,101775.818
ACC-3485804958,34,3903.73,31350.5,,CUS-1196156254,2018-10-24,Jessica,F,-35.01,138.52,0.0,,,,,,credit,posted,ffb451002a8e4812888e7196cc1ce48a,PAY/SALARY,30-40,2018,10,24,16,0,Wednesday,14 days,101775.818
ACC-1973887809,26,1098.91,1796.37,,CUS-1646621553,2018-08-01,Antonio,M,-31.90,115.78,0.0,,,,,,credit,posted,00e97a9be9654405bb44f96e748b3ace,PAY/SALARY,20-30,2018,8,1,16,0,Wednesday,7 days,57300.307
ACC-1973887809,26,1098.91,1477.59,,CUS-1646621553,2018-08-08,Antonio,M,-31.90,115.78,0.0,,,,,,credit,posted,76a69d307c6844cb89d55a5d8ac85248,PAY/SALARY,20-30,2018,8,8,16,0,Wednesday,7 days,57300.307
ACC-1973887809,26,1098.91,2178.57,,CUS-1646621553,2018-08-15,Antonio,M,-31.90,115.78,0.0,,,,,,credit,posted,d994adeb38fe444d9cf77d9ea37efff7,PAY/SALARY,20-30,2018,8,15,16,0,Wednesday,7 days,57300.307
ACC-1973887809,26,1098.91,3144.33,,CUS-1646621553,2018-08-22,Antonio,M,-31.90,115.78,0.0,,,,,,credit,posted,d1b1f165574f4e1a9c4c5c3e5af602d5,PAY/SALARY,20-30,2018,8,22,16,0,Wednesday,7 days,57300.307
ACC-1973887809,26,1098.91,3937.74,,CUS-1646621553,2018-08-29,Antonio,M,-31.90,115.78,0.0,,,,,,credit,posted,0fc7ab19a9f04e47828ca1ca6a0fd52f,PAY/SALARY,20-30,2018,8,29,16,0,Wednesday,7 days,57300.307
ACC-1973887809,26,1098.91,4857.86,,CUS-1646621553,2018-09-05,Antonio,M,-31.90,115.78,0.0,,,,,,credit,posted,94dc7f59e1354d31b68cad6afba9c9fe,PAY/SALARY,20-30,2018,9,5,16,0,Wednesday,7 days,57300.307
ACC-1973887809,26,1098.91,5674.54,,CUS-1646621553,2018-09-12,Antonio,M,-31.90,115.78,0.0,,,,,,credit,posted,dd06cc65cf474b15b84550fba6e3bb33,PAY/SALARY,20-30,2018,9,12,16,0,Wednesday,7 days,57300.307
ACC-1973887809,26,1098.91,6638.45,,CUS-1646621553,2018-09-19,Antonio,M,-31.90,115.78,0.0,,,,,,credit,posted,b6adef7a821940d9935cd3803281be48,PAY/SALARY,20-30,2018,9,19,16,0,Wednesday,7 days,57300.307
ACC-1973887809,26,1098.91,7602.45,,CUS-1646621553,2018-09-26,Antonio,M,-31.90,115.78,0.0,,,,,,credit,posted,9fc982f780a54938b78ec332c536a164,PAY/SALARY,20-30,2018,9,26,16,0,Wednesday,7 days,57300.307
ACC-1973887809,26,1098.91,7159.9,,CUS-1646621553,2018-10-03,Antonio,M,-31.90,115.78,0.0,,,,,,credit,posted,30fe349a77ef47628da0a3d0ff196dc9,PAY/SALARY,20-30,2018,10,3,16,0,Wednesday,7 days,57300.307
ACC-1973887809,26,1098.91,7845.61,,CUS-1646621553,2018-10-10,Antonio,M,-31.90,115.78,0.0,,,,,,credit,posted,d8c7fe5f4eed4f9fac483acde6252ffe,PAY/SALARY,20-30,2018,10,10,16,0,Wednesday,7 days,57300.307
ACC-1973887809,26,1098.91,8356.59,,CUS-1646621553,2018-10-17,Antonio,M,-31.90,115.78,0.0,,,,,,credit,posted,6f6513f4089a47ada198e97935998f48,PAY/SALARY,20-30,2018,10,17,16,0,Wednesday,7 days,57300.307
ACC-1973887809,26,1098.91,8630.16,,CUS-1646621553,2018-10-24,Antonio,M,-31.90,115.78,0.0,,,,,,credit,posted,ebabf4cff088457bbf72e60f289b706d,PAY/SALARY,20-30,2018,10,24,16,0,Wednesday,7 days,57300.307
ACC-1973887809,26,1098.91,9378.51,,CUS-1646621553,2018-10-31,Antonio,M,-31.90,115.78,0.0,,,,,,credit,posted,0e6cffb4401043c891ab7a50ec594208,PAY/SALARY,20-30,2018,10,31,16,0,Wednesday,7 days,57300.307
ACC-4059612845,38,2647.38,50383.16,,CUS-495599312,2018-08-01,Jonathan,M,-12.49,130.98,0.0,,,,,,credit,posted,794ef124f66645e68d0707ef0a544b50,PAY/SALARY,30-40,2018,8,1,16,0,Wednesday,14 days,69020.979
ACC-4059612845,38,2647.38,52568.04,,CUS-495599312,2018-08-15,Jonathan,M,-12.49,130.98,0.0,,,,,,credit,posted,941f60ad16bc42b2a53cefb0c70432ce,PAY/SALARY,30-40,2018,8,15,16,0,Wednesday,14 days,69020.979
ACC-4059612845,38,2647.38,54662.07,,CUS-495599312,2018-08-29,Jonathan,M,-12.49,130.98,0.0,,,,,,credit,posted,5a6379a5850d43cd95462e75c54fe20b,PAY/SALARY,30-40,2018,8,29,16,0,Wednesday,14 days,69020.979
ACC-4059612845,38,2647.38,57232.45,,CUS-495599312,2018-09-12,Jonathan,M,-12.49,130.98,0.0,,,,,,credit,posted,33f2d3441359415abb45170aab621a10,PAY/SALARY,30-40,2018,9,12,16,0,Wednesday,14 days,69020.979
ACC-4059612845,38,2647.38,59373.39,,CUS-495599312,2018-09-26,Jonathan,M,-12.49,130.98,0.0,,,,,,credit,posted,1c63074d77c845f5819458e8592a26e8,PAY/SALARY,30-40,2018,9,26,16,0,Wednesday,14 days,69020.979
ACC-4059612845,38,2647.38,61609.31,,CUS-495599312,2018-10-10,Jonathan,M,-12.49,130.98,0.0,,,,,,credit,posted,9ce710fb2f2442d2beab4c3df090e4e7,PAY/SALARY,30-40,2018,10,10,16,0,Wednesday,14 days,69020.979
ACC-4059612845,38,2647.38,63656.55,,CUS-495599312,2018-10-24,Jonathan,M,-12.49,130.98,0.0,,,,,,credit,posted,4fc58f9dfba14f7ea4d363b0de723c92,PAY/SALARY,30-40,2018,10,24,16,0,Wednesday,14 days,69020.979
ACC-819621312,30,1158.15,1244.45,,CUS-1271030853,2018-08-01,Michele,F,-37.85,145.04,0.0,,,,,,credit,posted,148a346f380948cfa1ee8e5166b56a6e,PAY/SALARY,20-30,2018,8,1,17,0,Wednesday,7 days,60389.25
ACC-819621312,30,1158.15,1951.42,,CUS-1271030853,2018-08-08,Michele,F,-37.85,145.04,0.0,,,,,,credit,posted,d6bd2c15b9b84ab093d22bb63cff37c1,PAY/SALARY,20-30,2018,8,8,17,0,Wednesday,7 days,60389.25
ACC-819621312,30,1158.15,2869.72,,CUS-1271030853,2018-08-15,Michele,F,-37.85,145.04,0.0,,,,,,credit,posted,1a3f9d04937b4569a0bd71a4aa8c4cde,PAY/SALARY,20-30,2018,8,15,17,0,Wednesday,7 days,60389.25
ACC-819621312,30,1158.15,3533.73,,CUS-1271030853,2018-08-22,Michele,F,-37.85,145.04,0.0,,,,,,credit,posted,7e24a84354ea4777aaa0a036835094ba,PAY/SALARY,20-30,2018,8,22,17,0,Wednesday,7 days,60389.25
ACC-819621312,30,1158.15,4537.68,,CUS-1271030853,2018-08-29,Michele,F,-37.85,145.04,0.0,,,,,,credit,posted,6213c383935345edac8126f91327f0e5,PAY/SALARY,20-30,2018,8,29,17,0,Wednesday,7 days,60389.25
ACC-819621312,30,1158.15,4977.55,,CUS-1271030853,2018-09-05,Michele,F,-37.85,145.04,0.0,,,,,,credit,posted,5f46d4a33fdc4d70ae0e395925f9eaba,PAY/SALARY,20-30,2018,9,5,17,0,Wednesday,7 days,60389.25
ACC-819621312,30,1158.15,5738.55,,CUS-1271030853,2018-09-12,Michele,F,-37.85,145.04,0.0,,,,,,credit,posted,d0679ffd892c42ebbeed60126e9d66bf,PAY/SALARY,20-30,2018,9,12,17,0,Wednesday,7 days,60389.25
ACC-819621312,30,1158.15,6481.87,,CUS-1271030853,2018-09-19,Michele,F,-37.85,145.04,0.0,,,,,,credit,posted,1c6afed09a8a47f1b5bda5ed93698be9,PAY/SALARY,20-30,2018,9,19,17,0,Wednesday,7 days,60389.25
ACC-819621312,30,1158.15,7409.85,,CUS-1271030853,2018-09-26,Michele,F,-37.85,145.04,0.0,,,,,,credit,posted,b311cef9f45c469e99558db92ff94b7d,PAY/SALARY,20-30,2018,9,26,17,0,Wednesday,7 days,60389.25
ACC-819621312,30,1158.15,7971.43,,CUS-1271030853,2018-10-03,Michele,F,-37.85,145.04,0.0,,,,,,credit,posted,1df7ae2bed8c4e6db0b10c8c6920536a,PAY/SALARY,20-30,2018,10,3,17,0,Wednesday,7 days,60389.25
ACC-819621312,30,1158.15,8854.58,,CUS-1271030853,2018-10-10,Michele,F,-37.85,145.04,0.0,,,,,,credit,posted,dcaaafbf9d504ecc8fde825534fd8693,PAY/SALARY,20-30,2018,10,10,17,0,Wednesday,7 days,60389.25
ACC-819621312,30,1158.15,9327.64,,CUS-1271030853,2018-10-17,Michele,F,-37.85,145.04,0.0,,,,,,credit,posted,5fb4c96d1ca94c6990246e5ff658e8a7,PAY/SALARY,20-30,2018,10,17,17,0,Wednesday,7 days,60389.25
ACC-819621312,30,1158.15,3097.72,,CUS-1271030853,2018-10-24,Michele,F,-37.85,145.04,0.0,,,,,,credit,posted,1d73be98a5db44b2a9d969909d1b8e52,PAY/SALARY,20-30,2018,10,24,17,0,Wednesday,7 days,60389.25
ACC-819621312,30,1158.15,3440.01,,CUS-1271030853,2018-10-31,Michele,F,-37.85,145.04,0.0,,,,,,credit,posted,ad13e06fffba4771b3c994f9147e68c0,PAY/SALARY,20-30,2018,10,31,17,0,Wednesday,7 days,60389.25
ACC-2920611728,69,1043.12,1969.05,,CUS-1388323263,2018-08-01,Tyler,M,-37.76,144.96,0.0,,,,,,credit,posted,360a8968ef944c9e91ee1f72a9759aec,PAY/SALARY,60-70,2018,8,1,17,0,Wednesday,7 days,54391.257
ACC-2920611728,69,1043.12,2840.39,,CUS-1388323263,2018-08-08,Tyler,M,-37.76,144.96,0.0,,,,,,credit,posted,c241dfaad46b451c9034ffc7b47651c5,PAY/SALARY,60-70,2018,8,8,17,0,Wednesday,7 days,54391.257
ACC-2920611728,69,1043.12,3655.94,,CUS-1388323263,2018-08-15,Tyler,M,-37.76,144.96,0.0,,,,,,credit,posted,4d8daaacc4264d6d92b2ea759cc80364,PAY/SALARY,60-70,2018,8,15,17,0,Wednesday,7 days,54391.257
ACC-2920611728,69,1043.12,4414.32,,CUS-1388323263,2018-08-22,Tyler,M,-37.76,144.96,0.0,,,,,,credit,posted,262d0a81a4e84826ae1a289ba30f4a18,PAY/SALARY,60-70,2018,8,22,17,0,Wednesday,7 days,54391.257
ACC-2920611728,69,1043.12,5005.03,,CUS-1388323263,2018-08-29,Tyler,M,-37.76,144.96,0.0,,,,,,credit,posted,7af1ca18f9764659a87bbf709cd9b815,PAY/SALARY,60-70,2018,8,29,17,0,Wednesday,7 days,54391.257
ACC-2920611728,69,1043.12,5529.57,,CUS-1388323263,2018-09-05,Tyler,M,-37.76,144.96,0.0,,,,,,credit,posted,088df9188b1f477fb3f9988f487616c6,PAY/SALARY,60-70,2018,9,5,17,0,Wednesday,7 days,54391.257
ACC-2920611728,69,1043.12,6215.88,,CUS-1388323263,2018-09-12,Tyler,M,-37.76,144.96,0.0,,,,,,credit,posted,25b25b556fa141719ff7148a299f741d,PAY/SALARY,60-70,2018,9,12,17,0,Wednesday,7 days,54391.257
ACC-2920611728,69,1043.12,7178.0,,CUS-1388323263,2018-09-19,Tyler,M,-37.76,144.96,0.0,,,,,,credit,posted,5450375a86a1474ba3c7ec683ae00474,PAY/SALARY,60-70,2018,9,19,17,0,Wednesday,7 days,54391.257
ACC-2920611728,69,1043.12,7754.2,,CUS-1388323263,2018-09-26,Tyler,M,-37.76,144.96,0.0,,,,,,credit,posted,34719e458cdf42e18ecacaa2474d75f6,PAY/SALARY,60-70,2018,9,26,17,0,Wednesday,7 days,54391.257
ACC-2920611728,69,1043.12,8392.68,,CUS-1388323263,2018-10-03,Tyler,M,-37.76,144.96,0.0,,,,,,credit,posted,415b21ba17c74d9892af805955229007,PAY/SALARY,60-70,2018,10,3,17,0,Wednesday,7 days,54391.257
ACC-2920611728,69,1043.12,9239.26,,CUS-1388323263,2018-10-10,Tyler,M,-37.76,144.96,0.0,,,,,,credit,posted,51411bf845ad4487ad0a76bb4cb63b98,PAY/SALARY,60-70,2018,10,10,17,0,Wednesday,7 days,54391.257
ACC-2920611728,69,1043.12,10065.15,,CUS-1388323263,2018-10-17,Tyler,M,-37.76,144.96,0.0,,,,,,credit,posted,d82481eeccae4ac3acd7f0f0f87a5fd2,PAY/SALARY,60-70,2018,10,17,17,0,Wednesday,7 days,54391.257
ACC-2920611728,69,1043.12,10642.38,,CUS-1388323263,2018-10-24,Tyler,M,-37.76,144.96,0.0,,,,,,credit,posted,98ab35051ca0478d992adbf000ab5578,PAY/SALARY,60-70,2018,10,24,17,0,Wednesday,7 days,54391.257
ACC-2920611728,69,1043.12,11381.44,,CUS-1388323263,2018-10-31,Tyler,M,-37.76,144.96,0.0,,,,,,credit,posted,14a1604e6ead4b54b65d7a28ec546a69,PAY/SALARY,60-70,2018,10,31,17,0,Wednesday,7 days,54391.257
ACC-1799207998,20,1395.49,1403.55,,CUS-164374203,2018-08-01,Susan,F,-33.79,150.68,0.0,,,,,,credit,posted,9767953f8ae94826aa145d6cac0be371,PAY/SALARY,<20,2018,8,1,17,0,Wednesday,7 days,72764.836
ACC-1799207998,20,1395.49,2542.41,,CUS-164374203,2018-08-08,Susan,F,-33.79,150.68,0.0,,,,,,credit,posted,7d3e6cb7dc2f44a38c4898964bcec1c0,PAY/SALARY,<20,2018,8,8,17,0,Wednesday,7 days,72764.836
ACC-1799207998,20,1395.49,3523.0,,CUS-164374203,2018-08-15,Susan,F,-33.79,150.68,0.0,,,,,,credit,posted,e79a43af900a40008f5d23aa947fd67f,PAY/SALARY,<20,2018,8,15,17,0,Wednesday,7 days,72764.836
ACC-1799207998,20,1395.49,4558.59,,CUS-164374203,2018-08-22,Susan,F,-33.79,150.68,0.0,,,,,,credit,posted,2fe681c09ee2439c9e76f9eefb550832,PAY/SALARY,<20,2018,8,22,17,0,Wednesday,7 days,72764.836
ACC-1799207998,20,1395.49,5283.42,,CUS-164374203,2018-08-29,Susan,F,-33.79,150.68,0.0,,,,,,credit,posted,2bb22874edd7440a888880e6be7c9cae,PAY/SALARY,<20,2018,8,29,17,0,Wednesday,7 days,72764.836
ACC-1799207998,20,1395.49,6566.23,,CUS-164374203,2018-09-05,Susan,F,-33.79,150.68,0.0,,,,,,credit,posted,712e728128584d5bb6e9277919b07107,PAY/SALARY,<20,2018,9,5,17,0,Wednesday,7 days,72764.836
ACC-1799207998,20,1395.49,7134.68,,CUS-164374203,2018-09-12,Susan,F,-33.79,150.68,0.0,,,,,,credit,posted,9f2008a66b214796beaaa56e4d57793d,PAY/SALARY,<20,2018,9,12,17,0,Wednesday,7 days,72764.836
ACC-1799207998,20,1395.49,8279.86,,CUS-164374203,2018-09-19,Susan,F,-33.79,150.68,0.0,,,,,,credit,posted,9220907fb0f04819a1362be5859b3451,PAY/SALARY,<20,2018,9,19,17,0,Wednesday,7 days,72764.836
ACC-1799207998,20,1395.49,9352.85,,CUS-164374203,2018-09-26,Susan,F,-33.79,150.68,0.0,,,,,,credit,posted,aefdd364f8f145e99dd6ccc74cd4079f,PAY/SALARY,<20,2018,9,26,17,0,Wednesday,7 days,72764.836
ACC-1799207998,20,1395.49,8058.58,,CUS-164374203,2018-10-03,Susan,F,-33.79,150.68,0.0,,,,,,credit,posted,452ad106a79949e58164db4db61f0825,PAY/SALARY,<20,2018,10,3,17,0,Wednesday,7 days,72764.836
ACC-1799207998,20,1395.49,9159.27,,CUS-164374203,2018-10-10,Susan,F,-33.79,150.68,0.0,,,,,,credit,posted,76afccbefe694bed94c08665d28b6559,PAY/SALARY,<20,2018,10,10,17,0,Wednesday,7 days,72764.836
ACC-1799207998,20,1395.49,9770.19,,CUS-164374203,2018-10-17,Susan,F,-33.79,150.68,0.0,,,,,,credit,posted,b6e8eea5307b4fec9c86e489978cd1fe,PAY/SALARY,<20,2018,10,17,17,0,Wednesday,7 days,72764.836
ACC-1799207998,20,1395.49,10855.6,,CUS-164374203,2018-10-24,Susan,F,-33.79,150.68,0.0,,,,,,credit,posted,fb5a19f43ed34c878a2830c7585e7f68,PAY/SALARY,<20,2018,10,24,17,0,Wednesday,7 days,72764.836
ACC-1799207998,20,1395.49,11454.52,,CUS-164374203,2018-10-31,Susan,F,-33.79,150.68,0.0,,,,,,credit,posted,cd1b1dea1d2f43e882d3499b3717d23b,PAY/SALARY,<20,2018,10,31,17,0,Wednesday,7 days,72764.836
ACC-1349834573,39,3071.14,7094.77,,CUS-1790886359,2018-08-01,Matthew,M,-37.84,145.17,0.0,,,,,,credit,posted,8c993ac0426d4f66a0b6322b4e56507c,PAY/SALARY,30-40,2018,8,1,17,0,Wednesday,14 days,80069.007
ACC-1349834573,39,3071.14,8965.29,,CUS-1790886359,2018-08-15,Matthew,M,-37.84,145.17,0.0,,,,,,credit,posted,ebb87a468a524e20b6bcff34bd7482bf,PAY/SALARY,30-40,2018,8,15,17,0,Wednesday,14 days,80069.007
ACC-1349834573,39,3071.14,10709.36,,CUS-1790886359,2018-08-29,Matthew,M,-37.84,145.17,0.0,,,,,,credit,posted,515ac107ec9946998b85d1e42ce9ea36,PAY/SALARY,30-40,2018,8,29,17,0,Wednesday,14 days,80069.007
ACC-1349834573,39,3071.14,12512.73,,CUS-1790886359,2018-09-12,Matthew,M,-37.84,145.17,0.0,,,,,,credit,posted,ecb210f2ff604e3a80c44e280b1a88f8,PAY/SALARY,30-40,2018,9,12,17,0,Wednesday,14 days,80069.007
ACC-1349834573,39,3071.14,14588.66,,CUS-1790886359,2018-09-26,Matthew,M,-37.84,145.17,0.0,,,,,,credit,posted,4b6d77a4a1f74f4ca73c5ef8cb61b0da,PAY/SALARY,30-40,2018,9,26,17,0,Wednesday,14 days,80069.007
ACC-1349834573,39,3071.14,16713.09,,CUS-1790886359,2018-10-10,Matthew,M,-37.84,145.17,0.0,,,,,,credit,posted,f214a29341414877ae792feb2e36c1f6,PAY/SALARY,30-40,2018,10,10,17,0,Wednesday,14 days,80069.007
ACC-1349834573,39,3071.14,18686.76,,CUS-1790886359,2018-10-24,Matthew,M,-37.84,145.17,0.0,,,,,,credit,posted,c68353c3fdd2475ba768b22edb0126af,PAY/SALARY,30-40,2018,10,24,17,0,Wednesday,14 days,80069.007
ACC-4163822186,26,920.71,3907.05,,CUS-2630892467,2018-08-02,Karen,F,-34.97,149.03,0.0,,,,,,credit,posted,650e693a72da4fa3a83a5f89ffd38a26,PAY/SALARY,20-30,2018,8,2,11,0,Thursday,7 days,48008.45
ACC-4163822186,26,920.71,4676.76,,CUS-2630892467,2018-08-09,Karen,F,-34.97,149.03,0.0,,,,,,credit,posted,7519954e5f7c482c8890f880ab8328dc,PAY/SALARY,20-30,2018,8,9,11,0,Thursday,7 days,48008.45
ACC-4163822186,26,920.71,5242.69,,CUS-2630892467,2018-08-23,Karen,F,-34.97,149.03,0.0,,,,,,credit,posted,7b53c9979ba3484ea9242139623ee318,PAY/SALARY,20-30,2018,8,23,11,0,Thursday,7 days,48008.45
ACC-4163822186,26,920.71,5990.09,,CUS-2630892467,2018-08-30,Karen,F,-34.97,149.03,0.0,,,,,,credit,posted,27f79cf5f9984310b2c1a9142dc0effd,PAY/SALARY,20-30,2018,8,30,11,0,Thursday,7 days,48008.45
ACC-4163822186,26,920.71,6759.8,,CUS-2630892467,2018-09-06,Karen,F,-34.97,149.03,0.0,,,,,,credit,posted,38f156fc5fa044e9b9c265af9016ad48,PAY/SALARY,20-30,2018,9,6,11,0,Thursday,7 days,48008.45
ACC-4163822186,26,920.71,7529.51,,CUS-2630892467,2018-09-13,Karen,F,-34.97,149.03,0.0,,,,,,credit,posted,f557bdb10a3847138897a11429671dcb,PAY/SALARY,20-30,2018,9,13,11,0,Thursday,7 days,48008.45
ACC-4163822186,26,920.71,8135.22,,CUS-2630892467,2018-09-20,Karen,F,-34.97,149.03,0.0,,,,,,credit,posted,3c2efde792214894afba49265883f485,PAY/SALARY,20-30,2018,9,20,11,0,Thursday,7 days,48008.45
ACC-4163822186,26,920.71,8904.93,,CUS-2630892467,2018-09-27,Karen,F,-34.97,149.03,0.0,,,,,,credit,posted,c91a06f0a50e4fd8857247c0e3638d54,PAY/SALARY,20-30,2018,9,27,11,0,Thursday,7 days,48008.45
ACC-4163822186,26,920.71,9674.64,,CUS-2630892467,2018-10-04,Karen,F,-34.97,149.03,0.0,,,,,,credit,posted,2311890a9b4b413db07846a877f1d64c,PAY/SALARY,20-30,2018,10,4,11,0,Thursday,7 days,48008.45
ACC-4163822186,26,920.71,10444.35,,CUS-2630892467,2018-10-11,Karen,F,-34.97,149.03,0.0,,,,,,credit,posted,f6f1dbcc6a86472798765c9dbb0b1034,PAY/SALARY,20-30,2018,10,11,11,0,Thursday,7 days,48008.45
ACC-4163822186,26,920.71,11050.06,,CUS-2630892467,2018-10-18,Karen,F,-34.97,149.03,0.0,,,,,,credit,posted,f383029cc81b4692af1e97589d566d74,PAY/SALARY,20-30,2018,10,18,11,0,Thursday,7 days,48008.45
ACC-4163822186,26,920.71,11819.77,,CUS-2630892467,2018-10-25,Karen,F,-34.97,149.03,0.0,,,,,,credit,posted,7bf75da46f6a4041bf306f6fca6f7beb,PAY/SALARY,20-30,2018,10,25,11,0,Thursday,7 days,48008.45
ACC-721712940,78,782.42,50526.26,,CUS-1646183815,2018-08-02,Andrew,M,-37.82,145.09,0.0,,,,,,credit,posted,087234ecb6994edbb66d56965387b885,PAY/SALARY,70>,2018,8,2,12,0,Thursday,7 days,40797.614
ACC-721712940,78,782.42,51237.54,,CUS-1646183815,2018-08-09,Andrew,M,-37.82,145.09,0.0,,,,,,credit,posted,cfa832fa1b9f4f0faeefafe52e5715aa,PAY/SALARY,70>,2018,8,9,12,0,Thursday,7 days,40797.614
ACC-721712940,78,782.42,52429.38,,CUS-1646183815,2018-08-23,Andrew,M,-37.82,145.09,0.0,,,,,,credit,posted,760b3b2616524669b845647f7f6c29c4,PAY/SALARY,70>,2018,8,23,12,0,Thursday,7 days,40797.614
ACC-721712940,78,782.42,53173.8,,CUS-1646183815,2018-08-30,Andrew,M,-37.82,145.09,0.0,,,,,,credit,posted,4dc6271b9c3b43cd8c966f207d6a62e9,PAY/SALARY,70>,2018,8,30,12,0,Thursday,7 days,40797.614
ACC-721712940,78,782.42,53918.22,,CUS-1646183815,2018-09-06,Andrew,M,-37.82,145.09,0.0,,,,,,credit,posted,530752c83b014bfa83e3ebc968701d5a,PAY/SALARY,70>,2018,9,6,12,0,Thursday,7 days,40797.614
ACC-721712940,78,782.42,54662.64,,CUS-1646183815,2018-09-13,Andrew,M,-37.82,145.09,0.0,,,,,,credit,posted,97b527697963482ebe45fb9487ec8c74,PAY/SALARY,70>,2018,9,13,12,0,Thursday,7 days,40797.614
ACC-721712940,78,782.42,55110.06,,CUS-1646183815,2018-09-20,Andrew,M,-37.82,145.09,0.0,,,,,,credit,posted,9aa85ccea9ed4d25b048937bfa75edcb,PAY/SALARY,70>,2018,9,20,12,0,Thursday,7 days,40797.614
ACC-721712940,78,782.42,55854.48,,CUS-1646183815,2018-09-27,Andrew,M,-37.82,145.09,0.0,,,,,,credit,posted,5a5c54c464124b2d9dc29616e8cb1aeb,PAY/SALARY,70>,2018,9,27,12,0,Thursday,7 days,40797.614
ACC-721712940,78,782.42,56598.9,,CUS-1646183815,2018-10-04,Andrew,M,-37.82,145.09,0.0,,,,,,credit,posted,f3cd890aa84c45c0aae45eef5427aafa,PAY/SALARY,70>,2018,10,4,12,0,Thursday,7 days,40797.614
ACC-721712940,78,782.42,57343.32,,CUS-1646183815,2018-10-11,Andrew,M,-37.82,145.09,0.0,,,,,,credit,posted,29e61a67f1d945f9bf63a7366dac5172,PAY/SALARY,70>,2018,10,11,12,0,Thursday,7 days,40797.614
ACC-721712940,78,782.42,58087.74,,CUS-1646183815,2018-10-18,Andrew,M,-37.82,145.09,0.0,,,,,,credit,posted,e2e097ad364d46aabe0cac5ad43c10cb,PAY/SALARY,70>,2018,10,18,12,0,Thursday,7 days,40797.614
ACC-721712940,78,782.42,58535.16,,CUS-1646183815,2018-10-25,Andrew,M,-37.82,145.09,0.0,,,,,,credit,posted,22366563746249fa966149c7de940a19,PAY/SALARY,70>,2018,10,25,12,0,Thursday,7 days,40797.614
ACC-2107684084,22,2218.73,2511.5,,CUS-2283904812,2018-08-02,Richard,M,-37.88,145.03,0.0,,,,,,credit,posted,f9fad2f5968d4d4398a23a5ac4410ec9,PAY/SALARY,20-30,2018,8,2,13,0,Thursday,14 days,57845.461
ACC-2107684084,22,2218.73,6210.42,,CUS-2283904812,2018-08-30,Richard,M,-37.88,145.03,0.0,,,,,,credit,posted,2c23a95a384b447cb209722a2274dfe4,PAY/SALARY,20-30,2018,8,30,13,0,Thursday,14 days,57845.461
ACC-2107684084,22,2218.73,7905.3,,CUS-2283904812,2018-09-13,Richard,M,-37.88,145.03,0.0,,,,,,credit,posted,18c60efd6f6e41b8ae42960e54e62368,PAY/SALARY,20-30,2018,9,13,13,0,Thursday,14 days,57845.461
ACC-2107684084,22,2218.73,9154.85,,CUS-2283904812,2018-09-27,Richard,M,-37.88,145.03,0.0,,,,,,credit,posted,11a21b84559e432595323cb3f3a41b59,PAY/SALARY,20-30,2018,9,27,13,0,Thursday,14 days,57845.461
ACC-2107684084,22,2218.73,10754.23,,CUS-2283904812,2018-10-11,Richard,M,-37.88,145.03,0.0,,,,,,credit,posted,44b121a09772458f918aa31b217ef3f6,PAY/SALARY,20-30,2018,10,11,13,0,Thursday,14 days,57845.461
ACC-2107684084,22,2218.73,12459.42,,CUS-2283904812,2018-10-25,Richard,M,-37.88,145.03,0.0,,,,,,credit,posted,69ff5a565de643268f0bdffce3bfabe4,PAY/SALARY,20-30,2018,10,25,13,0,Thursday,14 days,57845.461
ACC-1903037542,30,1808.62,1811.47,,CUS-860700529,2018-08-02,Jeffrey,M,-27.61,153.05,0.0,,,,,,credit,posted,5afba8cabdd843a7a342304d37597606,PAY/SALARY,20-30,2018,8,2,14,0,Thursday,14 days,48057.61714285714
ACC-1903037542,30,1808.62,3362.02,,CUS-860700529,2018-08-30,Jeffrey,M,-27.61,153.05,0.0,,,,,,credit,posted,d4ce31e0f08f434489eef2d277b5123b,PAY/SALARY,20-30,2018,8,30,14,0,Thursday,14 days,48057.61714285714
ACC-1903037542,30,1808.62,4197.26,,CUS-860700529,2018-09-13,Jeffrey,M,-27.61,153.05,0.0,,,,,,credit,posted,0b7d9dc698ea4c6e941b48480e361380,PAY/SALARY,20-30,2018,9,13,14,0,Thursday,14 days,48057.61714285714
ACC-1903037542,30,1808.62,4589.35,,CUS-860700529,2018-09-27,Jeffrey,M,-27.61,153.05,0.0,,,,,,credit,posted,d847a0a209b147c79573fd7945f8771e,PAY/SALARY,20-30,2018,9,27,14,0,Thursday,14 days,48057.61714285714
ACC-1903037542,30,1808.62,5694.13,,CUS-860700529,2018-10-11,Jeffrey,M,-27.61,153.05,0.0,,,,,,credit,posted,e62e1637cbdf4804af4059d1948f06e1,PAY/SALARY,20-30,2018,10,11,14,0,Thursday,14 days,48057.61714285714
ACC-1903037542,30,1808.62,5674.58,,CUS-860700529,2018-10-25,Jeffrey,M,-27.61,153.05,0.0,,,,,,credit,posted,5e77cc006c364167b34c340cfd879e8f,PAY/SALARY,20-30,2018,10,25,14,0,Thursday,14 days,48057.61714285714
ACC-2988263882,44,596.33,2480.74,,CUS-1233833708,2018-08-02,Michael,M,-37.90,145.18,0.0,,,,,,credit,posted,a9eedbf0c69945ee96dcb914e4adfb62,PAY/SALARY,40-50,2018,8,2,15,0,Thursday,7 days,31094.35
ACC-2988263882,44,596.33,3010.65,,CUS-1233833708,2018-08-09,Michael,M,-37.90,145.18,0.0,,,,,,credit,posted,fe11084092514eebba131d3472f0c3d7,PAY/SALARY,40-50,2018,8,9,15,0,Thursday,7 days,31094.35
ACC-2988263882,44,596.33,3769.84,,CUS-1233833708,2018-08-23,Michael,M,-37.90,145.18,0.0,,,,,,credit,posted,2630e89e08a44fdb9e8fcca6d0744be6,PAY/SALARY,40-50,2018,8,23,15,0,Thursday,7 days,31094.35
ACC-2988263882,44,596.33,4366.17,,CUS-1233833708,2018-08-30,Michael,M,-37.90,145.18,0.0,,,,,,credit,posted,f66c22b581c742c78b1731ab15dddae8,PAY/SALARY,40-50,2018,8,30,15,0,Thursday,7 days,31094.35
ACC-2988263882,44,596.33,4725.52,,CUS-1233833708,2018-09-06,Michael,M,-37.90,145.18,0.0,,,,,,credit,posted,60289954e1f240fd87b37c6de51b3a6e,PAY/SALARY,40-50,2018,9,6,15,0,Thursday,7 days,31094.35
ACC-2988263882,44,596.33,5321.85,,CUS-1233833708,2018-09-13,Michael,M,-37.90,145.18,0.0,,,,,,credit,posted,16a5fdfbf55b43cca235f81b9579f9fb,PAY/SALARY,40-50,2018,9,13,15,0,Thursday,7 days,31094.35
ACC-2988263882,44,596.33,5721.18,,CUS-1233833708,2018-09-20,Michael,M,-37.90,145.18,0.0,,,,,,credit,posted,4a0904987f9841828fad5cdb0297211e,PAY/SALARY,40-50,2018,9,20,15,0,Thursday,7 days,31094.35
ACC-2988263882,44,596.33,6317.51,,CUS-1233833708,2018-09-27,Michael,M,-37.90,145.18,0.0,,,,,,credit,posted,05c7a76eb9a443a199c675713c66a63d,PAY/SALARY,40-50,2018,9,27,15,0,Thursday,7 days,31094.35
ACC-2988263882,44,596.33,6756.84,,CUS-1233833708,2018-10-04,Michael,M,-37.90,145.18,0.0,,,,,,credit,posted,79a347369c0145859fdf28f797496f5d,PAY/SALARY,40-50,2018,10,4,15,0,Thursday,7 days,31094.35
ACC-2988263882,44,596.33,6930.24,,CUS-1233833708,2018-10-11,Michael,M,-37.90,145.18,0.0,,,,,,credit,posted,9067b27279bb4077b62ec788a785c9bf,PAY/SALARY,40-50,2018,10,11,15,0,Thursday,7 days,31094.35
ACC-2988263882,44,596.33,7218.79,,CUS-1233833708,2018-10-18,Michael,M,-37.90,145.18,0.0,,,,,,credit,posted,d23b936e2d5549a1aeb77c290cc8c2be,PAY/SALARY,40-50,2018,10,18,15,0,Thursday,7 days,31094.35
ACC-2988263882,44,596.33,6564.12,,CUS-1233833708,2018-10-25,Michael,M,-37.90,145.18,0.0,,,,,,credit,posted,c18f443163a84db4bdced431c17388fb,PAY/SALARY,40-50,2018,10,25,15,0,Thursday,7 days,31094.35
ACC-2970114956,26,1433.98,6722.85,,CUS-880898248,2018-08-02,Robert,M,-37.69,144.89,0.0,,,,,,credit,posted,a1fcadbedbdc4895b0d77535ec72363d,PAY/SALARY,20-30,2018,8,2,15,0,Thursday,14 days,36668.91714285714
ACC-2970114956,26,1433.98,8039.71,,CUS-880898248,2018-08-30,Robert,M,-37.69,144.89,0.0,,,,,,credit,posted,615cd11c8e4a4edca03ae00c88176bea,PAY/SALARY,20-30,2018,8,30,15,0,Thursday,14 days,36668.91714285714
ACC-2970114956,26,1433.98,9286.53,,CUS-880898248,2018-09-13,Robert,M,-37.69,144.89,0.0,,,,,,credit,posted,4717d1016e074732a2b0ffe524049ef5,PAY/SALARY,20-30,2018,9,13,15,0,Thursday,14 days,36668.91714285714
ACC-2970114956,26,1433.98,10367.22,,CUS-880898248,2018-09-27,Robert,M,-37.69,144.89,0.0,,,,,,credit,posted,1bf56867696a4d9fbc2cdb239fdedf1a,PAY/SALARY,20-30,2018,9,27,15,0,Thursday,14 days,36668.91714285714
ACC-2970114956,26,1433.98,11491.1,,CUS-880898248,2018-10-11,Robert,M,-37.69,144.89,0.0,,,,,,credit,posted,dcbed64edf4e43dea7f453f511e2b3ad,PAY/SALARY,20-30,2018,10,11,15,0,Thursday,14 days,36668.91714285714
ACC-2970114956,26,1433.98,12426.87,,CUS-880898248,2018-10-25,Robert,M,-37.69,144.89,0.0,,,,,,credit,posted,424299897e94489abae3b3a1eb29cb62,PAY/SALARY,20-30,2018,10,25,15,0,Thursday,14 days,36668.91714285714
ACC-414431115,43,1630.36,1634.77,,CUS-2599279756,2018-08-02,Amy,F,-37.06,142.77,0.0,,,,,,credit,posted,4bc4bd009cab4de5b6734e66c9546b7f,PAY/SALARY,40-50,2018,8,2,16,0,Thursday,14 days,41071.83428571428
ACC-414431115,43,1630.36,2907.3,,CUS-2599279756,2018-08-30,Amy,F,-37.06,142.77,0.0,,,,,,credit,posted,3008b3e4f7f24c968581f3145a388676,PAY/SALARY,40-50,2018,8,30,16,0,Thursday,14 days,41071.83428571428
ACC-414431115,43,1630.36,4072.78,,CUS-2599279756,2018-09-13,Amy,F,-37.06,142.77,0.0,,,,,,credit,posted,80f909564aa3469ebf2e4a31303a3ab8,PAY/SALARY,40-50,2018,9,13,16,0,Thursday,14 days,41071.83428571428
ACC-414431115,43,1630.36,4824.83,,CUS-2599279756,2018-09-27,Amy,F,-37.06,142.77,0.0,,,,,,credit,posted,c5c82f9db9e148688cbd086d64bcf5e7,PAY/SALARY,40-50,2018,9,27,16,0,Thursday,14 days,41071.83428571428
ACC-414431115,43,1630.36,6055.88,,CUS-2599279756,2018-10-11,Amy,F,-37.06,142.77,0.0,,,,,,credit,posted,355681842092470a8501e35b3fffaf1a,PAY/SALARY,40-50,2018,10,11,16,0,Thursday,14 days,41071.83428571428
ACC-414431115,43,1630.36,6988.64,,CUS-2599279756,2018-10-25,Amy,F,-37.06,142.77,0.0,,,,,,credit,posted,a1f2848d6308429c946021b9b6326a2e,PAY/SALARY,40-50,2018,10,25,16,0,Thursday,14 days,41071.83428571428
ACC-3881031190,37,916.75,1361.79,,CUS-3201519139,2018-08-02,Richard,M,-21.15,149.19,0.0,,,,,,credit,posted,d8511e188e98407ca0a3ef7049aae01b,PAY/SALARY,30-40,2018,8,2,16,0,Thursday,7 days,47801.964
ACC-3881031190,37,916.75,1963.59,,CUS-3201519139,2018-08-09,Richard,M,-21.15,149.19,0.0,,,,,,credit,posted,e67de79c51304c5c90a7329c934e3951,PAY/SALARY,30-40,2018,8,9,16,0,Thursday,7 days,47801.964
ACC-3881031190,37,916.75,3797.09,,CUS-3201519139,2018-08-23,Richard,M,-21.15,149.19,0.0,,,,,,credit,posted,4d0594f8badd47a7ac9038c3c4afea9e,PAY/SALARY,30-40,2018,8,23,16,0,Thursday,7 days,47801.964
ACC-3881031190,37,916.75,4147.84,,CUS-3201519139,2018-08-30,Richard,M,-21.15,149.19,0.0,,,,,,credit,posted,dc2294ace86a47baa74dbf87f0ede740,PAY/SALARY,30-40,2018,8,30,16,0,Thursday,7 days,47801.964
ACC-3881031190,37,916.75,5064.59,,CUS-3201519139,2018-09-06,Richard,M,-21.15,149.19,0.0,,,,,,credit,posted,4158492367ed4b88a418e87f02c0ae41,PAY/SALARY,30-40,2018,9,6,16,0,Thursday,7 days,47801.964
ACC-3881031190,37,916.75,5981.34,,CUS-3201519139,2018-09-13,Richard,M,-21.15,149.19,0.0,,,,,,credit,posted,07845d0dd9e341f4938224f964598edb,PAY/SALARY,30-40,2018,9,13,16,0,Thursday,7 days,47801.964
ACC-3881031190,37,916.75,6898.09,,CUS-3201519139,2018-09-20,Richard,M,-21.15,149.19,0.0,,,,,,credit,posted,cb11546d9e654356bf0dd606c65151e9,PAY/SALARY,30-40,2018,9,20,16,0,Thursday,7 days,47801.964
ACC-3881031190,37,916.75,7728.84,,CUS-3201519139,2018-09-27,Richard,M,-21.15,149.19,0.0,,,,,,credit,posted,9402fe61b76d4a5dbab9fcb7955d2170,PAY/SALARY,30-40,2018,9,27,16,0,Thursday,7 days,47801.964
ACC-3881031190,37,916.75,8165.59,,CUS-3201519139,2018-10-04,Richard,M,-21.15,149.19,0.0,,,,,,credit,posted,84c207fb038f420bb96df6b0df36e02f,PAY/SALARY,30-40,2018,10,4,16,0,Thursday,7 days,47801.964
ACC-3881031190,37,916.75,9082.34,,CUS-3201519139,2018-10-11,Richard,M,-21.15,149.19,0.0,,,,,,credit,posted,3c36e7394919424f80fe0e4b83c9dff8,PAY/SALARY,30-40,2018,10,11,16,0,Thursday,7 days,47801.964
ACC-3881031190,37,916.75,8501.79,,CUS-3201519139,2018-10-18,Richard,M,-21.15,149.19,0.0,,,,,,credit,posted,680a8ffb6b1d49fab6858d0aa0a20336,PAY/SALARY,30-40,2018,10,18,16,0,Thursday,7 days,47801.964
ACC-3881031190,37,916.75,9332.54,,CUS-3201519139,2018-10-25,Richard,M,-21.15,149.19,0.0,,,,,,credit,posted,bc18d1eef23346b8b067c4641dc1e5ff,PAY/SALARY,30-40,2018,10,25,16,0,Thursday,7 days,47801.964
ACC-1056639002,22,3195.01,42790.09,,CUS-3462882033,2018-08-02,Michael,M,-37.91,145.03,0.0,,,,,,credit,posted,914c8d4832cc42b99a37b5218ba84a80,PAY/SALARY,20-30,2018,8,2,17,0,Thursday,14 days,81700.97
ACC-1056639002,22,3195.01,45948.47,,CUS-3462882033,2018-08-30,Michael,M,-37.91,145.03,0.0,,,,,,credit,posted,fa43714cbbef4af5bacd95f4762d8ff2,PAY/SALARY,20-30,2018,8,30,17,0,Thursday,14 days,81700.97
ACC-1056639002,22,3195.01,48555.95,,CUS-3462882033,2018-09-13,Michael,M,-37.91,145.03,0.0,,,,,,credit,posted,dd9ac8be24424a4ebc1f50193b12f139,PAY/SALARY,20-30,2018,9,13,17,0,Thursday,14 days,81700.97
ACC-1056639002,22,3195.01,50843.14,,CUS-3462882033,2018-09-27,Michael,M,-37.91,145.03,0.0,,,,,,credit,posted,0b818af153a94f0580e8d3b32b7d92da,PAY/SALARY,20-30,2018,9,27,17,0,Thursday,14 days,81700.97
ACC-1056639002,22,3195.01,53645.3,,CUS-3462882033,2018-10-11,Michael,M,-37.91,145.03,0.0,,,,,,credit,posted,dda41bbd09824a74a90137d3db9f0965,PAY/SALARY,20-30,2018,10,11,17,0,Thursday,14 days,81700.97
ACC-1056639002,22,3195.01,56525.54,,CUS-3462882033,2018-10-25,Michael,M,-37.91,145.03,0.0,,,,,,credit,posted,e32f1cd8333547079e088a95fa166aa8,PAY/SALARY,20-30,2018,10,25,17,0,Thursday,14 days,81700.97
ACC-53508546,35,725.32,1067.25,,CUS-72755508,2018-08-02,Kimberly,F,-33.76,150.62,0.0,,,,,,credit,posted,7573c2cb8ab44dffbfa85361990e13da,PAY/SALARY,30-40,2018,8,2,17,0,Thursday,7 days,37820.257
ACC-53508546,35,725.32,1698.46,,CUS-72755508,2018-08-09,Kimberly,F,-33.76,150.62,0.0,,,,,,credit,posted,83a9bb386c9d4dc588a62fa32dafebd2,PAY/SALARY,30-40,2018,8,9,17,0,Thursday,7 days,37820.257
ACC-53508546,35,725.32,2597.23,,CUS-72755508,2018-08-23,Kimberly,F,-33.76,150.62,0.0,,,,,,credit,posted,bf0e58900aa941dfa67b68c8daf57098,PAY/SALARY,30-40,2018,8,23,17,0,Thursday,7 days,37820.257
ACC-53508546,35,725.32,3312.68,,CUS-72755508,2018-08-30,Kimberly,F,-33.76,150.62,0.0,,,,,,credit,posted,2f11cd8a1b6b426caa5075921ff6c6dd,PAY/SALARY,30-40,2018,8,30,17,0,Thursday,7 days,37820.257
ACC-53508546,35,725.32,3997.71,,CUS-72755508,2018-09-06,Kimberly,F,-33.76,150.62,0.0,,,,,,credit,posted,0199e2cd0eb84bc796994d194dca0b90,PAY/SALARY,30-40,2018,9,6,17,0,Thursday,7 days,37820.257
ACC-53508546,35,725.32,4605.84,,CUS-72755508,2018-09-13,Kimberly,F,-33.76,150.62,0.0,,,,,,credit,posted,5dc68f968e924f81a94ca0546bd32fca,PAY/SALARY,30-40,2018,9,13,17,0,Thursday,7 days,37820.257
ACC-53508546,35,725.32,5264.22,,CUS-72755508,2018-09-20,Kimberly,F,-33.76,150.62,0.0,,,,,,credit,posted,813e64b2b003470b850338731d2226c3,PAY/SALARY,30-40,2018,9,20,17,0,Thursday,7 days,37820.257
ACC-53508546,35,725.32,5974.5,,CUS-72755508,2018-09-27,Kimberly,F,-33.76,150.62,0.0,,,,,,credit,posted,0ae6376c67ad43619a46fd7582dd9be4,PAY/SALARY,30-40,2018,9,27,17,0,Thursday,7 days,37820.257
ACC-53508546,35,725.32,6566.87,,CUS-72755508,2018-10-04,Kimberly,F,-33.76,150.62,0.0,,,,,,credit,posted,afa3917eacd545eeaad9d925cec54e8d,PAY/SALARY,30-40,2018,10,4,17,0,Thursday,7 days,37820.257
ACC-53508546,35,725.32,5896.25,,CUS-72755508,2018-10-11,Kimberly,F,-33.76,150.62,0.0,,,,,,credit,posted,c0e996c64b6647cb9e363f58c07e6175,PAY/SALARY,30-40,2018,10,11,17,0,Thursday,7 days,37820.257
ACC-53508546,35,725.32,6560.03,,CUS-72755508,2018-10-18,Kimberly,F,-33.76,150.62,0.0,,,,,,credit,posted,5e72ede2d6db439cbc706e1bf3c84bb3,PAY/SALARY,30-40,2018,10,18,17,0,Thursday,7 days,37820.257
ACC-53508546,35,725.32,7163.07,,CUS-72755508,2018-10-25,Kimberly,F,-33.76,150.62,0.0,,,,,,credit,posted,663eadefacc64323966b8bb02f704a16,PAY/SALARY,30-40,2018,10,25,17,0,Thursday,7 days,37820.257
ACC-38923874,38,1880.95,30334.82,,CUS-3249305314,2018-08-03,Ryan,M,-33.90,151.27,0.0,,,,,,credit,posted,52824d9919d94bdc9e8c4552e8358b46,PAY/SALARY,30-40,2018,8,3,11,0,Friday,7 days,98078.107
ACC-38923874,38,1880.95,31600.84,,CUS-3249305314,2018-08-10,Ryan,M,-33.90,151.27,0.0,,,,,,credit,posted,a923418069464173aa2f810a2dbd8096,PAY/SALARY,30-40,2018,8,10,11,0,Friday,7 days,98078.107
ACC-38923874,38,1880.95,33238.34,,CUS-3249305314,2018-08-17,Ryan,M,-33.90,151.27,0.0,,,,,,credit,posted,8ece5fac2fb3406f94ecdb2cef634a5a,PAY/SALARY,30-40,2018,8,17,11,0,Friday,7 days,98078.107
ACC-38923874,38,1880.95,34933.29,,CUS-3249305314,2018-08-24,Ryan,M,-33.90,151.27,0.0,,,,,,credit,posted,ba985872615a444e8b30d1b07552e6da,PAY/SALARY,30-40,2018,8,24,11,0,Friday,7 days,98078.107
ACC-38923874,38,1880.95,36558.24,,CUS-3249305314,2018-08-31,Ryan,M,-33.90,151.27,0.0,,,,,,credit,posted,a7829be099c14536a77ccd456e4c938b,PAY/SALARY,30-40,2018,8,31,11,0,Friday,7 days,98078.107
ACC-38923874,38,1880.95,37879.54,,CUS-3249305314,2018-09-07,Ryan,M,-33.90,151.27,0.0,,,,,,credit,posted,10e1d913c37a478cb2c000d36ad29cf2,PAY/SALARY,30-40,2018,9,7,11,0,Friday,7 days,98078.107
ACC-38923874,38,1880.95,39591.31,,CUS-3249305314,2018-09-14,Ryan,M,-33.90,151.27,0.0,,,,,,credit,posted,3f180c26a7dd48f385f214fb789d5ee0,PAY/SALARY,30-40,2018,9,14,11,0,Friday,7 days,98078.107
ACC-38923874,38,1880.95,40947.46,,CUS-3249305314,2018-09-21,Ryan,M,-33.90,151.27,0.0,,,,,,credit,posted,1db77dedff52498d86b074f2902e07ec,PAY/SALARY,30-40,2018,9,21,11,0,Friday,7 days,98078.107
ACC-38923874,38,1880.95,42501.36,,CUS-3249305314,2018-09-28,Ryan,M,-33.90,151.27,0.0,,,,,,credit,posted,0761283aa87f4f09b0a1779b195beafe,PAY/SALARY,30-40,2018,9,28,11,0,Friday,7 days,98078.107
ACC-38923874,38,1880.95,44205.31,,CUS-3249305314,2018-10-05,Ryan,M,-33.90,151.27,0.0,,,,,,credit,posted,6f09a343bbba4f2a9293de748ad7ce93,PAY/SALARY,30-40,2018,10,5,11,0,Friday,7 days,98078.107
ACC-38923874,38,1880.95,45539.67,,CUS-3249305314,2018-10-12,Ryan,M,-33.90,151.27,0.0,,,,,,credit,posted,655695c2d2b54785ab0010d75cdb4849,PAY/SALARY,30-40,2018,10,12,11,0,Friday,7 days,98078.107
ACC-38923874,38,1880.95,43783.52,,CUS-3249305314,2018-10-19,Ryan,M,-33.90,151.27,0.0,,,,,,credit,posted,22cf6b9739e74b40a3247e329e1b6252,PAY/SALARY,30-40,2018,10,19,11,0,Friday,7 days,98078.107
ACC-38923874,38,1880.95,45032.02,,CUS-3249305314,2018-10-26,Ryan,M,-33.90,151.27,0.0,,,,,,credit,posted,b30130e82f0c435f8fb986a60d7a7220,PAY/SALARY,30-40,2018,10,26,11,0,Friday,7 days,98078.107
ACC-3689607373,20,1138.79,2205.14,,CUS-127297539,2018-08-03,Virginia,F,-31.79,115.79,0.0,,,,,,credit,posted,d4cad175b44e49f58af829b61dbd3f9c,PAY/SALARY,<20,2018,8,3,12,0,Friday,7 days,59379.764
ACC-3689607373,20,1138.79,2977.83,,CUS-127297539,2018-08-10,Virginia,F,-31.79,115.79,0.0,,,,,,credit,posted,ebe40d784c0d4375affef16bad73e43f,PAY/SALARY,<20,2018,8,10,12,0,Friday,7 days,59379.764
ACC-3689607373,20,1138.79,3885.62,,CUS-127297539,2018-08-17,Virginia,F,-31.79,115.79,0.0,,,,,,credit,posted,78abc2ea1c7b471e9e7bb1e5e0c87e3e,PAY/SALARY,<20,2018,8,17,12,0,Friday,7 days,59379.764
ACC-3689607373,20,1138.79,4567.32,,CUS-127297539,2018-08-24,Virginia,F,-31.79,115.79,0.0,,,,,,credit,posted,cd61bab5a5684ab694b6c763c7b96a4c,PAY/SALARY,<20,2018,8,24,12,0,Friday,7 days,59379.764
ACC-3689607373,20,1138.79,4999.83,,CUS-127297539,2018-08-31,Virginia,F,-31.79,115.79,0.0,,,,,,credit,posted,776eb3e74b534b8cbb6ab81196273bba,PAY/SALARY,<20,2018,8,31,12,0,Friday,7 days,59379.764
ACC-3689607373,20,1138.79,5127.85,,CUS-127297539,2018-09-07,Virginia,F,-31.79,115.79,0.0,,,,,,credit,posted,518de3e4f8664570b2ec59bb3e7fb5b3,PAY/SALARY,<20,2018,9,7,12,0,Friday,7 days,59379.764
ACC-3689607373,20,1138.79,5961.22,,CUS-127297539,2018-09-14,Virginia,F,-31.79,115.79,0.0,,,,,,credit,posted,41692d21b6eb433ea2a5f190da1873e5,PAY/SALARY,<20,2018,9,14,12,0,Friday,7 days,59379.764
ACC-3689607373,20,1138.79,6614.3,,CUS-127297539,2018-09-21,Virginia,F,-31.79,115.79,0.0,,,,,,credit,posted,e54a44b125104803acc4e47aeb1aedf4,PAY/SALARY,<20,2018,9,21,12,0,Friday,7 days,59379.764
ACC-3689607373,20,1138.79,7374.67,,CUS-127297539,2018-09-28,Virginia,F,-31.79,115.79,0.0,,,,,,credit,posted,21d1c35b53f442ddbc376adf27118957,PAY/SALARY,<20,2018,9,28,12,0,Friday,7 days,59379.764
ACC-3689607373,20,1138.79,7952.89,,CUS-127297539,2018-10-05,Virginia,F,-31.79,115.79,0.0,,,,,,credit,posted,6d4f8c218ba647a68bc3d883263317ab,PAY/SALARY,<20,2018,10,5,12,0,Friday,7 days,59379.764
ACC-3689607373,20,1138.79,7716.77,,CUS-127297539,2018-10-12,Virginia,F,-31.79,115.79,0.0,,,,,,credit,posted,a4fe589fadc7435db8c7bc03075b51f4,PAY/SALARY,<20,2018,10,12,12,0,Friday,7 days,59379.764
ACC-3689607373,20,1138.79,8236.54,,CUS-127297539,2018-10-19,Virginia,F,-31.79,115.79,0.0,,,,,,credit,posted,5da79d054a1d4c6db216bc301a909d67,PAY/SALARY,<20,2018,10,19,12,0,Friday,7 days,59379.764
ACC-3689607373,20,1138.79,9068.07,,CUS-127297539,2018-10-26,Virginia,F,-31.79,115.79,0.0,,,,,,credit,posted,ee30c05d28544a908eda8efe78f90477,PAY/SALARY,<20,2018,10,26,12,0,Friday,7 days,59379.764
ACC-2890243754,37,917.45,1072.04,,CUS-2695611575,2018-08-03,Joseph,M,-27.93,153.32,0.0,,,,,,credit,posted,f426bde403ae4ad5baf2fb5b5afabf67,PAY/SALARY,30-40,2018,8,3,12,0,Friday,7 days,47838.464
ACC-2890243754,37,917.45,1751.92,,CUS-2695611575,2018-08-10,Joseph,M,-27.93,153.32,0.0,,,,,,credit,posted,76d5e5c4660e4eb1856700e6375adf04,PAY/SALARY,30-40,2018,8,10,12,0,Friday,7 days,47838.464
ACC-2890243754,37,917.45,2173.88,,CUS-2695611575,2018-08-17,Joseph,M,-27.93,153.32,0.0,,,,,,credit,posted,96e7b205c91d4764937b8961e98b18c1,PAY/SALARY,30-40,2018,8,17,12,0,Friday,7 days,47838.464
ACC-2890243754,37,917.45,2632.57,,CUS-2695611575,2018-08-24,Joseph,M,-27.93,153.32,0.0,,,,,,credit,posted,398751777db14965971e2370b998c715,PAY/SALARY,30-40,2018,8,24,12,0,Friday,7 days,47838.464
ACC-2890243754,37,917.45,3046.63,,CUS-2695611575,2018-08-31,Joseph,M,-27.93,153.32,0.0,,,,,,credit,posted,45eb88c070ba4b1390de775db62d5a69,PAY/SALARY,30-40,2018,8,31,12,0,Friday,7 days,47838.464
ACC-2890243754,37,917.45,3654.88,,CUS-2695611575,2018-09-07,Joseph,M,-27.93,153.32,0.0,,,,,,credit,posted,1aae1f3957f64195a8ed52daa463b3aa,PAY/SALARY,30-40,2018,9,7,12,0,Friday,7 days,47838.464
ACC-2890243754,37,917.45,4011.36,,CUS-2695611575,2018-09-14,Joseph,M,-27.93,153.32,0.0,,,,,,credit,posted,dd77339eb1b74e498c22e162dea03e16,PAY/SALARY,30-40,2018,9,14,12,0,Friday,7 days,47838.464
ACC-2890243754,37,917.45,4630.53,,CUS-2695611575,2018-09-21,Joseph,M,-27.93,153.32,0.0,,,,,,credit,posted,ac211ba3517541ec879df2b72553eea5,PAY/SALARY,30-40,2018,9,21,12,0,Friday,7 days,47838.464
ACC-2890243754,37,917.45,4734.04,,CUS-2695611575,2018-09-28,Joseph,M,-27.93,153.32,0.0,,,,,,credit,posted,f8e726b409a74e26bfe67b179f1d5268,PAY/SALARY,30-40,2018,9,28,12,0,Friday,7 days,47838.464
ACC-2890243754,37,917.45,5281.59,,CUS-2695611575,2018-10-05,Joseph,M,-27.93,153.32,0.0,,,,,,credit,posted,f06098e9568143c5977a0a94383136a8,PAY/SALARY,30-40,2018,10,5,12,0,Friday,7 days,47838.464
ACC-2890243754,37,917.45,1911.03,,CUS-2695611575,2018-10-12,Joseph,M,-27.93,153.32,0.0,,,,,,credit,posted,1cdbc7ae2de143f2bebefdb0b9b81e21,PAY/SALARY,30-40,2018,10,12,12,0,Friday,7 days,47838.464
ACC-2890243754,37,917.45,2293.8,,CUS-2695611575,2018-10-19,Joseph,M,-27.93,153.32,0.0,,,,,,credit,posted,a559efbbf19f40aea79058f7bed954fc,PAY/SALARY,30-40,2018,10,19,12,0,Friday,7 days,47838.464
ACC-2890243754,37,917.45,2680.4,,CUS-2695611575,2018-10-26,Joseph,M,-27.93,153.32,0.0,,,,,,credit,posted,ab567a84f5444da4b1f870c332a01539,PAY/SALARY,30-40,2018,10,26,12,0,Friday,7 days,47838.464
ACC-1788473090,21,2023.68,2273.3,,CUS-134193016,2018-08-03,Rachael,F,-37.95,145.06,0.0,,,,,,credit,posted,ad0a0c17620f4553be4426a9933181f9,PAY/SALARY,20-30,2018,8,3,13,0,Friday,14 days,52760.229
ACC-1788473090,21,2023.68,3830.37,,CUS-134193016,2018-08-17,Rachael,F,-37.95,145.06,0.0,,,,,,credit,posted,ca932331b54d4cb4ac3659ad2ab18294,PAY/SALARY,20-30,2018,8,17,13,0,Friday,14 days,52760.229
ACC-1788473090,21,2023.68,5280.9,,CUS-134193016,2018-08-31,Rachael,F,-37.95,145.06,0.0,,,,,,credit,posted,df26ec928b604d1290bb4d2f797c4efc,PAY/SALARY,20-30,2018,8,31,13,0,Friday,14 days,52760.229
ACC-1788473090,21,2023.68,7066.58,,CUS-134193016,2018-09-14,Rachael,F,-37.95,145.06,0.0,,,,,,credit,posted,45abfcf4a6484fdc963d0846a41de0fc,PAY/SALARY,20-30,2018,9,14,13,0,Friday,14 days,52760.229
ACC-1788473090,21,2023.68,8577.56,,CUS-134193016,2018-09-28,Rachael,F,-37.95,145.06,0.0,,,,,,credit,posted,7805178f2d55475b98fe5d8bb4390e3a,PAY/SALARY,20-30,2018,9,28,13,0,Friday,14 days,52760.229
ACC-1788473090,21,2023.68,9926.89,,CUS-134193016,2018-10-12,Rachael,F,-37.95,145.06,0.0,,,,,,credit,posted,f1a1ffd9c8724371852ed3545818141b,PAY/SALARY,20-30,2018,10,12,13,0,Friday,14 days,52760.229
ACC-1788473090,21,2023.68,11506.49,,CUS-134193016,2018-10-26,Rachael,F,-37.95,145.06,0.0,,,,,,credit,posted,26c5b005b0e44c6384129ac0d87f1a75,PAY/SALARY,20-30,2018,10,26,13,0,Friday,14 days,52760.229
ACC-1199531521,52,3785.78,3801.41,,CUS-134833760,2018-08-03,Billy,M,-31.87,116.02,0.0,,,,,,credit,posted,6b84057bbf1a4ade865af4902c7517d8,PAY/SALARY,50-60,2018,8,3,13,0,Friday,14 days,98700.693
ACC-1199531521,52,3785.78,6941.28,,CUS-134833760,2018-08-17,Billy,M,-31.87,116.02,0.0,,,,,,credit,posted,c6ec65bc1f0f43109ba71d095afb7d34,PAY/SALARY,50-60,2018,8,17,13,0,Friday,14 days,98700.693
ACC-1199531521,52,3785.78,10176.4,,CUS-134833760,2018-08-31,Billy,M,-31.87,116.02,0.0,,,,,,credit,posted,8f92f3ea88fb456f8da40dafdfb879e4,PAY/SALARY,50-60,2018,8,31,13,0,Friday,14 days,98700.693
ACC-1199531521,52,3785.78,12848.72,,CUS-134833760,2018-09-14,Billy,M,-31.87,116.02,0.0,,,,,,credit,posted,45985033103147e1bb946e964b3135b1,PAY/SALARY,50-60,2018,9,14,13,0,Friday,14 days,98700.693
ACC-1199531521,52,3785.78,14490.97,,CUS-134833760,2018-09-28,Billy,M,-31.87,116.02,0.0,,,,,,credit,posted,d331c00099a5449195c41a0fc6324522,PAY/SALARY,50-60,2018,9,28,13,0,Friday,14 days,98700.693
ACC-1199531521,52,3785.78,17697.63,,CUS-134833760,2018-10-12,Billy,M,-31.87,116.02,0.0,,,,,,credit,posted,673eca6c8c144949b63295890727ff4d,PAY/SALARY,50-60,2018,10,12,13,0,Friday,14 days,98700.693
ACC-1199531521,52,3785.78,20941.64,,CUS-134833760,2018-10-26,Billy,M,-31.87,116.02,0.0,,,,,,credit,posted,f7fe613453934cf0b130c4f9c23ba55b,PAY/SALARY,50-60,2018,10,26,13,0,Friday,14 days,98700.693
ACC-559365433,64,576.0,735.66,,CUS-1654129794,2018-08-03,Mary,F,-42.88,147.31,0.0,,,,,,credit,posted,1157f87317a44c3aaf851d2e1b42ac37,PAY/SALARY,60-70,2018,8,3,13,0,Friday,7 days,30034.286
ACC-559365433,64,576.0,1256.9,,CUS-1654129794,2018-08-10,Mary,F,-42.88,147.31,0.0,,,,,,credit,posted,8d9329c7dff0494e9d232fd01538f580,PAY/SALARY,60-70,2018,8,10,13,0,Friday,7 days,30034.286
ACC-559365433,64,576.0,1540.22,,CUS-1654129794,2018-08-17,Mary,F,-42.88,147.31,0.0,,,,,,credit,posted,2b436f657bce4ce0b44a1583fea06a58,PAY/SALARY,60-70,2018,8,17,13,0,Friday,7 days,30034.286
ACC-559365433,64,576.0,1840.66,,CUS-1654129794,2018-08-24,Mary,F,-42.88,147.31,0.0,,,,,,credit,posted,dc9750fd810e494bb80f9323b417bea1,PAY/SALARY,60-70,2018,8,24,13,0,Friday,7 days,30034.286
ACC-559365433,64,576.0,2373.44,,CUS-1654129794,2018-08-31,Mary,F,-42.88,147.31,0.0,,,,,,credit,posted,f65d420896c2449abd8c02ffb9bd952a,PAY/SALARY,60-70,2018,8,31,13,0,Friday,7 days,30034.286
ACC-559365433,64,576.0,2403.78,,CUS-1654129794,2018-09-07,Mary,F,-42.88,147.31,0.0,,,,,,credit,posted,32f6d713bf9a4530963f6539a01ef621,PAY/SALARY,60-70,2018,9,7,13,0,Friday,7 days,30034.286
ACC-559365433,64,576.0,2491.69,,CUS-1654129794,2018-09-14,Mary,F,-42.88,147.31,0.0,,,,,,credit,posted,ede278d15cbb4c9a8a52f19562f19e6e,PAY/SALARY,60-70,2018,9,14,13,0,Friday,7 days,30034.286
ACC-559365433,64,576.0,3037.69,,CUS-1654129794,2018-09-21,Mary,F,-42.88,147.31,0.0,,,,,,credit,posted,fe3792bffa7542c89e9753e4a9822a3e,PAY/SALARY,60-70,2018,9,21,13,0,Friday,7 days,30034.286
ACC-559365433,64,576.0,3583.69,,CUS-1654129794,2018-09-28,Mary,F,-42.88,147.31,0.0,,,,,,credit,posted,2730ecdebe0747e6a45f973adf843a91,PAY/SALARY,60-70,2018,9,28,13,0,Friday,7 days,30034.286
ACC-559365433,64,576.0,3997.67,,CUS-1654129794,2018-10-05,Mary,F,-42.88,147.31,0.0,,,,,,credit,posted,2a418362e77a44f9af2611f0676e83b3,PAY/SALARY,60-70,2018,10,5,13,0,Friday,7 days,30034.286
ACC-559365433,64,576.0,4316.68,,CUS-1654129794,2018-10-12,Mary,F,-42.88,147.31,0.0,,,,,,credit,posted,638b943bbc2341bfaac2a7c331b7d3ae,PAY/SALARY,60-70,2018,10,12,13,0,Friday,7 days,30034.286
ACC-559365433,64,576.0,4241.98,,CUS-1654129794,2018-10-19,Mary,F,-42.88,147.31,0.0,,,,,,credit,posted,45127f74b9dc4f598b888488b0b78489,PAY/SALARY,60-70,2018,10,19,13,0,Friday,7 days,30034.286
ACC-559365433,64,576.0,4671.32,,CUS-1654129794,2018-10-26,Mary,F,-42.88,147.31,0.0,,,,,,credit,posted,26b1f45ae6ff425e9d23de19d53de83c,PAY/SALARY,60-70,2018,10,26,13,0,Friday,7 days,30034.286
ACC-3481401842,25,1225.33,1438.7,,CUS-1669695324,2018-08-03,Tiffany,F,-31.72,115.74,0.0,,,,,,credit,posted,b062082c5e7a4cb8b4fbcaf83f709b6c,PAY/SALARY,20-30,2018,8,3,13,0,Friday,7 days,63892.207
ACC-3481401842,25,1225.33,1894.28,,CUS-1669695324,2018-08-10,Tiffany,F,-31.72,115.74,0.0,,,,,,credit,posted,5a5d11cc5cae4c74a3b8bab5520b066e,PAY/SALARY,20-30,2018,8,10,13,0,Friday,7 days,63892.207
ACC-3481401842,25,1225.33,2300.25,,CUS-1669695324,2018-08-17,Tiffany,F,-31.72,115.74,0.0,,,,,,credit,posted,93d2f3f2acf546158512b5ddcdb769ed,PAY/SALARY,20-30,2018,8,17,13,0,Friday,7 days,63892.207
ACC-3481401842,25,1225.33,3354.01,,CUS-1669695324,2018-08-24,Tiffany,F,-31.72,115.74,0.0,,,,,,credit,posted,c45812e07135447e9d6ff06bf29fe9b5,PAY/SALARY,20-30,2018,8,24,13,0,Friday,7 days,63892.207
ACC-3481401842,25,1225.33,4306.38,,CUS-1669695324,2018-08-31,Tiffany,F,-31.72,115.74,0.0,,,,,,credit,posted,8d2d1cca8ab54090adbf51db90a212a0,PAY/SALARY,20-30,2018,8,31,13,0,Friday,7 days,63892.207
ACC-3481401842,25,1225.33,4337.41,,CUS-1669695324,2018-09-07,Tiffany,F,-31.72,115.74,0.0,,,,,,credit,posted,dfb2d00ff217456eb0b7b8426ca37116,PAY/SALARY,20-30,2018,9,7,13,0,Friday,7 days,63892.207
ACC-3481401842,25,1225.33,5187.29,,CUS-1669695324,2018-09-14,Tiffany,F,-31.72,115.74,0.0,,,,,,credit,posted,b42a029b97cc43249a9d57333b4bc65d,PAY/SALARY,20-30,2018,9,14,13,0,Friday,7 days,63892.207
ACC-3481401842,25,1225.33,6113.27,,CUS-1669695324,2018-09-21,Tiffany,F,-31.72,115.74,0.0,,,,,,credit,posted,71a18cb086324ca4ac4c67abfdbdb78b,PAY/SALARY,20-30,2018,9,21,13,0,Friday,7 days,63892.207
ACC-3481401842,25,1225.33,6407.21,,CUS-1669695324,2018-09-28,Tiffany,F,-31.72,115.74,0.0,,,,,,credit,posted,7944cd43721642ab86fc66416a1211f0,PAY/SALARY,20-30,2018,9,28,13,0,Friday,7 days,63892.207
ACC-3481401842,25,1225.33,7172.3,,CUS-1669695324,2018-10-05,Tiffany,F,-31.72,115.74,0.0,,,,,,credit,posted,05b464e7ed4a4690a126bca138fe2877,PAY/SALARY,20-30,2018,10,5,13,0,Friday,7 days,63892.207
ACC-3481401842,25,1225.33,7668.99,,CUS-1669695324,2018-10-12,Tiffany,F,-31.72,115.74,0.0,,,,,,credit,posted,dceafdf4f31147d09c8aceefb6c3a082,PAY/SALARY,20-30,2018,10,12,13,0,Friday,7 days,63892.207
ACC-3481401842,25,1225.33,8302.41,,CUS-1669695324,2018-10-19,Tiffany,F,-31.72,115.74,0.0,,,,,,credit,posted,89900560493f4877ac5b67987d2bb733,PAY/SALARY,20-30,2018,10,19,13,0,Friday,7 days,63892.207
ACC-3481401842,25,1225.33,9233.14,,CUS-1669695324,2018-10-26,Tiffany,F,-31.72,115.74,0.0,,,,,,credit,posted,e7a3fd8af7d64276a6bb3cc6fb8ceab8,PAY/SALARY,20-30,2018,10,26,13,0,Friday,7 days,63892.207
ACC-2528867619,40,1946.57,1956.58,,CUS-2505971401,2018-08-03,Abigail,F,-34.96,138.58,0.0,,,,,,credit,posted,054edd9467e243038678e15d90817862,PAY/SALARY,30-40,2018,8,3,13,0,Friday,7 days,101499.721
ACC-2528867619,40,1946.57,3566.25,,CUS-2505971401,2018-08-10,Abigail,F,-34.96,138.58,0.0,,,,,,credit,posted,8c0c8e7aeabd4865ba874093306dbac4,PAY/SALARY,30-40,2018,8,10,13,0,Friday,7 days,101499.721
ACC-2528867619,40,1946.57,5075.31,,CUS-2505971401,2018-08-17,Abigail,F,-34.96,138.58,0.0,,,,,,credit,posted,26795b712fa142b58a636d823b5e0191,PAY/SALARY,30-40,2018,8,17,13,0,Friday,7 days,101499.721
ACC-2528867619,40,1946.57,6711.74,,CUS-2505971401,2018-08-24,Abigail,F,-34.96,138.58,0.0,,,,,,credit,posted,fb732c8fc3904949a1d7a5103195cd52,PAY/SALARY,30-40,2018,8,24,13,0,Friday,7 days,101499.721
ACC-2528867619,40,1946.57,8532.43,,CUS-2505971401,2018-08-31,Abigail,F,-34.96,138.58,0.0,,,,,,credit,posted,8e1bad39009c4356aef19c44de6bae7b,PAY/SALARY,30-40,2018,8,31,13,0,Friday,7 days,101499.721
ACC-2528867619,40,1946.57,10201.9,,CUS-2505971401,2018-09-07,Abigail,F,-34.96,138.58,0.0,,,,,,credit,posted,9e143db5f523403cb161b094a32b8a13,PAY/SALARY,30-40,2018,9,7,13,0,Friday,7 days,101499.721
ACC-2528867619,40,1946.57,11526.36,,CUS-2505971401,2018-09-14,Abigail,F,-34.96,138.58,0.0,,,,,,credit,posted,4991c80eb8e94be881eb27a9c3428f7f,PAY/SALARY,30-40,2018,9,14,13,0,Friday,7 days,101499.721
ACC-2528867619,40,1946.57,13179.17,,CUS-2505971401,2018-09-21,Abigail,F,-34.96,138.58,0.0,,,,,,credit,posted,fb10516e88af4a2d905b7f3b4775fc8e,PAY/SALARY,30-40,2018,9,21,13,0,Friday,7 days,101499.721
ACC-2528867619,40,1946.57,14874.05,,CUS-2505971401,2018-09-28,Abigail,F,-34.96,138.58,0.0,,,,,,credit,posted,b3698c4da8dc48d1ac85e91e2eec3504,PAY/SALARY,30-40,2018,9,28,13,0,Friday,7 days,101499.721
ACC-2528867619,40,1946.57,16629.46,,CUS-2505971401,2018-10-05,Abigail,F,-34.96,138.58,0.0,,,,,,credit,posted,ec9bc910d4c5430cbdd75d9f8095e836,PAY/SALARY,30-40,2018,10,5,13,0,Friday,7 days,101499.721
ACC-2528867619,40,1946.57,17999.41,,CUS-2505971401,2018-10-12,Abigail,F,-34.96,138.58,0.0,,,,,,credit,posted,b75f0ae79bf14d728db68c23bb13ecb5,PAY/SALARY,30-40,2018,10,12,13,0,Friday,7 days,101499.721
ACC-2528867619,40,1946.57,19628.0,,CUS-2505971401,2018-10-19,Abigail,F,-34.96,138.58,0.0,,,,,,credit,posted,06d1ce95c69d40c0950878e6b1f3f474,PAY/SALARY,30-40,2018,10,19,13,0,Friday,7 days,101499.721
ACC-2528867619,40,1946.57,21213.46,,CUS-2505971401,2018-10-26,Abigail,F,-34.96,138.58,0.0,,,,,,credit,posted,85f0eef2dc9d4bd4b2cfa41e35c2bb6a,PAY/SALARY,30-40,2018,10,26,13,0,Friday,7 days,101499.721
ACC-2674800293,50,1436.98,25689.87,,CUS-2977593493,2018-08-03,Elizabeth,F,-37.69,144.96,0.0,,,,,,credit,posted,d97f03cabe1545e0afde5158417f03ea,PAY/SALARY,40-50,2018,8,3,14,0,Friday,14 days,37464.121
ACC-2674800293,50,1436.98,26639.12,,CUS-2977593493,2018-08-17,Elizabeth,F,-37.69,144.96,0.0,,,,,,credit,posted,72abab20f77041459f01494e95899b82,PAY/SALARY,40-50,2018,8,17,14,0,Friday,14 days,37464.121
ACC-2674800293,50,1436.98,28076.1,,CUS-2977593493,2018-08-31,Elizabeth,F,-37.69,144.96,0.0,,,,,,credit,posted,a8cb7f41af97447e806d4de1a51f88e4,PAY/SALARY,40-50,2018,8,31,14,0,Friday,14 days,37464.121
ACC-2674800293,50,1436.98,28444.11,,CUS-2977593493,2018-09-14,Elizabeth,F,-37.69,144.96,0.0,,,,,,credit,posted,9185a7bc20fd4958a7b7f8744321fde4,PAY/SALARY,40-50,2018,9,14,14,0,Friday,14 days,37464.121
ACC-2674800293,50,1436.98,28733.62,,CUS-2977593493,2018-09-28,Elizabeth,F,-37.69,144.96,0.0,,,,,,credit,posted,8c6ca247e4904071a9efe04a0c55a27b,PAY/SALARY,40-50,2018,9,28,14,0,Friday,14 days,37464.121
ACC-2674800293,50,1436.98,29795.19,,CUS-2977593493,2018-10-12,Elizabeth,F,-37.69,144.96,0.0,,,,,,credit,posted,ec6752fc867947bb81c32ab42f77f789,PAY/SALARY,40-50,2018,10,12,14,0,Friday,14 days,37464.121
ACC-2674800293,50,1436.98,30873.87,,CUS-2977593493,2018-10-26,Elizabeth,F,-37.69,144.96,0.0,,,,,,credit,posted,7c6e3b6ce7d74e9f931c4cdfa3eb3a64,PAY/SALARY,40-50,2018,10,26,14,0,Friday,14 days,37464.121
ACC-182446574,27,2840.15,2889.9,,CUS-3026014945,2018-08-03,Tonya,F,-32.00,116.06,0.0,,,,,,credit,posted,3d5a45a23ced48a29535212323a100e9,PAY/SALARY,20-30,2018,8,3,15,0,Friday,14 days,74046.768
ACC-182446574,27,2840.15,4739.35,,CUS-3026014945,2018-08-17,Tonya,F,-32.00,116.06,0.0,,,,,,credit,posted,b186a7531fc54e3cb9bc8b93f50be214,PAY/SALARY,20-30,2018,8,17,15,0,Friday,14 days,74046.768
ACC-182446574,27,2840.15,5392.21,,CUS-3026014945,2018-08-31,Tonya,F,-32.00,116.06,0.0,,,,,,credit,posted,7bd46e8199df4f10aaf42ec30b9ffe25,PAY/SALARY,20-30,2018,8,31,15,0,Friday,14 days,74046.768
ACC-182446574,27,2840.15,7453.73,,CUS-3026014945,2018-09-14,Tonya,F,-32.00,116.06,0.0,,,,,,credit,posted,86d954a4770c496c879893d321622e16,PAY/SALARY,20-30,2018,9,14,15,0,Friday,14 days,74046.768
ACC-182446574,27,2840.15,8287.07,,CUS-3026014945,2018-09-28,Tonya,F,-32.00,116.06,0.0,,,,,,credit,posted,1cdcd3b0262f4b7e90d37da08415706f,PAY/SALARY,20-30,2018,9,28,15,0,Friday,14 days,74046.768
ACC-182446574,27,2840.15,9707.53,,CUS-3026014945,2018-10-12,Tonya,F,-32.00,116.06,0.0,,,,,,credit,posted,a11774ec3da64cff9c2379d8b83bb17e,PAY/SALARY,20-30,2018,10,12,15,0,Friday,14 days,74046.768
ACC-182446574,27,2840.15,11553.31,,CUS-3026014945,2018-10-26,Tonya,F,-32.00,116.06,0.0,,,,,,credit,posted,7ad3b175697448978f54c879266d555e,PAY/SALARY,20-30,2018,10,26,15,0,Friday,14 days,74046.768
ACC-3741880913,25,2282.36,5042.78,,CUS-1220154422,2018-08-03,Ashley,F,-23.40,150.50,0.0,,,,,,credit,posted,f481205971f5419d98e5353fa8ecffb3,PAY/SALARY,20-30,2018,8,3,16,0,Friday,14 days,59504.386
ACC-3741880913,25,2282.36,6095.16,,CUS-1220154422,2018-08-17,Ashley,F,-23.40,150.50,0.0,,,,,,credit,posted,d7709442d6f84d2a8c2b95d1083f0590,PAY/SALARY,20-30,2018,8,17,16,0,Friday,14 days,59504.386
ACC-3741880913,25,2282.36,8239.4,,CUS-1220154422,2018-08-31,Ashley,F,-23.40,150.50,0.0,,,,,,credit,posted,a241350330274e5f8f16fed5eb37b5e8,PAY/SALARY,20-30,2018,8,31,16,0,Friday,14 days,59504.386
ACC-3741880913,25,2282.36,9316.39,,CUS-1220154422,2018-09-14,Ashley,F,-23.40,150.50,0.0,,,,,,credit,posted,a1bc6857bd66437884d36436dfeba733,PAY/SALARY,20-30,2018,9,14,16,0,Friday,14 days,59504.386
ACC-3741880913,25,2282.36,10368.02,,CUS-1220154422,2018-09-28,Ashley,F,-23.40,150.50,0.0,,,,,,credit,posted,207d411d82c44ead9fc49c4e4b363d50,PAY/SALARY,20-30,2018,9,28,16,0,Friday,14 days,59504.386
ACC-3741880913,25,2282.36,12061.0,,CUS-1220154422,2018-10-12,Ashley,F,-23.40,150.50,0.0,,,,,,credit,posted,f5d60ffc7db34721868c1df131dc9297,PAY/SALARY,20-30,2018,10,12,16,0,Friday,14 days,59504.386
ACC-3741880913,25,2282.36,13458.6,,CUS-1220154422,2018-10-26,Ashley,F,-23.40,150.50,0.0,,,,,,credit,posted,3f1402e35c084d90810ad1db317d19f5,PAY/SALARY,20-30,2018,10,26,16,0,Friday,14 days,59504.386
ACC-964839203,21,1560.2,29444.62,,CUS-2059096722,2018-08-03,Michael,M,-36.07,146.92,0.0,,,,,,credit,posted,0ecf63c3707e48b8b2a9867f14e58959,PAY/SALARY,20-30,2018,8,3,16,0,Friday,7 days,81353.286
ACC-964839203,21,1560.2,30780.23,,CUS-2059096722,2018-08-10,Michael,M,-36.07,146.92,0.0,,,,,,credit,posted,228d924501214204b0b1fb8cf116ac26,PAY/SALARY,20-30,2018,8,10,16,0,Friday,7 days,81353.286
ACC-964839203,21,1560.2,32030.97,,CUS-2059096722,2018-08-17,Michael,M,-36.07,146.92,0.0,,,,,,credit,posted,18cacc0fd615408c89248ae23a3545c4,PAY/SALARY,20-30,2018,8,17,16,0,Friday,7 days,81353.286
ACC-964839203,21,1560.2,33041.53,,CUS-2059096722,2018-08-24,Michael,M,-36.07,146.92,0.0,,,,,,credit,posted,68d429597e73430d8af03ca43ee5c4be,PAY/SALARY,20-30,2018,8,24,16,0,Friday,7 days,81353.286
ACC-964839203,21,1560.2,34453.2,,CUS-2059096722,2018-08-31,Michael,M,-36.07,146.92,0.0,,,,,,credit,posted,09119bfd8bfb47e68a2578ff69fd5485,PAY/SALARY,20-30,2018,8,31,16,0,Friday,7 days,81353.286
ACC-964839203,21,1560.2,35786.03,,CUS-2059096722,2018-09-07,Michael,M,-36.07,146.92,0.0,,,,,,credit,posted,fbe9a14cab2541ec9239030f5e314a2b,PAY/SALARY,20-30,2018,9,7,16,0,Friday,7 days,81353.286
ACC-964839203,21,1560.2,35029.67,,CUS-2059096722,2018-09-14,Michael,M,-36.07,146.92,0.0,,,,,,credit,posted,188c7663994241fbb263a08e3aa55cf6,PAY/SALARY,20-30,2018,9,14,16,0,Friday,7 days,81353.286
ACC-964839203,21,1560.2,36270.87,,CUS-2059096722,2018-09-21,Michael,M,-36.07,146.92,0.0,,,,,,credit,posted,e8d8344ec4f047698219612f6866eafb,PAY/SALARY,20-30,2018,9,21,16,0,Friday,7 days,81353.286
ACC-964839203,21,1560.2,37560.21,,CUS-2059096722,2018-09-28,Michael,M,-36.07,146.92,0.0,,,,,,credit,posted,e0a2bfcd459249fd877ae7f7e23230ca,PAY/SALARY,20-30,2018,9,28,16,0,Friday,7 days,81353.286
ACC-964839203,21,1560.2,38970.35,,CUS-2059096722,2018-10-05,Michael,M,-36.07,146.92,0.0,,,,,,credit,posted,8ebe440fe8da436fa614396187bcd1e9,PAY/SALARY,20-30,2018,10,5,16,0,Friday,7 days,81353.286
ACC-964839203,21,1560.2,40313.82,,CUS-2059096722,2018-10-12,Michael,M,-36.07,146.92,0.0,,,,,,credit,posted,713a5a74c4824397b691e78d168917f4,PAY/SALARY,20-30,2018,10,12,16,0,Friday,7 days,81353.286
ACC-964839203,21,1560.2,41292.8,,CUS-2059096722,2018-10-19,Michael,M,-36.07,146.92,0.0,,,,,,credit,posted,b449a6085dd947d28189175278a1bf74,PAY/SALARY,20-30,2018,10,19,16,0,Friday,7 days,81353.286
ACC-964839203,21,1560.2,42670.92,,CUS-2059096722,2018-10-26,Michael,M,-36.07,146.92,0.0,,,,,,credit,posted,2617c7640ba84009aadb079d10c9925b,PAY/SALARY,20-30,2018,10,26,16,0,Friday,7 days,81353.286
ACC-2901672282,22,3328.77,4490.85,,CUS-1617121891,2018-08-03,Daniel,M,-573.00,255.00,0.0,,,,,,credit,posted,035f7e013df6486f80e2245bea04a28f,PAY/SALARY,20-30,2018,8,3,17,0,Friday,14 days,86785.789
ACC-2901672282,22,3328.77,4869.27,,CUS-1617121891,2018-08-17,Daniel,M,-573.00,255.00,0.0,,,,,,credit,posted,07a631732ae34014b0ae59978e3ea821,PAY/SALARY,20-30,2018,8,17,17,0,Friday,14 days,86785.789
ACC-2901672282,22,3328.77,5924.7,,CUS-1617121891,2018-08-31,Daniel,M,-573.00,255.00,0.0,,,,,,credit,posted,e31dccf666dd4520b1c3636f5f81ca1e,PAY/SALARY,20-30,2018,8,31,17,0,Friday,14 days,86785.789
ACC-2901672282,22,3328.77,7280.85,,CUS-1617121891,2018-09-14,Daniel,M,-573.00,255.00,0.0,,,,,,credit,posted,123405299c9c4fab82b03f3f0060be7c,PAY/SALARY,20-30,2018,9,14,17,0,Friday,14 days,86785.789
ACC-2901672282,22,3328.77,9875.28,,CUS-1617121891,2018-09-28,Daniel,M,-573.00,255.00,0.0,,,,,,credit,posted,1d82953061fb4f9a80a6323760c93ee3,PAY/SALARY,20-30,2018,9,28,17,0,Friday,14 days,86785.789
ACC-2901672282,22,3328.77,11817.46,,CUS-1617121891,2018-10-12,Daniel,M,-573.00,255.00,0.0,,,,,,credit,posted,b3c10e0554f04876b4830d46a45bd62e,PAY/SALARY,20-30,2018,10,12,17,0,Friday,14 days,86785.789
ACC-2901672282,22,3328.77,14864.23,,CUS-1617121891,2018-10-26,Daniel,M,-573.00,255.00,0.0,,,,,,credit,posted,a3720984d89f441c93a62bbe12508eb1,PAY/SALARY,20-30,2018,10,26,17,0,Friday,14 days,86785.789
ACC-3317636250,35,2544.76,2645.62,,CUS-2738291516,2018-08-03,Kenneth,M,-27.66,153.02,0.0,,,,,,credit,posted,37f6f831162547ed87e15e8c8c60d61e,PAY/SALARY,30-40,2018,8,3,17,0,Friday,7 days,132691.057
ACC-3317636250,35,2544.76,4920.14,,CUS-2738291516,2018-08-10,Kenneth,M,-27.66,153.02,0.0,,,,,,credit,posted,6f063953997846e8a7b315a01f2bbf54,PAY/SALARY,30-40,2018,8,10,17,0,Friday,7 days,132691.057
ACC-3317636250,35,2544.76,7299.17,,CUS-2738291516,2018-08-17,Kenneth,M,-27.66,153.02,0.0,,,,,,credit,posted,e06412851d0240f9bad6af84e6942463,PAY/SALARY,30-40,2018,8,17,17,0,Friday,7 days,132691.057
ACC-3317636250,35,2544.76,9463.94,,CUS-2738291516,2018-08-24,Kenneth,M,-27.66,153.02,0.0,,,,,,credit,posted,f9057f5292ba418688af457c825e7a5b,PAY/SALARY,30-40,2018,8,24,17,0,Friday,7 days,132691.057
ACC-3317636250,35,2544.76,10265.95,,CUS-2738291516,2018-08-31,Kenneth,M,-27.66,153.02,0.0,,,,,,credit,posted,d0afe39d68e244d6a8b87cc1e2ff1f77,PAY/SALARY,30-40,2018,8,31,17,0,Friday,7 days,132691.057
ACC-3317636250,35,2544.76,12708.9,,CUS-2738291516,2018-09-07,Kenneth,M,-27.66,153.02,0.0,,,,,,credit,posted,7a1a6e5ab0114d15a110a812fa5c6117,PAY/SALARY,30-40,2018,9,7,17,0,Friday,7 days,132691.057
ACC-3317636250,35,2544.76,13215.66,,CUS-2738291516,2018-09-14,Kenneth,M,-27.66,153.02,0.0,,,,,,credit,posted,aed477f14cf34d26a6c02c2eca3a61b1,PAY/SALARY,30-40,2018,9,14,17,0,Friday,7 days,132691.057
ACC-3317636250,35,2544.76,15631.73,,CUS-2738291516,2018-09-21,Kenneth,M,-27.66,153.02,0.0,,,,,,credit,posted,58f3576c41c34e73ad7ed1b5cc5fe65c,PAY/SALARY,30-40,2018,9,21,17,0,Friday,7 days,132691.057
ACC-3317636250,35,2544.76,16788.49,,CUS-2738291516,2018-09-28,Kenneth,M,-27.66,153.02,0.0,,,,,,credit,posted,aedceb01ac854e75aa5b6893a3a62e62,PAY/SALARY,30-40,2018,9,28,17,0,Friday,7 days,132691.057
ACC-3317636250,35,2544.76,14387.37,,CUS-2738291516,2018-10-05,Kenneth,M,-27.66,153.02,0.0,,,,,,credit,posted,041c7cb256e940198cf22626ffaaea71,PAY/SALARY,30-40,2018,10,5,17,0,Friday,7 days,132691.057
ACC-3317636250,35,2544.76,16676.21,,CUS-2738291516,2018-10-12,Kenneth,M,-27.66,153.02,0.0,,,,,,credit,posted,6ab73e205b6a44a2a8ace5b339f3d955,PAY/SALARY,30-40,2018,10,12,17,0,Friday,7 days,132691.057
ACC-3317636250,35,2544.76,19130.97,,CUS-2738291516,2018-10-19,Kenneth,M,-27.66,153.02,0.0,,,,,,credit,posted,3351a527c30845aab80520ccfc7103a5,PAY/SALARY,30-40,2018,10,19,17,0,Friday,7 days,132691.057
ACC-3317636250,35,2544.76,21121.09,,CUS-2738291516,2018-10-26,Kenneth,M,-27.66,153.02,0.0,,,,,,credit,posted,b9d4f1eb054c4e51a4699ebae6e3d925,PAY/SALARY,30-40,2018,10,26,17,0,Friday,7 days,132691.057
ACC-966140392,21,2572.91,3158.66,,CUS-537508723,2018-08-03,Joseph,M,-37.97,147.08,0.0,,,,,,credit,posted,77195b2f0c3c4924a5cca52956ccaa01,PAY/SALARY,20-30,2018,8,3,17,0,Friday,14 days,67079.439
ACC-966140392,21,2572.91,3384.03,,CUS-537508723,2018-08-17,Joseph,M,-37.97,147.08,0.0,,,,,,credit,posted,323c1ea370fb442b9ec745b099854e98,PAY/SALARY,20-30,2018,8,17,17,0,Friday,14 days,67079.439
ACC-966140392,21,2572.91,4816.4,,CUS-537508723,2018-08-31,Joseph,M,-37.97,147.08,0.0,,,,,,credit,posted,3e7b05f58ef648c0be177f21308467c5,PAY/SALARY,20-30,2018,8,31,17,0,Friday,14 days,67079.439
ACC-966140392,21,2572.91,6919.34,,CUS-537508723,2018-09-14,Joseph,M,-37.97,147.08,0.0,,,,,,credit,posted,20fb52f285be4c1b9f7b2c0f78905ec3,PAY/SALARY,20-30,2018,9,14,17,0,Friday,14 days,67079.439
ACC-966140392,21,2572.91,9098.13,,CUS-537508723,2018-09-28,Joseph,M,-37.97,147.08,0.0,,,,,,credit,posted,ad75340c45a04fdb97b66a303d600710,PAY/SALARY,20-30,2018,9,28,17,0,Friday,14 days,67079.439
ACC-966140392,21,2572.91,10156.85,,CUS-537508723,2018-10-12,Joseph,M,-37.97,147.08,0.0,,,,,,credit,posted,b4ab76590c4846dda3eab005b49c93e3,PAY/SALARY,20-30,2018,10,12,17,0,Friday,14 days,67079.439
ACC-966140392,21,2572.91,12344.34,,CUS-537508723,2018-10-26,Joseph,M,-37.97,147.08,0.0,,,,,,credit,posted,ad492e5437884bf1b9af76c78ea944a3,PAY/SALARY,20-30,2018,10,26,17,0,Friday,14 days,67079.439
ACC-4065652575,21,3578.65,5835.11,,CUS-1117979751,2018-08-06,Lucas,M,-31.82,115.81,0.0,,,,,,credit,posted,5cd1e7f829d947a19d68cab7daa0d7fb,PAY/SALARY,20-30,2018,8,6,11,0,Monday,14 days,93300.518
ACC-4065652575,21,3578.65,8858.41,,CUS-1117979751,2018-08-20,Lucas,M,-31.82,115.81,0.0,,,,,,credit,posted,ec637c4990fa4f04a79550c50e6f18b3,PAY/SALARY,20-30,2018,8,20,11,0,Monday,14 days,93300.518
ACC-4065652575,21,3578.65,11449.84,,CUS-1117979751,2018-09-03,Lucas,M,-31.82,115.81,0.0,,,,,,credit,posted,7f1bbe5e434940bba95cba96ea35f482,PAY/SALARY,20-30,2018,9,3,11,0,Monday,14 days,93300.518
ACC-4065652575,21,3578.65,10861.16,,CUS-1117979751,2018-09-17,Lucas,M,-31.82,115.81,0.0,,,,,,credit,posted,4a9e0ec64a674cd8bf34db00f125946a,PAY/SALARY,20-30,2018,9,17,11,0,Monday,14 days,93300.518
ACC-4065652575,21,3578.65,12500.64,,CUS-1117979751,2018-10-01,Lucas,M,-31.82,115.81,0.0,,,,,,credit,posted,cff671f9cbaf4d86ab3d19c03cc0c1ef,PAY/SALARY,20-30,2018,10,1,11,0,Monday,14 days,93300.518
ACC-4065652575,21,3578.65,15678.86,,CUS-1117979751,2018-10-15,Lucas,M,-31.82,115.81,0.0,,,,,,credit,posted,547fc805d5a8460aafcb8dde33cc14bf,PAY/SALARY,20-30,2018,10,15,11,0,Monday,14 days,93300.518
ACC-4065652575,21,3578.65,18516.4,,CUS-1117979751,2018-10-29,Lucas,M,-31.82,115.81,0.0,,,,,,credit,posted,fda341137c594efb8d6722130ff029ee,PAY/SALARY,20-30,2018,10,29,11,0,Monday,14 days,93300.518
ACC-3233697971,34,1711.39,1726.28,,CUS-1147642491,2018-08-06,Robin,F,-33.77,151.04,0.0,,,,,,credit,posted,82706d8cafc5496f8339d762268115bb,PAY/SALARY,30-40,2018,8,6,11,0,Monday,7 days,89236.764
ACC-3233697971,34,1711.39,3351.9,,CUS-1147642491,2018-08-13,Robin,F,-33.77,151.04,0.0,,,,,,credit,posted,10e7c5b7a5e7404fa5ce0152a5513111,PAY/SALARY,30-40,2018,8,13,11,0,Monday,7 days,89236.764
ACC-3233697971,34,1711.39,4134.06,,CUS-1147642491,2018-08-20,Robin,F,-33.77,151.04,0.0,,,,,,credit,posted,4f7aa8a6c9964e1a83aac5b62b87b45b,PAY/SALARY,30-40,2018,8,20,11,0,Monday,7 days,89236.764
ACC-3233697971,34,1711.39,5719.06,,CUS-1147642491,2018-08-27,Robin,F,-33.77,151.04,0.0,,,,,,credit,posted,d0bd54391d674aa4846c422e559b10fe,PAY/SALARY,30-40,2018,8,27,11,0,Monday,7 days,89236.764
ACC-3233697971,34,1711.39,6293.87,,CUS-1147642491,2018-09-03,Robin,F,-33.77,151.04,0.0,,,,,,credit,posted,a001c1f03c2e410097f2edab070bea73,PAY/SALARY,30-40,2018,9,3,11,0,Monday,7 days,89236.764
ACC-3233697971,34,1711.39,7918.61,,CUS-1147642491,2018-09-10,Robin,F,-33.77,151.04,0.0,,,,,,credit,posted,91d9d52522a148328a42d61dbe6533f4,PAY/SALARY,30-40,2018,9,10,11,0,Monday,7 days,89236.764
ACC-3233697971,34,1711.39,8496.43,,CUS-1147642491,2018-09-17,Robin,F,-33.77,151.04,0.0,,,,,,credit,posted,b4ea64333bcd4d25959cd317d08496e0,PAY/SALARY,30-40,2018,9,17,11,0,Monday,7 days,89236.764
ACC-3233697971,34,1711.39,9760.77,,CUS-1147642491,2018-09-24,Robin,F,-33.77,151.04,0.0,,,,,,credit,posted,56a77368097845339fe25bcc30ce0230,PAY/SALARY,30-40,2018,9,24,11,0,Monday,7 days,89236.764
ACC-3233697971,34,1711.39,11185.81,,CUS-1147642491,2018-10-01,Robin,F,-33.77,151.04,0.0,,,,,,credit,posted,95b82a9d2b634dfdb68b1af19eabbe32,PAY/SALARY,30-40,2018,10,1,11,0,Monday,7 days,89236.764
ACC-3233697971,34,1711.39,12496.05,,CUS-1147642491,2018-10-08,Robin,F,-33.77,151.04,0.0,,,,,,credit,posted,f50d7834ee00499cb256ce657233e708,PAY/SALARY,30-40,2018,10,8,11,0,Monday,7 days,89236.764
ACC-3233697971,34,1711.39,13605.62,,CUS-1147642491,2018-10-15,Robin,F,-33.77,151.04,0.0,,,,,,credit,posted,e3f9eede5d7e4c77bc5917ca5fd118fb,PAY/SALARY,30-40,2018,10,15,11,0,Monday,7 days,89236.764
ACC-3233697971,34,1711.39,14354.16,,CUS-1147642491,2018-10-22,Robin,F,-33.77,151.04,0.0,,,,,,credit,posted,a7e2d7f1ab0b4d058028a3cc5c03224f,PAY/SALARY,30-40,2018,10,22,11,0,Monday,7 days,89236.764
ACC-3233697971,34,1711.39,15532.46,,CUS-1147642491,2018-10-29,Robin,F,-33.77,151.04,0.0,,,,,,credit,posted,cca9eb8e24e5492bb786d752ba64f794,PAY/SALARY,30-40,2018,10,29,11,0,Monday,7 days,89236.764
ACC-1037050564,40,892.09,1878.76,,CUS-1614226872,2018-08-06,Rhonda,F,-27.66,153.10,0.0,,,,,,credit,posted,de558a6e22b6402b948dcf24066ac595,PAY/SALARY,30-40,2018,8,6,11,0,Monday,7 days,46516.121
ACC-1037050564,40,892.09,2025.48,,CUS-1614226872,2018-08-13,Rhonda,F,-27.66,153.10,0.0,,,,,,credit,posted,91082f097ab7414eae8ff699aa744ac7,PAY/SALARY,30-40,2018,8,13,11,0,Monday,7 days,46516.121
ACC-1037050564,40,892.09,2628.62,,CUS-1614226872,2018-08-20,Rhonda,F,-27.66,153.10,0.0,,,,,,credit,posted,ffa86370a9f0457faf40e8349e9bf3d9,PAY/SALARY,30-40,2018,8,20,11,0,Monday,7 days,46516.121
ACC-1037050564,40,892.09,3060.28,,CUS-1614226872,2018-08-27,Rhonda,F,-27.66,153.10,0.0,,,,,,credit,posted,a11ace33fe2b484e9e512ca45516aeb7,PAY/SALARY,30-40,2018,8,27,11,0,Monday,7 days,46516.121
ACC-1037050564,40,892.09,3780.96,,CUS-1614226872,2018-09-03,Rhonda,F,-27.66,153.10,0.0,,,,,,credit,posted,586a7325e8d54385bf732eae289f670b,PAY/SALARY,30-40,2018,9,3,11,0,Monday,7 days,46516.121
ACC-1037050564,40,892.09,3724.18,,CUS-1614226872,2018-09-10,Rhonda,F,-27.66,153.10,0.0,,,,,,credit,posted,1cbbcb140c64400fb52801626b1631f4,PAY/SALARY,30-40,2018,9,10,11,0,Monday,7 days,46516.121
ACC-1037050564,40,892.09,4146.65,,CUS-1614226872,2018-09-17,Rhonda,F,-27.66,153.10,0.0,,,,,,credit,posted,ff5cb6b8664b4ceaba1b8b3d49024635,PAY/SALARY,30-40,2018,9,17,11,0,Monday,7 days,46516.121
ACC-1037050564,40,892.09,4465.56,,CUS-1614226872,2018-09-24,Rhonda,F,-27.66,153.10,0.0,,,,,,credit,posted,73e282fb810d4273b5482aa4c3cc601a,PAY/SALARY,30-40,2018,9,24,11,0,Monday,7 days,46516.121
ACC-1037050564,40,892.09,4494.64,,CUS-1614226872,2018-10-01,Rhonda,F,-27.66,153.10,0.0,,,,,,credit,posted,71b91722ce8f4177a4be692ebb088fe6,PAY/SALARY,30-40,2018,10,1,11,0,Monday,7 days,46516.121
ACC-1037050564,40,892.09,4545.77,,CUS-1614226872,2018-10-08,Rhonda,F,-27.66,153.10,0.0,,,,,,credit,posted,cbd08944c11c413ea210dcca994274e9,PAY/SALARY,30-40,2018,10,8,11,0,Monday,7 days,46516.121
ACC-1037050564,40,892.09,5131.42,,CUS-1614226872,2018-10-15,Rhonda,F,-27.66,153.10,0.0,,,,,,credit,posted,a3ff093322094a46a03426a36e0a2c94,PAY/SALARY,30-40,2018,10,15,11,0,Monday,7 days,46516.121
ACC-1037050564,40,892.09,5524.86,,CUS-1614226872,2018-10-22,Rhonda,F,-27.66,153.10,0.0,,,,,,credit,posted,05a4c832470f4a5aad166b965be8862c,PAY/SALARY,30-40,2018,10,22,11,0,Monday,7 days,46516.121
ACC-1037050564,40,892.09,6065.02,,CUS-1614226872,2018-10-29,Rhonda,F,-27.66,153.10,0.0,,,,,,credit,posted,e7e999056a1f4afdac171426e96c58ee,PAY/SALARY,30-40,2018,10,29,11,0,Monday,7 days,46516.121
ACC-240804743,29,4405.3,4407.89,,CUS-261674136,2018-08-06,Kenneth,M,-30.75,121.48,0.0,,,,,,credit,posted,81643ac523fd46018a525723984c68c9,PAY/SALARY,20-30,2018,8,6,11,0,Monday,14 days,114852.464
ACC-240804743,29,4405.3,7961.21,,CUS-261674136,2018-08-20,Kenneth,M,-30.75,121.48,0.0,,,,,,credit,posted,b309ae70aef54c3bbf6637813026ba1f,PAY/SALARY,20-30,2018,8,20,11,0,Monday,14 days,114852.464
ACC-240804743,29,4405.3,11753.39,,CUS-261674136,2018-09-03,Kenneth,M,-30.75,121.48,0.0,,,,,,credit,posted,0c2a160976714ebba65c9f39bdb6c9f6,PAY/SALARY,20-30,2018,9,3,11,0,Monday,14 days,114852.464
ACC-240804743,29,4405.3,15225.33,,CUS-261674136,2018-09-17,Kenneth,M,-30.75,121.48,0.0,,,,,,credit,posted,2dd00b58a81e4f7d9fc511f8ac2f3ab7,PAY/SALARY,20-30,2018,9,17,11,0,Monday,14 days,114852.464
ACC-240804743,29,4405.3,19236.36,,CUS-261674136,2018-10-01,Kenneth,M,-30.75,121.48,0.0,,,,,,credit,posted,0b57601cd8ba4a92b8df23ed9b1a0cf4,PAY/SALARY,20-30,2018,10,1,11,0,Monday,14 days,114852.464
ACC-240804743,29,4405.3,22784.93,,CUS-261674136,2018-10-15,Kenneth,M,-30.75,121.48,0.0,,,,,,credit,posted,d11bf667a05d44afbd835511fa85b82f,PAY/SALARY,20-30,2018,10,15,11,0,Monday,14 days,114852.464
ACC-240804743,29,4405.3,24929.99,,CUS-261674136,2018-10-29,Kenneth,M,-30.75,121.48,0.0,,,,,,credit,posted,d3bb8b156aa64be9a02eccba98f09435,PAY/SALARY,20-30,2018,10,29,11,0,Monday,14 days,114852.464
ACC-3879258709,40,4216.04,190299.56,,CUS-527400765,2018-08-06,Natasha,F,-37.66,143.83,0.0,,,,,,credit,posted,dd10f0e6270548a8a7d38b1f5b3ed065,PAY/SALARY,30-40,2018,8,6,11,0,Monday,14 days,109918.186
ACC-3879258709,40,4216.04,193621.49,,CUS-527400765,2018-08-20,Natasha,F,-37.66,143.83,0.0,,,,,,credit,posted,665d404d53dd4601bde0b14eb01d6135,PAY/SALARY,30-40,2018,8,20,11,0,Monday,14 days,109918.186
ACC-3879258709,40,4216.04,196933.96,,CUS-527400765,2018-09-03,Natasha,F,-37.66,143.83,0.0,,,,,,credit,posted,4e34057828fb45a3997ca4e84270f0be,PAY/SALARY,30-40,2018,9,3,11,0,Monday,14 days,109918.186
ACC-3879258709,40,4216.04,200023.81,,CUS-527400765,2018-09-17,Natasha,F,-37.66,143.83,0.0,,,,,,credit,posted,511186435eb54aa9b9f9fb6a6595cf87,PAY/SALARY,30-40,2018,9,17,11,0,Monday,14 days,109918.186
ACC-3879258709,40,4216.04,203046.0,,CUS-527400765,2018-10-01,Natasha,F,-37.66,143.83,0.0,,,,,,credit,posted,ea0b3c15258d418f8ea3461e164ca090,PAY/SALARY,30-40,2018,10,1,11,0,Monday,14 days,109918.186
ACC-3879258709,40,4216.04,206051.63,,CUS-527400765,2018-10-15,Natasha,F,-37.66,143.83,0.0,,,,,,credit,posted,3ed83bc1724f42148d1026fd33dd25f2,PAY/SALARY,30-40,2018,10,15,11,0,Monday,14 days,109918.186
ACC-3879258709,40,4216.04,208926.1,,CUS-527400765,2018-10-29,Natasha,F,-37.66,143.83,0.0,,,,,,credit,posted,321760de1a4143448b8635d7b2eb7582,PAY/SALARY,30-40,2018,10,29,11,0,Monday,14 days,109918.186
ACC-1438600314,35,862.95,2616.39,,CUS-2650223890,2018-08-06,Maria,F,-34.84,138.69,0.0,,,,,,credit,posted,e387b0b7f9c845dd8e1b9be6bccc4621,PAY/SALARY,30-40,2018,8,6,12,0,Monday,7 days,44996.679
ACC-1438600314,35,862.95,3160.27,,CUS-2650223890,2018-08-13,Maria,F,-34.84,138.69,0.0,,,,,,credit,posted,46411f95fa834298b4324ffb1581a57b,PAY/SALARY,30-40,2018,8,13,12,0,Monday,7 days,44996.679
ACC-1438600314,35,862.95,3685.22,,CUS-2650223890,2018-08-20,Maria,F,-34.84,138.69,0.0,,,,,,credit,posted,39d85a25026c41538783d97b42508a3a,PAY/SALARY,30-40,2018,8,20,12,0,Monday,7 days,44996.679
ACC-1438600314,35,862.95,4298.18,,CUS-2650223890,2018-08-27,Maria,F,-34.84,138.69,0.0,,,,,,credit,posted,0b26864f22aa4c569ee5573dd1255109,PAY/SALARY,30-40,2018,8,27,12,0,Monday,7 days,44996.679
ACC-1438600314,35,862.95,5081.13,,CUS-2650223890,2018-09-03,Maria,F,-34.84,138.69,0.0,,,,,,credit,posted,b089cb7aca424cf992c8b41db125fb8b,PAY/SALARY,30-40,2018,9,3,12,0,Monday,7 days,44996.679
ACC-1438600314,35,862.95,4313.61,,CUS-2650223890,2018-09-10,Maria,F,-34.84,138.69,0.0,,,,,,credit,posted,0218e312654f4e44adea1f5954b33abc,PAY/SALARY,30-40,2018,9,10,12,0,Monday,7 days,44996.679
ACC-1438600314,35,862.95,3664.63,,CUS-2650223890,2018-09-17,Maria,F,-34.84,138.69,0.0,,,,,,credit,posted,198a1deabbed434d8c80f6efbe862625,PAY/SALARY,30-40,2018,9,17,12,0,Monday,7 days,44996.679
ACC-1438600314,35,862.95,3272.79,,CUS-2650223890,2018-09-24,Maria,F,-34.84,138.69,0.0,,,,,,credit,posted,cbcaa37d5514427bae19a583bae171e8,PAY/SALARY,30-40,2018,9,24,12,0,Monday,7 days,44996.679
ACC-1438600314,35,862.95,4055.74,,CUS-2650223890,2018-10-01,Maria,F,-34.84,138.69,0.0,,,,,,credit,posted,cf11b352afb547739a4d084edd6620c0,PAY/SALARY,30-40,2018,10,1,12,0,Monday,7 days,44996.679
ACC-1438600314,35,862.95,4838.69,,CUS-2650223890,2018-10-08,Maria,F,-34.84,138.69,0.0,,,,,,credit,posted,db19e1f049e04253a894d74c8eedbeb4,PAY/SALARY,30-40,2018,10,8,12,0,Monday,7 days,44996.679
ACC-1438600314,35,862.95,5308.98,,CUS-2650223890,2018-10-15,Maria,F,-34.84,138.69,0.0,,,,,,credit,posted,7a1ba3feb4674b7686c90721c4a5425a,PAY/SALARY,30-40,2018,10,15,12,0,Monday,7 days,44996.679
ACC-1438600314,35,862.95,5982.48,,CUS-2650223890,2018-10-22,Maria,F,-34.84,138.69,0.0,,,,,,credit,posted,305ba9623dea4bc0877305340b947c03,PAY/SALARY,30-40,2018,10,22,12,0,Monday,7 days,44996.679
ACC-1438600314,35,862.95,6738.35,,CUS-2650223890,2018-10-29,Maria,F,-34.84,138.69,0.0,,,,,,credit,posted,8f271bbbbb8c4f59a8408a5fafb3715c,PAY/SALARY,30-40,2018,10,29,12,0,Monday,7 days,44996.679
ACC-2650850707,42,3231.26,106396.58,,CUS-2819545904,2018-08-06,Brian,M,-23.52,148.16,0.0,,,,,,credit,posted,5ea14cdc1f634e5c9904442771f8d0fb,PAY/SALARY,40-50,2018,8,6,13,0,Monday,14 days,84243.564
ACC-2650850707,42,3231.26,108791.32,,CUS-2819545904,2018-08-20,Brian,M,-23.52,148.16,0.0,,,,,,credit,posted,9fced8008cfb4ec6bbc2b74ba3f60e5d,PAY/SALARY,40-50,2018,8,20,13,0,Monday,14 days,84243.564
ACC-2650850707,42,3231.26,110361.62,,CUS-2819545904,2018-09-03,Brian,M,-23.52,148.16,0.0,,,,,,credit,posted,5e2f0c23195f4fb4b31bfc4080d6596c,PAY/SALARY,40-50,2018,9,3,13,0,Monday,14 days,84243.564
ACC-2650850707,42,3231.26,112836.96,,CUS-2819545904,2018-09-17,Brian,M,-23.52,148.16,0.0,,,,,,credit,posted,6d8741bab34547b79eb986f425a60415,PAY/SALARY,40-50,2018,9,17,13,0,Monday,14 days,84243.564
ACC-2650850707,42,3231.26,115674.97,,CUS-2819545904,2018-10-01,Brian,M,-23.52,148.16,0.0,,,,,,credit,posted,1e62db12cf774745817a93ad8a85fddb,PAY/SALARY,40-50,2018,10,1,13,0,Monday,14 days,84243.564
ACC-2650850707,42,3231.26,118342.23,,CUS-2819545904,2018-10-15,Brian,M,-23.52,148.16,0.0,,,,,,credit,posted,58e93aa034af4f118fdd7c3a3c42cee3,PAY/SALARY,40-50,2018,10,15,13,0,Monday,14 days,84243.564
ACC-2650850707,42,3231.26,120372.61,,CUS-2819545904,2018-10-29,Brian,M,-23.52,148.16,0.0,,,,,,credit,posted,96b2296a82ac4ac89df93a0f0bbb173e,PAY/SALARY,40-50,2018,10,29,13,0,Monday,14 days,84243.564
ACC-1496451953,43,2588.01,2664.6,,CUS-3142625864,2018-08-06,Ricky,M,-37.84,145.16,0.0,,,,,,credit,posted,3d41a4a9802941e19adaf2a6b36f7c94,PAY/SALARY,40-50,2018,8,6,13,0,Monday,7 days,134946.236
ACC-1496451953,43,2588.01,4980.61,,CUS-3142625864,2018-08-13,Ricky,M,-37.84,145.16,0.0,,,,,,credit,posted,a118bd4737ac4bd9a84f1fe1f0f252ae,PAY/SALARY,40-50,2018,8,13,13,0,Monday,7 days,134946.236
ACC-1496451953,43,2588.01,6910.63,,CUS-3142625864,2018-08-20,Ricky,M,-37.84,145.16,0.0,,,,,,credit,posted,117a420cbe6b408aa368abe46460fa75,PAY/SALARY,40-50,2018,8,20,13,0,Monday,7 days,134946.236
ACC-1496451953,43,2588.01,8607.25,,CUS-3142625864,2018-08-27,Ricky,M,-37.84,145.16,0.0,,,,,,credit,posted,e9e2dcd6b8ef414a8d261e16681dc1ef,PAY/SALARY,40-50,2018,8,27,13,0,Monday,7 days,134946.236
ACC-1496451953,43,2588.01,10942.33,,CUS-3142625864,2018-09-03,Ricky,M,-37.84,145.16,0.0,,,,,,credit,posted,7a9bd9f3a08e41859490d703c2117363,PAY/SALARY,40-50,2018,9,3,13,0,Monday,7 days,134946.236
ACC-1496451953,43,2588.01,13040.1,,CUS-3142625864,2018-09-10,Ricky,M,-37.84,145.16,0.0,,,,,,credit,posted,ef754fceafc5407b877abdb42967a3f6,PAY/SALARY,40-50,2018,9,10,13,0,Monday,7 days,134946.236
ACC-1496451953,43,2588.01,13784.06,,CUS-3142625864,2018-09-17,Ricky,M,-37.84,145.16,0.0,,,,,,credit,posted,878567dfeeb1497a8fc6894ae1f3bd11,PAY/SALARY,40-50,2018,9,17,13,0,Monday,7 days,134946.236
ACC-1496451953,43,2588.01,15391.73,,CUS-3142625864,2018-09-24,Ricky,M,-37.84,145.16,0.0,,,,,,credit,posted,6cf19ee26ce245549b9eb99283af22af,PAY/SALARY,40-50,2018,9,24,13,0,Monday,7 days,134946.236
ACC-1496451953,43,2588.01,17543.05,,CUS-3142625864,2018-10-01,Ricky,M,-37.84,145.16,0.0,,,,,,credit,posted,bb51c88d3ca4407b999ad0e73e7ec26d,PAY/SALARY,40-50,2018,10,1,13,0,Monday,7 days,134946.236
ACC-1496451953,43,2588.01,20005.06,,CUS-3142625864,2018-10-08,Ricky,M,-37.84,145.16,0.0,,,,,,credit,posted,0ed12db8c72b470fbfb5406e10bb353a,PAY/SALARY,40-50,2018,10,8,13,0,Monday,7 days,134946.236
ACC-1496451953,43,2588.01,22036.89,,CUS-3142625864,2018-10-15,Ricky,M,-37.84,145.16,0.0,,,,,,credit,posted,ac0ef1ea0f2b406483b6c9e4266ac8dc,PAY/SALARY,40-50,2018,10,15,13,0,Monday,7 days,134946.236
ACC-1496451953,43,2588.01,22563.12,,CUS-3142625864,2018-10-22,Ricky,M,-37.84,145.16,0.0,,,,,,credit,posted,7d2216dd562a46fa9415243401d50f26,PAY/SALARY,40-50,2018,10,22,13,0,Monday,7 days,134946.236
ACC-1496451953,43,2588.01,24818.11,,CUS-3142625864,2018-10-29,Ricky,M,-37.84,145.16,0.0,,,,,,credit,posted,abddb0637e4143f9b31bcc18a83f9477,PAY/SALARY,40-50,2018,10,29,13,0,Monday,7 days,134946.236
ACC-2173390920,27,1396.23,1402.71,,CUS-3180318393,2018-08-06,Luis,M,-37.58,144.71,0.0,,,,,,credit,posted,a9724092d01d4587bf81a409c436ad9e,PAY/SALARY,20-30,2018,8,6,13,0,Monday,7 days,72803.421
ACC-2173390920,27,1396.23,2440.1,,CUS-3180318393,2018-08-13,Luis,M,-37.58,144.71,0.0,,,,,,credit,posted,f2b79570548944c48f55b9f2ee9feac6,PAY/SALARY,20-30,2018,8,13,13,0,Monday,7 days,72803.421
ACC-2173390920,27,1396.23,3532.33,,CUS-3180318393,2018-08-20,Luis,M,-37.58,144.71,0.0,,,,,,credit,posted,c6ffab05060943d688d1d02f78db2a34,PAY/SALARY,20-30,2018,8,20,13,0,Monday,7 days,72803.421
ACC-2173390920,27,1396.23,4442.86,,CUS-3180318393,2018-08-27,Luis,M,-37.58,144.71,0.0,,,,,,credit,posted,30dc7e2c5fe3402cbabae3a2ff345c4b,PAY/SALARY,20-30,2018,8,27,13,0,Monday,7 days,72803.421
ACC-2173390920,27,1396.23,5206.26,,CUS-3180318393,2018-09-03,Luis,M,-37.58,144.71,0.0,,,,,,credit,posted,5d29e59dfaa346efb744d98f30efbf90,PAY/SALARY,20-30,2018,9,3,13,0,Monday,7 days,72803.421
ACC-2173390920,27,1396.23,6232.5,,CUS-3180318393,2018-09-10,Luis,M,-37.58,144.71,0.0,,,,,,credit,posted,3d1430ed3f494ecab0ab5afce0b6accb,PAY/SALARY,20-30,2018,9,10,13,0,Monday,7 days,72803.421
ACC-2173390920,27,1396.23,7254.36,,CUS-3180318393,2018-09-17,Luis,M,-37.58,144.71,0.0,,,,,,credit,posted,7cf35d7c033d415da6eb77bb0f71853d,PAY/SALARY,20-30,2018,9,17,13,0,Monday,7 days,72803.421
ACC-2173390920,27,1396.23,8100.28,,CUS-3180318393,2018-09-24,Luis,M,-37.58,144.71,0.0,,,,,,credit,posted,785942a6528f418aace2b1e5a292d75e,PAY/SALARY,20-30,2018,9,24,13,0,Monday,7 days,72803.421
ACC-2173390920,27,1396.23,9098.06,,CUS-3180318393,2018-10-01,Luis,M,-37.58,144.71,0.0,,,,,,credit,posted,f9b95ada28534d2d9b3a35e71b2c75fb,PAY/SALARY,20-30,2018,10,1,13,0,Monday,7 days,72803.421
ACC-2173390920,27,1396.23,10162.29,,CUS-3180318393,2018-10-08,Luis,M,-37.58,144.71,0.0,,,,,,credit,posted,fc274f9ad16444deadc54586d564704f,PAY/SALARY,20-30,2018,10,8,13,0,Monday,7 days,72803.421
ACC-2173390920,27,1396.23,11405.52,,CUS-3180318393,2018-10-15,Luis,M,-37.58,144.71,0.0,,,,,,credit,posted,3d04a309ef1d47b9abd2f93c5420d375,PAY/SALARY,20-30,2018,10,15,13,0,Monday,7 days,72803.421
ACC-2173390920,27,1396.23,12508.75,,CUS-3180318393,2018-10-22,Luis,M,-37.58,144.71,0.0,,,,,,credit,posted,c6999b0ddd1343e6a6b76bf0abbaf997,PAY/SALARY,20-30,2018,10,22,13,0,Monday,7 days,72803.421
ACC-2173390920,27,1396.23,13661.75,,CUS-3180318393,2018-10-29,Luis,M,-37.58,144.71,0.0,,,,,,credit,posted,b3232af7aa424d669d611b9425601e3b,PAY/SALARY,20-30,2018,10,29,13,0,Monday,7 days,72803.421
ACC-2615038700,43,664.43,29114.92,,CUS-3255104878,2018-08-06,Emily,F,-38.03,145.35,0.0,,,,,,credit,posted,221dbed8696b4ce9bd952cfa403330ef,PAY/SALARY,40-50,2018,8,6,13,0,Monday,7 days,34645.279
ACC-2615038700,43,664.43,29573.4,,CUS-3255104878,2018-08-13,Emily,F,-38.03,145.35,0.0,,,,,,credit,posted,a8b946b318fa41509dad44e081a3fb7f,PAY/SALARY,40-50,2018,8,13,13,0,Monday,7 days,34645.279
ACC-2615038700,43,664.43,30006.42,,CUS-3255104878,2018-08-20,Emily,F,-38.03,145.35,0.0,,,,,,credit,posted,43a4bc84d9554750a238351e4aec136c,PAY/SALARY,40-50,2018,8,20,13,0,Monday,7 days,34645.279
ACC-2615038700,43,664.43,30444.74,,CUS-3255104878,2018-08-27,Emily,F,-38.03,145.35,0.0,,,,,,credit,posted,893d00e5033142b589415b709cdeca63,PAY/SALARY,40-50,2018,8,27,13,0,Monday,7 days,34645.279
ACC-2615038700,43,664.43,31071.17,,CUS-3255104878,2018-09-03,Emily,F,-38.03,145.35,0.0,,,,,,credit,posted,6dcaa668861b4d598d3dde412e300116,PAY/SALARY,40-50,2018,9,3,13,0,Monday,7 days,34645.279
ACC-2615038700,43,664.43,30326.6,,CUS-3255104878,2018-09-10,Emily,F,-38.03,145.35,0.0,,,,,,credit,posted,a633faff3ea54430bb9e5f1408b2a48a,PAY/SALARY,40-50,2018,9,10,13,0,Monday,7 days,34645.279
ACC-2615038700,43,664.43,30914.92,,CUS-3255104878,2018-09-17,Emily,F,-38.03,145.35,0.0,,,,,,credit,posted,ab5b42eed109404c8f5fb9173b95a659,PAY/SALARY,40-50,2018,9,17,13,0,Monday,7 days,34645.279
ACC-2615038700,43,664.43,31541.35,,CUS-3255104878,2018-09-24,Emily,F,-38.03,145.35,0.0,,,,,,credit,posted,04aaf86c4fac47a389f8ba0ea2445058,PAY/SALARY,40-50,2018,9,24,13,0,Monday,7 days,34645.279
ACC-2615038700,43,664.43,32167.78,,CUS-3255104878,2018-10-01,Emily,F,-38.03,145.35,0.0,,,,,,credit,posted,d9994094548141218aad0a07dee19175,PAY/SALARY,40-50,2018,10,1,13,0,Monday,7 days,34645.279
ACC-2615038700,43,664.43,32794.21,,CUS-3255104878,2018-10-08,Emily,F,-38.03,145.35,0.0,,,,,,credit,posted,769ade911c5647919f5f105406b44332,PAY/SALARY,40-50,2018,10,8,13,0,Monday,7 days,34645.279
ACC-2615038700,43,664.43,33319.64,,CUS-3255104878,2018-10-15,Emily,F,-38.03,145.35,0.0,,,,,,credit,posted,eb6494cf039e446e8f90c897001fd420,PAY/SALARY,40-50,2018,10,15,13,0,Monday,7 days,34645.279
ACC-2615038700,43,664.43,33946.07,,CUS-3255104878,2018-10-22,Emily,F,-38.03,145.35,0.0,,,,,,credit,posted,508dab8973a34d6381ab03dd068d9e62,PAY/SALARY,40-50,2018,10,22,13,0,Monday,7 days,34645.279
ACC-2615038700,43,664.43,34572.5,,CUS-3255104878,2018-10-29,Emily,F,-38.03,145.35,0.0,,,,,,credit,posted,2060d7b090d949f2a9c1834941a3c518,PAY/SALARY,40-50,2018,10,29,13,0,Monday,7 days,34645.279
ACC-4258502723,24,1059.84,1483.02,,CUS-3378712515,2018-08-06,Kimberly,F,-37.74,145.45,0.0,,,,,,credit,posted,413cb33293da4dac89e77bddf011dfdf,PAY/SALARY,20-30,2018,8,6,13,0,Monday,7 days,55263.086
ACC-4258502723,24,1059.84,2179.91,,CUS-3378712515,2018-08-13,Kimberly,F,-37.74,145.45,0.0,,,,,,credit,posted,58a6434c3c5042e493376afce6009331,PAY/SALARY,20-30,2018,8,13,13,0,Monday,7 days,55263.086
ACC-4258502723,24,1059.84,2094.76,,CUS-3378712515,2018-08-20,Kimberly,F,-37.74,145.45,0.0,,,,,,credit,posted,8fd1dd6469ce4991bda924321ab4c7e2,PAY/SALARY,20-30,2018,8,20,13,0,Monday,7 days,55263.086
ACC-4258502723,24,1059.84,2587.71,,CUS-3378712515,2018-08-27,Kimberly,F,-37.74,145.45,0.0,,,,,,credit,posted,27fbe4564a494fe7ab4786443a846b9e,PAY/SALARY,20-30,2018,8,27,13,0,Monday,7 days,55263.086
ACC-4258502723,24,1059.84,3068.41,,CUS-3378712515,2018-09-03,Kimberly,F,-37.74,145.45,0.0,,,,,,credit,posted,babc13a6d2a9481dae7efdfa02287ea8,PAY/SALARY,20-30,2018,9,3,13,0,Monday,7 days,55263.086
ACC-4258502723,24,1059.84,3594.17,,CUS-3378712515,2018-09-10,Kimberly,F,-37.74,145.45,0.0,,,,,,credit,posted,29fa60567e5a49f6b744b4b220e632f0,PAY/SALARY,20-30,2018,9,10,13,0,Monday,7 days,55263.086
ACC-4258502723,24,1059.84,3975.76,,CUS-3378712515,2018-09-17,Kimberly,F,-37.74,145.45,0.0,,,,,,credit,posted,a947066e58ad49ae883995ff29edad46,PAY/SALARY,20-30,2018,9,17,13,0,Monday,7 days,55263.086
ACC-4258502723,24,1059.84,4682.77,,CUS-3378712515,2018-09-24,Kimberly,F,-37.74,145.45,0.0,,,,,,credit,posted,0a23787c48f4449cbbeb92a53e37d821,PAY/SALARY,20-30,2018,9,24,13,0,Monday,7 days,55263.086
ACC-4258502723,24,1059.84,4946.07,,CUS-3378712515,2018-10-01,Kimberly,F,-37.74,145.45,0.0,,,,,,credit,posted,9348cf8a727b4a1daff261cfef8369e0,PAY/SALARY,20-30,2018,10,1,13,0,Monday,7 days,55263.086
ACC-4258502723,24,1059.84,5301.6,,CUS-3378712515,2018-10-08,Kimberly,F,-37.74,145.45,0.0,,,,,,credit,posted,629e6fc418f8435db21bb2749a698d40,PAY/SALARY,20-30,2018,10,8,13,0,Monday,7 days,55263.086
ACC-4258502723,24,1059.84,5990.08,,CUS-3378712515,2018-10-15,Kimberly,F,-37.74,145.45,0.0,,,,,,credit,posted,b3e9409dc32d403c9004ae71697731a8,PAY/SALARY,20-30,2018,10,15,13,0,Monday,7 days,55263.086
ACC-4258502723,24,1059.84,6203.64,,CUS-3378712515,2018-10-22,Kimberly,F,-37.74,145.45,0.0,,,,,,credit,posted,fd84456331d7452fae73be187e0aadcf,PAY/SALARY,20-30,2018,10,22,13,0,Monday,7 days,55263.086
ACC-4258502723,24,1059.84,5517.05,,CUS-3378712515,2018-10-29,Kimberly,F,-37.74,145.45,0.0,,,,,,credit,posted,8680e89aa038482681da933a7023ee27,PAY/SALARY,20-30,2018,10,29,13,0,Monday,7 days,55263.086
ACC-2249586092,19,990.55,5053.83,,CUS-443776336,2018-08-06,Edward,M,-32.07,115.98,0.0,,,,,,credit,posted,975f3f94186245f0a38afde27da06654,PAY/SALARY,<20,2018,8,6,13,0,Monday,7 days,51650.107
ACC-2249586092,19,990.55,5087.36,,CUS-443776336,2018-08-13,Edward,M,-32.07,115.98,0.0,,,,,,credit,posted,bb21f590ac944842b5e5c318bf797e2e,PAY/SALARY,<20,2018,8,13,13,0,Monday,7 days,51650.107
ACC-2249586092,19,990.55,5878.28,,CUS-443776336,2018-08-20,Edward,M,-32.07,115.98,0.0,,,,,,credit,posted,e298be12b99d47ecbdcea391ca9477d1,PAY/SALARY,<20,2018,8,20,13,0,Monday,7 days,51650.107
ACC-2249586092,19,990.55,6609.23,,CUS-443776336,2018-08-27,Edward,M,-32.07,115.98,0.0,,,,,,credit,posted,44613cb105574badb087c9c46ade4b6e,PAY/SALARY,<20,2018,8,27,13,0,Monday,7 days,51650.107
ACC-2249586092,19,990.55,7254.29,,CUS-443776336,2018-09-03,Edward,M,-32.07,115.98,0.0,,,,,,credit,posted,3492ea5435844d35b2d617b71743f57a,PAY/SALARY,<20,2018,9,3,13,0,Monday,7 days,51650.107
ACC-2249586092,19,990.55,7874.68,,CUS-443776336,2018-09-10,Edward,M,-32.07,115.98,0.0,,,,,,credit,posted,e6e530a418914a788d9fca25def32f2b,PAY/SALARY,<20,2018,9,10,13,0,Monday,7 days,51650.107
ACC-2249586092,19,990.55,8617.23,,CUS-443776336,2018-09-17,Edward,M,-32.07,115.98,0.0,,,,,,credit,posted,6e3f2b34beb64991b29977bb580fe197,PAY/SALARY,<20,2018,9,17,13,0,Monday,7 days,51650.107
ACC-2249586092,19,990.55,9465.08,,CUS-443776336,2018-09-24,Edward,M,-32.07,115.98,0.0,,,,,,credit,posted,0e204c412e734080b9e9e6c62cb403b3,PAY/SALARY,<20,2018,9,24,13,0,Monday,7 days,51650.107
ACC-2249586092,19,990.55,10387.63,,CUS-443776336,2018-10-01,Edward,M,-32.07,115.98,0.0,,,,,,credit,posted,f05b6db11c334ae3a217da8d2a7b5699,PAY/SALARY,<20,2018,10,1,13,0,Monday,7 days,51650.107
ACC-2249586092,19,990.55,10766.72,,CUS-443776336,2018-10-08,Edward,M,-32.07,115.98,0.0,,,,,,credit,posted,10d115954b2e411bbcfeb5d0fc38b009,PAY/SALARY,<20,2018,10,8,13,0,Monday,7 days,51650.107
ACC-2249586092,19,990.55,11555.84,,CUS-443776336,2018-10-15,Edward,M,-32.07,115.98,0.0,,,,,,credit,posted,1e3b0573b37d445cbffa98058055f699,PAY/SALARY,<20,2018,10,15,13,0,Monday,7 days,51650.107
ACC-2249586092,19,990.55,12439.49,,CUS-443776336,2018-10-22,Edward,M,-32.07,115.98,0.0,,,,,,credit,posted,f9e39276a7294b6cb46600878c0aaac6,PAY/SALARY,<20,2018,10,22,13,0,Monday,7 days,51650.107
ACC-2249586092,19,990.55,13070.01,,CUS-443776336,2018-10-29,Edward,M,-32.07,115.98,0.0,,,,,,credit,posted,cdd0b73fa0524810bd2c860c6976c857,PAY/SALARY,<20,2018,10,29,13,0,Monday,7 days,51650.107
ACC-602667573,40,2280.36,2454.56,,CUS-2031327464,2018-08-06,Michael,M,-33.96,151.23,0.0,,,,,,credit,posted,1b28a60443b44ac6b3361023430c95d0,PAY/SALARY,30-40,2018,8,6,14,0,Monday,7 days,118904.486
ACC-602667573,40,2280.36,4413.74,,CUS-2031327464,2018-08-13,Michael,M,-33.96,151.23,0.0,,,,,,credit,posted,f8aa1b40d0754848a48e99572c16d045,PAY/SALARY,30-40,2018,8,13,14,0,Monday,7 days,118904.486
ACC-602667573,40,2280.36,6139.55,,CUS-2031327464,2018-08-20,Michael,M,-33.96,151.23,0.0,,,,,,credit,posted,ec29a25a35774614a89d87fa42f28f8b,PAY/SALARY,30-40,2018,8,20,14,0,Monday,7 days,118904.486
ACC-602667573,40,2280.36,7125.16,,CUS-2031327464,2018-08-27,Michael,M,-33.96,151.23,0.0,,,,,,credit,posted,ae85daf2579d45328aaf698745c219a5,PAY/SALARY,30-40,2018,8,27,14,0,Monday,7 days,118904.486
ACC-602667573,40,2280.36,9318.52,,CUS-2031327464,2018-09-03,Michael,M,-33.96,151.23,0.0,,,,,,credit,posted,01f49a91e8524aed8fa456709b5d03ea,PAY/SALARY,30-40,2018,9,3,14,0,Monday,7 days,118904.486
ACC-602667573,40,2280.36,11322.88,,CUS-2031327464,2018-09-10,Michael,M,-33.96,151.23,0.0,,,,,,credit,posted,3fcef640bf40403fa3de11dd0f89d8ee,PAY/SALARY,30-40,2018,9,10,14,0,Monday,7 days,118904.486
ACC-602667573,40,2280.36,13334.24,,CUS-2031327464,2018-09-17,Michael,M,-33.96,151.23,0.0,,,,,,credit,posted,3587ec511e824af7a0c64e289239dd81,PAY/SALARY,30-40,2018,9,17,14,0,Monday,7 days,118904.486
ACC-602667573,40,2280.36,15337.6,,CUS-2031327464,2018-09-24,Michael,M,-33.96,151.23,0.0,,,,,,credit,posted,b935362095f54f5cb278099c28c8d4b6,PAY/SALARY,30-40,2018,9,24,14,0,Monday,7 days,118904.486
ACC-602667573,40,2280.36,17215.49,,CUS-2031327464,2018-10-01,Michael,M,-33.96,151.23,0.0,,,,,,credit,posted,3a68f6aef9924e7e8e69c1b3eb94f33f,PAY/SALARY,30-40,2018,10,1,14,0,Monday,7 days,118904.486
ACC-602667573,40,2280.36,18606.85,,CUS-2031327464,2018-10-08,Michael,M,-33.96,151.23,0.0,,,,,,credit,posted,11ac6e0110734f40bcb03ba1c747924e,PAY/SALARY,30-40,2018,10,8,14,0,Monday,7 days,118904.486
ACC-602667573,40,2280.36,20359.78,,CUS-2031327464,2018-10-15,Michael,M,-33.96,151.23,0.0,,,,,,credit,posted,36238c6fdef74aaf87b8d538c2f02178,PAY/SALARY,30-40,2018,10,15,14,0,Monday,7 days,118904.486
ACC-602667573,40,2280.36,22286.42,,CUS-2031327464,2018-10-22,Michael,M,-33.96,151.23,0.0,,,,,,credit,posted,f49cfbabae804c0b85bd2abbae5807b3,PAY/SALARY,30-40,2018,10,22,14,0,Monday,7 days,118904.486
ACC-602667573,40,2280.36,23964.97,,CUS-2031327464,2018-10-29,Michael,M,-33.96,151.23,0.0,,,,,,credit,posted,a0a9310f35d843fc9f51dc50b907de1c,PAY/SALARY,30-40,2018,10,29,14,0,Monday,7 days,118904.486
ACC-3021093232,30,1636.72,1681.07,,CUS-55310383,2018-08-06,Melissa,F,-29.47,149.83,0.0,,,,,,credit,posted,a0eba98b444945bda90764a7492b9e57,PAY/SALARY,20-30,2018,8,6,14,0,Monday,7 days,85343.257
ACC-3021093232,30,1636.72,3317.79,,CUS-55310383,2018-08-13,Melissa,F,-29.47,149.83,0.0,,,,,,credit,posted,c622ae8fed24422fb4769272330ee01a,PAY/SALARY,20-30,2018,8,13,14,0,Monday,7 days,85343.257
ACC-3021093232,30,1636.72,4537.19,,CUS-55310383,2018-08-20,Melissa,F,-29.47,149.83,0.0,,,,,,credit,posted,12494b4dff2d4146adae23f0e93ebce2,PAY/SALARY,20-30,2018,8,20,14,0,Monday,7 days,85343.257
ACC-3021093232,30,1636.72,5188.27,,CUS-55310383,2018-08-27,Melissa,F,-29.47,149.83,0.0,,,,,,credit,posted,4c19fac9a3f44246ba225945bbabcdf2,PAY/SALARY,20-30,2018,8,27,14,0,Monday,7 days,85343.257
ACC-3021093232,30,1636.72,6809.38,,CUS-55310383,2018-09-03,Melissa,F,-29.47,149.83,0.0,,,,,,credit,posted,cb2822399f7a4ec78bfbaec88463baaf,PAY/SALARY,20-30,2018,9,3,14,0,Monday,7 days,85343.257
ACC-3021093232,30,1636.72,8446.1,,CUS-55310383,2018-09-10,Melissa,F,-29.47,149.83,0.0,,,,,,credit,posted,ecae7b61234d4ee7ad0fc47f9bf25790,PAY/SALARY,20-30,2018,9,10,14,0,Monday,7 days,85343.257
ACC-3021093232,30,1636.72,8048.82,,CUS-55310383,2018-09-17,Melissa,F,-29.47,149.83,0.0,,,,,,credit,posted,bfb857a3882044b7a87733038fd1d719,PAY/SALARY,20-30,2018,9,17,14,0,Monday,7 days,85343.257
ACC-3021093232,30,1636.72,9530.54,,CUS-55310383,2018-09-24,Melissa,F,-29.47,149.83,0.0,,,,,,credit,posted,533c999dbd9c44d0ae195dbdfcbf12b9,PAY/SALARY,20-30,2018,9,24,14,0,Monday,7 days,85343.257
ACC-3021093232,30,1636.72,9127.16,,CUS-55310383,2018-10-01,Melissa,F,-29.47,149.83,0.0,,,,,,credit,posted,9305ea032f5c4547b03ddac605e6340f,PAY/SALARY,20-30,2018,10,1,14,0,Monday,7 days,85343.257
ACC-3021093232,30,1636.72,10687.82,,CUS-55310383,2018-10-08,Melissa,F,-29.47,149.83,0.0,,,,,,credit,posted,72f77f04c4b048598e5007760a49e25a,PAY/SALARY,20-30,2018,10,8,14,0,Monday,7 days,85343.257
ACC-3021093232,30,1636.72,11434.8,,CUS-55310383,2018-10-15,Melissa,F,-29.47,149.83,0.0,,,,,,credit,posted,b2e199b7dd6f497cbdfea7290b935552,PAY/SALARY,20-30,2018,10,15,14,0,Monday,7 days,85343.257
ACC-3021093232,30,1636.72,12739.58,,CUS-55310383,2018-10-22,Melissa,F,-29.47,149.83,0.0,,,,,,credit,posted,b4887960610f4ee387a235759f87bc8b,PAY/SALARY,20-30,2018,10,22,14,0,Monday,7 days,85343.257
ACC-3021093232,30,1636.72,14090.3,,CUS-55310383,2018-10-29,Melissa,F,-29.47,149.83,0.0,,,,,,credit,posted,7a7532f1a87a4bf3b42e09d7c2deb7c4,PAY/SALARY,20-30,2018,10,29,14,0,Monday,7 days,85343.257
ACC-2270192619,20,3026.95,9637.69,,CUS-2110742437,2018-08-06,Darren,M,-35.27,138.56,0.0,,,,,,credit,posted,c1d51fe6ac554d37b93d57dba64d6674,PAY/SALARY,<20,2018,8,6,17,0,Monday,0 days,39854.84166666666
ACC-2270192619,20,3026.95,11970.46,,CUS-2110742437,2018-09-06,Darren,M,-35.27,138.56,0.0,,,,,,credit,posted,11372fe1819f48a8b0260bf3c046e4e0,PAY/SALARY,<20,2018,9,6,17,0,Thursday,0 days,39854.84166666666
ACC-2270192619,20,3026.95,14448.78,,CUS-2110742437,2018-10-05,Darren,M,-35.27,138.56,0.0,,,,,,credit,posted,812d58434d704041aa033b5ae904efe9,PAY/SALARY,<20,2018,10,5,17,0,Friday,0 days,39854.84166666666
ACC-2270192619,20,3026.95,17475.73,,CUS-2110742437,2018-10-05,Darren,M,-35.27,138.56,0.0,,,,,,credit,posted,efbc0cb742af4879a122c99ae728354b,PAY/SALARY,<20,2018,10,5,17,0,Friday,0 days,39854.84166666666
ACC-854938045,28,2538.68,9062.57,,CUS-4023861240,2018-08-06,James,M,-22.84,147.63,0.0,,,,,,credit,posted,4f1eda4e413e4a309ce8f72761008bef,PAY/SALARY,20-30,2018,8,6,17,0,Monday,14 days,66187.014
ACC-854938045,28,2538.68,10551.95,,CUS-4023861240,2018-08-20,James,M,-22.84,147.63,0.0,,,,,,credit,posted,959cd84aa6f046d0841a94f804be20de,PAY/SALARY,20-30,2018,8,20,17,0,Monday,14 days,66187.014
ACC-854938045,28,2538.68,12017.2,,CUS-4023861240,2018-09-03,James,M,-22.84,147.63,0.0,,,,,,credit,posted,fef99a266627463f9db994c9856cfefa,PAY/SALARY,20-30,2018,9,3,17,0,Monday,14 days,66187.014
ACC-854938045,28,2538.68,12325.14,,CUS-4023861240,2018-09-17,James,M,-22.84,147.63,0.0,,,,,,credit,posted,a5454f72331a404a8ed1f89d845322b1,PAY/SALARY,20-30,2018,9,17,17,0,Monday,14 days,66187.014
ACC-854938045,28,2538.68,13644.01,,CUS-4023861240,2018-10-01,James,M,-22.84,147.63,0.0,,,,,,credit,posted,cd8bcb85c55846b39224c9f05209ff38,PAY/SALARY,20-30,2018,10,1,17,0,Monday,14 days,66187.014
ACC-854938045,28,2538.68,14561.34,,CUS-4023861240,2018-10-15,James,M,-22.84,147.63,0.0,,,,,,credit,posted,fc0a0e7692d04a5cb1e01801e516fd79,PAY/SALARY,20-30,2018,10,15,17,0,Monday,14 days,66187.014
ACC-854938045,28,2538.68,16007.11,,CUS-4023861240,2018-10-29,James,M,-22.84,147.63,0.0,,,,,,credit,posted,7f3ddab0cd1a48fca86f29ff64152721,PAY/SALARY,20-30,2018,10,29,17,0,Monday,14 days,66187.014
ACC-1710017148,19,3977.46,5314.17,,CUS-883482547,2018-08-06,Michelle,F,-34.01,150.82,0.0,,,,,,credit,posted,b9d1728e45d643fd9d6f9a38b0bf93ee,PAY/SALARY,<20,2018,8,6,17,0,Monday,14 days,103698.064
ACC-1710017148,19,3977.46,7764.35,,CUS-883482547,2018-08-20,Michelle,F,-34.01,150.82,0.0,,,,,,credit,posted,39a8014c8a71409698f8bf05e2ee2ff9,PAY/SALARY,<20,2018,8,20,17,0,Monday,14 days,103698.064
ACC-1710017148,19,3977.46,10636.12,,CUS-883482547,2018-09-03,Michelle,F,-34.01,150.82,0.0,,,,,,credit,posted,fcbe30a25f774e7c80d5b94d991a6d15,PAY/SALARY,<20,2018,9,3,17,0,Monday,14 days,103698.064
ACC-1710017148,19,3977.46,11850.78,,CUS-883482547,2018-09-17,Michelle,F,-34.01,150.82,0.0,,,,,,credit,posted,e4b6c13973724177875982372bfeb1f3,PAY/SALARY,<20,2018,9,17,17,0,Monday,14 days,103698.064
ACC-1710017148,19,3977.46,14850.71,,CUS-883482547,2018-10-01,Michelle,F,-34.01,150.82,0.0,,,,,,credit,posted,fd601d147cb144279b862f83dce3f72a,PAY/SALARY,<20,2018,10,1,17,0,Monday,14 days,103698.064
ACC-1710017148,19,3977.46,17663.99,,CUS-883482547,2018-10-15,Michelle,F,-34.01,150.82,0.0,,,,,,credit,posted,237ce909ec984191b6229ec39d82a99c,PAY/SALARY,<20,2018,10,15,17,0,Monday,14 days,103698.064
ACC-1710017148,19,3977.46,20812.96,,CUS-883482547,2018-10-29,Michelle,F,-34.01,150.82,0.0,,,,,,credit,posted,cf8d7e2fcd304ac5932cb8bcb3e3c43a,PAY/SALARY,<20,2018,10,29,17,0,Monday,14 days,103698.064
ACC-37709441,18,4132.23,4138.72,,CUS-3336454548,2018-08-07,Charles,M,-28.01,153.41,0.0,,,,,,credit,posted,9f00417dbb9a45cea772f8450136d614,PAY/SALARY,<20,2018,8,7,11,0,Tuesday,14 days,107733.139
ACC-37709441,18,4132.23,7544.15,,CUS-3336454548,2018-08-21,Charles,M,-28.01,153.41,0.0,,,,,,credit,posted,38978fa0f10f4213aa6b51c1fb119e7d,PAY/SALARY,<20,2018,8,21,11,0,Tuesday,14 days,107733.139
ACC-37709441,18,4132.23,10631.69,,CUS-3336454548,2018-09-04,Charles,M,-28.01,153.41,0.0,,,,,,credit,posted,dc3bdf6788aa41b9bbfcb44d2fdbb8c9,PAY/SALARY,<20,2018,9,4,11,0,Tuesday,14 days,107733.139
ACC-37709441,18,4132.23,14022.13,,CUS-3336454548,2018-09-18,Charles,M,-28.01,153.41,0.0,,,,,,credit,posted,239a5365c2e14136a4f482ed70323356,PAY/SALARY,<20,2018,9,18,11,0,Tuesday,14 days,107733.139
ACC-37709441,18,4132.23,17139.54,,CUS-3336454548,2018-10-02,Charles,M,-28.01,153.41,0.0,,,,,,credit,posted,691d8672378940c3a753f95d5c589be4,PAY/SALARY,<20,2018,10,2,11,0,Tuesday,14 days,107733.139
ACC-37709441,18,4132.23,20639.81,,CUS-3336454548,2018-10-16,Charles,M,-28.01,153.41,0.0,,,,,,credit,posted,ea8099bb495d42dd929bb25ad49b01e4,PAY/SALARY,<20,2018,10,16,11,0,Tuesday,14 days,107733.139
ACC-37709441,18,4132.23,23990.99,,CUS-3336454548,2018-10-30,Charles,M,-28.01,153.41,0.0,,,,,,credit,posted,4bc63113260e43babd23f2c0228cf896,PAY/SALARY,<20,2018,10,30,11,0,Tuesday,14 days,107733.139
ACC-2231965366,35,2443.24,3667.29,,CUS-2155701614,2018-08-07,Linda,F,-37.84,144.96,0.0,,,,,,credit,posted,3723ca07d17d4f5d9484c5525028def1,PAY/SALARY,30-40,2018,8,7,12,0,Tuesday,7 days,127397.514
ACC-2231965366,35,2443.24,5813.53,,CUS-2155701614,2018-08-14,Linda,F,-37.84,144.96,0.0,,,,,,credit,posted,261b77f3fcd64bfabf1083900bdc79dc,PAY/SALARY,30-40,2018,8,14,12,0,Tuesday,7 days,127397.514
ACC-2231965366,35,2443.24,8125.77,,CUS-2155701614,2018-08-21,Linda,F,-37.84,144.96,0.0,,,,,,credit,posted,86a31fef5ca34ddbbf2c44f1da25c91a,PAY/SALARY,30-40,2018,8,21,12,0,Tuesday,7 days,127397.514
ACC-2231965366,35,2443.24,10258.01,,CUS-2155701614,2018-08-28,Linda,F,-37.84,144.96,0.0,,,,,,credit,posted,9df11efb513f4b24a0af57a0902ab4b0,PAY/SALARY,30-40,2018,8,28,12,0,Tuesday,7 days,127397.514
ACC-2231965366,35,2443.24,12367.1,,CUS-2155701614,2018-09-04,Linda,F,-37.84,144.96,0.0,,,,,,credit,posted,cb5668e0879240dd8e1ea61089af86d8,PAY/SALARY,30-40,2018,9,4,12,0,Tuesday,7 days,127397.514
ACC-2231965366,35,2443.24,14154.4,,CUS-2155701614,2018-09-11,Linda,F,-37.84,144.96,0.0,,,,,,credit,posted,c2c9ba89ec19446ebbaf340e523295df,PAY/SALARY,30-40,2018,9,11,12,0,Tuesday,7 days,127397.514
ACC-2231965366,35,2443.24,16407.89,,CUS-2155701614,2018-09-18,Linda,F,-37.84,144.96,0.0,,,,,,credit,posted,509c66ec9f2e438b8b6c7cf5753a1f30,PAY/SALARY,30-40,2018,9,18,12,0,Tuesday,7 days,127397.514
ACC-2231965366,35,2443.24,17307.33,,CUS-2155701614,2018-09-25,Linda,F,-37.84,144.96,0.0,,,,,,credit,posted,060f777d8220427b8bc0a80b4f596e4e,PAY/SALARY,30-40,2018,9,25,12,0,Tuesday,7 days,127397.514
ACC-2231965366,35,2443.24,19619.57,,CUS-2155701614,2018-10-02,Linda,F,-37.84,144.96,0.0,,,,,,credit,posted,2acfc593ace1478588d4100f2528d786,PAY/SALARY,30-40,2018,10,2,12,0,Tuesday,7 days,127397.514
ACC-2231965366,35,2443.24,21702.81,,CUS-2155701614,2018-10-09,Linda,F,-37.84,144.96,0.0,,,,,,credit,posted,c214c8b6717b48efa5c1b0dc7957accb,PAY/SALARY,30-40,2018,10,9,12,0,Tuesday,7 days,127397.514
ACC-2231965366,35,2443.24,22948.05,,CUS-2155701614,2018-10-16,Linda,F,-37.84,144.96,0.0,,,,,,credit,posted,fec04df35a3e4e2c8fa843e940861ee4,PAY/SALARY,30-40,2018,10,16,12,0,Tuesday,7 days,127397.514
ACC-2231965366,35,2443.24,25125.33,,CUS-2155701614,2018-10-23,Linda,F,-37.84,144.96,0.0,,,,,,credit,posted,8908b2659e2b4eda9cf4b0aec7b9222b,PAY/SALARY,30-40,2018,10,23,12,0,Tuesday,7 days,127397.514
ACC-2231965366,35,2443.24,27160.77,,CUS-2155701614,2018-10-30,Linda,F,-37.84,144.96,0.0,,,,,,credit,posted,4309773d67504bfea42c1ea61027d8af,PAY/SALARY,30-40,2018,10,30,12,0,Tuesday,7 days,127397.514
ACC-1443681913,31,996.24,1236.1,,CUS-3129499595,2018-08-07,Ryan,M,-33.77,150.92,0.0,,,,,,credit,posted,4fc46c1b66ea4c6a865be524c1a0355a,PAY/SALARY,30-40,2018,8,7,13,0,Tuesday,7 days,51946.8
ACC-1443681913,31,996.24,1966.12,,CUS-3129499595,2018-08-14,Ryan,M,-33.77,150.92,0.0,,,,,,credit,posted,78790b5dedee4ceeba66ac74e265371c,PAY/SALARY,30-40,2018,8,14,13,0,Tuesday,7 days,51946.8
ACC-1443681913,31,996.24,2813.36,,CUS-3129499595,2018-08-21,Ryan,M,-33.77,150.92,0.0,,,,,,credit,posted,00ddc65eb7674cfdbeee864ef245e2e5,PAY/SALARY,30-40,2018,8,21,13,0,Tuesday,7 days,51946.8
ACC-1443681913,31,996.24,3183.94,,CUS-3129499595,2018-08-28,Ryan,M,-33.77,150.92,0.0,,,,,,credit,posted,b8814521a4c94a1ebdc77ca1181ecf4a,PAY/SALARY,30-40,2018,8,28,13,0,Tuesday,7 days,51946.8
ACC-1443681913,31,996.24,3648.8,,CUS-3129499595,2018-09-04,Ryan,M,-33.77,150.92,0.0,,,,,,credit,posted,06337a7922a74adeba5615061e473cce,PAY/SALARY,30-40,2018,9,4,13,0,Tuesday,7 days,51946.8
ACC-1443681913,31,996.24,3730.39,,CUS-3129499595,2018-09-11,Ryan,M,-33.77,150.92,0.0,,,,,,credit,posted,327eab5dc19e48a8b1447d06b453f078,PAY/SALARY,30-40,2018,9,11,13,0,Tuesday,7 days,51946.8
ACC-1443681913,31,996.24,4473.58,,CUS-3129499595,2018-09-18,Ryan,M,-33.77,150.92,0.0,,,,,,credit,posted,f938390b03d04f9788c9414d8224d11d,PAY/SALARY,30-40,2018,9,18,13,0,Tuesday,7 days,51946.8
ACC-1443681913,31,996.24,4109.09,,CUS-3129499595,2018-09-25,Ryan,M,-33.77,150.92,0.0,,,,,,credit,posted,0b1fa12f9d224e3b98b23cc83554d173,PAY/SALARY,30-40,2018,9,25,13,0,Tuesday,7 days,51946.8
ACC-1443681913,31,996.24,5033.11,,CUS-3129499595,2018-10-02,Ryan,M,-33.77,150.92,0.0,,,,,,credit,posted,2949427d86ab483f9128b9affcf5fde8,PAY/SALARY,30-40,2018,10,2,13,0,Tuesday,7 days,51946.8
ACC-1443681913,31,996.24,5692.83,,CUS-3129499595,2018-10-09,Ryan,M,-33.77,150.92,0.0,,,,,,credit,posted,dd256c388b264e38b06459f2c26da955,PAY/SALARY,30-40,2018,10,9,13,0,Tuesday,7 days,51946.8
ACC-1443681913,31,996.24,4734.94,,CUS-3129499595,2018-10-16,Ryan,M,-33.77,150.92,0.0,,,,,,credit,posted,752e58c464854512b64e7821c50f21b2,PAY/SALARY,30-40,2018,10,16,13,0,Tuesday,7 days,51946.8
ACC-1443681913,31,996.24,5299.68,,CUS-3129499595,2018-10-23,Ryan,M,-33.77,150.92,0.0,,,,,,credit,posted,04e4894977834fb0b4459127fcd4ba7f,PAY/SALARY,30-40,2018,10,23,13,0,Tuesday,7 days,51946.8
ACC-1443681913,31,996.24,5881.68,,CUS-3129499595,2018-10-30,Ryan,M,-33.77,150.92,0.0,,,,,,credit,posted,808238d0a46141479c6a9d73afd21d1c,PAY/SALARY,30-40,2018,10,30,13,0,Tuesday,7 days,51946.8
ACC-2305712452,18,761.33,792.7,,CUS-1842679196,2018-08-07,Debra,F,-34.89,138.61,0.0,,,,,,credit,posted,66fd1e62b52546ff804cb12a2c058b86,PAY/SALARY,<20,2018,8,7,14,0,Tuesday,7 days,39697.921
ACC-2305712452,18,761.33,1331.91,,CUS-1842679196,2018-08-14,Debra,F,-34.89,138.61,0.0,,,,,,credit,posted,22a5df109b624ffc9b3b1606128a0899,PAY/SALARY,<20,2018,8,14,14,0,Tuesday,7 days,39697.921
ACC-2305712452,18,761.33,2017.93,,CUS-1842679196,2018-08-21,Debra,F,-34.89,138.61,0.0,,,,,,credit,posted,fe7f117134e448f2a9c1b69fa4c7db84,PAY/SALARY,<20,2018,8,21,14,0,Tuesday,7 days,39697.921
ACC-2305712452,18,761.33,2646.08,,CUS-1842679196,2018-08-28,Debra,F,-34.89,138.61,0.0,,,,,,credit,posted,6d211c321d064654815546ffaa9ea24b,PAY/SALARY,<20,2018,8,28,14,0,Tuesday,7 days,39697.921
ACC-2305712452,18,761.33,3115.05,,CUS-1842679196,2018-09-04,Debra,F,-34.89,138.61,0.0,,,,,,credit,posted,87db9d5781c043b7add0e2c0b283b60b,PAY/SALARY,<20,2018,9,4,14,0,Tuesday,7 days,39697.921
ACC-2305712452,18,761.33,3749.71,,CUS-1842679196,2018-09-11,Debra,F,-34.89,138.61,0.0,,,,,,credit,posted,afa049ab3ad54f01800846803aa682a9,PAY/SALARY,<20,2018,9,11,14,0,Tuesday,7 days,39697.921
ACC-2305712452,18,761.33,4354.21,,CUS-1842679196,2018-09-18,Debra,F,-34.89,138.61,0.0,,,,,,credit,posted,54bcd376c0874a5abee54edf428511f1,PAY/SALARY,<20,2018,9,18,14,0,Tuesday,7 days,39697.921
ACC-2305712452,18,761.33,4991.65,,CUS-1842679196,2018-09-25,Debra,F,-34.89,138.61,0.0,,,,,,credit,posted,8cfa9ffe30424c74b15de5844b4fca28,PAY/SALARY,<20,2018,9,25,14,0,Tuesday,7 days,39697.921
ACC-2305712452,18,761.33,5525.93,,CUS-1842679196,2018-10-02,Debra,F,-34.89,138.61,0.0,,,,,,credit,posted,0ecdf428e1334cb7a3cf4c83ff8066a4,PAY/SALARY,<20,2018,10,2,14,0,Tuesday,7 days,39697.921
ACC-2305712452,18,761.33,6174.3,,CUS-1842679196,2018-10-09,Debra,F,-34.89,138.61,0.0,,,,,,credit,posted,fd8c7cd3dca14d44857f6b96cb832d6b,PAY/SALARY,<20,2018,10,9,14,0,Tuesday,7 days,39697.921
ACC-2305712452,18,761.33,6657.1,,CUS-1842679196,2018-10-16,Debra,F,-34.89,138.61,0.0,,,,,,credit,posted,696e1da8a1284340826e3820176513b6,PAY/SALARY,<20,2018,10,16,14,0,Tuesday,7 days,39697.921
ACC-2305712452,18,761.33,7022.35,,CUS-1842679196,2018-10-23,Debra,F,-34.89,138.61,0.0,,,,,,credit,posted,1de0ae45570441fbab71959b5a4b8c63,PAY/SALARY,<20,2018,10,23,14,0,Tuesday,7 days,39697.921
ACC-2305712452,18,761.33,7515.44,,CUS-1842679196,2018-10-30,Debra,F,-34.89,138.61,0.0,,,,,,credit,posted,a65014f2fc8b4a9fa21b6cbed5065e41,PAY/SALARY,<20,2018,10,30,14,0,Tuesday,7 days,39697.921
ACC-1990648130,21,1037.07,2507.96,,CUS-809013380,2018-08-07,Kaitlyn,F,-28.80,114.62,0.0,,,,,,credit,posted,b1377c1b408b4729a38cc96b4a528ca1,PAY/SALARY,20-30,2018,8,7,14,0,Tuesday,7 days,54075.793
ACC-1990648130,21,1037.07,3357.61,,CUS-809013380,2018-08-14,Kaitlyn,F,-28.80,114.62,0.0,,,,,,credit,posted,6f9ab08a03db4e3888b0023984ced9f0,PAY/SALARY,20-30,2018,8,14,14,0,Tuesday,7 days,54075.793
ACC-1990648130,21,1037.07,4193.48,,CUS-809013380,2018-08-21,Kaitlyn,F,-28.80,114.62,0.0,,,,,,credit,posted,db340e81757c479285ce999d234ac857,PAY/SALARY,20-30,2018,8,21,14,0,Tuesday,7 days,54075.793
ACC-1990648130,21,1037.07,3139.2,,CUS-809013380,2018-08-28,Kaitlyn,F,-28.80,114.62,0.0,,,,,,credit,posted,41e48fca189b46b78001e98a8a74d11c,PAY/SALARY,20-30,2018,8,28,14,0,Tuesday,7 days,54075.793
ACC-1990648130,21,1037.07,3399.94,,CUS-809013380,2018-09-04,Kaitlyn,F,-28.80,114.62,0.0,,,,,,credit,posted,83552d789d9f407b80117b6de437cfe4,PAY/SALARY,20-30,2018,9,4,14,0,Tuesday,7 days,54075.793
ACC-1990648130,21,1037.07,4328.62,,CUS-809013380,2018-09-11,Kaitlyn,F,-28.80,114.62,0.0,,,,,,credit,posted,d0c9f31a2afe49368c2f82864a322203,PAY/SALARY,20-30,2018,9,11,14,0,Tuesday,7 days,54075.793
ACC-1990648130,21,1037.07,5324.35,,CUS-809013380,2018-09-18,Kaitlyn,F,-28.80,114.62,0.0,,,,,,credit,posted,26b953d7fcf84aca8d847355553bda5d,PAY/SALARY,20-30,2018,9,18,14,0,Tuesday,7 days,54075.793
ACC-1990648130,21,1037.07,5772.74,,CUS-809013380,2018-09-25,Kaitlyn,F,-28.80,114.62,0.0,,,,,,credit,posted,7248e68d380a4dc08dc08298438ff686,PAY/SALARY,20-30,2018,9,25,14,0,Tuesday,7 days,54075.793
ACC-1990648130,21,1037.07,6300.23,,CUS-809013380,2018-10-02,Kaitlyn,F,-28.80,114.62,0.0,,,,,,credit,posted,21219ec8542b448b9bed5eafcaa98d64,PAY/SALARY,20-30,2018,10,2,14,0,Tuesday,7 days,54075.793
ACC-1990648130,21,1037.07,7127.99,,CUS-809013380,2018-10-09,Kaitlyn,F,-28.80,114.62,0.0,,,,,,credit,posted,f37fbb68bddf4cf3b847cebdcd210388,PAY/SALARY,20-30,2018,10,9,14,0,Tuesday,7 days,54075.793
ACC-1990648130,21,1037.07,8137.06,,CUS-809013380,2018-10-16,Kaitlyn,F,-28.80,114.62,0.0,,,,,,credit,posted,d7439fe72e134c6680f03555281e5141,PAY/SALARY,20-30,2018,10,16,14,0,Tuesday,7 days,54075.793
ACC-1990648130,21,1037.07,9068.13,,CUS-809013380,2018-10-23,Kaitlyn,F,-28.80,114.62,0.0,,,,,,credit,posted,28ef582e6b044e539a251589c0860b8a,PAY/SALARY,20-30,2018,10,23,14,0,Tuesday,7 days,54075.793
ACC-1990648130,21,1037.07,9872.11,,CUS-809013380,2018-10-30,Kaitlyn,F,-28.80,114.62,0.0,,,,,,credit,posted,d015393be2704308a1dc05ef9ce55cef,PAY/SALARY,20-30,2018,10,30,14,0,Tuesday,7 days,54075.793
ACC-2673069055,24,6024.49,17127.02,,CUS-51506836,2018-08-07,Richard,M,-27.49,152.99,0.0,,,,,,credit,posted,b2fedeaf02a6485ba4cf3be69b56a80b,PAY/SALARY,20-30,2018,8,7,15,0,Tuesday,31 days,73297.96166666666
ACC-2673069055,24,6024.49,21158.28,,CUS-51506836,2018-09-07,Richard,M,-27.49,152.99,0.0,,,,,,credit,posted,2a20583ac7ce4bffa46624de2f94d5af,PAY/SALARY,20-30,2018,9,7,15,0,Friday,31 days,73297.96166666666
ACC-2828321672,53,970.47,1011.87,,CUS-1005756958,2018-08-07,Stephanie,F,-27.51,153.03,0.0,,,,,,credit,posted,33c2b30f5b064710a53a45ef89460e16,PAY/SALARY,50-60,2018,8,7,16,0,Tuesday,7 days,50603.079
ACC-2828321672,53,970.47,1398.7,,CUS-1005756958,2018-08-14,Stephanie,F,-27.51,153.03,0.0,,,,,,credit,posted,deaff82de78840f08a035e5404ce5e29,PAY/SALARY,50-60,2018,8,14,16,0,Tuesday,7 days,50603.079
ACC-2828321672,53,970.47,1853.47,,CUS-1005756958,2018-08-21,Stephanie,F,-27.51,153.03,0.0,,,,,,credit,posted,71cd874fc20741f8b4a589c8286afeb2,PAY/SALARY,50-60,2018,8,21,16,0,Tuesday,7 days,50603.079
ACC-2828321672,53,970.47,2099.14,,CUS-1005756958,2018-08-28,Stephanie,F,-27.51,153.03,0.0,,,,,,credit,posted,9bcd1945ef0a43b5a59d0ba2cf2ee4df,PAY/SALARY,50-60,2018,8,28,16,0,Tuesday,7 days,50603.079
ACC-2828321672,53,970.47,2793.61,,CUS-1005756958,2018-09-04,Stephanie,F,-27.51,153.03,0.0,,,,,,credit,posted,e588bd113b3645ee82fb386e336c42a1,PAY/SALARY,50-60,2018,9,4,16,0,Tuesday,7 days,50603.079
ACC-2828321672,53,970.47,3717.52,,CUS-1005756958,2018-09-11,Stephanie,F,-27.51,153.03,0.0,,,,,,credit,posted,27e8d534b0ef4aa5857e4d56dc1cdda2,PAY/SALARY,50-60,2018,9,11,16,0,Tuesday,7 days,50603.079
ACC-2828321672,53,970.47,4567.21,,CUS-1005756958,2018-09-18,Stephanie,F,-27.51,153.03,0.0,,,,,,credit,posted,6b622e0b12324ac2a1b6c946f43bce04,PAY/SALARY,50-60,2018,9,18,16,0,Tuesday,7 days,50603.079
ACC-2828321672,53,970.47,5199.68,,CUS-1005756958,2018-09-25,Stephanie,F,-27.51,153.03,0.0,,,,,,credit,posted,a519227ab3e848b898e2e105ee078bdf,PAY/SALARY,50-60,2018,9,25,16,0,Tuesday,7 days,50603.079
ACC-2828321672,53,970.47,6042.15,,CUS-1005756958,2018-10-02,Stephanie,F,-27.51,153.03,0.0,,,,,,credit,posted,6a0796f6e44c4d49b288a593bdc23503,PAY/SALARY,50-60,2018,10,2,16,0,Tuesday,7 days,50603.079
ACC-2828321672,53,970.47,6864.62,,CUS-1005756958,2018-10-09,Stephanie,F,-27.51,153.03,0.0,,,,,,credit,posted,8e0fb2a9850a4ed884b4ccd5a3873693,PAY/SALARY,50-60,2018,10,9,16,0,Tuesday,7 days,50603.079
ACC-2828321672,53,970.47,7835.09,,CUS-1005756958,2018-10-16,Stephanie,F,-27.51,153.03,0.0,,,,,,credit,posted,802176ff06614fa2900f36c19bee5a41,PAY/SALARY,50-60,2018,10,16,16,0,Tuesday,7 days,50603.079
ACC-2828321672,53,970.47,8649.56,,CUS-1005756958,2018-10-23,Stephanie,F,-27.51,153.03,0.0,,,,,,credit,posted,e0caf4357a4e42e09fd7879463af07fa,PAY/SALARY,50-60,2018,10,23,16,0,Tuesday,7 days,50603.079
ACC-2828321672,53,970.47,9310.03,,CUS-1005756958,2018-10-30,Stephanie,F,-27.51,153.03,0.0,,,,,,credit,posted,1adf440dfa15480395e3baf0899bd9ce,PAY/SALARY,50-60,2018,10,30,16,0,Tuesday,7 days,50603.079
ACC-4281711154,42,1757.82,34865.92,,CUS-3151318058,2018-08-07,Eric,M,-37.84,144.98,0.0,,,,,,credit,posted,ae3cdd43c71b4d1b87ad77f1ccb564ba,PAY/SALARY,40-50,2018,8,7,16,0,Tuesday,14 days,45828.879
ACC-4281711154,42,1757.82,36477.74,,CUS-3151318058,2018-08-21,Eric,M,-37.84,144.98,0.0,,,,,,credit,posted,ddf4eadbf3d744caa74e2d05905b7e35,PAY/SALARY,40-50,2018,8,21,16,0,Tuesday,14 days,45828.879
ACC-4281711154,42,1757.82,37770.56,,CUS-3151318058,2018-09-04,Eric,M,-37.84,144.98,0.0,,,,,,credit,posted,858d30d47f304cce93da6fedad4cc160,PAY/SALARY,40-50,2018,9,4,16,0,Tuesday,14 days,45828.879
ACC-4281711154,42,1757.82,39382.38,,CUS-3151318058,2018-09-18,Eric,M,-37.84,144.98,0.0,,,,,,credit,posted,93cf18c7c08547cf9c4a46ed69016ee9,PAY/SALARY,40-50,2018,9,18,16,0,Tuesday,14 days,45828.879
ACC-4281711154,42,1757.82,40675.2,,CUS-3151318058,2018-10-02,Eric,M,-37.84,144.98,0.0,,,,,,credit,posted,d643c6c0d79442439142565158d008c1,PAY/SALARY,40-50,2018,10,2,16,0,Tuesday,14 days,45828.879
ACC-4281711154,42,1757.82,42287.02,,CUS-3151318058,2018-10-16,Eric,M,-37.84,144.98,0.0,,,,,,credit,posted,d2cb5dea41614ff491a57fdee32b842d,PAY/SALARY,40-50,2018,10,16,16,0,Tuesday,14 days,45828.879
ACC-4281711154,42,1757.82,43579.84,,CUS-3151318058,2018-10-30,Eric,M,-37.84,144.98,0.0,,,,,,credit,posted,b6d417eb17f14acdb488d491b19a3f5e,PAY/SALARY,40-50,2018,10,30,16,0,Tuesday,14 days,45828.879
ACC-1222300524,38,1002.13,1002.38,,CUS-2142601169,2018-08-07,Michael,M,-33.94,151.23,0.0,,,,,,credit,posted,add2ff36bbb94d2eabdbd5b41c78b501,PAY/SALARY,30-40,2018,8,7,17,0,Tuesday,7 days,52253.921
ACC-1222300524,38,1002.13,1132.66,,CUS-2142601169,2018-08-14,Michael,M,-33.94,151.23,0.0,,,,,,credit,posted,6217095136fc488fa19ba8c1a716e8f9,PAY/SALARY,30-40,2018,8,14,17,0,Tuesday,7 days,52253.921
ACC-1222300524,38,1002.13,2084.79,,CUS-2142601169,2018-08-21,Michael,M,-33.94,151.23,0.0,,,,,,credit,posted,033c6a989918484899e9ff3b9d066f31,PAY/SALARY,30-40,2018,8,21,17,0,Tuesday,7 days,52253.921
ACC-1222300524,38,1002.13,2279.63,,CUS-2142601169,2018-08-28,Michael,M,-33.94,151.23,0.0,,,,,,credit,posted,c313c9506ec44e8e80ca038c42b45d5f,PAY/SALARY,30-40,2018,8,28,17,0,Tuesday,7 days,52253.921
ACC-1222300524,38,1002.13,2535.72,,CUS-2142601169,2018-09-04,Michael,M,-33.94,151.23,0.0,,,,,,credit,posted,55f30325fb894bb8896e4fc6c6d9ecf8,PAY/SALARY,30-40,2018,9,4,17,0,Tuesday,7 days,52253.921
ACC-1222300524,38,1002.13,1006.33,,CUS-2142601169,2018-09-11,Michael,M,-33.94,151.23,0.0,,,,,,credit,posted,a482d73773854d24a97ad042ef265852,PAY/SALARY,30-40,2018,9,11,17,0,Tuesday,7 days,52253.921
ACC-1222300524,38,1002.13,1003.11,,CUS-2142601169,2018-09-18,Michael,M,-33.94,151.23,0.0,,,,,,credit,posted,08767d7901cd4688978d2cf2fb03f55a,PAY/SALARY,30-40,2018,9,18,17,0,Tuesday,7 days,52253.921
ACC-1222300524,38,1002.13,1213.26,,CUS-2142601169,2018-09-25,Michael,M,-33.94,151.23,0.0,,,,,,credit,posted,4b8ba9aadd5c439f93c1eeccc6180bac,PAY/SALARY,30-40,2018,9,25,17,0,Tuesday,7 days,52253.921
ACC-1222300524,38,1002.13,1592.49,,CUS-2142601169,2018-10-02,Michael,M,-33.94,151.23,0.0,,,,,,credit,posted,80224f315b0c45f4ab5d81fe51be6be6,PAY/SALARY,30-40,2018,10,2,17,0,Tuesday,7 days,52253.921
ACC-1222300524,38,1002.13,1561.23,,CUS-2142601169,2018-10-09,Michael,M,-33.94,151.23,0.0,,,,,,credit,posted,02fbb74ca47541ac859702f3c8d6d3f8,PAY/SALARY,30-40,2018,10,9,17,0,Tuesday,7 days,52253.921
ACC-1222300524,38,1002.13,2245.02,,CUS-2142601169,2018-10-16,Michael,M,-33.94,151.23,0.0,,,,,,credit,posted,84c8c8bff2c24bbfb644808e2783e1b3,PAY/SALARY,30-40,2018,10,16,17,0,Tuesday,7 days,52253.921
ACC-1222300524,38,1002.13,2758.28,,CUS-2142601169,2018-10-23,Michael,M,-33.94,151.23,0.0,,,,,,credit,posted,38b5147f9a6641a2b8e0d1a0b8b9daaf,PAY/SALARY,30-40,2018,10,23,17,0,Tuesday,7 days,52253.921
ACC-1222300524,38,1002.13,2411.7,,CUS-2142601169,2018-10-30,Michael,M,-33.94,151.23,0.0,,,,,,credit,posted,05181faded304452b4829105b1fa9261,PAY/SALARY,30-40,2018,10,30,17,0,Tuesday,7 days,52253.921
ACC-3771436525,20,1099.7,1628.18,,CUS-3325710106,2018-08-07,Derek,M,-37.92,145.04,0.0,,,,,,credit,posted,fe9b2df65feb4872bf558c73147a6e76,PAY/SALARY,<20,2018,8,7,17,0,Tuesday,7 days,57341.5
ACC-3771436525,20,1099.7,1154.57,,CUS-3325710106,2018-08-14,Derek,M,-37.92,145.04,0.0,,,,,,credit,posted,ddd53b5c8e6d4f58acea7157c4be5794,PAY/SALARY,<20,2018,8,14,17,0,Tuesday,7 days,57341.5
ACC-3771436525,20,1099.7,1544.92,,CUS-3325710106,2018-08-21,Derek,M,-37.92,145.04,0.0,,,,,,credit,posted,10ae4e5029634b44acb5f4dd17507d83,PAY/SALARY,<20,2018,8,21,17,0,Tuesday,7 days,57341.5
ACC-3771436525,20,1099.7,2574.74,,CUS-3325710106,2018-08-28,Derek,M,-37.92,145.04,0.0,,,,,,credit,posted,ccbfb0d5b5d243788a4ef04cee5732f9,PAY/SALARY,<20,2018,8,28,17,0,Tuesday,7 days,57341.5
ACC-3771436525,20,1099.7,3216.82,,CUS-3325710106,2018-09-04,Derek,M,-37.92,145.04,0.0,,,,,,credit,posted,09419603f0644debb343bffa623cad6d,PAY/SALARY,<20,2018,9,4,17,0,Tuesday,7 days,57341.5
ACC-3771436525,20,1099.7,4164.86,,CUS-3325710106,2018-09-11,Derek,M,-37.92,145.04,0.0,,,,,,credit,posted,a7ff118bb530493d9b6f08f2aebb7360,PAY/SALARY,<20,2018,9,11,17,0,Tuesday,7 days,57341.5
ACC-3771436525,20,1099.7,4855.9,,CUS-3325710106,2018-09-18,Derek,M,-37.92,145.04,0.0,,,,,,credit,posted,ee678eee03d54fd4bdf0f18fc98efb88,PAY/SALARY,<20,2018,9,18,17,0,Tuesday,7 days,57341.5
ACC-3771436525,20,1099.7,5178.63,,CUS-3325710106,2018-09-25,Derek,M,-37.92,145.04,0.0,,,,,,credit,posted,ad14dcf0caa242e2ad0692efad875f18,PAY/SALARY,<20,2018,9,25,17,0,Tuesday,7 days,57341.5
ACC-3771436525,20,1099.7,5077.98,,CUS-3325710106,2018-10-02,Derek,M,-37.92,145.04,0.0,,,,,,credit,posted,5a7168db7ffd497b95ae10cc26255c79,PAY/SALARY,<20,2018,10,2,17,0,Tuesday,7 days,57341.5
ACC-3771436525,20,1099.7,5981.11,,CUS-3325710106,2018-10-09,Derek,M,-37.92,145.04,0.0,,,,,,credit,posted,f9a764d322e840d8b69965710039c439,PAY/SALARY,<20,2018,10,9,17,0,Tuesday,7 days,57341.5
ACC-3771436525,20,1099.7,6820.47,,CUS-3325710106,2018-10-16,Derek,M,-37.92,145.04,0.0,,,,,,credit,posted,b95e75e7fe8e49ad814896b1178806b7,PAY/SALARY,<20,2018,10,16,17,0,Tuesday,7 days,57341.5
ACC-3771436525,20,1099.7,7773.73,,CUS-3325710106,2018-10-23,Derek,M,-37.92,145.04,0.0,,,,,,credit,posted,825c2410daab4f88b3b22604a15c48d9,PAY/SALARY,<20,2018,10,23,17,0,Tuesday,7 days,57341.5
ACC-3771436525,20,1099.7,8682.68,,CUS-3325710106,2018-10-30,Derek,M,-37.92,145.04,0.0,,,,,,credit,posted,df7cf5f12a374d71b075518558ee424d,PAY/SALARY,<20,2018,10,30,17,0,Tuesday,7 days,57341.5
ACC-3954677887,47,1272.47,1289.91,,CUS-3716701010,2018-08-07,Ruth,F,-32.28,115.72,0.0,,,,,,credit,posted,d29b9e5f070147da86a3d35614cd2453,PAY/SALARY,40-50,2018,8,7,17,0,Tuesday,7 days,66350.221
ACC-3954677887,47,1272.47,2434.38,,CUS-3716701010,2018-08-14,Ruth,F,-32.28,115.72,0.0,,,,,,credit,posted,78ee022d7f07475fadd4e6810b96f560,PAY/SALARY,40-50,2018,8,14,17,0,Tuesday,7 days,66350.221
ACC-3954677887,47,1272.47,3507.7,,CUS-3716701010,2018-08-21,Ruth,F,-32.28,115.72,0.0,,,,,,credit,posted,fcad081cbfd043bca5d941742f24611b,PAY/SALARY,40-50,2018,8,21,17,0,Tuesday,7 days,66350.221
ACC-3954677887,47,1272.47,4072.15,,CUS-3716701010,2018-08-28,Ruth,F,-32.28,115.72,0.0,,,,,,credit,posted,178890e03a594b6db9491a2783219a4d,PAY/SALARY,40-50,2018,8,28,17,0,Tuesday,7 days,66350.221
ACC-3954677887,47,1272.47,5028.43,,CUS-3716701010,2018-09-04,Ruth,F,-32.28,115.72,0.0,,,,,,credit,posted,33fa7bcab6b34cd2bc98973b88bec191,PAY/SALARY,40-50,2018,9,4,17,0,Tuesday,7 days,66350.221
ACC-3954677887,47,1272.47,5764.99,,CUS-3716701010,2018-09-11,Ruth,F,-32.28,115.72,0.0,,,,,,credit,posted,d825e56a393d4b769668bc8985c66fe5,PAY/SALARY,40-50,2018,9,11,17,0,Tuesday,7 days,66350.221
ACC-3954677887,47,1272.47,6821.13,,CUS-3716701010,2018-09-18,Ruth,F,-32.28,115.72,0.0,,,,,,credit,posted,3e7e8d74fdf847579bb7083cdc0f63b2,PAY/SALARY,40-50,2018,9,18,17,0,Tuesday,7 days,66350.221
ACC-3954677887,47,1272.47,5243.6,,CUS-3716701010,2018-09-25,Ruth,F,-32.28,115.72,0.0,,,,,,credit,posted,f34c0667e77d42c98c89e19a309960d5,PAY/SALARY,40-50,2018,9,25,17,0,Tuesday,7 days,66350.221
ACC-3954677887,47,1272.47,6388.07,,CUS-3716701010,2018-10-02,Ruth,F,-32.28,115.72,0.0,,,,,,credit,posted,48951c1865de4d52a049194d5f2ca25f,PAY/SALARY,40-50,2018,10,2,17,0,Tuesday,7 days,66350.221
ACC-3954677887,47,1272.47,7532.54,,CUS-3716701010,2018-10-09,Ruth,F,-32.28,115.72,0.0,,,,,,credit,posted,337ddca27d254d9087993e674bcea6ae,PAY/SALARY,40-50,2018,10,9,17,0,Tuesday,7 days,66350.221
ACC-3954677887,47,1272.47,8677.01,,CUS-3716701010,2018-10-16,Ruth,F,-32.28,115.72,0.0,,,,,,credit,posted,2843332ac01b4d89811884482467571b,PAY/SALARY,40-50,2018,10,16,17,0,Tuesday,7 days,66350.221
ACC-3954677887,47,1272.47,9107.27,,CUS-3716701010,2018-10-23,Ruth,F,-32.28,115.72,0.0,,,,,,credit,posted,55a77ed50d834a9b9c728b9a7d6f1626,PAY/SALARY,40-50,2018,10,23,17,0,Tuesday,7 days,66350.221
ACC-3954677887,47,1272.47,10053.14,,CUS-3716701010,2018-10-30,Ruth,F,-32.28,115.72,0.0,,,,,,credit,posted,0c7862d4c36b4d9abf5cc629b0dacea5,PAY/SALARY,40-50,2018,10,30,17,0,Tuesday,7 days,66350.221
ACC-958000567,34,3517.61,3725.95,,CUS-4142663097,2018-08-07,Sandra,F,-12.37,130.90,0.0,,,,,,credit,posted,123943e86d6c44e9bafe6097034b44d9,PAY/SALARY,30-40,2018,8,7,17,0,Tuesday,14 days,91709.118
ACC-958000567,34,3517.61,5737.9,,CUS-4142663097,2018-08-21,Sandra,F,-12.37,130.90,0.0,,,,,,credit,posted,b8a40b7265b544599d45eefaa5980f10,PAY/SALARY,30-40,2018,8,21,17,0,Tuesday,14 days,91709.118
ACC-958000567,34,3517.61,7578.2,,CUS-4142663097,2018-09-04,Sandra,F,-12.37,130.90,0.0,,,,,,credit,posted,ea4b316d3bbb471c8deac4d5134a0c86,PAY/SALARY,30-40,2018,9,4,17,0,Tuesday,14 days,91709.118
ACC-958000567,34,3517.61,8571.85,,CUS-4142663097,2018-09-18,Sandra,F,-12.37,130.90,0.0,,,,,,credit,posted,cdb5ea7395584550be4f06e0f3750937,PAY/SALARY,30-40,2018,9,18,17,0,Tuesday,14 days,91709.118
ACC-958000567,34,3517.61,9391.41,,CUS-4142663097,2018-10-02,Sandra,F,-12.37,130.90,0.0,,,,,,credit,posted,20a378c72ab24168afe3d42aff58e422,PAY/SALARY,30-40,2018,10,2,17,0,Tuesday,14 days,91709.118
ACC-958000567,34,3517.61,11860.84,,CUS-4142663097,2018-10-16,Sandra,F,-12.37,130.90,0.0,,,,,,credit,posted,0e62ca27a2774be3ac8a0075dfda66fa,PAY/SALARY,30-40,2018,10,16,17,0,Tuesday,14 days,91709.118
ACC-958000567,34,3517.61,12941.1,,CUS-4142663097,2018-10-30,Sandra,F,-12.37,130.90,0.0,,,,,,credit,posted,259d50b522a64b6f82cc898198b290ff,PAY/SALARY,30-40,2018,10,30,17,0,Tuesday,14 days,91709.118
ACC-2897221629,23,982.71,987.16,,CUS-511326734,2018-08-07,Scott,M,-34.37,150.90,0.0,,,,,,credit,posted,78a5cf0943d34e4faf75732305550dce,PAY/SALARY,20-30,2018,8,7,17,0,Tuesday,7 days,51241.307
ACC-2897221629,23,982.71,1823.78,,CUS-511326734,2018-08-14,Scott,M,-34.37,150.90,0.0,,,,,,credit,posted,9cc3a5b1b4c34354b8a17122b9d1b528,PAY/SALARY,20-30,2018,8,14,17,0,Tuesday,7 days,51241.307
ACC-2897221629,23,982.71,2360.24,,CUS-511326734,2018-08-21,Scott,M,-34.37,150.90,0.0,,,,,,credit,posted,d21dc45b5eb046c38d37a9037dfe6e8e,PAY/SALARY,20-30,2018,8,21,17,0,Tuesday,7 days,51241.307
ACC-2897221629,23,982.71,3019.32,,CUS-511326734,2018-08-28,Scott,M,-34.37,150.90,0.0,,,,,,credit,posted,ae01a5673cc34af48976d51d037f6d2b,PAY/SALARY,20-30,2018,8,28,17,0,Tuesday,7 days,51241.307
ACC-2897221629,23,982.71,3633.78,,CUS-511326734,2018-09-04,Scott,M,-34.37,150.90,0.0,,,,,,credit,posted,cbda2838bb754588981b8db9591ca364,PAY/SALARY,20-30,2018,9,4,17,0,Tuesday,7 days,51241.307
ACC-2897221629,23,982.71,4498.34,,CUS-511326734,2018-09-11,Scott,M,-34.37,150.90,0.0,,,,,,credit,posted,f17db34b51224b0caaa44e8f7a2880ae,PAY/SALARY,20-30,2018,9,11,17,0,Tuesday,7 days,51241.307
ACC-2897221629,23,982.71,5094.51,,CUS-511326734,2018-09-18,Scott,M,-34.37,150.90,0.0,,,,,,credit,posted,1a9bae047d0d4ffdbe58dc84b1d49acf,PAY/SALARY,20-30,2018,9,18,17,0,Tuesday,7 days,51241.307
ACC-2897221629,23,982.71,5796.61,,CUS-511326734,2018-09-25,Scott,M,-34.37,150.90,0.0,,,,,,credit,posted,f4f4d6e125514f2aa75c7d6a2a906fc6,PAY/SALARY,20-30,2018,9,25,17,0,Tuesday,7 days,51241.307
ACC-2897221629,23,982.71,6572.32,,CUS-511326734,2018-10-02,Scott,M,-34.37,150.90,0.0,,,,,,credit,posted,bc63022ce08f43949780cae481892b7b,PAY/SALARY,20-30,2018,10,2,17,0,Tuesday,7 days,51241.307
ACC-2897221629,23,982.71,7323.66,,CUS-511326734,2018-10-09,Scott,M,-34.37,150.90,0.0,,,,,,credit,posted,f6e456a1247f404bbf4734e1a433ef15,PAY/SALARY,20-30,2018,10,9,17,0,Tuesday,7 days,51241.307
ACC-2897221629,23,982.71,7850.26,,CUS-511326734,2018-10-16,Scott,M,-34.37,150.90,0.0,,,,,,credit,posted,d700ec0c10d546fdb9e8c4a467782a5c,PAY/SALARY,20-30,2018,10,16,17,0,Tuesday,7 days,51241.307
ACC-2897221629,23,982.71,8516.39,,CUS-511326734,2018-10-23,Scott,M,-34.37,150.90,0.0,,,,,,credit,posted,7da6310cf41a4ebd9c40340dfbd256df,PAY/SALARY,20-30,2018,10,23,17,0,Tuesday,7 days,51241.307
ACC-2897221629,23,982.71,9274.13,,CUS-511326734,2018-10-30,Scott,M,-34.37,150.90,0.0,,,,,,credit,posted,37a753880ad242099d3a73a2e1638f86,PAY/SALARY,20-30,2018,10,30,17,0,Tuesday,7 days,51241.307
ACC-3084464802,19,2485.37,3173.24,,CUS-1928710999,2018-08-08,Susan,F,-37.76,145.15,0.0,,,,,,credit,posted,86d8278bf8f64d5f8e10bcf1be8a2f06,PAY/SALARY,<20,2018,8,8,12,0,Wednesday,14 days,64797.146
ACC-3084464802,19,2485.37,5209.5,,CUS-1928710999,2018-08-22,Susan,F,-37.76,145.15,0.0,,,,,,credit,posted,3a4c893374e8425c9a0639321b35ac80,PAY/SALARY,<20,2018,8,22,12,0,Wednesday,14 days,64797.146
ACC-3084464802,19,2485.37,6937.91,,CUS-1928710999,2018-09-05,Susan,F,-37.76,145.15,0.0,,,,,,credit,posted,e5afaaee85254ddf9e600f0881149295,PAY/SALARY,<20,2018,9,5,12,0,Wednesday,14 days,64797.146
ACC-3084464802,19,2485.37,7801.1,,CUS-1928710999,2018-09-19,Susan,F,-37.76,145.15,0.0,,,,,,credit,posted,385d6f254bf94f25b304ff73ef406cf1,PAY/SALARY,<20,2018,9,19,12,0,Wednesday,14 days,64797.146
ACC-3084464802,19,2485.37,9848.49,,CUS-1928710999,2018-10-03,Susan,F,-37.76,145.15,0.0,,,,,,credit,posted,d66cc7f2ae35474984ed4e60fadcb2cc,PAY/SALARY,<20,2018,10,3,12,0,Wednesday,14 days,64797.146
ACC-3084464802,19,2485.37,11464.28,,CUS-1928710999,2018-10-17,Susan,F,-37.76,145.15,0.0,,,,,,credit,posted,557721059ea447db887dd3bb32126bb7,PAY/SALARY,<20,2018,10,17,12,0,Wednesday,14 days,64797.146
ACC-3084464802,19,2485.37,12930.2,,CUS-1928710999,2018-10-31,Susan,F,-37.76,145.15,0.0,,,,,,credit,posted,a028a7a91b664a6baffad7668a3f3eeb,PAY/SALARY,<20,2018,10,31,12,0,Wednesday,14 days,64797.146
ACC-1516130869,21,2306.63,2316.26,,CUS-325142416,2018-08-08,Jessica,F,-12.45,130.84,0.0,,,,,,credit,posted,6370bebac3db42d3850b6c334d2460f1,PAY/SALARY,20-30,2018,8,8,13,0,Wednesday,14 days,60137.139
ACC-1516130869,21,2306.63,4183.72,,CUS-325142416,2018-08-22,Jessica,F,-12.45,130.84,0.0,,,,,,credit,posted,052fb1250a904c83826a152294ef15d8,PAY/SALARY,20-30,2018,8,22,13,0,Wednesday,14 days,60137.139
ACC-1516130869,21,2306.63,3351.59,,CUS-325142416,2018-09-05,Jessica,F,-12.45,130.84,0.0,,,,,,credit,posted,07e4515c72c34957b946a926b888819b,PAY/SALARY,20-30,2018,9,5,13,0,Wednesday,14 days,60137.139
ACC-1516130869,21,2306.63,5042.29,,CUS-325142416,2018-09-19,Jessica,F,-12.45,130.84,0.0,,,,,,credit,posted,ba5f73ed90a242499fd77a2405e3e766,PAY/SALARY,20-30,2018,9,19,13,0,Wednesday,14 days,60137.139
ACC-1516130869,21,2306.63,4995.95,,CUS-325142416,2018-10-03,Jessica,F,-12.45,130.84,0.0,,,,,,credit,posted,176629775d0648dd94bb475ee74ddb7a,PAY/SALARY,20-30,2018,10,3,13,0,Wednesday,14 days,60137.139
ACC-1516130869,21,2306.63,7021.14,,CUS-325142416,2018-10-17,Jessica,F,-12.45,130.84,0.0,,,,,,credit,posted,1a8698e63179449b82e743c4db3fbc8a,PAY/SALARY,20-30,2018,10,17,13,0,Wednesday,14 days,60137.139
ACC-1516130869,21,2306.63,4970.1,,CUS-325142416,2018-10-31,Jessica,F,-12.45,130.84,0.0,,,,,,credit,posted,8d243f88cede47a48d7ebcd3e3e97f57,PAY/SALARY,20-30,2018,10,31,13,0,Wednesday,14 days,60137.139
ACC-2171593283,19,2639.76,6691.71,,CUS-2317998716,2018-08-08,Fernando,M,-36.04,146.94,0.0,,,,,,credit,posted,abafeae1dd9949f0a75f65cdd265fce0,PAY/SALARY,<20,2018,8,8,17,0,Wednesday,14 days,68822.314
ACC-2171593283,19,2639.76,8997.47,,CUS-2317998716,2018-08-22,Fernando,M,-36.04,146.94,0.0,,,,,,credit,posted,827b074bb96e49afa0d222e4d8184d3c,PAY/SALARY,<20,2018,8,22,17,0,Wednesday,14 days,68822.314
ACC-2171593283,19,2639.76,11218.81,,CUS-2317998716,2018-09-05,Fernando,M,-36.04,146.94,0.0,,,,,,credit,posted,2f596d5dcf8e4dacb17644d0d29518f3,PAY/SALARY,<20,2018,9,5,17,0,Wednesday,14 days,68822.314
ACC-2171593283,19,2639.76,13456.9,,CUS-2317998716,2018-09-19,Fernando,M,-36.04,146.94,0.0,,,,,,credit,posted,25bfe1182aa74adc94381e155981c910,PAY/SALARY,<20,2018,9,19,17,0,Wednesday,14 days,68822.314
ACC-2171593283,19,2639.76,15631.99,,CUS-2317998716,2018-10-03,Fernando,M,-36.04,146.94,0.0,,,,,,credit,posted,6bf15a477072426da85ddc866e76f492,PAY/SALARY,<20,2018,10,3,17,0,Wednesday,14 days,68822.314
ACC-2171593283,19,2639.76,17841.1,,CUS-2317998716,2018-10-17,Fernando,M,-36.04,146.94,0.0,,,,,,credit,posted,3e9cd50640d34e17b8c5aacc8e7ac1c3,PAY/SALARY,<20,2018,10,17,17,0,Wednesday,14 days,68822.314
ACC-2171593283,19,2639.76,19893.45,,CUS-2317998716,2018-10-31,Fernando,M,-36.04,146.94,0.0,,,,,,credit,posted,d4804402c1c34e0ebc53a4c395e0c63d,PAY/SALARY,<20,2018,10,31,17,0,Wednesday,14 days,68822.314
ACC-3536132544,41,2101.51,3275.64,,CUS-2348881191,2018-08-09,Heather,F,-37.79,144.93,0.0,,,,,,credit,posted,526abbf608a441ad905192afff3a71db,PAY/SALARY,40-50,2018,8,9,11,0,Thursday,14 days,54789.368
ACC-3536132544,41,2101.51,3042.91,,CUS-2348881191,2018-08-23,Heather,F,-37.79,144.93,0.0,,,,,,credit,posted,f74facc23b4649d88888338a805999c1,PAY/SALARY,40-50,2018,8,23,11,0,Thursday,14 days,54789.368
ACC-3536132544,41,2101.51,4406.95,,CUS-2348881191,2018-09-06,Heather,F,-37.79,144.93,0.0,,,,,,credit,posted,0165224903084eb3b25b17a419bd17eb,PAY/SALARY,40-50,2018,9,6,11,0,Thursday,14 days,54789.368
ACC-3536132544,41,2101.51,5999.62,,CUS-2348881191,2018-09-20,Heather,F,-37.79,144.93,0.0,,,,,,credit,posted,2356ed0d04cd436d961500c6dbd05f44,PAY/SALARY,40-50,2018,9,20,11,0,Thursday,14 days,54789.368
ACC-3536132544,41,2101.51,7333.65,,CUS-2348881191,2018-10-04,Heather,F,-37.79,144.93,0.0,,,,,,credit,posted,b813a81187c2450aa840afb3822fdb01,PAY/SALARY,40-50,2018,10,4,11,0,Thursday,14 days,54789.368
ACC-3536132544,41,2101.51,8727.47,,CUS-2348881191,2018-10-18,Heather,F,-37.79,144.93,0.0,,,,,,credit,posted,5bd791f6625b48858b36e632adc4a22e,PAY/SALARY,40-50,2018,10,18,11,0,Thursday,14 days,54789.368
ACC-2259139624,19,3676.94,4386.28,,CUS-3174332735,2018-08-09,Cindy,F,-37.91,144.66,0.0,,,,,,credit,posted,fe4e25f654d14059b1e9eb45c4a2c0bb,PAY/SALARY,<20,2018,8,9,11,0,Thursday,14 days,95863.079
ACC-2259139624,19,3676.94,7736.06,,CUS-3174332735,2018-08-23,Cindy,F,-37.91,144.66,0.0,,,,,,credit,posted,234d04e1aefe4bd78e7500635e77f47a,PAY/SALARY,<20,2018,8,23,11,0,Thursday,14 days,95863.079
ACC-2259139624,19,3676.94,10642.9,,CUS-3174332735,2018-09-06,Cindy,F,-37.91,144.66,0.0,,,,,,credit,posted,746fad2c34ac488c866a441332476cfe,PAY/SALARY,<20,2018,9,6,11,0,Thursday,14 days,95863.079
ACC-2259139624,19,3676.94,14053.84,,CUS-3174332735,2018-09-20,Cindy,F,-37.91,144.66,0.0,,,,,,credit,posted,f44ee633bce248d4b4e9260dffd673f4,PAY/SALARY,<20,2018,9,20,11,0,Thursday,14 days,95863.079
ACC-2259139624,19,3676.94,17337.78,,CUS-3174332735,2018-10-04,Cindy,F,-37.91,144.66,0.0,,,,,,credit,posted,f3cdba3955f24c63bf425da95ecfcb8a,PAY/SALARY,<20,2018,10,4,11,0,Thursday,14 days,95863.079
ACC-2259139624,19,3676.94,20858.72,,CUS-3174332735,2018-10-18,Cindy,F,-37.91,144.66,0.0,,,,,,credit,posted,36352d4a7a3644d1b5168d9d37c632f7,PAY/SALARY,<20,2018,10,18,11,0,Thursday,14 days,95863.079
ACC-1279356312,44,2887.34,3683.89,,CUS-1892177589,2018-08-09,Tyler,M,-37.73,144.79,0.0,,,,,,credit,posted,f898c3159e774202a8967e81d9cf43ca,PAY/SALARY,40-50,2018,8,9,12,0,Thursday,14 days,75277.079
ACC-1279356312,44,2887.34,6082.23,,CUS-1892177589,2018-08-23,Tyler,M,-37.73,144.79,0.0,,,,,,credit,posted,3434358e28e14c9a8f749d55cc77ad39,PAY/SALARY,40-50,2018,8,23,12,0,Thursday,14 days,75277.079
ACC-1279356312,44,2887.34,7878.7,,CUS-1892177589,2018-09-06,Tyler,M,-37.73,144.79,0.0,,,,,,credit,posted,e95f1a3e50494d56a9011a9d5340d4e7,PAY/SALARY,40-50,2018,9,6,12,0,Thursday,14 days,75277.079
ACC-1279356312,44,2887.34,8809.04,,CUS-1892177589,2018-09-20,Tyler,M,-37.73,144.79,0.0,,,,,,credit,posted,e8d6658e93b54f1b92e0f5926b289f89,PAY/SALARY,40-50,2018,9,20,12,0,Thursday,14 days,75277.079
ACC-1279356312,44,2887.34,10854.8,,CUS-1892177589,2018-10-04,Tyler,M,-37.73,144.79,0.0,,,,,,credit,posted,8b43e2dd497b487c99d28383b0ababd9,PAY/SALARY,40-50,2018,10,4,12,0,Thursday,14 days,75277.079
ACC-1279356312,44,2887.34,12625.91,,CUS-1892177589,2018-10-18,Tyler,M,-37.73,144.79,0.0,,,,,,credit,posted,a09159eb3acd4663baca1fe789df31f3,PAY/SALARY,40-50,2018,10,18,12,0,Thursday,14 days,75277.079
ACC-1243371644,42,1681.58,1984.7,,CUS-3904958894,2018-08-09,Gregory,M,-33.78,150.90,0.0,,,,,,credit,posted,84ae4cc4e20f4ab99a1022aebd5ab661,PAY/SALARY,40-50,2018,8,9,13,0,Thursday,14 days,43841.193
ACC-1243371644,42,1681.58,3001.96,,CUS-3904958894,2018-08-23,Gregory,M,-33.78,150.90,0.0,,,,,,credit,posted,6b34b828709141bc968b5b52f21b60c3,PAY/SALARY,40-50,2018,8,23,13,0,Thursday,14 days,43841.193
ACC-1243371644,42,1681.58,4469.65,,CUS-3904958894,2018-09-06,Gregory,M,-33.78,150.90,0.0,,,,,,credit,posted,5523a430064842528aad16e99d0429d1,PAY/SALARY,40-50,2018,9,6,13,0,Thursday,14 days,43841.193
ACC-1243371644,42,1681.58,5514.14,,CUS-3904958894,2018-09-20,Gregory,M,-33.78,150.90,0.0,,,,,,credit,posted,b4a899be87b84679ade944726ee0e955,PAY/SALARY,40-50,2018,9,20,13,0,Thursday,14 days,43841.193
ACC-1243371644,42,1681.58,7005.72,,CUS-3904958894,2018-10-04,Gregory,M,-33.78,150.90,0.0,,,,,,credit,posted,db8489f99aa2460488ea7882af61c516,PAY/SALARY,40-50,2018,10,4,13,0,Thursday,14 days,43841.193
ACC-1243371644,42,1681.58,6599.68,,CUS-3904958894,2018-10-18,Gregory,M,-33.78,150.90,0.0,,,,,,credit,posted,76d2ee9752334f47a12c1ec298921b5b,PAY/SALARY,40-50,2018,10,18,13,0,Thursday,14 days,43841.193
ACC-1608363396,20,2320.3,3512.95,,CUS-2688605418,2018-08-09,Robert,M,-33.87,151.22,0.0,,,,,,credit,posted,fe6fd0586a2846049f200b05e93ba834,PAY/SALARY,<20,2018,8,9,14,0,Thursday,14 days,60493.536
ACC-1608363396,20,2320.3,4969.93,,CUS-2688605418,2018-08-23,Robert,M,-33.87,151.22,0.0,,,,,,credit,posted,7bbd4205e7e949efb780da07b2e950a2,PAY/SALARY,<20,2018,8,23,14,0,Thursday,14 days,60493.536
ACC-1608363396,20,2320.3,6069.17,,CUS-2688605418,2018-09-06,Robert,M,-33.87,151.22,0.0,,,,,,credit,posted,cce2cd0dd5854a82bff8cfd1165095e1,PAY/SALARY,<20,2018,9,6,14,0,Thursday,14 days,60493.536
ACC-1608363396,20,2320.3,7529.7,,CUS-2688605418,2018-09-20,Robert,M,-33.87,151.22,0.0,,,,,,credit,posted,4893f701f6cf4d738a8b4636b1ca1e0e,PAY/SALARY,<20,2018,9,20,14,0,Thursday,14 days,60493.536
ACC-1608363396,20,2320.3,8939.31,,CUS-2688605418,2018-10-04,Robert,M,-33.87,151.22,0.0,,,,,,credit,posted,96b2b3f80a774b95877abb5d5684baf8,PAY/SALARY,<20,2018,10,4,14,0,Thursday,14 days,60493.536
ACC-1608363396,20,2320.3,9739.88,,CUS-2688605418,2018-10-18,Robert,M,-33.87,151.22,0.0,,,,,,credit,posted,49bf55fb7e3a4f0aafad245ecc0f34c6,PAY/SALARY,<20,2018,10,18,14,0,Thursday,14 days,60493.536
ACC-1424176027,22,1928.97,2200.13,,CUS-3431016847,2018-08-09,Donald,M,-33.93,151.08,0.0,,,,,,credit,posted,af797fa1790942a882d4b53da514731c,PAY/SALARY,20-30,2018,8,9,14,0,Thursday,14 days,50291.004
ACC-1424176027,22,1928.97,3842.64,,CUS-3431016847,2018-08-23,Donald,M,-33.93,151.08,0.0,,,,,,credit,posted,65fadb4d7a0041929329ae0f80374558,PAY/SALARY,20-30,2018,8,23,14,0,Thursday,14 days,50291.004
ACC-1424176027,22,1928.97,5332.13,,CUS-3431016847,2018-09-06,Donald,M,-33.93,151.08,0.0,,,,,,credit,posted,7094f5bf008347159c76ec8e8e646073,PAY/SALARY,20-30,2018,9,6,14,0,Thursday,14 days,50291.004
ACC-1424176027,22,1928.97,6993.27,,CUS-3431016847,2018-09-20,Donald,M,-33.93,151.08,0.0,,,,,,credit,posted,72ed7d1d9c3b453290cf878ce84d0e08,PAY/SALARY,20-30,2018,9,20,14,0,Thursday,14 days,50291.004
ACC-1424176027,22,1928.97,8533.91,,CUS-3431016847,2018-10-04,Donald,M,-33.93,151.08,0.0,,,,,,credit,posted,fb707ad2568e46ea9a083f92972d3e72,PAY/SALARY,20-30,2018,10,4,14,0,Thursday,14 days,50291.004
ACC-1424176027,22,1928.97,10185.91,,CUS-3431016847,2018-10-18,Donald,M,-33.93,151.08,0.0,,,,,,credit,posted,16eba9e431ca413d8c03a4e3b7e7c9b1,PAY/SALARY,20-30,2018,10,18,14,0,Thursday,14 days,50291.004
ACC-154431271,18,1537.68,1546.67,,CUS-3702001629,2018-08-09,Lori,F,-27.48,153.09,0.0,,,,,,credit,posted,e3d04e24400c474583e98f82f75c4869,PAY/SALARY,<20,2018,8,9,17,0,Thursday,14 days,40089.514
ACC-154431271,18,1537.68,2187.72,,CUS-3702001629,2018-08-23,Lori,F,-27.48,153.09,0.0,,,,,,credit,posted,adf7a47ca709400d97842b12cc43c2a7,PAY/SALARY,<20,2018,8,23,17,0,Thursday,14 days,40089.514
ACC-154431271,18,1537.68,3132.9,,CUS-3702001629,2018-09-06,Lori,F,-27.48,153.09,0.0,,,,,,credit,posted,1ac5e6c847844edeb61242dd28b622c2,PAY/SALARY,<20,2018,9,6,17,0,Thursday,14 days,40089.514
ACC-154431271,18,1537.68,3757.83,,CUS-3702001629,2018-09-20,Lori,F,-27.48,153.09,0.0,,,,,,credit,posted,a0b2ed79a99345aa9d5ab94f2371b236,PAY/SALARY,<20,2018,9,20,17,0,Thursday,14 days,40089.514
ACC-154431271,18,1537.68,3391.29,,CUS-3702001629,2018-10-04,Lori,F,-27.48,153.09,0.0,,,,,,credit,posted,14ba76f664624bc1aacf749bc9191158,PAY/SALARY,<20,2018,10,4,17,0,Thursday,14 days,40089.514
ACC-154431271,18,1537.68,3460.03,,CUS-3702001629,2018-10-18,Lori,F,-27.48,153.09,0.0,,,,,,credit,posted,7dba9afaf1e741eca008218c978f24fb,PAY/SALARY,<20,2018,10,18,17,0,Thursday,14 days,40089.514
ACC-3941181087,25,2687.85,3506.06,,CUS-3989008654,2018-08-09,Paul,M,-31.94,115.79,0.0,,,,,,credit,posted,acf0440be17643a088a11d1fa7f048d2,PAY/SALARY,20-30,2018,8,9,17,0,Thursday,14 days,70076.089
ACC-3941181087,25,2687.85,5543.03,,CUS-3989008654,2018-08-23,Paul,M,-31.94,115.79,0.0,,,,,,credit,posted,ca45bac0e4fd42f484fc028aa9b650b1,PAY/SALARY,20-30,2018,8,23,17,0,Thursday,14 days,70076.089
ACC-3941181087,25,2687.85,7997.88,,CUS-3989008654,2018-09-06,Paul,M,-31.94,115.79,0.0,,,,,,credit,posted,a27d1250de15477b9d88d945f593a8a7,PAY/SALARY,20-30,2018,9,6,17,0,Thursday,14 days,70076.089
ACC-3941181087,25,2687.85,10173.73,,CUS-3989008654,2018-09-20,Paul,M,-31.94,115.79,0.0,,,,,,credit,posted,e2094f656619475c8e1ba656d0cdc3be,PAY/SALARY,20-30,2018,9,20,17,0,Thursday,14 days,70076.089
ACC-3941181087,25,2687.85,12539.58,,CUS-3989008654,2018-10-04,Paul,M,-31.94,115.79,0.0,,,,,,credit,posted,405381caf3684cc6ab9abe1ed726a1c0,PAY/SALARY,20-30,2018,10,4,17,0,Thursday,14 days,70076.089
ACC-3941181087,25,2687.85,14907.43,,CUS-3989008654,2018-10-18,Paul,M,-31.94,115.79,0.0,,,,,,credit,posted,18ee9edbb9214bffa21e19a5cb3fd783,PAY/SALARY,20-30,2018,10,18,17,0,Thursday,14 days,70076.089
ACC-574997646,18,1952.29,1954.67,,CUS-586638664,2018-08-10,Mackenzie,F,-33.64,150.79,0.0,,,,,,credit,posted,f173979b334f436ca465925955b13fb3,PAY/SALARY,<20,2018,8,10,14,0,Friday,14 days,50898.989
ACC-574997646,18,1952.29,3333.39,,CUS-586638664,2018-08-24,Mackenzie,F,-33.64,150.79,0.0,,,,,,credit,posted,8825f1d53e994088907801792ebabcc3,PAY/SALARY,<20,2018,8,24,14,0,Friday,14 days,50898.989
ACC-574997646,18,1952.29,4757.68,,CUS-586638664,2018-09-07,Mackenzie,F,-33.64,150.79,0.0,,,,,,credit,posted,c82a4d082baa49c689d4d0c511e77116,PAY/SALARY,<20,2018,9,7,14,0,Friday,14 days,50898.989
ACC-574997646,18,1952.29,4135.17,,CUS-586638664,2018-09-21,Mackenzie,F,-33.64,150.79,0.0,,,,,,credit,posted,81b7a1f6544d42f6b3816f965c807bcf,PAY/SALARY,<20,2018,9,21,14,0,Friday,14 days,50898.989
ACC-574997646,18,1952.29,5367.0,,CUS-586638664,2018-10-05,Mackenzie,F,-33.64,150.79,0.0,,,,,,credit,posted,60af7365d05b47f9b1da2302c48c9270,PAY/SALARY,<20,2018,10,5,14,0,Friday,14 days,50898.989
ACC-574997646,18,1952.29,6988.76,,CUS-586638664,2018-10-19,Mackenzie,F,-33.64,150.79,0.0,,,,,,credit,posted,4ec0e86aff554c94b59b08df78d1d7d3,PAY/SALARY,<20,2018,10,19,14,0,Friday,14 days,50898.989
ACC-1890605467,38,3649.51,9011.76,,CUS-1478398256,2018-08-10,Alexander,M,-37.66,143.88,0.0,,,,,,credit,posted,42d5f43bf1a14443ac0d8e67d55db42a,PAY/SALARY,30-40,2018,8,10,15,0,Friday,14 days,95147.939
ACC-1890605467,38,3649.51,11860.25,,CUS-1478398256,2018-08-24,Alexander,M,-37.66,143.88,0.0,,,,,,credit,posted,0f70c817266045b7b85bba25d71b59e2,PAY/SALARY,30-40,2018,8,24,15,0,Friday,14 days,95147.939
ACC-1890605467,38,3649.51,13615.34,,CUS-1478398256,2018-09-07,Alexander,M,-37.66,143.88,0.0,,,,,,credit,posted,3663547785fb4528a21a7efe47337b57,PAY/SALARY,30-40,2018,9,7,15,0,Friday,14 days,95147.939
ACC-1890605467,38,3649.51,16609.05,,CUS-1478398256,2018-09-21,Alexander,M,-37.66,143.88,0.0,,,,,,credit,posted,8f8370298ac143d78e8ec0c2593e4adb,PAY/SALARY,30-40,2018,9,21,15,0,Friday,14 days,95147.939
ACC-1890605467,38,3649.51,19467.4,,CUS-1478398256,2018-10-05,Alexander,M,-37.66,143.88,0.0,,,,,,credit,posted,acae45de6c9242c5a178239d7ef01c63,PAY/SALARY,30-40,2018,10,5,15,0,Friday,14 days,95147.939
ACC-1890605467,38,3649.51,22337.94,,CUS-1478398256,2018-10-19,Alexander,M,-37.66,143.88,0.0,,,,,,credit,posted,ed2673045be1465888c5cf111629be77,PAY/SALARY,30-40,2018,10,19,15,0,Friday,14 days,95147.939
ACC-90814749,35,2308.67,7810.26,,CUS-1896554896,2018-08-10,Christopher,M,-32.98,151.68,0.0,,,,,,credit,posted,5d671d9b4a8f4fb8a13e1266ac9733a4,PAY/SALARY,30-40,2018,8,10,15,0,Friday,14 days,60190.325
ACC-90814749,35,2308.67,9905.8,,CUS-1896554896,2018-08-24,Christopher,M,-32.98,151.68,0.0,,,,,,credit,posted,90769ac836244a65b66c505bcf9e7f56,PAY/SALARY,30-40,2018,8,24,15,0,Friday,14 days,60190.325
ACC-90814749,35,2308.67,10796.61,,CUS-1896554896,2018-09-07,Christopher,M,-32.98,151.68,0.0,,,,,,credit,posted,6cab3f8e7b9141128db766f5c737cd16,PAY/SALARY,30-40,2018,9,7,15,0,Friday,14 days,60190.325
ACC-90814749,35,2308.67,11829.28,,CUS-1896554896,2018-09-21,Christopher,M,-32.98,151.68,0.0,,,,,,credit,posted,c70f6ab71733421fb66eae3c467b628c,PAY/SALARY,30-40,2018,9,21,15,0,Friday,14 days,60190.325
ACC-90814749,35,2308.67,11740.7,,CUS-1896554896,2018-10-05,Christopher,M,-32.98,151.68,0.0,,,,,,credit,posted,1611bb06585b4918892e226f80a2ba18,PAY/SALARY,30-40,2018,10,5,15,0,Friday,14 days,60190.325
ACC-90814749,35,2308.67,13218.68,,CUS-1896554896,2018-10-19,Christopher,M,-32.98,151.68,0.0,,,,,,credit,posted,a3ffbe8303bf468c9f7a08d1dc040843,PAY/SALARY,30-40,2018,10,19,15,0,Friday,14 days,60190.325
ACC-80388494,28,1916.51,2658.33,,CUS-1140341822,2018-08-10,Dustin,M,-37.42,144.97,0.0,,,,,,credit,posted,068a8f108221449a9e08f7753c2f7f19,PAY/SALARY,20-30,2018,8,10,16,0,Friday,14 days,49966.154
ACC-80388494,28,1916.51,4170.52,,CUS-1140341822,2018-08-24,Dustin,M,-37.42,144.97,0.0,,,,,,credit,posted,65772072c5954b5ca69edb12b50a680c,PAY/SALARY,20-30,2018,8,24,16,0,Friday,14 days,49966.154
ACC-80388494,28,1916.51,5896.44,,CUS-1140341822,2018-09-07,Dustin,M,-37.42,144.97,0.0,,,,,,credit,posted,4127c11da7a5449295a0e85135d17ecb,PAY/SALARY,20-30,2018,9,7,16,0,Friday,14 days,49966.154
ACC-80388494,28,1916.51,7136.0,,CUS-1140341822,2018-09-21,Dustin,M,-37.42,144.97,0.0,,,,,,credit,posted,c4816355845047249f1aa6a95ce7bd06,PAY/SALARY,20-30,2018,9,21,16,0,Friday,14 days,49966.154
ACC-80388494,28,1916.51,7530.55,,CUS-1140341822,2018-10-05,Dustin,M,-37.42,144.97,0.0,,,,,,credit,posted,6f8f9c1d34ec4e25accc4821c0cc8292,PAY/SALARY,20-30,2018,10,5,16,0,Friday,14 days,49966.154
ACC-80388494,28,1916.51,7658.48,,CUS-1140341822,2018-10-19,Dustin,M,-37.42,144.97,0.0,,,,,,credit,posted,78db82cfc63341cbbdbf0c292723f9ab,PAY/SALARY,20-30,2018,10,19,16,0,Friday,14 days,49966.154
ACC-1344825761,46,2470.45,15824.73,,CUS-1499065773,2018-08-10,Sarah,F,-33.91,151.09,0.0,,,,,,credit,posted,39fd469b65184dfe913384df8f3089c8,PAY/SALARY,40-50,2018,8,10,17,0,Friday,14 days,64408.161
ACC-1344825761,46,2470.45,17950.18,,CUS-1499065773,2018-08-24,Sarah,F,-33.91,151.09,0.0,,,,,,credit,posted,8d6121bf7a874ddf83113b91ea357311,PAY/SALARY,40-50,2018,8,24,17,0,Friday,14 days,64408.161
ACC-1344825761,46,2470.45,20008.25,,CUS-1499065773,2018-09-07,Sarah,F,-33.91,151.09,0.0,,,,,,credit,posted,2c569398214145d19ac219c67b6381f9,PAY/SALARY,40-50,2018,9,7,17,0,Friday,14 days,64408.161
ACC-1344825761,46,2470.45,21463.53,,CUS-1499065773,2018-09-21,Sarah,F,-33.91,151.09,0.0,,,,,,credit,posted,19efad8562794aac992d3ece9ce098eb,PAY/SALARY,40-50,2018,9,21,17,0,Friday,14 days,64408.161
ACC-1344825761,46,2470.45,22761.41,,CUS-1499065773,2018-10-05,Sarah,F,-33.91,151.09,0.0,,,,,,credit,posted,8ab1241b36214742bf6b93a54bd1e053,PAY/SALARY,40-50,2018,10,5,17,0,Friday,14 days,64408.161
ACC-1344825761,46,2470.45,24857.97,,CUS-1499065773,2018-10-19,Sarah,F,-33.91,151.09,0.0,,,,,,credit,posted,1adedffa7ab04aad9cfd277c1485de74,PAY/SALARY,40-50,2018,10,19,17,0,Friday,14 days,64408.161
ACC-2014856841,46,2179.96,260393.9,,CUS-2370108457,2018-08-10,Patrick,M,-37.90,144.99,0.0,,,,,,credit,posted,dde605aacebe400fbd69520e2b9e8593,PAY/SALARY,40-50,2018,8,10,17,0,Friday,14 days,56834.671
ACC-2014856841,46,2179.96,262153.86,,CUS-2370108457,2018-08-24,Patrick,M,-37.90,144.99,0.0,,,,,,credit,posted,e4f1c2edf241411590bf599ff865f9ed,PAY/SALARY,40-50,2018,8,24,17,0,Friday,14 days,56834.671
ACC-2014856841,46,2179.96,264103.82,,CUS-2370108457,2018-09-07,Patrick,M,-37.90,144.99,0.0,,,,,,credit,posted,4939d20a732a4a2d95c1a98bc0264d3d,PAY/SALARY,40-50,2018,9,7,17,0,Friday,14 days,56834.671
ACC-2014856841,46,2179.96,264519.11,,CUS-2370108457,2018-09-21,Patrick,M,-37.90,144.99,0.0,,,,,,credit,posted,c979ba0f444243c9ae4e8b9733156afd,PAY/SALARY,40-50,2018,9,21,17,0,Friday,14 days,56834.671
ACC-2014856841,46,2179.96,266469.07,,CUS-2370108457,2018-10-05,Patrick,M,-37.90,144.99,0.0,,,,,,credit,posted,f703bd6205a34886aee4108ff7bbc252,PAY/SALARY,40-50,2018,10,5,17,0,Friday,14 days,56834.671
ACC-2014856841,46,2179.96,267128.52,,CUS-2370108457,2018-10-19,Patrick,M,-37.90,144.99,0.0,,,,,,credit,posted,a6ac361f68cf4442804fa8aa785b3ac7,PAY/SALARY,40-50,2018,10,19,17,0,Friday,14 days,56834.671
ACC-2265520058,26,1843.14,1853.29,,CUS-331942311,2018-08-13,Catherine,F,-33.85,151.27,0.0,,,,,,credit,posted,10445868a8cc4e4e902adc255520d6db,PAY/SALARY,20-30,2018,8,13,11,0,Monday,14 days,48053.293
ACC-2265520058,26,1843.14,3414.87,,CUS-331942311,2018-08-27,Catherine,F,-33.85,151.27,0.0,,,,,,credit,posted,5c7f6ca760f64bf3b1ff5ad8cc335aac,PAY/SALARY,20-30,2018,8,27,11,0,Monday,14 days,48053.293
ACC-2265520058,26,1843.14,3742.72,,CUS-331942311,2018-09-10,Catherine,F,-33.85,151.27,0.0,,,,,,credit,posted,9df7121be945439a9fcdf4f4834fa597,PAY/SALARY,20-30,2018,9,10,11,0,Monday,14 days,48053.293
ACC-2265520058,26,1843.14,4863.09,,CUS-331942311,2018-09-24,Catherine,F,-33.85,151.27,0.0,,,,,,credit,posted,3b35dc3f30a244898b04fd1530f92b72,PAY/SALARY,20-30,2018,9,24,11,0,Monday,14 days,48053.293
ACC-2265520058,26,1843.14,6548.23,,CUS-331942311,2018-10-08,Catherine,F,-33.85,151.27,0.0,,,,,,credit,posted,6494bb95d4264711b3f866af7326e127,PAY/SALARY,20-30,2018,10,8,11,0,Monday,14 days,48053.293
ACC-2265520058,26,1843.14,7496.65,,CUS-331942311,2018-10-22,Catherine,F,-33.85,151.27,0.0,,,,,,credit,posted,1fd90ea0181f4a608c5ebb59976ce1c1,PAY/SALARY,20-30,2018,10,22,11,0,Monday,14 days,48053.293
ACC-4274272854,20,1640.83,3955.08,,CUS-2484453271,2018-08-13,Timothy,M,-37.86,145.23,0.0,,,,,,credit,posted,cec50d338a5046fea8f2438993ba5c13,PAY/SALARY,<20,2018,8,13,12,0,Monday,14 days,42778.782
ACC-4274272854,20,1640.83,5310.91,,CUS-2484453271,2018-08-27,Timothy,M,-37.86,145.23,0.0,,,,,,credit,posted,4a29660bd57f496b99a6f11e04847d81,PAY/SALARY,<20,2018,8,27,12,0,Monday,14 days,42778.782
ACC-4274272854,20,1640.83,6853.74,,CUS-2484453271,2018-09-10,Timothy,M,-37.86,145.23,0.0,,,,,,credit,posted,616d7569fe8e4ece8aadfb2a504a5ac9,PAY/SALARY,<20,2018,9,10,12,0,Monday,14 days,42778.782
ACC-4274272854,20,1640.83,7178.3,,CUS-2484453271,2018-09-24,Timothy,M,-37.86,145.23,0.0,,,,,,credit,posted,f8257d22de3140a38c57fae393d19e49,PAY/SALARY,<20,2018,9,24,12,0,Monday,14 days,42778.782
ACC-4274272854,20,1640.83,8638.2,,CUS-2484453271,2018-10-08,Timothy,M,-37.86,145.23,0.0,,,,,,credit,posted,936b71941a8a421a9df82847183a0386,PAY/SALARY,<20,2018,10,8,12,0,Monday,14 days,42778.782
ACC-4274272854,20,1640.83,10064.07,,CUS-2484453271,2018-10-22,Timothy,M,-37.86,145.23,0.0,,,,,,credit,posted,2f02a833bff945128e76ccd29539816a,PAY/SALARY,<20,2018,10,22,12,0,Monday,14 days,42778.782
ACC-2681137560,31,2886.52,2887.54,,CUS-2083971310,2018-08-13,Nathaniel,M,-33.99,151.11,0.0,,,,,,credit,posted,77b161f025244c5e9ad82a157fcf293b,PAY/SALARY,30-40,2018,8,13,13,0,Monday,14 days,75255.7
ACC-2681137560,31,2886.52,5409.34,,CUS-2083971310,2018-08-27,Nathaniel,M,-33.99,151.11,0.0,,,,,,credit,posted,73ef29ee367b4c05b617f58f6353a2fa,PAY/SALARY,30-40,2018,8,27,13,0,Monday,14 days,75255.7
ACC-2681137560,31,2886.52,7495.12,,CUS-2083971310,2018-09-10,Nathaniel,M,-33.99,151.11,0.0,,,,,,credit,posted,d9d57552cb7a4adcad24cf514c4c40f9,PAY/SALARY,30-40,2018,9,10,13,0,Monday,14 days,75255.7
ACC-2681137560,31,2886.52,9468.98,,CUS-2083971310,2018-09-24,Nathaniel,M,-33.99,151.11,0.0,,,,,,credit,posted,c7b544d210c948f3b84edd7093593865,PAY/SALARY,30-40,2018,9,24,13,0,Monday,14 days,75255.7
ACC-2681137560,31,2886.52,11684.97,,CUS-2083971310,2018-10-08,Nathaniel,M,-33.99,151.11,0.0,,,,,,credit,posted,077f7883618c47d59f7b7d63b309ac74,PAY/SALARY,30-40,2018,10,8,13,0,Monday,14 days,75255.7
ACC-2681137560,31,2886.52,13706.66,,CUS-2083971310,2018-10-22,Nathaniel,M,-33.99,151.11,0.0,,,,,,credit,posted,0a789c20ba26446e8b48e4c85f014ee9,PAY/SALARY,30-40,2018,10,22,13,0,Monday,14 days,75255.7
ACC-847145727,19,2854.74,52796.92,,CUS-1609060617,2018-08-13,Michael,M,-31.92,115.90,0.0,,,,,,credit,posted,7b882ac44a6043c6a8c7ec0aa4d84207,PAY/SALARY,<20,2018,8,13,17,0,Monday,14 days,74427.15
ACC-847145727,19,2854.74,55207.57,,CUS-1609060617,2018-08-27,Michael,M,-31.92,115.90,0.0,,,,,,credit,posted,26e99cb71f874ae68d0933cade64f2c6,PAY/SALARY,<20,2018,8,27,17,0,Monday,14 days,74427.15
ACC-847145727,19,2854.74,57686.46,,CUS-1609060617,2018-09-10,Michael,M,-31.92,115.90,0.0,,,,,,credit,posted,8420a9b70719410d9703755cc77e3f0a,PAY/SALARY,<20,2018,9,10,17,0,Monday,14 days,74427.15
ACC-847145727,19,2854.74,59584.84,,CUS-1609060617,2018-09-24,Michael,M,-31.92,115.90,0.0,,,,,,credit,posted,0bb85af550734ed985fd9061381cca45,PAY/SALARY,<20,2018,9,24,17,0,Monday,14 days,74427.15
ACC-847145727,19,2854.74,61632.61,,CUS-1609060617,2018-10-08,Michael,M,-31.92,115.90,0.0,,,,,,credit,posted,e0d16e74c9ed4e0fb8dcebf370e6e52d,PAY/SALARY,<20,2018,10,8,17,0,Monday,14 days,74427.15
ACC-847145727,19,2854.74,63597.43,,CUS-1609060617,2018-10-22,Michael,M,-31.92,115.90,0.0,,,,,,credit,posted,9c5ad1a8017f42b1baec387eb08c1959,PAY/SALARY,<20,2018,10,22,17,0,Monday,14 days,74427.15
ACC-3827517394,28,4054.77,33035.16,,CUS-2663907001,2018-08-13,Craig,M,-33.89,151.12,0.0,,,,,,credit,posted,05f95c09b465486b8979293114ec6a8a,PAY/SALARY,20-30,2018,8,13,17,0,Monday,14 days,105713.646
ACC-3827517394,28,4054.77,36576.93,,CUS-2663907001,2018-08-27,Craig,M,-33.89,151.12,0.0,,,,,,credit,posted,54189e4ab38a4b54922c6f96caac2dd8,PAY/SALARY,20-30,2018,8,27,17,0,Monday,14 days,105713.646
ACC-3827517394,28,4054.77,39563.7,,CUS-2663907001,2018-09-10,Craig,M,-33.89,151.12,0.0,,,,,,credit,posted,9636a6cfa6114db4840bcccf942cd412,PAY/SALARY,20-30,2018,9,10,17,0,Monday,14 days,105713.646
ACC-3827517394,28,4054.77,42425.26,,CUS-2663907001,2018-09-24,Craig,M,-33.89,151.12,0.0,,,,,,credit,posted,58ebc15cc3fb499d95af95263d637832,PAY/SALARY,20-30,2018,9,24,17,0,Monday,14 days,105713.646
ACC-3827517394,28,4054.77,45187.76,,CUS-2663907001,2018-10-08,Craig,M,-33.89,151.12,0.0,,,,,,credit,posted,fa56b9c4c89640c4a4b49cea6692be83,PAY/SALARY,20-30,2018,10,8,17,0,Monday,14 days,105713.646
ACC-3827517394,28,4054.77,47613.15,,CUS-2663907001,2018-10-22,Craig,M,-33.89,151.12,0.0,,,,,,credit,posted,b21ec763f9854b73aabffed94511e72a,PAY/SALARY,20-30,2018,10,22,17,0,Monday,14 days,105713.646
ACC-1334819143,33,2718.51,59558.05,,CUS-3117610635,2018-08-14,Christopher,M,-37.70,145.13,0.0,,,,,,credit,posted,6fa554ff89ee46a38db9e8bd8abc354d,PAY/SALARY,30-40,2018,8,14,12,0,Tuesday,14 days,70875.439
ACC-1334819143,33,2718.51,60739.04,,CUS-3117610635,2018-08-28,Christopher,M,-37.70,145.13,0.0,,,,,,credit,posted,3e28c68b797b41ce9c660c7e2dfc514d,PAY/SALARY,30-40,2018,8,28,12,0,Tuesday,14 days,70875.439
ACC-1334819143,33,2718.51,62519.84,,CUS-3117610635,2018-09-11,Christopher,M,-37.70,145.13,0.0,,,,,,credit,posted,99fab95431724bd99bf2c4ebd1c278c4,PAY/SALARY,30-40,2018,9,11,12,0,Tuesday,14 days,70875.439
ACC-1334819143,33,2718.51,64558.32,,CUS-3117610635,2018-09-25,Christopher,M,-37.70,145.13,0.0,,,,,,credit,posted,b463b2c625d740f892e53756c9b8c173,PAY/SALARY,30-40,2018,9,25,12,0,Tuesday,14 days,70875.439
ACC-1334819143,33,2718.51,65929.46,,CUS-3117610635,2018-10-09,Christopher,M,-37.70,145.13,0.0,,,,,,credit,posted,f94aa50746204f5188227c3faa63e79d,PAY/SALARY,30-40,2018,10,9,12,0,Tuesday,14 days,70875.439
ACC-1334819143,33,2718.51,68167.53,,CUS-3117610635,2018-10-23,Christopher,M,-37.70,145.13,0.0,,,,,,credit,posted,67f05b89b3664e6d8c2fdd31884d55b0,PAY/SALARY,30-40,2018,10,23,12,0,Tuesday,14 days,70875.439
ACC-1998563091,42,1757.81,14565.96,,CUS-3395687666,2018-08-14,David,M,-35.25,149.03,0.0,,,,,,credit,posted,ae9bbd51de854da0b2b2a9308f768ddb,PAY/SALARY,40-50,2018,8,14,13,0,Tuesday,14 days,45828.618
ACC-1998563091,42,1757.81,16233.77,,CUS-3395687666,2018-08-28,David,M,-35.25,149.03,0.0,,,,,,credit,posted,333624a8128f4b0099588c437db7d159,PAY/SALARY,40-50,2018,8,28,13,0,Tuesday,14 days,45828.618
ACC-1998563091,42,1757.81,17520.17,,CUS-3395687666,2018-09-11,David,M,-35.25,149.03,0.0,,,,,,credit,posted,f5688af1387a4d7cab6c526402acebc3,PAY/SALARY,40-50,2018,9,11,13,0,Tuesday,14 days,45828.618
ACC-1998563091,42,1757.81,17783.98,,CUS-3395687666,2018-09-25,David,M,-35.25,149.03,0.0,,,,,,credit,posted,32db8866c6f44720b6c37ebcd202c64a,PAY/SALARY,40-50,2018,9,25,13,0,Tuesday,14 days,45828.618
ACC-1998563091,42,1757.81,19041.24,,CUS-3395687666,2018-10-09,David,M,-35.25,149.03,0.0,,,,,,credit,posted,bc2a49c97206465fa31ce8619457ab49,PAY/SALARY,40-50,2018,10,9,13,0,Tuesday,14 days,45828.618
ACC-1998563091,42,1757.81,20269.03,,CUS-3395687666,2018-10-23,David,M,-35.25,149.03,0.0,,,,,,credit,posted,b7b5b719587c4e66af1d4b60e9b83284,PAY/SALARY,40-50,2018,10,23,13,0,Tuesday,14 days,45828.618
ACC-1652235822,38,1541.12,19822.38,,CUS-2206365095,2018-08-14,Renee,F,-37.81,144.89,0.0,,,,,,credit,posted,20d2648065e54e6a84ed1b760c5c969f,PAY/SALARY,30-40,2018,8,14,17,0,Tuesday,14 days,40179.2
ACC-1652235822,38,1541.12,21123.41,,CUS-2206365095,2018-08-28,Renee,F,-37.81,144.89,0.0,,,,,,credit,posted,af89d0bb05734fa6b769366d20a97dd0,PAY/SALARY,30-40,2018,8,28,17,0,Tuesday,14 days,40179.2
ACC-1652235822,38,1541.12,22079.56,,CUS-2206365095,2018-09-11,Renee,F,-37.81,144.89,0.0,,,,,,credit,posted,2968a33ec5994ebdb0454c437408fbaf,PAY/SALARY,30-40,2018,9,11,17,0,Tuesday,14 days,40179.2
ACC-1652235822,38,1541.12,21251.74,,CUS-2206365095,2018-09-25,Renee,F,-37.81,144.89,0.0,,,,,,credit,posted,1a695a55b1164b4c806a25cf835fed98,PAY/SALARY,30-40,2018,9,25,17,0,Tuesday,14 days,40179.2
ACC-1652235822,38,1541.12,21581.92,,CUS-2206365095,2018-10-09,Renee,F,-37.81,144.89,0.0,,,,,,credit,posted,b489e3b8a4fc4311a72cfdce0eb186f4,PAY/SALARY,30-40,2018,10,9,17,0,Tuesday,14 days,40179.2
ACC-1652235822,38,1541.12,22480.73,,CUS-2206365095,2018-10-23,Renee,F,-37.81,144.89,0.0,,,,,,credit,posted,15788b98824e4807a729ace08b686444,PAY/SALARY,30-40,2018,10,23,17,0,Tuesday,14 days,40179.2
ACC-354106658,39,5103.51,8754.76,,CUS-2376382098,2018-08-15,Christine,F,-33.80,151.04,0.0,,,,,,credit,posted,41ce67e6c8a4474385fd1646963b6758,PAY/SALARY,30-40,2018,8,15,15,0,Wednesday,0 days,119081.90000000002
ACC-354106658,39,5103.51,10891.05,,CUS-2376382098,2018-09-14,Christine,F,-33.80,151.04,0.0,,,,,,credit,posted,188e04b6e00f44f3a43afbf232a6f5c3,PAY/SALARY,30-40,2018,9,14,15,0,Friday,0 days,119081.90000000002
ACC-354106658,39,5103.51,15994.56,,CUS-2376382098,2018-09-14,Christine,F,-33.80,151.04,0.0,,,,,,credit,posted,7faf986ac5a341e3adfdb7030ec03f48,PAY/SALARY,30-40,2018,9,14,15,0,Friday,0 days,119081.90000000002
ACC-354106658,39,5103.51,19032.03,,CUS-2376382098,2018-10-15,Christine,F,-33.80,151.04,0.0,,,,,,credit,posted,dfff2531d8434969b7f385d364772534,PAY/SALARY,30-40,2018,10,15,15,0,Monday,0 days,119081.90000000002
ACC-354106658,39,5103.51,24135.54,,CUS-2376382098,2018-10-15,Christine,F,-33.80,151.04,0.0,,,,,,credit,posted,e4e7f0dd7c504c45990277dad7a8a86c,PAY/SALARY,30-40,2018,10,15,15,0,Monday,0 days,119081.90000000002
ACC-1683215619,38,2500.0,2503.1,,CUS-1604596597,2018-08-17,Barry,M,-34.86,138.67,0.0,,,,,,credit,posted,04919fcea7f94f67a0110b4fe9e566d2,PAY/SALARY,30-40,2018,8,17,15,0,Friday,0 days,60833.33333333333
ACC-1683215619,38,2500.0,5003.1,,CUS-1604596597,2018-08-17,Barry,M,-34.86,138.67,0.0,,,,,,credit,posted,c0d8288597cd4e42adfec1a5e161e68b,PAY/SALARY,30-40,2018,8,17,15,0,Friday,0 days,60833.33333333333
ACC-1683215619,38,2500.0,6380.41,,CUS-1604596597,2018-09-18,Barry,M,-34.86,138.67,0.0,,,,,,credit,posted,4c76e959bda94646b2ebba276487aa18,PAY/SALARY,30-40,2018,9,18,15,0,Tuesday,0 days,60833.33333333333
ACC-1683215619,38,2500.0,8880.41,,CUS-1604596597,2018-09-18,Barry,M,-34.86,138.67,0.0,,,,,,credit,posted,2503b83e36074dfab25e0f1c5f4ed31c,PAY/SALARY,30-40,2018,9,18,15,0,Tuesday,0 days,60833.33333333333
ACC-1683215619,38,2500.0,9344.75,,CUS-1604596597,2018-10-18,Barry,M,-34.86,138.67,0.0,,,,,,credit,posted,b953427fc9b94de9ad872379108004d7,PAY/SALARY,30-40,2018,10,18,15,0,Thursday,0 days,60833.33333333333
ACC-1683215619,38,2500.0,11844.75,,CUS-1604596597,2018-10-18,Barry,M,-34.86,138.67,0.0,,,,,,credit,posted,85ac3df9a1554c84b7956086e1e86cf3,PAY/SALARY,30-40,2018,10,18,15,0,Thursday,0 days,60833.33333333333
ACC-1523339231,40,8835.98,62647.22,,CUS-1816693151,2018-08-20,Tim,M,-31.90,115.83,0.0,,,,,,credit,posted,b608ce5142664a79af4fa071a886c8f7,PAY/SALARY,30-40,2018,8,20,13,0,Monday,0 days,116340.40333333334
ACC-1523339231,40,8835.98,70242.78,,CUS-1816693151,2018-09-20,Tim,M,-31.90,115.83,0.0,,,,,,credit,posted,854ded55d0034ac8b9e91e16334768ca,PAY/SALARY,30-40,2018,9,20,13,0,Thursday,0 days,116340.40333333334
ACC-1523339231,40,8835.98,77054.31,,CUS-1816693151,2018-10-19,Tim,M,-31.90,115.83,0.0,,,,,,credit,posted,873a3f11d03d41a99c55a5b1a3850e1a,PAY/SALARY,30-40,2018,10,19,13,0,Friday,0 days,116340.40333333334
ACC-1523339231,40,8835.98,85890.29,,CUS-1816693151,2018-10-19,Tim,M,-31.90,115.83,0.0,,,,,,credit,posted,d996300131a641c8bf25f86e1aef9bc6,PAY/SALARY,30-40,2018,10,19,13,0,Friday,0 days,116340.40333333334
ACC-211792489,30,4910.9,6731.99,,CUS-497688347,2018-08-23,Jacqueline,F,-34.93,138.63,0.0,,,,,,credit,posted,2b4ecc820d834f6ea016b40abbfbfde5,PAY/SALARY,20-30,2018,8,23,17,0,Thursday,61 days,29874.641666666663
ACC-211792489,30,4910.9,7397.59,,CUS-497688347,2018-10-23,Jacqueline,F,-34.93,138.63,0.0,,,,,,credit,posted,1c410d75288f4fbb832f88d7f612693b,PAY/SALARY,20-30,2018,10,23,17,0,Tuesday,61 days,29874.641666666663
ACC-2153562714,24,3712.56,3992.78,,CUS-423725039,2018-08-24,Linda,F,-31.88,116.00,0.0,,,,,,credit,posted,13d1b673d560462aa9b879f6b3730e39,PAY/SALARY,20-30,2018,8,24,14,0,Friday,30 days,45169.48
ACC-2153562714,24,3712.56,7076.21,,CUS-423725039,2018-09-24,Linda,F,-31.88,116.00,0.0,,,,,,credit,posted,8d7ddef22c7c4404b63137f3ebd1a6ff,PAY/SALARY,20-30,2018,9,24,14,0,Monday,30 days,45169.48
ACC-2153562714,24,3712.56,9707.77,,CUS-423725039,2018-10-24,Linda,F,-31.88,116.00,0.0,,,,,,credit,posted,fe1b1a6bdd9b43f7985acc4af7b0a101,PAY/SALARY,20-30,2018,10,24,14,0,Wednesday,30 days,45169.48
ACC-1217063613,27,4863.62,4863.86,,CUS-1739931018,2018-09-26,Kimberly,F,-37.82,147.61,0.0,,,,,,credit,posted,8659baa692924427aefbf4077c5a9d67,PAY/SALARY,20-30,2018,9,26,13,0,Wednesday,30 days,59174.043333333335
ACC-1217063613,27,4863.62,8905.77,,CUS-1739931018,2018-10-26,Kimberly,F,-37.82,147.61,0.0,,,,,,credit,posted,e6d8f31d269d4e8388e115719a59dd98,PAY/SALARY,20-30,2018,10,26,13,0,Friday,30 days,59174.043333333335
ACC-3100725361,25,6107.23,6111.57,,CUS-2178051368,2018-09-26,Ronald,M,-17.03,145.73,0.0,,,,,,credit,posted,7eb1fdb7aefb40d1a8ada1d27f556542,PAY/SALARY,20-30,2018,9,26,15,0,Wednesday,30 days,74304.632
ACC-3100725361,25,6107.23,10753.02,,CUS-2178051368,2018-10-26,Ronald,M,-17.03,145.73,0.0,,,,,,credit,posted,56e1a0f55f354624a3c713c37415d216,PAY/SALARY,20-30,2018,10,26,15,0,Friday,30 days,74304.632
